state,report_for_period_ending,indicator_type,0-7,15-21,22-28,29-35,36-42,43-49,50-56,57-63,64-70,71-+,8-14,total,14days_or_fewer,21days_or_fewer,non_waiting_week,first_payment_promptness,md_fy_num,md_fy_str
AK,2019-01-31,inter-total,283,12,3,3,0,0,0,0,0,1,114,416,397,409,FALSE,0.983173076923077,2018,2018-2019
AK,2019-01-31,inter-ucfe,15,0,0,0,0,0,0,0,0,0,8,23,23,23,FALSE,1,2018,2018-2019
AK,2019-01-31,inter-ucx,0,0,0,0,0,0,0,0,0,0,0,0,0,0,FALSE,0,2018,2018-2019
AK,2019-01-31,inter-ui,268,12,3,3,0,0,0,0,0,1,106,393,374,386,FALSE,0.982188295165394,2018,2018-2019
AK,2019-01-31,intra-total,1731,88,17,13,8,4,0,1,0,5,685,2552,2416,2504,FALSE,0.981191222570533,2018,2018-2019
AK,2019-01-31,intra-ucfe,85,6,2,0,0,0,0,0,0,0,42,135,127,133,FALSE,0.985185185185185,2018,2018-2019
AK,2019-01-31,intra-ucx,2,0,0,0,0,0,0,0,0,0,2,4,4,4,FALSE,1,2018,2018-2019
AK,2019-01-31,intra-ui,1644,82,15,13,8,4,0,1,0,5,641,2413,2285,2367,FALSE,0.980936593452134,2018,2018-2019
AK,2019-02-28,inter-total,136,5,0,2,1,0,0,0,0,3,52,199,188,193,FALSE,0.969849246231156,2018,2018-2019
AK,2019-02-28,inter-ucfe,6,1,0,0,0,0,0,0,0,1,3,11,9,10,FALSE,0.909090909090909,2018,2018-2019
AK,2019-02-28,inter-ucx,0,0,0,0,0,0,0,0,0,0,0,0,0,0,FALSE,0,2018,2018-2019
AK,2019-02-28,inter-ui,130,4,0,2,1,0,0,0,0,2,49,188,179,183,FALSE,0.973404255319149,2018,2018-2019
AK,2019-02-28,intra-total,1092,67,34,12,8,7,1,1,2,6,459,1689,1551,1618,FALSE,0.957963291888692,2018,2018-2019
AK,2019-02-28,intra-ucfe,11,5,4,2,1,0,0,0,0,0,3,26,14,19,FALSE,0.730769230769231,2018,2018-2019
AK,2019-02-28,intra-ucx,3,0,0,0,0,0,0,0,0,0,1,4,4,4,FALSE,1,2018,2018-2019
AK,2019-02-28,intra-ui,1078,62,30,10,7,7,1,1,2,6,455,1659,1533,1595,FALSE,0.961422543701025,2018,2018-2019
AK,2019-03-31,inter-total,105,7,5,0,1,0,1,0,1,0,41,161,146,153,FALSE,0.950310559006211,2018,2018-2019
AK,2019-03-31,inter-ucfe,1,1,0,0,0,0,0,0,0,0,1,3,2,3,FALSE,1,2018,2018-2019
AK,2019-03-31,inter-ucx,0,0,0,0,0,0,0,0,0,0,0,0,0,0,FALSE,0,2018,2018-2019
AK,2019-03-31,inter-ui,104,6,5,0,1,0,1,0,1,0,40,158,144,150,FALSE,0.949367088607595,2018,2018-2019
AK,2019-03-31,intra-total,772,41,8,12,6,5,4,2,2,5,315,1172,1087,1128,FALSE,0.962457337883959,2018,2018-2019
AK,2019-03-31,intra-ucfe,8,0,0,0,0,1,0,0,0,2,4,15,12,12,FALSE,0.8,2018,2018-2019
AK,2019-03-31,intra-ucx,3,0,0,0,0,0,0,0,0,0,1,4,4,4,FALSE,1,2018,2018-2019
AK,2019-03-31,intra-ui,761,41,8,12,6,4,4,2,2,3,310,1153,1071,1112,FALSE,0.964440589765828,2018,2018-2019
AK,2019-04-30,inter-total,157,2,1,0,0,0,0,0,0,0,45,205,202,204,FALSE,0.995121951219512,2018,2018-2019
AK,2019-04-30,inter-ucfe,5,0,0,0,0,0,0,0,0,0,0,5,5,5,FALSE,1,2018,2018-2019
AK,2019-04-30,inter-ucx,0,0,0,0,0,0,0,0,0,0,0,0,0,0,FALSE,0,2018,2018-2019
AK,2019-04-30,inter-ui,152,2,1,0,0,0,0,0,0,0,45,200,197,199,FALSE,0.995,2018,2018-2019
AK,2019-04-30,intra-total,703,48,11,9,3,3,1,2,0,5,270,1055,973,1021,FALSE,0.967772511848341,2018,2018-2019
AK,2019-04-30,intra-ucfe,0,1,0,2,0,0,0,1,0,1,2,7,2,3,FALSE,0.428571428571429,2018,2018-2019
AK,2019-04-30,intra-ucx,1,0,0,0,0,0,0,0,0,0,1,2,2,2,FALSE,1,2018,2018-2019
AK,2019-04-30,intra-ui,702,47,11,7,3,3,1,1,0,4,267,1046,969,1016,FALSE,0.97131931166348,2018,2018-2019
AK,2019-05-31,inter-total,248,6,2,1,0,0,0,0,0,0,107,364,355,361,FALSE,0.991758241758242,2018,2018-2019
AK,2019-05-31,inter-ucfe,1,0,0,0,0,0,0,0,0,0,0,1,1,1,FALSE,1,2018,2018-2019
AK,2019-05-31,inter-ucx,0,0,0,0,0,0,0,0,0,0,0,0,0,0,FALSE,0,2018,2018-2019
AK,2019-05-31,inter-ui,247,6,2,1,0,0,0,0,0,0,107,363,354,360,FALSE,0.991735537190083,2018,2018-2019
AK,2019-05-31,intra-total,590,33,8,3,1,0,0,0,1,2,285,923,875,908,FALSE,0.983748645720477,2018,2018-2019
AK,2019-05-31,intra-ucfe,4,1,0,0,0,0,0,0,0,0,5,10,9,10,FALSE,1,2018,2018-2019
AK,2019-05-31,intra-ucx,2,0,0,0,0,0,0,0,0,0,0,2,2,2,FALSE,1,2018,2018-2019
AK,2019-05-31,intra-ui,584,32,8,3,1,0,0,0,1,2,280,911,864,896,FALSE,0.983534577387486,2018,2018-2019
AK,2019-06-30,inter-total,61,3,1,0,1,0,0,0,0,0,28,94,89,92,FALSE,0.978723404255319,2018,2018-2019
AK,2019-06-30,inter-ucfe,2,0,0,0,0,0,0,0,0,0,1,3,3,3,FALSE,1,2018,2018-2019
AK,2019-06-30,inter-ucx,0,0,0,0,0,0,0,0,0,0,0,0,0,0,FALSE,0,2018,2018-2019
AK,2019-06-30,inter-ui,59,3,1,0,1,0,0,0,0,0,27,91,86,89,FALSE,0.978021978021978,2018,2018-2019
AK,2019-06-30,intra-total,671,38,7,2,4,2,0,0,0,3,326,1053,997,1035,FALSE,0.982905982905983,2018,2018-2019
AK,2019-06-30,intra-ucfe,3,0,0,0,0,0,0,0,0,0,0,3,3,3,FALSE,1,2018,2018-2019
AK,2019-06-30,intra-ucx,4,0,0,0,0,0,0,0,0,0,0,4,4,4,FALSE,1,2018,2018-2019
AK,2019-06-30,intra-ui,664,38,7,2,4,2,0,0,0,3,326,1046,990,1028,FALSE,0.982791586998088,2018,2018-2019
AK,2019-07-31,inter-total,67,4,0,0,0,0,0,0,0,0,33,104,100,104,FALSE,1,2019,2019-2020
AK,2019-07-31,inter-ucfe,1,0,0,0,0,0,0,0,0,0,3,4,4,4,FALSE,1,2019,2019-2020
AK,2019-07-31,inter-ucx,0,0,0,0,0,0,0,0,0,0,0,0,0,0,FALSE,0,2019,2019-2020
AK,2019-07-31,inter-ui,66,4,0,0,0,0,0,0,0,0,30,100,96,100,FALSE,1,2019,2019-2020
AK,2019-07-31,intra-total,521,37,6,5,0,5,1,2,1,2,298,878,819,856,FALSE,0.9749430523918,2019,2019-2020
AK,2019-07-31,intra-ucfe,2,1,0,0,0,0,0,0,0,0,0,3,2,3,FALSE,1,2019,2019-2020
AK,2019-07-31,intra-ucx,1,0,0,0,0,0,0,0,0,0,0,1,1,1,FALSE,1,2019,2019-2020
AK,2019-07-31,intra-ui,518,36,6,5,0,5,1,2,1,2,298,874,816,852,FALSE,0.974828375286041,2019,2019-2020
AK,2019-08-31,inter-total,62,2,0,1,0,0,0,0,0,2,28,95,90,92,FALSE,0.968421052631579,2019,2019-2020
AK,2019-08-31,inter-ucfe,0,0,0,0,0,0,0,0,0,1,1,2,1,1,FALSE,0.5,2019,2019-2020
AK,2019-08-31,inter-ucx,0,0,0,0,0,0,0,0,0,0,0,0,0,0,FALSE,0,2019,2019-2020
AK,2019-08-31,inter-ui,62,2,0,1,0,0,0,0,0,1,27,93,89,91,FALSE,0.978494623655914,2019,2019-2020
AK,2019-08-31,intra-total,409,19,5,4,2,1,1,0,0,2,183,626,592,611,FALSE,0.976038338658147,2019,2019-2020
AK,2019-08-31,intra-ucfe,1,0,0,0,0,0,0,0,0,0,1,2,2,2,FALSE,1,2019,2019-2020
AK,2019-08-31,intra-ucx,2,0,0,0,0,0,0,0,0,0,1,3,3,3,FALSE,1,2019,2019-2020
AK,2019-08-31,intra-ui,406,19,5,4,2,1,1,0,0,2,181,621,587,606,FALSE,0.975845410628019,2019,2019-2020
AK,2019-09-30,inter-total,100,2,2,0,1,0,0,1,0,1,47,154,147,149,FALSE,0.967532467532468,2019,2019-2020
AK,2019-09-30,inter-ucfe,1,0,0,0,0,0,0,0,0,0,0,1,1,1,FALSE,1,2019,2019-2020
AK,2019-09-30,inter-ucx,0,0,0,0,0,0,0,0,0,0,0,0,0,0,FALSE,0,2019,2019-2020
AK,2019-09-30,inter-ui,99,2,2,0,1,0,0,1,0,1,47,153,146,148,FALSE,0.967320261437908,2019,2019-2020
AK,2019-09-30,intra-total,368,26,14,3,7,1,1,0,1,3,227,651,595,621,FALSE,0.953917050691244,2019,2019-2020
AK,2019-09-30,intra-ucfe,4,2,1,2,0,0,0,0,0,0,2,11,6,8,FALSE,0.727272727272727,2019,2019-2020
AK,2019-09-30,intra-ucx,2,0,0,0,0,0,0,0,0,0,3,5,5,5,FALSE,1,2019,2019-2020
AK,2019-09-30,intra-ui,362,24,13,1,7,1,1,0,1,3,222,635,584,608,FALSE,0.95748031496063,2019,2019-2020
AK,2019-10-31,inter-total,319,5,1,0,1,0,0,0,0,1,128,455,447,452,FALSE,0.993406593406593,2019,2019-2020
AK,2019-10-31,inter-ucfe,10,0,0,0,0,0,0,0,0,1,0,11,10,10,FALSE,0.909090909090909,2019,2019-2020
AK,2019-10-31,inter-ucx,0,0,0,0,0,0,0,0,0,0,0,0,0,0,FALSE,0,2019,2019-2020
AK,2019-10-31,inter-ui,309,5,1,0,1,0,0,0,0,0,128,444,437,442,FALSE,0.995495495495495,2019,2019-2020
AK,2019-10-31,intra-total,795,34,10,7,0,0,0,2,1,1,354,1204,1149,1183,FALSE,0.982558139534884,2019,2019-2020
AK,2019-10-31,intra-ucfe,11,1,0,1,0,0,0,0,1,0,4,18,15,16,FALSE,0.888888888888889,2019,2019-2020
AK,2019-10-31,intra-ucx,1,0,0,0,0,0,0,0,0,0,1,2,2,2,FALSE,1,2019,2019-2020
AK,2019-10-31,intra-ui,783,33,10,6,0,0,0,2,0,1,349,1184,1132,1165,FALSE,0.983952702702703,2019,2019-2020
AK,2019-11-30,inter-total,463,16,6,2,1,0,0,0,0,0,162,650,625,641,FALSE,0.986153846153846,2019,2019-2020
AK,2019-11-30,inter-ucfe,13,1,0,0,0,0,0,0,0,0,3,17,16,17,FALSE,1,2019,2019-2020
AK,2019-11-30,inter-ucx,0,0,0,0,0,0,0,0,0,0,0,0,0,0,FALSE,0,2019,2019-2020
AK,2019-11-30,inter-ui,450,15,6,2,1,0,0,0,0,0,159,633,609,624,FALSE,0.985781990521327,2019,2019-2020
AK,2019-11-30,intra-total,1130,55,10,5,7,1,2,1,2,0,392,1605,1522,1577,FALSE,0.982554517133956,2019,2019-2020
AK,2019-11-30,intra-ucfe,13,2,0,0,1,0,0,0,0,0,9,25,22,24,FALSE,0.96,2019,2019-2020
AK,2019-11-30,intra-ucx,2,0,0,0,1,0,0,0,0,0,2,5,4,4,FALSE,0.8,2019,2019-2020
AK,2019-11-30,intra-ui,1115,53,10,5,5,1,2,1,2,0,381,1575,1496,1549,FALSE,0.983492063492064,2019,2019-2020
AK,2019-12-31,inter-total,404,24,1,0,0,0,1,0,1,0,173,604,577,601,FALSE,0.995033112582781,2019,2019-2020
AK,2019-12-31,inter-ucfe,15,0,0,0,0,0,0,0,0,0,6,21,21,21,FALSE,1,2019,2019-2020
AK,2019-12-31,inter-ucx,0,0,0,0,0,0,0,0,0,0,0,0,0,0,FALSE,0,2019,2019-2020
AK,2019-12-31,inter-ui,389,24,1,0,0,0,1,0,1,0,167,583,556,580,FALSE,0.994854202401372,2019,2019-2020
AK,2019-12-31,intra-total,1196,65,16,9,1,3,2,2,0,0,573,1867,1769,1834,FALSE,0.982324584895554,2019,2019-2020
AK,2019-12-31,intra-ucfe,20,1,1,0,0,0,1,0,0,0,13,36,33,34,FALSE,0.944444444444444,2019,2019-2020
AK,2019-12-31,intra-ucx,0,0,0,0,0,0,0,0,0,0,1,1,1,1,FALSE,1,2019,2019-2020
AK,2019-12-31,intra-ui,1176,64,15,9,1,3,1,2,0,0,559,1830,1735,1799,FALSE,0.983060109289618,2019,2019-2020
AK,2020-01-31,inter-total,264,11,3,1,1,1,0,0,0,1,90,372,354,365,FALSE,0.981182795698925,2019,2019-2020
AK,2020-01-31,inter-ucfe,16,0,0,0,0,1,0,0,0,1,2,20,18,18,FALSE,0.9,2019,2019-2020
AK,2020-01-31,inter-ucx,0,0,0,0,0,0,0,0,0,0,0,0,0,0,FALSE,0,2019,2019-2020
AK,2020-01-31,inter-ui,248,11,3,1,1,0,0,0,0,0,88,352,336,347,FALSE,0.985795454545455,2019,2019-2020
AK,2020-01-31,intra-total,1267,58,15,10,3,3,2,1,1,3,558,1921,1825,1883,FALSE,0.980218636127017,2019,2019-2020
AK,2020-01-31,intra-ucfe,18,2,0,0,0,0,1,0,0,0,9,30,27,29,FALSE,0.966666666666667,2019,2019-2020
AK,2020-01-31,intra-ucx,1,0,0,0,0,0,1,0,0,0,2,4,3,3,FALSE,0.75,2019,2019-2020
AK,2020-01-31,intra-ui,1248,56,15,10,3,3,0,1,1,3,547,1887,1795,1851,FALSE,0.980922098569157,2019,2019-2020
AK,2020-02-29,inter-total,127,8,2,0,0,1,0,0,0,0,68,206,195,203,FALSE,0.985436893203883,2019,2019-2020
AK,2020-02-29,inter-ucfe,8,0,0,0,0,1,0,0,0,0,3,12,11,11,FALSE,0.916666666666667,2019,2019-2020
AK,2020-02-29,inter-ucx,0,0,0,0,0,0,0,0,0,0,0,0,0,0,FALSE,0,2019,2019-2020
AK,2020-02-29,inter-ui,119,8,2,0,0,0,0,0,0,0,65,194,184,192,FALSE,0.989690721649485,2019,2019-2020
AK,2020-02-29,intra-total,978,55,14,2,6,1,2,1,1,1,446,1507,1424,1479,FALSE,0.9814200398142,2019,2019-2020
AK,2020-02-29,intra-ucfe,10,0,0,0,1,0,0,0,0,0,5,16,15,15,FALSE,0.9375,2019,2019-2020
AK,2020-02-29,intra-ucx,1,0,0,0,0,0,0,0,1,0,1,3,2,2,FALSE,0.666666666666667,2019,2019-2020
AK,2020-02-29,intra-ui,967,55,14,2,5,1,2,1,0,1,440,1488,1407,1462,FALSE,0.98252688172043,2019,2019-2020
AK,2020-03-31,inter-total,142,6,2,0,1,0,0,0,0,0,43,194,185,191,FALSE,0.984536082474227,2019,2019-2020
AK,2020-03-31,inter-ucfe,2,1,1,0,0,0,0,0,0,0,3,7,5,6,FALSE,0.857142857142857,2019,2019-2020
AK,2020-03-31,inter-ucx,0,0,0,0,0,0,0,0,0,0,0,0,0,0,FALSE,0,2019,2019-2020
AK,2020-03-31,inter-ui,140,5,1,0,1,0,0,0,0,0,40,187,180,185,FALSE,0.989304812834225,2019,2019-2020
AK,2020-03-31,intra-total,1407,55,9,3,1,3,2,1,2,1,381,1865,1788,1843,FALSE,0.988203753351207,2019,2019-2020
AK,2020-03-31,intra-ucfe,5,0,1,0,1,0,0,0,0,0,4,11,9,9,FALSE,0.818181818181818,2019,2019-2020
AK,2020-03-31,intra-ucx,0,0,0,0,0,0,0,0,0,0,2,2,2,2,FALSE,1,2019,2019-2020
AK,2020-03-31,intra-ui,1402,55,8,3,0,3,2,1,2,1,375,1852,1777,1832,FALSE,0.989200863930886,2019,2019-2020
AK,2020-04-30,inter-total,775,516,469,140,10,3,0,0,1,1,504,2419,1279,1795,FALSE,0.742042166184374,2019,2019-2020
AK,2020-04-30,inter-ucfe,1,1,1,1,0,0,0,0,1,0,2,7,3,4,FALSE,0.571428571428571,2019,2019-2020
AK,2020-04-30,inter-ucx,0,0,0,0,0,0,0,0,0,0,0,0,0,0,FALSE,0,2019,2019-2020
AK,2020-04-30,inter-ui,774,515,468,139,10,3,0,0,0,1,502,2412,1276,1791,FALSE,0.742537313432836,2019,2019-2020
AK,2020-04-30,intra-total,5829,6683,7462,2839,160,50,3,2,1,3,5973,29005,11802,18485,FALSE,0.637303913118428,2019,2019-2020
AK,2020-04-30,intra-ucfe,5,5,7,5,1,0,0,0,0,0,4,27,9,14,FALSE,0.518518518518519,2019,2019-2020
AK,2020-04-30,intra-ucx,0,6,0,2,0,0,0,0,0,0,3,11,3,9,FALSE,0.818181818181818,2019,2019-2020
AK,2020-04-30,intra-ui,5824,6672,7455,2832,159,50,3,2,1,3,5966,28967,11790,18462,FALSE,0.637345945386129,2019,2019-2020
AK,2020-05-31,inter-total,884,49,37,42,19,13,2,0,1,1,172,1220,1056,1105,FALSE,0.905737704918033,2019,2019-2020
AK,2020-05-31,inter-ucfe,0,2,0,0,1,0,0,0,0,0,1,4,1,3,FALSE,0.75,2019,2019-2020
AK,2020-05-31,inter-ucx,0,0,2,0,0,0,0,0,0,0,0,2,0,0,FALSE,0,2019,2019-2020
AK,2020-05-31,inter-ui,884,47,35,42,18,13,2,0,1,1,171,1214,1055,1102,FALSE,0.907742998352554,2019,2019-2020
AK,2020-05-31,intra-total,5663,732,706,667,407,230,77,40,11,3,1331,9867,6994,7726,FALSE,0.783014087361913,2019,2019-2020
AK,2020-05-31,intra-ucfe,6,6,6,4,7,5,1,0,0,0,8,43,14,20,FALSE,0.465116279069768,2019,2019-2020
AK,2020-05-31,intra-ucx,0,1,2,0,0,0,0,0,0,0,4,7,4,5,FALSE,0.714285714285714,2019,2019-2020
AK,2020-05-31,intra-ui,5657,725,698,663,400,225,76,40,11,3,1319,9817,6976,7701,FALSE,0.784455536314556,2019,2019-2020
AK,2020-06-30,inter-total,420,45,44,32,20,23,7,7,9,14,75,696,495,540,FALSE,0.775862068965517,2019,2019-2020
AK,2020-06-30,inter-ucfe,0,1,0,0,0,0,1,0,0,1,0,3,0,1,FALSE,0.333333333333333,2019,2019-2020
AK,2020-06-30,inter-ucx,0,0,3,0,0,0,0,0,0,0,0,3,0,0,FALSE,0,2019,2019-2020
AK,2020-06-30,inter-ui,420,44,41,32,20,23,6,7,9,13,75,690,495,539,FALSE,0.781159420289855,2019,2019-2020
AK,2020-06-30,intra-total,3126,369,295,274,276,207,179,144,169,246,646,5931,3772,4141,FALSE,0.698195919743719,2019,2019-2020
AK,2020-06-30,intra-ucfe,1,4,3,8,4,5,6,3,4,1,7,46,8,12,FALSE,0.260869565217391,2019,2019-2020
AK,2020-06-30,intra-ucx,3,5,3,5,1,2,1,2,1,1,2,26,5,10,FALSE,0.384615384615385,2019,2019-2020
AK,2020-06-30,intra-ui,3122,360,289,261,271,200,172,139,164,244,637,5859,3759,4119,FALSE,0.703020993343574,2019,2019-2020
AK,2020-07-31,inter-total,236,26,11,12,9,1,7,6,1,38,45,392,281,307,FALSE,0.783163265306123,2020,2020-2021
AK,2020-07-31,inter-ucfe,0,0,0,0,0,0,0,0,0,0,1,1,1,1,FALSE,1,2020,2020-2021
AK,2020-07-31,inter-ucx,0,1,1,0,0,0,0,0,0,0,0,2,0,1,FALSE,0.5,2020,2020-2021
AK,2020-07-31,inter-ui,236,25,10,12,9,1,7,6,1,38,44,389,280,305,FALSE,0.784061696658098,2020,2020-2021
AK,2020-07-31,intra-total,1708,188,102,79,80,73,78,87,82,417,484,3378,2192,2380,FALSE,0.704558910597987,2020,2020-2021
AK,2020-07-31,intra-ucfe,17,5,1,0,0,2,1,1,1,9,12,49,29,34,FALSE,0.693877551020408,2020,2020-2021
AK,2020-07-31,intra-ucx,9,2,1,2,0,2,3,0,4,2,5,30,14,16,FALSE,0.533333333333333,2020,2020-2021
AK,2020-07-31,intra-ui,1682,181,100,77,80,69,74,86,77,406,467,3299,2149,2330,FALSE,0.706274628675356,2020,2020-2021
AK,2020-08-31,inter-total,193,21,10,4,1,2,3,5,3,16,52,310,245,266,FALSE,0.858064516129032,2020,2020-2021
AK,2020-08-31,inter-ucfe,1,0,0,1,0,0,0,0,0,0,1,3,2,2,FALSE,0.666666666666667,2020,2020-2021
AK,2020-08-31,inter-ucx,1,0,0,0,0,0,0,0,0,0,0,1,1,1,FALSE,1,2020,2020-2021
AK,2020-08-31,inter-ui,191,21,10,3,1,2,3,5,3,16,51,306,242,263,FALSE,0.859477124183007,2020,2020-2021
AK,2020-08-31,intra-total,1069,101,81,53,43,32,30,59,39,247,287,2041,1356,1457,FALSE,0.713865752082313,2020,2020-2021
AK,2020-08-31,intra-ucfe,4,1,1,0,1,1,1,3,0,5,2,19,6,7,FALSE,0.368421052631579,2020,2020-2021
AK,2020-08-31,intra-ucx,3,1,0,0,1,0,1,0,0,2,1,9,4,5,FALSE,0.555555555555556,2020,2020-2021
AK,2020-08-31,intra-ui,1062,99,80,53,41,31,28,56,39,240,284,2013,1346,1445,FALSE,0.717834078489816,2020,2020-2021
AK,2020-09-30,inter-total,286,23,16,11,4,5,3,1,1,15,61,426,347,370,FALSE,0.868544600938967,2020,2020-2021
AK,2020-09-30,inter-ucfe,1,0,0,0,0,0,0,0,0,0,0,1,1,1,FALSE,1,2020,2020-2021
AK,2020-09-30,inter-ucx,0,0,2,0,0,0,0,0,0,0,0,2,0,0,FALSE,0,2020,2020-2021
AK,2020-09-30,inter-ui,285,23,14,11,4,5,3,1,1,15,61,423,346,369,FALSE,0.872340425531915,2020,2020-2021
AK,2020-09-30,intra-total,1087,105,62,61,48,26,25,17,14,229,248,1922,1335,1440,FALSE,0.749219562955255,2020,2020-2021
AK,2020-09-30,intra-ucfe,5,3,3,0,0,0,1,0,2,1,1,16,6,9,FALSE,0.5625,2020,2020-2021
AK,2020-09-30,intra-ucx,2,0,2,0,0,0,0,0,0,0,1,5,3,3,FALSE,0.6,2020,2020-2021
AK,2020-09-30,intra-ui,1080,102,57,61,48,26,24,17,12,228,246,1901,1326,1428,FALSE,0.751183587585481,2020,2020-2021
AK,2020-10-31,inter-total,397,21,9,0,4,5,4,2,0,20,80,542,477,498,FALSE,0.918819188191882,2020,2020-2021
AK,2020-10-31,inter-ucfe,4,2,0,0,1,0,0,0,0,1,1,9,5,7,FALSE,0.777777777777778,2020,2020-2021
AK,2020-10-31,inter-ucx,0,0,1,0,0,0,0,0,0,0,0,1,0,0,FALSE,0,2020,2020-2021
AK,2020-10-31,inter-ui,393,19,8,0,3,5,4,2,0,19,79,532,472,491,FALSE,0.922932330827068,2020,2020-2021
AK,2020-10-31,intra-total,1272,98,45,34,25,28,33,25,14,237,304,2115,1576,1674,FALSE,0.791489361702128,2020,2020-2021
AK,2020-10-31,intra-ucfe,6,4,4,3,2,2,0,1,0,5,5,32,11,15,FALSE,0.46875,2020,2020-2021
AK,2020-10-31,intra-ucx,2,2,1,0,1,0,0,0,0,0,0,6,2,4,FALSE,0.666666666666667,2020,2020-2021
AK,2020-10-31,intra-ui,1264,92,40,31,22,26,33,24,14,232,299,2077,1563,1655,FALSE,0.796822339913337,2020,2020-2021
AK,2020-11-30,inter-total,554,35,13,4,4,2,2,2,1,18,95,730,649,684,FALSE,0.936986301369863,2020,2020-2021
AK,2020-11-30,inter-ucfe,0,4,2,0,1,0,0,0,0,0,4,11,4,8,FALSE,0.727272727272727,2020,2020-2021
AK,2020-11-30,inter-ucx,0,0,0,0,0,0,0,0,0,0,0,0,0,0,FALSE,0,2020,2020-2021
AK,2020-11-30,inter-ui,554,31,11,4,3,2,2,2,1,18,91,719,645,676,FALSE,0.94019471488178,2020,2020-2021
AK,2020-11-30,intra-total,1776,134,49,29,9,16,6,14,24,260,409,2726,2185,2319,FALSE,0.850696991929567,2020,2020-2021
AK,2020-11-30,intra-ucfe,8,8,4,6,2,0,0,0,0,7,13,48,21,29,FALSE,0.604166666666667,2020,2020-2021
AK,2020-11-30,intra-ucx,1,2,0,0,0,0,0,0,0,1,2,6,3,5,FALSE,0.833333333333333,2020,2020-2021
AK,2020-11-30,intra-ui,1767,124,45,23,7,16,6,14,24,252,394,2672,2161,2285,FALSE,0.855164670658683,2020,2020-2021
AK,2020-12-31,inter-total,498,24,20,13,6,4,1,2,2,12,66,648,564,588,FALSE,0.907407407407407,2020,2020-2021
AK,2020-12-31,inter-ucfe,1,1,8,3,2,0,1,1,1,0,1,19,2,3,FALSE,0.157894736842105,2020,2020-2021
AK,2020-12-31,inter-ucx,0,0,0,0,0,0,0,0,0,0,0,0,0,0,FALSE,0,2020,2020-2021
AK,2020-12-31,inter-ui,497,23,12,10,4,4,0,1,1,12,65,629,562,585,FALSE,0.930047694753577,2020,2020-2021
AK,2020-12-31,intra-total,2304,184,111,57,41,29,12,10,2,165,413,3328,2717,2901,FALSE,0.871694711538462,2020,2020-2021
AK,2020-12-31,intra-ucfe,9,9,6,9,5,4,2,1,0,4,11,60,20,29,FALSE,0.483333333333333,2020,2020-2021
AK,2020-12-31,intra-ucx,0,0,0,0,0,0,0,0,0,0,2,2,2,2,FALSE,1,2020,2020-2021
AK,2020-12-31,intra-ui,2295,175,105,48,36,25,10,9,2,161,400,3266,2695,2870,FALSE,0.878750765462339,2020,2020-2021
AK,2021-01-31,inter-total,246,21,9,6,10,6,5,7,5,17,53,385,299,320,FALSE,0.831168831168831,2020,2020-2021
AK,2021-01-31,inter-ucfe,2,2,2,1,0,4,1,1,2,1,2,18,4,6,FALSE,0.333333333333333,2020,2020-2021
AK,2021-01-31,inter-ucx,0,0,0,0,0,0,0,0,0,0,0,0,0,0,FALSE,0,2020,2020-2021
AK,2021-01-31,inter-ui,244,19,7,5,10,2,4,6,3,16,51,367,295,314,FALSE,0.85558583106267,2020,2020-2021
AK,2021-01-31,intra-total,1510,147,67,51,31,29,27,22,14,113,334,2345,1844,1991,FALSE,0.849040511727079,2020,2020-2021
AK,2021-01-31,intra-ucfe,10,4,6,3,7,3,5,1,0,2,11,52,21,25,FALSE,0.480769230769231,2020,2020-2021
AK,2021-01-31,intra-ucx,0,1,0,0,0,0,1,0,0,1,1,4,1,2,FALSE,0.5,2020,2020-2021
AK,2021-01-31,intra-ui,1500,142,61,48,24,26,21,21,14,110,322,2289,1822,1964,FALSE,0.858016601135867,2020,2020-2021
AK,2021-02-28,inter-total,168,18,12,6,4,3,3,2,2,21,36,275,204,222,FALSE,0.807272727272727,2020,2020-2021
AK,2021-02-28,inter-ucfe,0,3,4,2,0,0,0,0,0,4,4,17,4,7,FALSE,0.411764705882353,2020,2020-2021
AK,2021-02-28,inter-ucx,0,0,0,0,0,0,0,0,0,0,0,0,0,0,FALSE,0,2020,2020-2021
AK,2021-02-28,inter-ui,168,15,8,4,4,3,3,2,2,17,32,258,200,215,FALSE,0.833333333333333,2020,2020-2021
AK,2021-02-28,intra-total,1463,140,84,38,25,20,20,15,20,296,369,2490,1832,1972,FALSE,0.791967871485944,2020,2020-2021
AK,2021-02-28,intra-ucfe,2,10,7,2,1,1,3,1,1,4,7,39,9,19,FALSE,0.487179487179487,2020,2020-2021
AK,2021-02-28,intra-ucx,2,1,0,0,0,1,0,0,0,0,2,6,4,5,FALSE,0.833333333333333,2020,2020-2021
AK,2021-02-28,intra-ui,1459,129,77,36,24,18,17,14,19,292,360,2445,1819,1948,FALSE,0.796728016359918,2020,2020-2021
AK,2021-03-31,inter-total,177,8,2,2,1,5,2,4,3,28,25,257,202,210,FALSE,0.817120622568093,2020,2020-2021
AK,2021-03-31,inter-ucfe,0,0,0,0,0,1,0,2,0,3,0,6,0,0,FALSE,0,2020,2020-2021
AK,2021-03-31,inter-ucx,0,0,0,0,0,0,0,0,0,0,0,0,0,0,FALSE,0,2020,2020-2021
AK,2021-03-31,inter-ui,177,8,2,2,1,4,2,2,3,25,25,251,202,210,FALSE,0.836653386454183,2020,2020-2021
AK,2021-03-31,intra-total,1532,94,49,25,19,19,14,23,15,306,362,2458,1894,1988,FALSE,0.808787632221318,2020,2020-2021
AK,2021-03-31,intra-ucfe,4,6,3,0,1,1,3,2,0,8,8,36,12,18,FALSE,0.5,2020,2020-2021
AK,2021-03-31,intra-ucx,4,2,0,0,0,0,1,0,0,2,0,9,4,6,FALSE,0.666666666666667,2020,2020-2021
AK,2021-03-31,intra-ui,1524,86,46,25,18,18,10,21,15,296,354,2413,1878,1964,FALSE,0.813924575217571,2020,2020-2021
AK,2021-04-30,inter-total,187,13,5,3,0,0,1,1,0,10,37,257,224,237,FALSE,0.922178988326848,2020,2020-2021
AK,2021-04-30,inter-ucfe,1,0,0,0,0,0,0,0,0,0,0,1,1,1,FALSE,1,2020,2020-2021
AK,2021-04-30,inter-ucx,0,0,0,0,0,0,0,0,0,0,0,0,0,0,FALSE,0,2020,2020-2021
AK,2021-04-30,inter-ui,186,13,5,3,0,0,1,1,0,10,37,256,223,236,FALSE,0.921875,2020,2020-2021
AK,2021-04-30,intra-total,1711,143,48,33,17,4,6,10,14,212,427,2625,2138,2281,FALSE,0.868952380952381,2020,2020-2021
AK,2021-04-30,intra-ucfe,3,5,1,1,0,1,0,1,0,3,6,21,9,14,FALSE,0.666666666666667,2020,2020-2021
AK,2021-04-30,intra-ucx,1,1,0,1,1,0,0,0,0,0,1,5,2,3,FALSE,0.6,2020,2020-2021
AK,2021-04-30,intra-ui,1707,137,47,31,16,3,6,9,14,209,420,2599,2127,2264,FALSE,0.871104270873413,2020,2020-2021
AK,2021-05-31,inter-total,346,12,4,2,1,0,0,0,2,13,27,407,373,385,FALSE,0.945945945945946,2020,2020-2021
AK,2021-05-31,inter-ucfe,0,0,1,0,0,0,0,0,1,3,0,5,0,0,FALSE,0,2020,2020-2021
AK,2021-05-31,inter-ucx,0,0,0,0,0,0,0,0,0,0,0,0,0,0,FALSE,0,2020,2020-2021
AK,2021-05-31,inter-ui,346,12,3,2,1,0,0,0,1,10,27,402,373,385,FALSE,0.95771144278607,2020,2020-2021
AK,2021-05-31,intra-total,1238,75,45,25,14,8,10,15,8,169,177,1784,1415,1490,FALSE,0.835201793721973,2020,2020-2021
AK,2021-05-31,intra-ucfe,7,3,0,0,0,0,0,1,0,11,6,28,13,16,FALSE,0.571428571428571,2020,2020-2021
AK,2021-05-31,intra-ucx,3,0,0,0,0,0,0,0,0,1,0,4,3,3,FALSE,0.75,2020,2020-2021
AK,2021-05-31,intra-ui,1228,72,45,25,14,8,10,14,8,157,171,1752,1399,1471,FALSE,0.839611872146119,2020,2020-2021
AK,2021-06-30,inter-total,197,7,5,3,4,2,2,5,2,6,15,248,212,219,FALSE,0.883064516129032,2020,2020-2021
AK,2021-06-30,inter-ucfe,0,1,0,0,0,0,1,0,0,0,0,2,0,1,FALSE,0.5,2020,2020-2021
AK,2021-06-30,inter-ucx,0,0,1,0,0,0,0,0,0,0,0,1,0,0,FALSE,0,2020,2020-2021
AK,2021-06-30,inter-ui,197,6,4,3,4,2,1,5,2,6,15,245,212,218,FALSE,0.889795918367347,2020,2020-2021
AK,2021-06-30,intra-total,1174,52,41,25,17,20,23,35,33,148,183,1751,1357,1409,FALSE,0.804683038263849,2020,2020-2021
AK,2021-06-30,intra-ucfe,2,0,1,3,0,1,1,1,0,3,3,15,5,5,FALSE,0.333333333333333,2020,2020-2021
AK,2021-06-30,intra-ucx,1,0,1,0,0,0,0,0,0,0,0,2,1,1,FALSE,0.5,2020,2020-2021
AK,2021-06-30,intra-ui,1171,52,39,22,17,19,22,34,33,145,180,1734,1351,1403,FALSE,0.809111880046136,2020,2020-2021
AK,2021-07-31,inter-total,59,1,1,0,2,2,5,6,0,2,4,82,63,64,FALSE,0.780487804878049,2021,2021-2022
AK,2021-07-31,inter-ucfe,0,1,0,0,0,0,0,0,0,0,0,1,0,1,FALSE,1,2021,2021-2022
AK,2021-07-31,inter-ucx,0,0,0,0,0,0,0,0,0,0,0,0,0,0,FALSE,0,2021,2021-2022
AK,2021-07-31,inter-ui,59,0,1,0,2,2,5,6,0,2,4,81,63,63,FALSE,0.777777777777778,2021,2021-2022
AK,2021-07-31,intra-total,622,30,13,21,19,42,44,55,31,46,112,1035,734,764,FALSE,0.73816425120773,2021,2021-2022
AK,2021-07-31,intra-ucfe,4,0,0,0,1,1,1,1,0,2,0,10,4,4,FALSE,0.4,2021,2021-2022
AK,2021-07-31,intra-ucx,2,0,0,0,0,0,0,0,0,0,0,2,2,2,FALSE,1,2021,2021-2022
AK,2021-07-31,intra-ui,616,30,13,21,18,41,43,54,31,44,112,1023,728,758,FALSE,0.740957966764418,2021,2021-2022
AK,2021-08-31,inter-total,130,8,1,3,4,5,1,4,3,3,13,175,143,151,FALSE,0.862857142857143,2021,2021-2022
AK,2021-08-31,inter-ucfe,0,0,0,0,0,0,0,0,1,0,0,1,0,0,FALSE,0,2021,2021-2022
AK,2021-08-31,inter-ucx,0,0,0,0,0,0,0,0,0,0,0,0,0,0,FALSE,0,2021,2021-2022
AK,2021-08-31,inter-ui,130,8,1,3,4,5,1,4,2,3,13,174,143,151,FALSE,0.867816091954023,2021,2021-2022
AK,2021-08-31,intra-total,553,32,33,31,44,34,20,17,13,33,79,889,632,664,FALSE,0.746906636670416,2021,2021-2022
AK,2021-08-31,intra-ucfe,5,1,3,0,0,1,1,0,1,3,1,16,6,7,FALSE,0.4375,2021,2021-2022
AK,2021-08-31,intra-ucx,0,1,0,0,0,0,0,0,0,0,0,1,0,1,FALSE,1,2021,2021-2022
AK,2021-08-31,intra-ui,548,30,30,31,44,33,19,17,12,30,78,872,626,656,FALSE,0.752293577981651,2021,2021-2022
AK,2021-09-30,inter-total,206,5,6,1,1,2,1,0,0,2,17,241,223,228,FALSE,0.946058091286307,2021,2021-2022
AK,2021-09-30,inter-ucfe,1,1,1,0,0,0,0,0,0,0,0,3,1,2,FALSE,0.666666666666667,2021,2021-2022
AK,2021-09-30,inter-ucx,0,0,0,0,0,0,0,0,0,0,0,0,0,0,FALSE,0,2021,2021-2022
AK,2021-09-30,inter-ui,205,4,5,1,1,2,1,0,0,2,17,238,222,226,FALSE,0.949579831932773,2021,2021-2022
AK,2021-09-30,intra-total,1051,52,55,27,10,9,6,3,1,30,128,1372,1179,1231,FALSE,0.897230320699709,2021,2021-2022
AK,2021-09-30,intra-ucfe,6,2,0,1,0,0,0,1,0,5,3,18,9,11,FALSE,0.611111111111111,2021,2021-2022
AK,2021-09-30,intra-ucx,2,0,0,0,0,0,0,0,1,0,1,4,3,3,FALSE,0.75,2021,2021-2022
AK,2021-09-30,intra-ui,1043,50,55,26,10,9,6,2,0,25,124,1350,1167,1217,FALSE,0.901481481481481,2021,2021-2022
AK,2021-10-31,inter-total,254,9,7,5,0,0,0,1,0,2,39,317,293,302,FALSE,0.952681388012618,2021,2021-2022
AK,2021-10-31,inter-ucfe,1,0,0,1,0,0,0,0,0,0,1,3,2,2,FALSE,0.666666666666667,2021,2021-2022
AK,2021-10-31,inter-ucx,0,0,0,0,0,0,0,0,0,0,0,0,0,0,FALSE,0,2021,2021-2022
AK,2021-10-31,inter-ui,253,9,7,4,0,0,0,1,0,2,38,314,291,300,FALSE,0.955414012738854,2021,2021-2022
AK,2021-10-31,intra-total,698,64,29,11,10,1,2,1,0,10,135,961,833,897,FALSE,0.933402705515088,2021,2021-2022
AK,2021-10-31,intra-ucfe,4,2,0,0,0,0,1,0,0,1,4,12,8,10,FALSE,0.833333333333333,2021,2021-2022
AK,2021-10-31,intra-ucx,1,0,0,0,0,1,0,0,0,0,1,3,2,2,FALSE,0.666666666666667,2021,2021-2022
AK,2021-10-31,intra-ui,693,62,29,11,10,0,1,1,0,9,130,946,823,885,FALSE,0.935517970401691,2021,2021-2022
AK,2021-11-30,inter-total,508,20,8,3,1,2,1,0,0,2,79,624,587,607,FALSE,0.97275641025641,2021,2021-2022
AK,2021-11-30,inter-ucfe,10,2,0,0,0,1,1,0,0,1,3,18,13,15,FALSE,0.833333333333333,2021,2021-2022
AK,2021-11-30,inter-ucx,0,0,1,0,0,0,0,0,0,0,0,1,0,0,FALSE,0,2021,2021-2022
AK,2021-11-30,inter-ui,498,18,7,3,1,1,0,0,0,1,76,605,574,592,FALSE,0.978512396694215,2021,2021-2022
AK,2021-11-30,intra-total,1317,62,33,10,11,6,2,3,3,13,215,1675,1532,1594,FALSE,0.951641791044776,2021,2021-2022
AK,2021-11-30,intra-ucfe,9,0,0,1,1,0,0,0,1,2,5,19,14,14,FALSE,0.736842105263158,2021,2021-2022
AK,2021-11-30,intra-ucx,1,1,1,0,0,0,0,0,0,0,1,4,2,3,FALSE,0.75,2021,2021-2022
AK,2021-11-30,intra-ui,1307,61,32,9,10,6,2,3,2,11,209,1652,1516,1577,FALSE,0.954600484261501,2021,2021-2022
AK,2021-12-31,inter-total,322,16,9,6,5,0,1,0,0,2,39,400,361,377,FALSE,0.9425,2021,2021-2022
AK,2021-12-31,inter-ucfe,5,1,4,5,0,0,0,0,0,1,6,22,11,12,FALSE,0.545454545454545,2021,2021-2022
AK,2021-12-31,inter-ucx,0,0,0,0,0,0,0,0,0,0,0,0,0,0,FALSE,0,2021,2021-2022
AK,2021-12-31,inter-ui,317,15,5,1,5,0,1,0,0,1,33,378,350,365,FALSE,0.965608465608465,2021,2021-2022
AK,2021-12-31,intra-total,1253,60,34,19,8,4,2,0,1,16,215,1612,1468,1528,FALSE,0.947890818858561,2021,2021-2022
AK,2021-12-31,intra-ucfe,15,2,5,2,3,1,1,0,0,1,10,40,25,27,FALSE,0.675,2021,2021-2022
AK,2021-12-31,intra-ucx,3,0,0,0,0,0,0,0,0,0,0,3,3,3,FALSE,1,2021,2021-2022
AK,2021-12-31,intra-ui,1235,58,29,17,5,3,1,0,1,15,205,1569,1440,1498,FALSE,0.954748247291268,2021,2021-2022
AK,2022-01-31,inter-total,238,10,5,0,0,1,0,0,1,1,42,298,280,290,FALSE,0.973154362416107,2021,2021-2022
AK,2022-01-31,inter-ucfe,6,2,1,0,0,0,0,0,0,0,2,11,8,10,FALSE,0.909090909090909,2021,2021-2022
AK,2022-01-31,inter-ucx,0,0,0,0,0,0,0,0,0,0,0,0,0,0,FALSE,0,2021,2021-2022
AK,2022-01-31,inter-ui,232,8,4,0,0,1,0,0,1,1,40,287,272,280,FALSE,0.975609756097561,2021,2021-2022
AK,2022-01-31,intra-total,1043,63,22,11,4,3,4,0,0,17,185,1352,1228,1291,FALSE,0.954881656804734,2021,2021-2022
AK,2022-01-31,intra-ucfe,10,2,0,1,1,1,0,0,0,1,8,24,18,20,FALSE,0.833333333333333,2021,2021-2022
AK,2022-01-31,intra-ucx,0,0,0,0,0,0,0,0,0,0,0,0,0,0,FALSE,0,2021,2021-2022
AK,2022-01-31,intra-ui,1033,61,22,10,3,2,4,0,0,16,177,1328,1210,1271,FALSE,0.957078313253012,2021,2021-2022
AK,2022-02-28,inter-total,137,4,1,0,1,0,0,0,0,2,15,160,152,156,FALSE,0.975,2021,2021-2022
AK,2022-02-28,inter-ucfe,4,1,1,0,1,0,0,0,0,0,2,9,6,7,FALSE,0.777777777777778,2021,2021-2022
AK,2022-02-28,inter-ucx,0,0,0,0,0,0,0,0,0,0,0,0,0,0,FALSE,0,2021,2021-2022
AK,2022-02-28,inter-ui,133,3,0,0,0,0,0,0,0,2,13,151,146,149,FALSE,0.986754966887417,2021,2021-2022
AK,2022-02-28,intra-total,829,39,9,10,2,0,0,1,1,10,134,1035,963,1002,FALSE,0.968115942028986,2021,2021-2022
AK,2022-02-28,intra-ucfe,10,4,0,1,0,0,0,0,0,2,3,20,13,17,FALSE,0.85,2021,2021-2022
AK,2022-02-28,intra-ucx,1,0,0,0,0,0,0,0,0,0,1,2,2,2,FALSE,1,2021,2021-2022
AK,2022-02-28,intra-ui,818,35,9,9,2,0,0,1,1,8,130,1013,948,983,FALSE,0.970384995064166,2021,2021-2022
AK,2022-03-31,inter-total,109,0,3,0,0,0,1,0,0,1,16,130,125,125,FALSE,0.961538461538461,2021,2021-2022
AK,2022-03-31,inter-ucfe,0,0,1,0,0,0,1,0,0,1,2,5,2,2,FALSE,0.4,2021,2021-2022
AK,2022-03-31,inter-ucx,0,0,0,0,0,0,0,0,0,0,0,0,0,0,FALSE,0,2021,2021-2022
AK,2022-03-31,inter-ui,109,0,2,0,0,0,0,0,0,0,14,125,123,123,FALSE,0.984,2021,2021-2022
AK,2022-03-31,intra-total,754,16,5,6,4,3,2,3,1,14,115,923,869,885,FALSE,0.958829902491874,2021,2021-2022
AK,2022-03-31,intra-ucfe,7,0,1,0,1,2,2,2,0,1,5,21,12,12,FALSE,0.571428571428571,2021,2021-2022
AK,2022-03-31,intra-ucx,1,0,0,0,0,0,0,0,0,0,0,1,1,1,FALSE,1,2021,2021-2022
AK,2022-03-31,intra-ui,746,16,4,6,3,1,0,1,1,13,110,901,856,872,FALSE,0.967813540510544,2021,2021-2022
AK,2022-04-30,inter-total,129,3,1,0,0,0,1,1,0,2,11,148,140,143,FALSE,0.966216216216216,2021,2021-2022
AK,2022-04-30,inter-ucfe,1,0,0,0,0,0,1,0,0,0,0,2,1,1,FALSE,0.5,2021,2021-2022
AK,2022-04-30,inter-ucx,0,0,1,0,0,0,0,0,0,0,0,1,0,0,FALSE,0,2021,2021-2022
AK,2022-04-30,inter-ui,128,3,0,0,0,0,0,1,0,2,11,145,139,142,FALSE,0.979310344827586,2021,2021-2022
AK,2022-04-30,intra-total,595,22,9,5,3,6,1,0,1,7,76,725,671,693,FALSE,0.955862068965517,2021,2021-2022
AK,2022-04-30,intra-ucfe,1,1,2,1,0,0,0,0,0,0,1,6,2,3,FALSE,0.5,2021,2021-2022
AK,2022-04-30,intra-ucx,2,0,1,0,0,0,1,0,0,0,1,5,3,3,FALSE,0.6,2021,2021-2022
AK,2022-04-30,intra-ui,592,21,6,4,3,6,0,0,1,7,74,714,666,687,FALSE,0.96218487394958,2021,2021-2022
AK,2022-05-31,inter-total,217,1,2,0,0,1,0,0,0,2,17,240,234,235,FALSE,0.979166666666667,2021,2021-2022
AK,2022-05-31,inter-ucfe,0,0,0,0,0,0,0,0,0,1,0,1,0,0,FALSE,0,2021,2021-2022
AK,2022-05-31,inter-ucx,0,0,1,0,0,0,0,0,0,0,0,1,0,0,FALSE,0,2021,2021-2022
AK,2022-05-31,inter-ui,217,1,1,0,0,1,0,0,0,1,17,238,234,235,FALSE,0.987394957983193,2021,2021-2022
AK,2022-05-31,intra-total,511,30,10,4,1,3,1,2,1,8,86,657,597,627,FALSE,0.954337899543379,2021,2021-2022
AK,2022-05-31,intra-ucfe,3,2,0,0,0,0,0,0,0,0,0,5,3,5,FALSE,1,2021,2021-2022
AK,2022-05-31,intra-ucx,1,0,1,0,0,0,0,0,0,0,0,2,1,1,FALSE,0.5,2021,2021-2022
AK,2022-05-31,intra-ui,507,28,9,4,1,3,1,2,1,8,86,650,593,621,FALSE,0.955384615384615,2021,2021-2022
AK,2022-06-30,inter-total,107,5,0,0,0,0,0,0,0,3,14,129,121,126,FALSE,0.976744186046512,2021,2021-2022
AK,2022-06-30,inter-ucfe,0,1,0,0,0,0,0,0,0,0,1,2,1,2,FALSE,1,2021,2021-2022
AK,2022-06-30,inter-ucx,0,0,0,0,0,0,0,0,0,0,0,0,0,0,FALSE,0,2021,2021-2022
AK,2022-06-30,inter-ui,107,4,0,0,0,0,0,0,0,3,13,127,120,124,FALSE,0.976377952755906,2021,2021-2022
AK,2022-06-30,intra-total,586,27,7,3,0,0,0,0,2,9,95,729,681,708,FALSE,0.97119341563786,2021,2021-2022
AK,2022-06-30,intra-ucfe,1,0,0,0,0,0,0,0,0,0,1,2,2,2,FALSE,1,2021,2021-2022
AK,2022-06-30,intra-ucx,2,1,0,0,0,0,0,0,0,0,0,3,2,3,FALSE,1,2021,2021-2022
AK,2022-06-30,intra-ui,583,26,7,3,0,0,0,0,2,9,94,724,677,703,FALSE,0.970994475138122,2021,2021-2022
AK,2022-07-31,inter-total,45,0,0,0,0,0,0,0,0,3,9,57,54,54,FALSE,0.947368421052632,2022,2022-2023
AK,2022-07-31,inter-ucfe,0,0,0,0,0,0,0,0,0,0,0,0,0,0,FALSE,0,2022,2022-2023
AK,2022-07-31,inter-ucx,0,0,0,0,0,0,0,0,0,0,0,0,0,0,FALSE,0,2022,2022-2023
AK,2022-07-31,inter-ui,45,0,0,0,0,0,0,0,0,3,9,57,54,54,FALSE,0.947368421052632,2022,2022-2023
AK,2022-07-31,intra-total,516,19,6,3,2,1,1,1,0,14,110,673,626,645,FALSE,0.958395245170877,2022,2022-2023
AK,2022-07-31,intra-ucfe,0,1,0,0,0,0,0,0,0,0,2,3,2,3,FALSE,1,2022,2022-2023
AK,2022-07-31,intra-ucx,1,0,0,0,0,0,1,0,0,0,1,3,2,2,FALSE,0.666666666666667,2022,2022-2023
AK,2022-07-31,intra-ui,515,18,6,3,2,1,0,1,0,14,107,667,622,640,FALSE,0.95952023988006,2022,2022-2023
AK,2022-08-31,inter-total,101,1,1,0,0,0,0,1,0,1,15,120,116,117,FALSE,0.975,2022,2022-2023
AK,2022-08-31,inter-ucfe,2,0,0,0,0,0,0,0,0,0,1,3,3,3,FALSE,1,2022,2022-2023
AK,2022-08-31,inter-ucx,0,0,0,0,0,0,0,0,0,0,0,0,0,0,FALSE,0,2022,2022-2023
AK,2022-08-31,inter-ui,99,1,1,0,0,0,0,1,0,1,14,117,113,114,FALSE,0.974358974358974,2022,2022-2023
AK,2022-08-31,intra-total,344,24,5,5,1,0,1,2,1,15,81,479,425,449,FALSE,0.937369519832985,2022,2022-2023
AK,2022-08-31,intra-ucfe,1,0,0,0,0,0,0,0,0,1,1,3,2,2,FALSE,0.666666666666667,2022,2022-2023
AK,2022-08-31,intra-ucx,4,0,0,0,0,0,0,0,0,0,0,4,4,4,FALSE,1,2022,2022-2023
AK,2022-08-31,intra-ui,339,24,5,5,1,0,1,2,1,14,80,472,419,443,FALSE,0.938559322033898,2022,2022-2023
AK,2022-09-30,inter-total,207,6,3,0,1,0,1,0,0,0,18,236,225,231,FALSE,0.978813559322034,2022,2022-2023
AK,2022-09-30,inter-ucfe,0,0,0,0,1,0,1,0,0,0,0,2,0,0,FALSE,0,2022,2022-2023
AK,2022-09-30,inter-ucx,0,0,1,0,0,0,0,0,0,0,0,1,0,0,FALSE,0,2022,2022-2023
AK,2022-09-30,inter-ui,207,6,2,0,0,0,0,0,0,0,18,233,225,231,FALSE,0.991416309012876,2022,2022-2023
AK,2022-09-30,intra-total,319,14,12,4,5,3,0,2,1,6,72,438,391,405,FALSE,0.924657534246575,2022,2022-2023
AK,2022-09-30,intra-ucfe,3,1,1,0,0,0,0,1,0,0,1,7,4,5,FALSE,0.714285714285714,2022,2022-2023
AK,2022-09-30,intra-ucx,0,0,1,0,0,0,0,0,0,0,0,1,0,0,FALSE,0,2022,2022-2023
AK,2022-09-30,intra-ui,316,13,10,4,5,3,0,1,1,6,71,430,387,400,FALSE,0.930232558139535,2022,2022-2023
AK,2022-10-31,inter-total,316,11,3,0,2,0,0,0,0,0,29,361,345,356,FALSE,0.986149584487535,2022,2022-2023
AK,2022-10-31,inter-ucfe,4,1,2,0,0,0,0,0,0,0,0,7,4,5,FALSE,0.714285714285714,2022,2022-2023
AK,2022-10-31,inter-ucx,1,0,0,0,0,0,0,0,0,0,0,1,1,1,FALSE,1,2022,2022-2023
AK,2022-10-31,inter-ui,311,10,1,0,2,0,0,0,0,0,29,353,340,350,FALSE,0.991501416430595,2022,2022-2023
AK,2022-10-31,intra-total,447,20,3,5,3,1,2,1,1,0,85,568,532,552,FALSE,0.971830985915493,2022,2022-2023
AK,2022-10-31,intra-ucfe,2,0,0,0,0,0,0,0,1,0,2,5,4,4,FALSE,0.8,2022,2022-2023
AK,2022-10-31,intra-ucx,1,0,0,0,0,0,0,0,0,0,0,1,1,1,FALSE,1,2022,2022-2023
AK,2022-10-31,intra-ui,444,20,3,5,3,1,2,1,0,0,83,562,527,547,FALSE,0.973309608540925,2022,2022-2023
AK,2022-11-30,inter-total,488,11,5,2,1,0,0,0,0,0,60,567,548,559,FALSE,0.985890652557319,2022,2022-2023
AK,2022-11-30,inter-ucfe,4,2,0,0,0,0,0,0,0,0,11,17,15,17,FALSE,1,2022,2022-2023
AK,2022-11-30,inter-ucx,0,0,0,0,0,0,0,0,0,0,0,0,0,0,FALSE,0,2022,2022-2023
AK,2022-11-30,inter-ui,484,9,5,2,1,0,0,0,0,0,49,550,533,542,FALSE,0.985454545454546,2022,2022-2023
AK,2022-11-30,intra-total,1027,50,12,11,8,0,1,0,0,5,148,1262,1175,1225,FALSE,0.97068145800317,2022,2022-2023
AK,2022-11-30,intra-ucfe,3,0,0,1,2,0,0,0,0,0,4,10,7,7,FALSE,0.7,2022,2022-2023
AK,2022-11-30,intra-ucx,1,0,0,0,0,0,0,0,0,0,0,1,1,1,FALSE,1,2022,2022-2023
AK,2022-11-30,intra-ui,1023,50,12,10,6,0,1,0,0,5,144,1251,1167,1217,FALSE,0.972821742605915,2022,2022-2023
AK,2022-12-31,inter-total,308,4,5,5,1,0,2,0,1,1,36,363,344,348,FALSE,0.958677685950413,2022,2022-2023
AK,2022-12-31,inter-ucfe,2,1,2,1,0,0,0,0,0,0,4,10,6,7,FALSE,0.7,2022,2022-2023
AK,2022-12-31,inter-ucx,1,0,1,0,0,0,0,0,0,0,0,2,1,1,FALSE,0.5,2022,2022-2023
AK,2022-12-31,inter-ui,305,3,2,4,1,0,2,0,1,1,32,351,337,340,FALSE,0.968660968660969,2022,2022-2023
AK,2022-12-31,intra-total,985,36,20,14,9,0,1,2,0,3,167,1237,1152,1188,FALSE,0.960388035569927,2022,2022-2023
AK,2022-12-31,intra-ucfe,8,3,0,1,3,0,0,0,0,0,6,21,14,17,FALSE,0.80952380952381,2022,2022-2023
AK,2022-12-31,intra-ucx,4,2,1,2,0,0,0,0,0,0,0,9,4,6,FALSE,0.666666666666667,2022,2022-2023
AK,2022-12-31,intra-ui,973,31,19,11,6,0,1,2,0,3,161,1207,1134,1165,FALSE,0.965202982601491,2022,2022-2023
AK,2023-01-31,inter-total,197,5,6,5,1,0,0,0,0,0,30,244,227,232,FALSE,0.950819672131147,2022,2022-2023
AK,2023-01-31,inter-ucfe,1,1,3,1,0,0,0,0,0,0,2,8,3,4,FALSE,0.5,2022,2022-2023
AK,2023-01-31,inter-ucx,0,0,0,0,0,0,0,0,0,0,0,0,0,0,FALSE,0,2022,2022-2023
AK,2023-01-31,inter-ui,196,4,3,4,1,0,0,0,0,0,28,236,224,228,FALSE,0.966101694915254,2022,2022-2023
AK,2023-01-31,intra-total,1053,46,30,17,7,3,1,1,0,7,151,1316,1204,1250,FALSE,0.949848024316109,2022,2022-2023
AK,2023-01-31,intra-ucfe,5,6,3,0,0,0,0,1,0,1,6,22,11,17,FALSE,0.772727272727273,2022,2022-2023
AK,2023-01-31,intra-ucx,5,0,0,0,0,0,0,0,0,0,0,5,5,5,FALSE,1,2022,2022-2023
AK,2023-01-31,intra-ui,1043,40,27,17,7,3,1,0,0,6,145,1289,1188,1228,FALSE,0.952676493405741,2022,2022-2023
AK,2023-02-28,inter-total,114,4,1,3,0,0,0,0,1,0,24,147,138,142,FALSE,0.965986394557823,2022,2022-2023
AK,2023-02-28,inter-ucfe,1,0,1,0,0,0,0,0,0,0,2,4,3,3,FALSE,0.75,2022,2022-2023
AK,2023-02-28,inter-ucx,0,0,0,0,0,0,0,0,0,0,0,0,0,0,FALSE,0,2022,2022-2023
AK,2023-02-28,inter-ui,113,4,0,3,0,0,0,0,1,0,22,143,135,139,FALSE,0.972027972027972,2022,2022-2023
AK,2023-02-28,intra-total,745,74,26,13,3,3,2,3,1,4,192,1066,937,1011,FALSE,0.948405253283302,2022,2022-2023
AK,2023-02-28,intra-ucfe,0,4,0,4,0,0,0,0,0,0,3,11,3,7,FALSE,0.636363636363636,2022,2022-2023
AK,2023-02-28,intra-ucx,1,0,0,0,0,0,0,0,0,0,0,1,1,1,FALSE,1,2022,2022-2023
AK,2023-02-28,intra-ui,744,70,26,9,3,3,2,3,1,4,189,1054,933,1003,FALSE,0.951612903225806,2022,2022-2023
AK,2023-03-31,inter-total,89,4,7,2,2,0,1,0,0,1,13,119,102,106,FALSE,0.890756302521008,2022,2022-2023
AK,2023-03-31,inter-ucfe,2,0,5,1,2,0,1,0,0,1,0,12,2,2,FALSE,0.166666666666667,2022,2022-2023
AK,2023-03-31,inter-ucx,0,0,0,0,0,0,0,0,0,0,0,0,0,0,FALSE,0,2022,2022-2023
AK,2023-03-31,inter-ui,87,4,2,1,0,0,0,0,0,0,13,107,100,104,FALSE,0.97196261682243,2022,2022-2023
AK,2023-03-31,intra-total,532,43,18,9,11,5,5,5,1,1,115,745,647,690,FALSE,0.926174496644295,2022,2022-2023
AK,2023-03-31,intra-ucfe,2,2,2,3,3,1,2,0,1,0,2,18,4,6,FALSE,0.333333333333333,2022,2022-2023
AK,2023-03-31,intra-ucx,0,0,0,0,0,0,0,0,0,0,2,2,2,2,FALSE,1,2022,2022-2023
AK,2023-03-31,intra-ui,530,41,16,6,8,4,3,5,0,1,111,725,641,682,FALSE,0.940689655172414,2022,2022-2023
AK,2023-04-30,inter-total,131,0,1,0,0,0,0,0,0,0,9,141,140,140,FALSE,0.99290780141844,2022,2022-2023
AK,2023-04-30,inter-ucfe,0,0,0,0,0,0,0,0,0,0,0,0,0,0,FALSE,0,2022,2022-2023
AK,2023-04-30,inter-ucx,0,0,0,0,0,0,0,0,0,0,0,0,0,0,FALSE,0,2022,2022-2023
AK,2023-04-30,inter-ui,131,0,1,0,0,0,0,0,0,0,9,141,140,140,FALSE,0.99290780141844,2022,2022-2023
AK,2023-04-30,intra-total,489,18,6,2,6,1,1,0,0,2,72,597,561,579,FALSE,0.969849246231156,2022,2022-2023
AK,2023-04-30,intra-ucfe,1,1,1,1,0,0,0,0,0,0,1,5,2,3,FALSE,0.6,2022,2022-2023
AK,2023-04-30,intra-ucx,0,0,0,0,0,0,0,0,0,0,0,0,0,0,FALSE,0,2022,2022-2023
AK,2023-04-30,intra-ui,488,17,5,1,6,1,1,0,0,2,71,592,559,576,FALSE,0.972972972972973,2022,2022-2023
AK,2023-05-31,inter-total,293,7,3,0,0,0,0,0,0,0,19,322,312,319,FALSE,0.990683229813665,2022,2022-2023
AK,2023-05-31,inter-ucfe,0,0,1,0,0,0,0,0,0,0,0,1,0,0,FALSE,0,2022,2022-2023
AK,2023-05-31,inter-ucx,0,0,0,0,0,0,0,0,0,0,0,0,0,0,FALSE,0,2022,2022-2023
AK,2023-05-31,inter-ui,293,7,2,0,0,0,0,0,0,0,19,321,312,319,FALSE,0.993769470404984,2022,2022-2023
AK,2023-05-31,intra-total,441,24,11,6,5,1,0,0,0,5,81,574,522,546,FALSE,0.951219512195122,2022,2022-2023
AK,2023-05-31,intra-ucfe,3,1,0,1,0,0,0,0,0,0,1,6,4,5,FALSE,0.833333333333333,2022,2022-2023
AK,2023-05-31,intra-ucx,0,0,0,0,0,0,0,0,0,0,1,1,1,1,FALSE,1,2022,2022-2023
AK,2023-05-31,intra-ui,438,23,11,5,5,1,0,0,0,5,79,567,517,540,FALSE,0.952380952380952,2022,2022-2023
AK,2023-06-30,inter-total,68,2,1,1,0,0,0,0,0,0,5,77,73,75,FALSE,0.974025974025974,2022,2022-2023
AK,2023-06-30,inter-ucfe,1,0,0,0,0,0,0,0,0,0,0,1,1,1,FALSE,1,2022,2022-2023
AK,2023-06-30,inter-ucx,0,0,0,0,0,0,0,0,0,0,0,0,0,0,FALSE,0,2022,2022-2023
AK,2023-06-30,inter-ui,67,2,1,1,0,0,0,0,0,0,5,76,72,74,FALSE,0.973684210526316,2022,2022-2023
AK,2023-06-30,intra-total,466,19,12,5,3,3,0,2,0,6,95,611,561,580,FALSE,0.949263502454992,2022,2022-2023
AK,2023-06-30,intra-ucfe,1,0,0,0,0,1,0,0,0,0,0,2,1,1,FALSE,0.5,2022,2022-2023
AK,2023-06-30,intra-ucx,1,0,0,0,0,0,0,0,0,0,0,1,1,1,FALSE,1,2022,2022-2023
AK,2023-06-30,intra-ui,464,19,12,5,3,2,0,2,0,6,95,608,559,578,FALSE,0.950657894736842,2022,2022-2023
AK,2023-07-31,inter-total,48,2,1,0,0,0,0,0,0,0,10,61,58,60,FALSE,0.983606557377049,2023,2023-2024
AK,2023-07-31,inter-ucfe,0,0,0,0,0,0,0,0,0,0,0,0,0,0,FALSE,0,2023,2023-2024
AK,2023-07-31,inter-ucx,0,0,0,0,0,0,0,0,0,0,0,0,0,0,FALSE,0,2023,2023-2024
AK,2023-07-31,inter-ui,48,2,1,0,0,0,0,0,0,0,10,61,58,60,FALSE,0.983606557377049,2023,2023-2024
AK,2023-07-31,intra-total,404,15,3,3,2,4,2,3,1,5,69,511,473,488,FALSE,0.954990215264188,2023,2023-2024
AK,2023-07-31,intra-ucfe,0,1,0,0,0,0,0,0,0,0,0,1,0,1,FALSE,1,2023,2023-2024
AK,2023-07-31,intra-ucx,0,0,0,0,0,0,0,0,0,0,0,0,0,0,FALSE,0,2023,2023-2024
AK,2023-07-31,intra-ui,404,14,3,3,2,4,2,3,1,5,69,510,473,487,FALSE,0.954901960784314,2023,2023-2024
AK,2023-08-31,inter-total,108,5,0,0,0,0,0,0,1,0,11,125,119,124,FALSE,0.992,2023,2023-2024
AK,2023-08-31,inter-ucfe,0,1,0,0,0,0,0,0,0,0,0,1,0,1,FALSE,1,2023,2023-2024
AK,2023-08-31,inter-ucx,0,0,0,0,0,0,0,0,0,0,0,0,0,0,FALSE,0,2023,2023-2024
AK,2023-08-31,inter-ui,108,4,0,0,0,0,0,0,1,0,11,124,119,123,FALSE,0.991935483870968,2023,2023-2024
AK,2023-08-31,intra-total,354,19,8,2,1,5,2,1,2,2,79,475,433,452,FALSE,0.951578947368421,2023,2023-2024
AK,2023-08-31,intra-ucfe,1,0,0,0,0,0,0,0,0,0,1,2,2,2,FALSE,1,2023,2023-2024
AK,2023-08-31,intra-ucx,2,0,0,0,0,0,0,0,0,1,0,3,2,2,FALSE,0.666666666666667,2023,2023-2024
AK,2023-08-31,intra-ui,351,19,8,2,1,5,2,1,2,1,78,470,429,448,FALSE,0.953191489361702,2023,2023-2024
AK,2023-09-30,inter-total,183,1,1,0,1,0,1,0,0,0,13,200,196,197,FALSE,0.985,2023,2023-2024
AK,2023-09-30,inter-ucfe,1,0,0,0,0,0,0,0,0,0,0,1,1,1,FALSE,1,2023,2023-2024
AK,2023-09-30,inter-ucx,0,0,0,0,0,0,0,0,0,0,0,0,0,0,FALSE,0,2023,2023-2024
AK,2023-09-30,inter-ui,182,1,1,0,1,0,1,0,0,0,13,199,195,196,FALSE,0.984924623115578,2023,2023-2024
AK,2023-09-30,intra-total,293,20,2,4,0,2,0,2,0,2,73,398,366,386,FALSE,0.969849246231156,2023,2023-2024
AK,2023-09-30,intra-ucfe,3,1,0,0,0,0,0,1,0,0,1,6,4,5,FALSE,0.833333333333333,2023,2023-2024
AK,2023-09-30,intra-ucx,0,0,0,0,0,0,0,0,0,0,0,0,0,0,FALSE,0,2023,2023-2024
AK,2023-09-30,intra-ui,290,19,2,4,0,2,0,1,0,2,72,392,362,381,FALSE,0.971938775510204,2023,2023-2024
AK,2023-10-31,inter-total,440,8,1,1,0,0,0,0,0,0,48,498,488,496,FALSE,0.995983935742972,2023,2023-2024
AK,2023-10-31,inter-ucfe,1,0,0,0,0,0,0,0,0,0,2,3,3,3,FALSE,1,2023,2023-2024
AK,2023-10-31,inter-ucx,0,0,0,0,0,0,0,0,0,0,0,0,0,0,FALSE,0,2023,2023-2024
AK,2023-10-31,inter-ui,439,8,1,1,0,0,0,0,0,0,46,495,485,493,FALSE,0.995959595959596,2023,2023-2024
AK,2023-10-31,intra-total,591,24,10,4,4,0,1,0,2,1,102,739,693,717,FALSE,0.970230040595399,2023,2023-2024
AK,2023-10-31,intra-ucfe,2,0,1,0,0,0,0,0,0,0,2,5,4,4,FALSE,0.8,2023,2023-2024
AK,2023-10-31,intra-ucx,1,0,0,0,0,0,0,0,0,0,0,1,1,1,FALSE,1,2023,2023-2024
AK,2023-10-31,intra-ui,588,24,9,4,4,0,1,0,2,1,100,733,688,712,FALSE,0.971350613915416,2023,2023-2024
AK,2023-11-30,inter-total,582,10,6,1,0,1,1,0,0,0,72,673,654,664,FALSE,0.986627043090639,2023,2023-2024
AK,2023-11-30,inter-ucfe,7,0,0,0,0,0,0,0,0,0,6,13,13,13,FALSE,1,2023,2023-2024
AK,2023-11-30,inter-ucx,0,0,0,0,0,0,0,0,0,0,0,0,0,0,FALSE,0,2023,2023-2024
AK,2023-11-30,inter-ui,575,10,6,1,0,1,1,0,0,0,66,660,641,651,FALSE,0.986363636363636,2023,2023-2024
AK,2023-11-30,intra-total,895,30,13,4,3,0,1,0,0,5,140,1091,1035,1065,FALSE,0.976168652612282,2023,2023-2024
AK,2023-11-30,intra-ucfe,7,2,0,0,0,0,0,0,0,0,8,17,15,17,FALSE,1,2023,2023-2024
AK,2023-11-30,intra-ucx,1,0,0,0,0,0,0,0,0,0,0,1,1,1,FALSE,1,2023,2023-2024
AK,2023-11-30,intra-ui,887,28,13,4,3,0,1,0,0,5,132,1073,1019,1047,FALSE,0.975768872320596,2023,2023-2024
AK,2023-12-31,inter-total,352,9,2,2,0,2,0,0,0,0,34,401,386,395,FALSE,0.985037406483791,2023,2023-2024
AK,2023-12-31,inter-ucfe,7,1,0,1,0,0,0,0,0,0,1,10,8,9,FALSE,0.9,2023,2023-2024
AK,2023-12-31,inter-ucx,0,0,0,0,0,0,0,0,0,0,0,0,0,0,FALSE,0,2023,2023-2024
AK,2023-12-31,inter-ui,345,8,2,1,0,2,0,0,0,0,33,391,378,386,FALSE,0.987212276214834,2023,2023-2024
AK,2023-12-31,intra-total,901,23,14,12,5,0,1,1,0,2,98,1057,999,1022,FALSE,0.966887417218543,2023,2023-2024
AK,2023-12-31,intra-ucfe,9,0,1,0,0,0,0,1,0,0,5,16,14,14,FALSE,0.875,2023,2023-2024
AK,2023-12-31,intra-ucx,0,0,0,0,0,0,0,0,0,0,0,0,0,0,FALSE,0,2023,2023-2024
AK,2023-12-31,intra-ui,892,23,13,12,5,0,1,0,0,2,93,1041,985,1008,FALSE,0.968299711815562,2023,2023-2024
AK,2024-01-31,inter-total,284,7,0,0,0,0,0,0,0,0,28,319,312,319,FALSE,1,2023,2023-2024
AK,2024-01-31,inter-ucfe,6,1,0,0,0,0,0,0,0,0,3,10,9,10,FALSE,1,2023,2023-2024
AK,2024-01-31,inter-ucx,0,0,0,0,0,0,0,0,0,0,0,0,0,0,FALSE,0,2023,2023-2024
AK,2024-01-31,inter-ui,278,6,0,0,0,0,0,0,0,0,25,309,303,309,FALSE,1,2023,2023-2024
AK,2024-01-31,intra-total,1068,33,8,6,7,4,1,0,2,2,126,1257,1194,1227,FALSE,0.976133651551313,2023,2023-2024
AK,2024-01-31,intra-ucfe,8,2,0,0,0,0,0,0,0,0,8,18,16,18,FALSE,1,2023,2023-2024
AK,2024-01-31,intra-ucx,2,0,0,0,0,0,0,0,0,0,0,2,2,2,FALSE,1,2023,2023-2024
AK,2024-01-31,intra-ui,1058,31,8,6,7,4,1,0,2,2,118,1237,1176,1207,FALSE,0.975747776879547,2023,2023-2024
AK,2024-02-29,inter-total,172,3,1,4,0,0,0,0,0,1,18,199,190,193,FALSE,0.969849246231156,2023,2023-2024
AK,2024-02-29,inter-ucfe,9,0,1,1,0,0,0,0,0,0,0,11,9,9,FALSE,0.818181818181818,2023,2023-2024
AK,2024-02-29,inter-ucx,0,0,0,0,0,0,0,0,0,0,0,0,0,0,FALSE,0,2023,2023-2024
AK,2024-02-29,inter-ui,163,3,0,3,0,0,0,0,0,1,18,188,181,184,FALSE,0.978723404255319,2023,2023-2024
AK,2024-02-29,intra-total,680,20,8,4,2,0,0,2,0,3,107,826,787,807,FALSE,0.976997578692494,2023,2023-2024
AK,2024-02-29,intra-ucfe,8,1,0,0,0,0,0,0,0,0,7,16,15,16,FALSE,1,2023,2023-2024
AK,2024-02-29,intra-ucx,0,0,0,0,0,0,0,0,0,0,0,0,0,0,FALSE,0,2023,2023-2024
AK,2024-02-29,intra-ui,672,19,8,4,2,0,0,2,0,3,100,810,772,791,FALSE,0.976543209876543,2023,2023-2024
AK,2024-03-31,inter-total,96,3,0,0,0,0,0,2,0,0,13,114,109,112,FALSE,0.982456140350877,2023,2023-2024
AK,2024-03-31,inter-ucfe,2,0,0,0,0,0,0,1,0,0,0,3,2,2,FALSE,0.666666666666667,2023,2023-2024
AK,2024-03-31,inter-ucx,0,0,0,0,0,0,0,0,0,0,0,0,0,0,FALSE,0,2023,2023-2024
AK,2024-03-31,inter-ui,94,3,0,0,0,0,0,1,0,0,13,111,107,110,FALSE,0.990990990990991,2023,2023-2024
AK,2024-03-31,intra-total,508,10,7,3,1,2,2,1,2,7,68,611,576,586,FALSE,0.959083469721768,2023,2023-2024
AK,2024-03-31,intra-ucfe,4,0,0,0,0,0,1,0,1,1,4,11,8,8,FALSE,0.727272727272727,2023,2023-2024
AK,2024-03-31,intra-ucx,1,0,0,0,0,0,0,0,0,0,0,1,1,1,FALSE,1,2023,2023-2024
AK,2024-03-31,intra-ui,503,10,7,3,1,2,1,1,1,6,64,599,567,577,FALSE,0.963272120200334,2023,2023-2024
AK,2024-04-30,inter-total,150,2,0,0,0,1,1,0,0,1,16,171,166,168,FALSE,0.982456140350877,2023,2023-2024
AK,2024-04-30,inter-ucfe,1,0,0,0,0,0,0,0,0,0,1,2,2,2,FALSE,1,2023,2023-2024
AK,2024-04-30,inter-ucx,0,0,0,0,0,0,0,0,0,0,0,0,0,0,FALSE,0,2023,2023-2024
AK,2024-04-30,inter-ui,149,2,0,0,0,1,1,0,0,1,15,169,164,166,FALSE,0.982248520710059,2023,2023-2024
AK,2024-04-30,intra-total,543,21,5,2,5,2,0,2,2,0,71,653,614,635,FALSE,0.972434915773354,2023,2023-2024
AK,2024-04-30,intra-ucfe,2,2,0,0,0,0,0,0,0,0,0,4,2,4,FALSE,1,2023,2023-2024
AK,2024-04-30,intra-ucx,2,1,0,0,0,0,0,0,0,0,0,3,2,3,FALSE,1,2023,2023-2024
AK,2024-04-30,intra-ui,539,18,5,2,5,2,0,2,2,0,71,646,610,628,FALSE,0.972136222910217,2023,2023-2024
AK,2024-05-31,inter-total,274,5,3,0,0,0,0,0,0,0,20,302,294,299,FALSE,0.990066225165563,2023,2023-2024
AK,2024-05-31,inter-ucfe,0,0,0,0,0,0,0,0,0,0,0,0,0,0,FALSE,0,2023,2023-2024
AK,2024-05-31,inter-ucx,0,0,0,0,0,0,0,0,0,0,0,0,0,0,FALSE,0,2023,2023-2024
AK,2024-05-31,inter-ui,274,5,3,0,0,0,0,0,0,0,20,302,294,299,FALSE,0.990066225165563,2023,2023-2024
AK,2024-05-31,intra-total,450,13,5,0,1,3,0,4,0,2,75,553,525,538,FALSE,0.972875226039783,2023,2023-2024
AK,2024-05-31,intra-ucfe,1,0,0,0,0,0,0,0,0,0,2,3,3,3,FALSE,1,2023,2023-2024
AK,2024-05-31,intra-ucx,1,0,0,0,0,0,0,0,0,0,0,1,1,1,FALSE,1,2023,2023-2024
AK,2024-05-31,intra-ui,448,13,5,0,1,3,0,4,0,2,73,549,521,534,FALSE,0.972677595628415,2023,2023-2024
AK,2024-06-30,inter-total,63,3,1,0,1,0,0,0,2,0,7,77,70,73,FALSE,0.948051948051948,2023,2023-2024
AK,2024-06-30,inter-ucfe,2,0,0,0,0,0,0,0,1,0,0,3,2,2,FALSE,0.666666666666667,2023,2023-2024
AK,2024-06-30,inter-ucx,0,0,0,0,0,0,0,0,0,0,0,0,0,0,FALSE,0,2023,2023-2024
AK,2024-06-30,inter-ui,61,3,1,0,1,0,0,0,1,0,7,74,68,71,FALSE,0.959459459459459,2023,2023-2024
AK,2024-06-30,intra-total,445,28,4,2,2,3,1,1,0,1,91,578,536,564,FALSE,0.975778546712803,2023,2023-2024
AK,2024-06-30,intra-ucfe,1,1,0,0,0,0,0,0,0,0,1,3,2,3,FALSE,1,2023,2023-2024
AK,2024-06-30,intra-ucx,0,0,0,0,0,0,0,0,0,0,0,0,0,0,FALSE,0,2023,2023-2024
AK,2024-06-30,intra-ui,444,27,4,2,2,3,1,1,0,1,90,575,534,561,FALSE,0.975652173913043,2023,2023-2024
AK,2024-07-31,inter-total,55,3,3,0,0,0,0,0,0,0,10,71,65,68,FALSE,0.957746478873239,2024,2024-2025
AK,2024-07-31,inter-ucfe,2,0,0,0,0,0,0,0,0,0,0,2,2,2,FALSE,1,2024,2024-2025
AK,2024-07-31,inter-ucx,0,0,0,0,0,0,0,0,0,0,0,0,0,0,FALSE,0,2024,2024-2025
AK,2024-07-31,inter-ui,53,3,3,0,0,0,0,0,0,0,10,69,63,66,FALSE,0.956521739130435,2024,2024-2025
AK,2024-07-31,intra-total,483,17,7,6,1,1,1,1,0,1,84,602,567,584,FALSE,0.970099667774086,2024,2024-2025
AK,2024-07-31,intra-ucfe,0,0,0,0,0,0,0,0,0,0,0,0,0,0,FALSE,0,2024,2024-2025
AK,2024-07-31,intra-ucx,0,0,0,0,0,0,0,0,0,0,0,0,0,0,FALSE,0,2024,2024-2025
AK,2024-07-31,intra-ui,483,17,7,6,1,1,1,1,0,1,84,602,567,584,FALSE,0.970099667774086,2024,2024-2025
AK,2024-08-31,inter-total,106,3,1,0,0,0,0,0,0,0,9,119,115,118,FALSE,0.991596638655462,2024,2024-2025
AK,2024-08-31,inter-ucfe,1,0,0,0,0,0,0,0,0,0,1,2,2,2,FALSE,1,2024,2024-2025
AK,2024-08-31,inter-ucx,0,0,0,0,0,0,0,0,0,0,0,0,0,0,FALSE,0,2024,2024-2025
AK,2024-08-31,inter-ui,105,3,1,0,0,0,0,0,0,0,8,117,113,116,FALSE,0.991452991452991,2024,2024-2025
AK,2024-08-31,intra-total,316,17,12,4,4,1,1,2,0,7,52,416,368,385,FALSE,0.925480769230769,2024,2024-2025
AK,2024-08-31,intra-ucfe,0,0,0,0,0,0,0,0,0,0,0,0,0,0,FALSE,0,2024,2024-2025
AK,2024-08-31,intra-ucx,1,0,0,0,0,0,0,0,0,0,0,1,1,1,FALSE,1,2024,2024-2025
AK,2024-08-31,intra-ui,315,17,12,4,4,1,1,2,0,7,52,415,367,384,FALSE,0.925301204819277,2024,2024-2025
AK,2024-09-30,inter-total,171,7,2,2,1,0,0,0,0,0,17,200,188,195,FALSE,0.975,2024,2024-2025
AK,2024-09-30,inter-ucfe,1,0,0,0,0,0,0,0,0,0,0,1,1,1,FALSE,1,2024,2024-2025
AK,2024-09-30,inter-ucx,0,0,0,0,0,0,0,0,0,0,0,0,0,0,FALSE,0,2024,2024-2025
AK,2024-09-30,inter-ui,170,7,2,2,1,0,0,0,0,0,17,199,187,194,FALSE,0.974874371859297,2024,2024-2025
AK,2024-09-30,intra-total,323,19,13,9,9,1,2,2,2,5,74,459,397,416,FALSE,0.906318082788671,2024,2024-2025
AK,2024-09-30,intra-ucfe,2,0,0,0,0,0,0,0,0,1,0,3,2,2,FALSE,0.666666666666667,2024,2024-2025
AK,2024-09-30,intra-ucx,0,0,0,0,0,0,0,0,0,0,0,0,0,0,FALSE,0,2024,2024-2025
AK,2024-09-30,intra-ui,321,19,13,9,9,1,2,2,2,4,74,456,395,414,FALSE,0.907894736842105,2024,2024-2025
AK,2024-10-31,inter-total,398,10,2,0,1,0,0,0,1,0,32,444,430,440,FALSE,0.990990990990991,2024,2024-2025
AK,2024-10-31,inter-ucfe,2,0,0,0,0,0,0,0,0,0,1,3,3,3,FALSE,1,2024,2024-2025
AK,2024-10-31,inter-ucx,0,0,0,0,0,0,0,0,0,0,0,0,0,0,FALSE,0,2024,2024-2025
AK,2024-10-31,inter-ui,396,10,2,0,1,0,0,0,1,0,31,441,427,437,FALSE,0.990929705215419,2024,2024-2025
AK,2024-10-31,intra-total,540,20,8,5,5,0,1,1,0,5,100,685,640,660,FALSE,0.963503649635036,2024,2024-2025
AK,2024-10-31,intra-ucfe,4,0,0,0,0,0,0,0,0,0,3,7,7,7,FALSE,1,2024,2024-2025
AK,2024-10-31,intra-ucx,0,1,0,0,0,0,0,0,0,0,0,1,0,1,FALSE,1,2024,2024-2025
AK,2024-10-31,intra-ui,536,19,8,5,5,0,1,1,0,5,97,677,633,652,FALSE,0.963072378138848,2024,2024-2025
AK,2024-11-30,inter-total,539,14,3,4,1,1,0,0,0,1,30,593,569,583,FALSE,0.983136593591906,2024,2024-2025
AK,2024-11-30,inter-ucfe,9,1,0,1,0,0,0,0,0,1,2,14,11,12,FALSE,0.857142857142857,2024,2024-2025
AK,2024-11-30,inter-ucx,0,0,0,0,0,0,0,0,0,0,0,0,0,0,FALSE,0,2024,2024-2025
AK,2024-11-30,inter-ui,530,13,3,3,1,1,0,0,0,0,28,579,558,571,FALSE,0.986183074265976,2024,2024-2025
AK,2024-11-30,intra-total,831,22,6,2,1,1,1,0,0,12,104,980,935,957,FALSE,0.976530612244898,2024,2024-2025
AK,2024-11-30,intra-ucfe,4,1,0,0,0,0,0,0,0,1,4,10,8,9,FALSE,0.9,2024,2024-2025
AK,2024-11-30,intra-ucx,0,0,0,0,0,0,0,0,0,0,0,0,0,0,FALSE,0,2024,2024-2025
AK,2024-11-30,intra-ui,827,21,6,2,1,1,1,0,0,11,100,970,927,948,FALSE,0.977319587628866,2024,2024-2025
AK,2024-12-31,inter-total,397,12,6,3,1,1,0,1,0,0,39,460,436,448,FALSE,0.973913043478261,2024,2024-2025
AK,2024-12-31,inter-ucfe,4,2,0,0,0,0,0,1,0,0,4,11,8,10,FALSE,0.909090909090909,2024,2024-2025
AK,2024-12-31,inter-ucx,0,0,0,0,0,0,0,0,0,0,0,0,0,0,FALSE,0,2024,2024-2025
AK,2024-12-31,inter-ui,393,10,6,3,1,1,0,0,0,0,35,449,428,438,FALSE,0.975501113585746,2024,2024-2025
AK,2024-12-31,intra-total,938,32,8,10,4,1,1,1,1,6,141,1143,1079,1111,FALSE,0.972003499562555,2024,2024-2025
AK,2024-12-31,intra-ucfe,10,1,0,0,0,0,0,0,0,0,7,18,17,18,FALSE,1,2024,2024-2025
AK,2024-12-31,intra-ucx,0,0,0,0,0,0,0,0,0,0,1,1,1,1,FALSE,1,2024,2024-2025
AK,2024-12-31,intra-ui,928,31,8,10,4,1,1,1,1,6,133,1124,1061,1092,FALSE,0.97153024911032,2024,2024-2025
AL,2019-01-31,inter-total,157,42,25,9,5,2,2,2,1,1,83,329,240,282,FALSE,0.857142857142857,2018,2018-2019
AL,2019-01-31,inter-ucfe,0,1,0,0,0,0,0,0,0,0,3,4,3,4,FALSE,1,2018,2018-2019
AL,2019-01-31,inter-ucx,1,0,0,0,0,0,0,0,0,0,0,1,1,1,FALSE,1,2018,2018-2019
AL,2019-01-31,inter-ui,156,41,25,9,5,2,2,2,1,1,80,324,236,277,FALSE,0.854938271604938,2018,2018-2019
AL,2019-01-31,intra-total,3676,586,238,71,48,11,7,1,5,15,1730,6388,5406,5992,FALSE,0.938008766437069,2018,2018-2019
AL,2019-01-31,intra-ucfe,34,9,0,0,0,0,0,0,0,0,74,117,108,117,FALSE,1,2018,2018-2019
AL,2019-01-31,intra-ucx,9,3,0,0,0,0,0,0,0,0,7,19,16,19,FALSE,1,2018,2018-2019
AL,2019-01-31,intra-ui,3633,574,238,71,48,11,7,1,5,15,1649,6252,5282,5856,FALSE,0.936660268714012,2018,2018-2019
AL,2019-02-28,inter-total,95,26,12,10,6,0,0,2,2,3,57,213,152,178,FALSE,0.835680751173709,2018,2018-2019
AL,2019-02-28,inter-ucfe,0,2,0,0,1,0,0,0,0,1,1,5,1,3,FALSE,0.6,2018,2018-2019
AL,2019-02-28,inter-ucx,0,0,0,0,0,0,0,0,0,0,0,0,0,0,FALSE,0,2018,2018-2019
AL,2019-02-28,inter-ui,95,24,12,10,5,0,0,2,2,2,56,208,151,175,FALSE,0.841346153846154,2018,2018-2019
AL,2019-02-28,intra-total,1992,280,139,116,41,24,8,4,2,6,823,3435,2815,3095,FALSE,0.901018922852984,2018,2018-2019
AL,2019-02-28,intra-ucfe,5,13,2,1,1,0,0,0,0,0,11,33,16,29,FALSE,0.878787878787879,2018,2018-2019
AL,2019-02-28,intra-ucx,13,0,1,0,0,0,0,0,0,0,6,20,19,19,FALSE,0.95,2018,2018-2019
AL,2019-02-28,intra-ui,1974,267,136,115,40,24,8,4,2,6,806,3382,2780,3047,FALSE,0.900946185688941,2018,2018-2019
AL,2019-03-31,inter-total,86,10,6,3,1,0,2,2,0,0,54,164,140,150,FALSE,0.914634146341463,2018,2018-2019
AL,2019-03-31,inter-ucfe,0,0,0,0,0,0,0,0,0,0,0,0,0,0,FALSE,0,2018,2018-2019
AL,2019-03-31,inter-ucx,1,0,0,0,0,0,0,0,0,0,0,1,1,1,FALSE,1,2018,2018-2019
AL,2019-03-31,inter-ui,85,10,6,3,1,0,2,2,0,0,54,163,139,149,FALSE,0.914110429447853,2018,2018-2019
AL,2019-03-31,intra-total,1708,107,63,40,19,9,5,4,5,16,620,2596,2328,2435,FALSE,0.937981510015408,2018,2018-2019
AL,2019-03-31,intra-ucfe,2,1,0,0,0,0,0,0,0,0,6,9,8,9,FALSE,1,2018,2018-2019
AL,2019-03-31,intra-ucx,7,2,0,0,0,0,0,0,0,0,1,10,8,10,FALSE,1,2018,2018-2019
AL,2019-03-31,intra-ui,1699,104,63,40,19,9,5,4,5,16,613,2577,2312,2416,FALSE,0.937524253007373,2018,2018-2019
AL,2019-04-30,inter-total,62,10,6,2,5,2,0,1,1,2,42,133,104,114,FALSE,0.857142857142857,2018,2018-2019
AL,2019-04-30,inter-ucfe,0,0,0,0,0,0,0,0,0,0,0,0,0,0,FALSE,0,2018,2018-2019
AL,2019-04-30,inter-ucx,1,0,0,0,0,0,0,0,0,0,0,1,1,1,FALSE,1,2018,2018-2019
AL,2019-04-30,inter-ui,61,10,6,2,5,2,0,1,1,2,42,132,103,113,FALSE,0.856060606060606,2018,2018-2019
AL,2019-04-30,intra-total,2077,102,42,26,17,8,3,3,1,11,726,3016,2803,2905,FALSE,0.963196286472149,2018,2018-2019
AL,2019-04-30,intra-ucfe,4,0,0,0,1,0,0,0,0,0,2,7,6,6,FALSE,0.857142857142857,2018,2018-2019
AL,2019-04-30,intra-ucx,4,0,0,0,0,0,0,0,0,0,1,5,5,5,FALSE,1,2018,2018-2019
AL,2019-04-30,intra-ui,2069,102,42,26,16,8,3,3,1,11,723,3004,2792,2894,FALSE,0.963382157123835,2018,2018-2019
AL,2019-05-31,inter-total,42,16,6,2,2,1,0,0,0,2,25,96,67,83,FALSE,0.864583333333333,2018,2018-2019
AL,2019-05-31,inter-ucfe,0,0,0,0,0,0,0,0,0,0,0,0,0,0,FALSE,0,2018,2018-2019
AL,2019-05-31,inter-ucx,0,0,0,0,0,0,0,0,0,0,0,0,0,0,FALSE,0,2018,2018-2019
AL,2019-05-31,inter-ui,42,16,6,2,2,1,0,0,0,2,25,96,67,83,FALSE,0.864583333333333,2018,2018-2019
AL,2019-05-31,intra-total,2184,134,62,41,16,14,4,4,1,8,658,3126,2842,2976,FALSE,0.952015355086372,2018,2018-2019
AL,2019-05-31,intra-ucfe,6,1,0,1,0,0,0,0,0,0,7,15,13,14,FALSE,0.933333333333333,2018,2018-2019
AL,2019-05-31,intra-ucx,8,0,0,0,0,0,0,0,0,0,2,10,10,10,FALSE,1,2018,2018-2019
AL,2019-05-31,intra-ui,2170,133,62,40,16,14,4,4,1,8,649,3101,2819,2952,FALSE,0.951950983553692,2018,2018-2019
AL,2019-06-30,inter-total,50,7,10,2,2,0,0,0,0,3,23,97,73,80,FALSE,0.824742268041237,2018,2018-2019
AL,2019-06-30,inter-ucfe,0,1,0,0,0,0,0,0,0,0,0,1,0,1,FALSE,1,2018,2018-2019
AL,2019-06-30,inter-ucx,0,0,0,0,0,0,0,0,0,0,0,0,0,0,FALSE,0,2018,2018-2019
AL,2019-06-30,inter-ui,50,6,10,2,2,0,0,0,0,3,23,96,73,79,FALSE,0.822916666666667,2018,2018-2019
AL,2019-06-30,intra-total,2531,176,98,33,16,10,4,4,3,8,956,3839,3487,3663,FALSE,0.954154727793696,2018,2018-2019
AL,2019-06-30,intra-ucfe,5,0,0,0,0,0,0,0,0,0,2,7,7,7,FALSE,1,2018,2018-2019
AL,2019-06-30,intra-ucx,3,1,0,0,0,0,0,0,0,0,1,5,4,5,FALSE,1,2018,2018-2019
AL,2019-06-30,intra-ui,2523,175,98,33,16,10,4,4,3,8,953,3827,3476,3651,FALSE,0.954010974653776,2018,2018-2019
AL,2019-07-31,inter-total,57,18,10,5,2,1,1,0,1,2,49,146,106,124,FALSE,0.849315068493151,2019,2019-2020
AL,2019-07-31,inter-ucfe,0,0,0,0,0,0,0,0,0,0,0,0,0,0,FALSE,0,2019,2019-2020
AL,2019-07-31,inter-ucx,0,0,0,0,0,0,0,0,0,0,0,0,0,0,FALSE,0,2019,2019-2020
AL,2019-07-31,inter-ui,57,18,10,5,2,1,1,0,1,2,49,146,106,124,FALSE,0.849315068493151,2019,2019-2020
AL,2019-07-31,intra-total,2598,528,193,85,20,13,4,3,2,11,1573,5030,4171,4699,FALSE,0.934194831013917,2019,2019-2020
AL,2019-07-31,intra-ucfe,4,4,1,0,0,0,0,1,0,0,6,16,10,14,FALSE,0.875,2019,2019-2020
AL,2019-07-31,intra-ucx,5,1,0,0,0,0,0,0,0,1,4,11,9,10,FALSE,0.909090909090909,2019,2019-2020
AL,2019-07-31,intra-ui,2589,523,192,85,20,13,4,2,2,10,1563,5003,4152,4675,FALSE,0.934439336398161,2019,2019-2020
AL,2019-08-31,inter-total,58,11,2,5,1,1,1,0,0,4,39,122,97,108,FALSE,0.885245901639344,2019,2019-2020
AL,2019-08-31,inter-ucfe,0,0,0,0,0,0,0,0,0,0,0,0,0,0,FALSE,0,2019,2019-2020
AL,2019-08-31,inter-ucx,0,0,0,0,0,0,0,0,0,0,0,0,0,0,FALSE,0,2019,2019-2020
AL,2019-08-31,inter-ui,58,11,2,5,1,1,1,0,0,4,39,122,97,108,FALSE,0.885245901639344,2019,2019-2020
AL,2019-08-31,intra-total,2022,149,98,85,37,6,4,7,2,15,864,3289,2886,3035,FALSE,0.922772879294618,2019,2019-2020
AL,2019-08-31,intra-ucfe,5,1,0,0,1,0,0,0,0,0,3,10,8,9,FALSE,0.9,2019,2019-2020
AL,2019-08-31,intra-ucx,8,0,0,1,0,0,0,0,0,0,5,14,13,13,FALSE,0.928571428571429,2019,2019-2020
AL,2019-08-31,intra-ui,2009,148,98,84,36,6,4,7,2,15,856,3265,2865,3013,FALSE,0.922817764165391,2019,2019-2020
AL,2019-09-30,inter-total,39,18,2,3,0,2,0,0,0,1,18,83,57,75,FALSE,0.903614457831325,2019,2019-2020
AL,2019-09-30,inter-ucfe,0,0,0,0,0,0,0,0,0,0,0,0,0,0,FALSE,0,2019,2019-2020
AL,2019-09-30,inter-ucx,0,0,0,0,0,0,0,0,0,0,0,0,0,0,FALSE,0,2019,2019-2020
AL,2019-09-30,inter-ui,39,18,2,3,0,2,0,0,0,1,18,83,57,75,FALSE,0.903614457831325,2019,2019-2020
AL,2019-09-30,intra-total,1535,155,61,45,26,18,3,3,1,11,656,2514,2191,2346,FALSE,0.933174224343675,2019,2019-2020
AL,2019-09-30,intra-ucfe,2,2,0,1,0,0,0,0,0,0,1,6,3,5,FALSE,0.833333333333333,2019,2019-2020
AL,2019-09-30,intra-ucx,9,0,0,0,0,0,0,0,0,0,2,11,11,11,FALSE,1,2019,2019-2020
AL,2019-09-30,intra-ui,1524,153,61,44,26,18,3,3,1,11,653,2497,2177,2330,FALSE,0.933119743692431,2019,2019-2020
AL,2019-10-31,inter-total,36,7,6,1,3,0,0,0,0,1,23,77,59,66,FALSE,0.857142857142857,2019,2019-2020
AL,2019-10-31,inter-ucfe,0,0,0,0,0,0,0,0,0,0,0,0,0,0,FALSE,0,2019,2019-2020
AL,2019-10-31,inter-ucx,0,0,0,0,0,0,0,0,0,0,0,0,0,0,FALSE,0,2019,2019-2020
AL,2019-10-31,inter-ui,36,7,6,1,3,0,0,0,0,1,23,77,59,66,FALSE,0.857142857142857,2019,2019-2020
AL,2019-10-31,intra-total,1779,181,49,40,23,18,6,4,0,15,785,2900,2564,2745,FALSE,0.946551724137931,2019,2019-2020
AL,2019-10-31,intra-ucfe,4,1,0,1,1,0,0,0,0,0,4,11,8,9,FALSE,0.818181818181818,2019,2019-2020
AL,2019-10-31,intra-ucx,7,1,0,1,0,0,0,0,0,0,1,10,8,9,FALSE,0.9,2019,2019-2020
AL,2019-10-31,intra-ui,1768,179,49,38,22,18,6,4,0,15,780,2879,2548,2727,FALSE,0.947203890239667,2019,2019-2020
AL,2019-11-30,inter-total,50,8,7,3,0,0,0,0,0,3,23,94,73,81,FALSE,0.861702127659575,2019,2019-2020
AL,2019-11-30,inter-ucfe,0,0,0,0,0,0,0,0,0,0,1,1,1,1,FALSE,1,2019,2019-2020
AL,2019-11-30,inter-ucx,0,0,0,0,0,0,0,0,0,0,0,0,0,0,FALSE,0,2019,2019-2020
AL,2019-11-30,inter-ui,50,8,7,3,0,0,0,0,0,3,22,93,72,80,FALSE,0.860215053763441,2019,2019-2020
AL,2019-11-30,intra-total,1492,125,76,34,25,13,7,2,0,5,677,2456,2169,2294,FALSE,0.934039087947883,2019,2019-2020
AL,2019-11-30,intra-ucfe,4,0,1,0,0,0,1,0,0,0,3,9,7,7,FALSE,0.777777777777778,2019,2019-2020
AL,2019-11-30,intra-ucx,8,0,0,0,0,0,0,0,0,0,1,9,9,9,FALSE,1,2019,2019-2020
AL,2019-11-30,intra-ui,1480,125,75,34,25,13,6,2,0,5,673,2438,2153,2278,FALSE,0.934372436423298,2019,2019-2020
AL,2019-12-31,inter-total,50,23,6,4,1,1,0,0,0,3,33,121,83,106,FALSE,0.87603305785124,2019,2019-2020
AL,2019-12-31,inter-ucfe,0,0,0,0,0,0,0,0,0,0,0,0,0,0,FALSE,0,2019,2019-2020
AL,2019-12-31,inter-ucx,0,0,0,0,0,0,0,0,0,0,0,0,0,0,FALSE,0,2019,2019-2020
AL,2019-12-31,inter-ui,50,23,6,4,1,1,0,0,0,3,33,121,83,106,FALSE,0.87603305785124,2019,2019-2020
AL,2019-12-31,intra-total,2100,175,42,32,17,12,8,6,2,20,883,3297,2983,3158,FALSE,0.957840461025174,2019,2019-2020
AL,2019-12-31,intra-ucfe,1,0,0,0,0,0,0,0,0,0,4,5,5,5,FALSE,1,2019,2019-2020
AL,2019-12-31,intra-ucx,6,1,1,0,0,0,0,0,0,0,3,11,9,10,FALSE,0.909090909090909,2019,2019-2020
AL,2019-12-31,intra-ui,2093,174,41,32,17,12,8,6,2,20,876,3281,2969,3143,FALSE,0.957939652544956,2019,2019-2020
AL,2020-01-31,inter-total,61,6,3,0,2,0,3,1,1,0,19,96,80,86,FALSE,0.895833333333333,2019,2019-2020
AL,2020-01-31,inter-ucfe,0,0,0,0,0,0,0,0,0,0,0,0,0,0,FALSE,0,2019,2019-2020
AL,2020-01-31,inter-ucx,0,0,0,0,0,0,0,0,0,0,0,0,0,0,FALSE,0,2019,2019-2020
AL,2020-01-31,inter-ui,61,6,3,0,2,0,3,1,1,0,19,96,80,86,FALSE,0.895833333333333,2019,2019-2020
AL,2020-01-31,intra-total,3071,184,59,25,7,9,1,1,1,36,964,4358,4035,4219,FALSE,0.96810463515374,2019,2019-2020
AL,2020-01-31,intra-ucfe,2,0,1,0,0,0,0,0,0,0,0,3,2,2,FALSE,0.666666666666667,2019,2019-2020
AL,2020-01-31,intra-ucx,4,0,0,0,0,0,0,0,0,0,0,4,4,4,FALSE,1,2019,2019-2020
AL,2020-01-31,intra-ui,3065,184,58,25,7,9,1,1,1,36,964,4351,4029,4213,FALSE,0.968283153298092,2019,2019-2020
AL,2020-02-29,inter-total,17,0,0,0,0,0,0,0,0,0,2,19,19,19,FALSE,1,2019,2019-2020
AL,2020-02-29,inter-ucfe,0,0,0,0,0,0,0,0,0,0,0,0,0,0,FALSE,0,2019,2019-2020
AL,2020-02-29,inter-ucx,0,0,0,0,0,0,0,0,0,0,0,0,0,0,FALSE,0,2019,2019-2020
AL,2020-02-29,inter-ui,17,0,0,0,0,0,0,0,0,0,2,19,19,19,FALSE,1,2019,2019-2020
AL,2020-02-29,intra-total,1887,47,9,9,2,8,4,2,1,9,309,2287,2196,2243,FALSE,0.980760822037604,2019,2019-2020
AL,2020-02-29,intra-ucfe,5,0,0,0,0,0,0,0,0,0,0,5,5,5,FALSE,1,2019,2019-2020
AL,2020-02-29,intra-ucx,4,0,1,0,0,0,0,0,0,0,0,5,4,4,FALSE,0.8,2019,2019-2020
AL,2020-02-29,intra-ui,1878,47,8,9,2,8,4,2,1,9,309,2277,2187,2234,FALSE,0.981115502854633,2019,2019-2020
AL,2020-03-31,inter-total,13,0,0,0,0,0,0,0,0,0,0,13,13,13,FALSE,1,2019,2019-2020
AL,2020-03-31,inter-ucfe,0,0,0,0,0,0,0,0,0,0,0,0,0,0,FALSE,0,2019,2019-2020
AL,2020-03-31,inter-ucx,0,0,0,0,0,0,0,0,0,0,0,0,0,0,FALSE,0,2019,2019-2020
AL,2020-03-31,inter-ui,13,0,0,0,0,0,0,0,0,0,0,13,13,13,FALSE,1,2019,2019-2020
AL,2020-03-31,intra-total,6222,7,9,5,6,1,4,0,1,36,34,6325,6256,6263,FALSE,0.990197628458498,2019,2019-2020
AL,2020-03-31,intra-ucfe,2,0,0,0,0,0,0,0,0,0,0,2,2,2,FALSE,1,2019,2019-2020
AL,2020-03-31,intra-ucx,2,0,0,0,0,0,1,0,0,0,0,3,2,2,FALSE,0.666666666666667,2019,2019-2020
AL,2020-03-31,intra-ui,6218,7,9,5,6,1,3,0,1,36,34,6320,6252,6259,FALSE,0.990348101265823,2019,2019-2020
AL,2020-04-30,inter-total,185,44,3,2,0,2,1,0,0,1,152,390,337,381,FALSE,0.976923076923077,2019,2019-2020
AL,2020-04-30,inter-ucfe,0,0,0,0,0,0,0,0,0,0,0,0,0,0,FALSE,0,2019,2019-2020
AL,2020-04-30,inter-ucx,0,0,0,0,0,0,0,0,0,0,0,0,0,0,FALSE,0,2019,2019-2020
AL,2020-04-30,inter-ui,185,44,3,2,0,2,1,0,0,1,152,390,337,381,FALSE,0.976923076923077,2019,2019-2020
AL,2020-04-30,intra-total,84569,10383,4947,1584,366,145,56,32,21,124,71172,173399,155741,166124,FALSE,0.95804474074245,2019,2019-2020
AL,2020-04-30,intra-ucfe,3,8,5,3,1,0,1,0,0,0,9,30,12,20,FALSE,0.666666666666667,2019,2019-2020
AL,2020-04-30,intra-ucx,0,3,0,2,0,2,0,0,0,0,2,9,2,5,FALSE,0.555555555555556,2019,2019-2020
AL,2020-04-30,intra-ui,84566,10372,4942,1579,365,143,55,32,21,124,71161,173360,155727,166099,FALSE,0.958116059067836,2019,2019-2020
AL,2020-05-31,inter-total,52,16,14,9,9,4,2,2,0,1,14,123,66,82,FALSE,0.666666666666667,2019,2019-2020
AL,2020-05-31,inter-ucfe,0,0,0,0,0,0,0,0,0,0,0,0,0,0,FALSE,0,2019,2019-2020
AL,2020-05-31,inter-ucx,0,0,0,0,0,0,0,0,0,0,0,0,0,0,FALSE,0,2019,2019-2020
AL,2020-05-31,inter-ui,52,16,14,9,9,4,2,2,0,1,14,123,66,82,FALSE,0.666666666666667,2019,2019-2020
AL,2020-05-31,intra-total,40058,7258,5196,6064,3413,2401,931,508,75,217,5649,71770,45707,52965,FALSE,0.737982443918072,2019,2019-2020
AL,2020-05-31,intra-ucfe,20,4,8,9,11,5,3,2,1,2,8,73,28,32,FALSE,0.438356164383562,2019,2019-2020
AL,2020-05-31,intra-ucx,6,8,7,14,9,0,3,1,0,0,9,57,15,23,FALSE,0.403508771929825,2019,2019-2020
AL,2020-05-31,intra-ui,40032,7246,5181,6041,3393,2396,925,505,74,215,5632,71640,45664,52910,FALSE,0.73855388051368,2019,2019-2020
AL,2020-06-30,inter-total,271,9,5,6,6,14,10,13,10,24,16,384,287,296,FALSE,0.770833333333333,2019,2019-2020
AL,2020-06-30,inter-ucfe,0,0,0,0,0,0,0,0,0,0,0,0,0,0,FALSE,0,2019,2019-2020
AL,2020-06-30,inter-ucx,0,0,0,0,0,0,0,0,0,0,0,0,0,0,FALSE,0,2019,2019-2020
AL,2020-06-30,inter-ui,271,9,5,6,6,14,10,13,10,24,16,384,287,296,FALSE,0.770833333333333,2019,2019-2020
AL,2020-06-30,intra-total,21725,867,856,627,508,588,743,1174,948,2506,1381,31923,23106,23973,FALSE,0.750963255333145,2019,2019-2020
AL,2020-06-30,intra-ucfe,8,3,4,1,1,3,2,1,3,6,1,33,9,12,FALSE,0.363636363636364,2019,2019-2020
AL,2020-06-30,intra-ucx,12,3,2,4,2,5,6,1,4,4,9,52,21,24,FALSE,0.461538461538462,2019,2019-2020
AL,2020-06-30,intra-ui,21705,861,850,622,505,580,735,1172,941,2496,1371,31838,23076,23937,FALSE,0.751837426974056,2019,2019-2020
AL,2020-07-31,inter-total,214,8,4,2,2,3,2,2,2,42,69,350,283,291,FALSE,0.831428571428571,2020,2020-2021
AL,2020-07-31,inter-ucfe,0,0,0,0,0,0,0,0,0,1,0,1,0,0,FALSE,0,2020,2020-2021
AL,2020-07-31,inter-ucx,0,0,0,0,0,0,0,0,0,0,0,0,0,0,FALSE,0,2020,2020-2021
AL,2020-07-31,inter-ui,214,8,4,2,2,3,2,2,2,41,69,349,283,291,FALSE,0.833810888252149,2020,2020-2021
AL,2020-07-31,intra-total,14011,955,415,267,294,294,251,269,252,3038,5492,25538,19503,20458,FALSE,0.801080742423056,2020,2020-2021
AL,2020-07-31,intra-ucfe,8,7,0,0,1,1,1,0,5,6,6,35,14,21,FALSE,0.6,2020,2020-2021
AL,2020-07-31,intra-ucx,3,1,5,0,2,2,0,2,1,5,4,25,7,8,FALSE,0.32,2020,2020-2021
AL,2020-07-31,intra-ui,14000,947,410,267,291,291,250,267,246,3027,5482,25478,19482,20429,FALSE,0.801829028966167,2020,2020-2021
AL,2020-08-31,inter-total,102,7,8,4,9,1,2,3,2,35,59,232,161,168,FALSE,0.724137931034483,2020,2020-2021
AL,2020-08-31,inter-ucfe,0,1,0,0,0,0,0,0,0,0,0,1,0,1,FALSE,1,2020,2020-2021
AL,2020-08-31,inter-ucx,0,0,0,0,0,0,0,0,0,0,0,0,0,0,FALSE,0,2020,2020-2021
AL,2020-08-31,inter-ui,102,6,8,4,9,1,2,3,2,35,59,231,161,167,FALSE,0.722943722943723,2020,2020-2021
AL,2020-08-31,intra-total,4154,346,498,377,258,240,164,130,129,2398,3009,11703,7163,7509,FALSE,0.641630351192002,2020,2020-2021
AL,2020-08-31,intra-ucfe,10,5,5,1,0,0,1,1,0,8,4,35,14,19,FALSE,0.542857142857143,2020,2020-2021
AL,2020-08-31,intra-ucx,6,2,2,2,2,1,1,0,2,11,9,38,15,17,FALSE,0.447368421052632,2020,2020-2021
AL,2020-08-31,intra-ui,4138,339,491,374,256,239,162,129,127,2379,2996,11630,7134,7473,FALSE,0.64256233877902,2020,2020-2021
AL,2020-09-30,inter-total,35,7,5,4,1,8,5,6,4,30,36,141,71,78,FALSE,0.553191489361702,2020,2020-2021
AL,2020-09-30,inter-ucfe,0,0,0,0,0,0,0,0,0,0,0,0,0,0,FALSE,0,2020,2020-2021
AL,2020-09-30,inter-ucx,0,0,0,0,0,0,0,0,0,0,0,0,0,0,FALSE,0,2020,2020-2021
AL,2020-09-30,inter-ui,35,7,5,4,1,8,5,6,4,30,36,141,71,78,FALSE,0.553191489361702,2020,2020-2021
AL,2020-09-30,intra-total,2124,211,160,128,152,186,167,151,152,2129,1786,7346,3910,4121,FALSE,0.560985570378437,2020,2020-2021
AL,2020-09-30,intra-ucfe,3,1,0,0,0,1,1,0,0,6,4,16,7,8,FALSE,0.5,2020,2020-2021
AL,2020-09-30,intra-ucx,2,0,0,2,0,0,2,0,1,4,3,14,5,5,FALSE,0.357142857142857,2020,2020-2021
AL,2020-09-30,intra-ui,2119,210,160,126,152,185,164,151,151,2119,1779,7316,3898,4108,FALSE,0.561509021323127,2020,2020-2021
AL,2020-10-31,inter-total,71,3,2,0,2,7,1,1,3,33,44,167,115,118,FALSE,0.706586826347305,2020,2020-2021
AL,2020-10-31,inter-ucfe,0,0,0,0,0,0,0,0,0,1,0,1,0,0,FALSE,0,2020,2020-2021
AL,2020-10-31,inter-ucx,1,0,0,0,0,0,0,0,0,0,0,1,1,1,FALSE,1,2020,2020-2021
AL,2020-10-31,inter-ui,70,3,2,0,2,7,1,1,3,32,44,165,114,117,FALSE,0.709090909090909,2020,2020-2021
AL,2020-10-31,intra-total,2905,216,157,133,116,122,107,81,81,1848,1406,7172,4311,4527,FALSE,0.631204684885667,2020,2020-2021
AL,2020-10-31,intra-ucfe,7,1,0,2,1,1,1,1,0,4,2,20,9,10,FALSE,0.5,2020,2020-2021
AL,2020-10-31,intra-ucx,6,0,1,4,1,0,0,0,0,8,6,26,12,12,FALSE,0.461538461538462,2020,2020-2021
AL,2020-10-31,intra-ui,2892,215,156,127,114,121,106,80,81,1836,1398,7126,4290,4505,FALSE,0.632191973056413,2020,2020-2021
AL,2020-11-30,inter-total,17,5,1,2,2,0,0,1,2,34,27,91,44,49,FALSE,0.538461538461538,2020,2020-2021
AL,2020-11-30,inter-ucfe,0,0,0,0,1,0,0,0,0,0,0,1,0,0,FALSE,0,2020,2020-2021
AL,2020-11-30,inter-ucx,0,0,0,0,0,0,0,0,0,0,0,0,0,0,FALSE,0,2020,2020-2021
AL,2020-11-30,inter-ui,17,5,1,2,1,0,0,1,2,34,27,90,44,49,FALSE,0.544444444444444,2020,2020-2021
AL,2020-11-30,intra-total,1143,212,136,138,87,91,75,63,61,1578,877,4461,2020,2232,FALSE,0.500336247478144,2020,2020-2021
AL,2020-11-30,intra-ucfe,8,2,2,1,0,0,0,0,0,4,2,19,10,12,FALSE,0.631578947368421,2020,2020-2021
AL,2020-11-30,intra-ucx,5,1,0,0,0,1,0,0,0,4,0,11,5,6,FALSE,0.545454545454545,2020,2020-2021
AL,2020-11-30,intra-ui,1130,209,134,137,87,90,75,63,61,1570,875,4431,2005,2214,FALSE,0.499661475964794,2020,2020-2021
AL,2020-12-31,inter-total,25,16,3,3,4,0,3,2,0,41,32,129,57,73,FALSE,0.565891472868217,2020,2020-2021
AL,2020-12-31,inter-ucfe,0,0,0,0,0,0,0,0,0,1,0,1,0,0,FALSE,0,2020,2020-2021
AL,2020-12-31,inter-ucx,0,0,0,0,0,0,0,0,0,0,0,0,0,0,FALSE,0,2020,2020-2021
AL,2020-12-31,inter-ui,25,16,3,3,4,0,3,2,0,40,32,128,57,73,FALSE,0.5703125,2020,2020-2021
AL,2020-12-31,intra-total,1279,346,173,139,121,82,84,70,62,1439,1109,4904,2388,2734,FALSE,0.557504078303426,2020,2020-2021
AL,2020-12-31,intra-ucfe,7,1,6,3,2,3,5,1,0,4,1,33,8,9,FALSE,0.272727272727273,2020,2020-2021
AL,2020-12-31,intra-ucx,1,0,1,0,1,0,1,1,0,11,1,17,2,2,FALSE,0.117647058823529,2020,2020-2021
AL,2020-12-31,intra-ui,1271,345,166,136,118,79,78,68,62,1424,1107,4854,2378,2723,FALSE,0.560980634528224,2020,2020-2021
AL,2021-01-31,inter-total,69,15,3,3,5,3,3,1,3,39,41,185,110,125,FALSE,0.675675675675676,2020,2020-2021
AL,2021-01-31,inter-ucfe,0,0,0,0,0,0,0,0,0,1,0,1,0,0,FALSE,0,2020,2020-2021
AL,2021-01-31,inter-ucx,0,0,0,0,0,0,0,0,0,0,0,0,0,0,FALSE,0,2020,2020-2021
AL,2021-01-31,inter-ui,69,15,3,3,5,3,3,1,3,38,41,184,110,125,FALSE,0.679347826086957,2020,2020-2021
AL,2021-01-31,intra-total,2846,677,221,153,107,79,82,65,52,1015,2177,7474,5023,5700,FALSE,0.762643831950763,2020,2020-2021
AL,2021-01-31,intra-ucfe,10,2,1,2,1,1,2,0,2,6,6,33,16,18,FALSE,0.545454545454545,2020,2020-2021
AL,2021-01-31,intra-ucx,1,3,0,3,0,2,0,0,0,4,2,15,3,6,FALSE,0.4,2020,2020-2021
AL,2021-01-31,intra-ui,2835,672,220,148,106,76,80,65,50,1005,2169,7426,5004,5676,FALSE,0.764341502827902,2020,2020-2021
AL,2021-02-28,inter-total,86,8,7,5,3,5,3,3,2,36,143,301,229,237,FALSE,0.787375415282392,2020,2020-2021
AL,2021-02-28,inter-ucfe,0,0,0,0,0,0,0,0,0,1,0,1,0,0,FALSE,0,2020,2020-2021
AL,2021-02-28,inter-ucx,0,0,0,0,0,0,0,0,0,1,1,2,1,1,FALSE,0.5,2020,2020-2021
AL,2021-02-28,inter-ui,86,8,7,5,3,5,3,3,2,34,142,298,228,236,FALSE,0.791946308724832,2020,2020-2021
AL,2021-02-28,intra-total,2058,311,251,186,159,142,83,69,42,1498,2116,6915,4174,4485,FALSE,0.648590021691974,2020,2020-2021
AL,2021-02-28,intra-ucfe,9,2,0,1,0,0,0,0,0,8,2,22,11,13,FALSE,0.590909090909091,2020,2020-2021
AL,2021-02-28,intra-ucx,7,2,2,1,0,0,0,2,0,9,4,27,11,13,FALSE,0.481481481481482,2020,2020-2021
AL,2021-02-28,intra-ui,2042,307,249,184,159,142,83,67,42,1481,2110,6866,4152,4459,FALSE,0.649431983687737,2020,2020-2021
AL,2021-03-31,inter-total,154,10,7,2,3,2,5,5,2,57,232,479,386,396,FALSE,0.826722338204593,2020,2020-2021
AL,2021-03-31,inter-ucfe,0,0,0,0,0,0,0,0,0,0,0,0,0,0,FALSE,0,2020,2020-2021
AL,2021-03-31,inter-ucx,0,0,0,0,0,0,0,0,0,1,0,1,0,0,FALSE,0,2020,2020-2021
AL,2021-03-31,inter-ui,154,10,7,2,3,2,5,5,2,56,232,478,386,396,FALSE,0.828451882845188,2020,2020-2021
AL,2021-03-31,intra-total,1959,261,187,161,144,121,102,124,79,1715,2293,7146,4252,4513,FALSE,0.631542121466555,2020,2020-2021
AL,2021-03-31,intra-ucfe,3,1,0,1,0,1,0,0,0,1,2,9,5,6,FALSE,0.666666666666667,2020,2020-2021
AL,2021-03-31,intra-ucx,3,1,2,1,1,0,2,1,0,3,2,16,5,6,FALSE,0.375,2020,2020-2021
AL,2021-03-31,intra-ui,1953,259,185,159,143,120,100,123,79,1711,2289,7121,4242,4501,FALSE,0.632074146889482,2020,2020-2021
AL,2021-04-30,inter-total,203,14,25,16,3,2,0,0,1,37,340,641,543,557,FALSE,0.868954758190328,2020,2020-2021
AL,2021-04-30,inter-ucfe,0,0,0,1,0,0,0,0,0,0,0,1,0,0,FALSE,0,2020,2020-2021
AL,2021-04-30,inter-ucx,0,0,0,0,0,0,0,0,0,0,0,0,0,0,FALSE,0,2020,2020-2021
AL,2021-04-30,inter-ui,203,14,25,15,3,2,0,0,1,37,340,640,543,557,FALSE,0.8703125,2020,2020-2021
AL,2021-04-30,intra-total,4309,476,335,240,104,82,84,44,46,1217,4631,11568,8940,9416,FALSE,0.813969571230982,2020,2020-2021
AL,2021-04-30,intra-ucfe,7,1,2,0,0,0,1,0,0,3,2,16,9,10,FALSE,0.625,2020,2020-2021
AL,2021-04-30,intra-ucx,3,3,2,0,0,0,1,0,0,5,3,17,6,9,FALSE,0.529411764705882,2020,2020-2021
AL,2021-04-30,intra-ui,4299,472,331,240,104,82,82,44,46,1209,4626,11535,8925,9397,FALSE,0.814651061985262,2020,2020-2021
AL,2021-05-31,inter-total,32,10,9,7,7,2,1,1,1,28,169,267,201,211,FALSE,0.790262172284644,2020,2020-2021
AL,2021-05-31,inter-ucfe,0,0,0,0,0,0,0,0,0,3,0,3,0,0,FALSE,0,2020,2020-2021
AL,2021-05-31,inter-ucx,0,0,0,0,0,0,0,0,0,0,0,0,0,0,FALSE,0,2020,2020-2021
AL,2021-05-31,inter-ui,32,10,9,7,7,2,1,1,1,25,169,264,201,211,FALSE,0.799242424242424,2020,2020-2021
AL,2021-05-31,intra-total,989,316,239,220,237,129,94,43,44,1088,1604,5003,2593,2909,FALSE,0.581451129322407,2020,2020-2021
AL,2021-05-31,intra-ucfe,7,3,2,0,1,1,1,0,0,5,1,21,8,11,FALSE,0.523809523809524,2020,2020-2021
AL,2021-05-31,intra-ucx,8,1,1,1,0,0,0,0,0,2,0,13,8,9,FALSE,0.692307692307692,2020,2020-2021
AL,2021-05-31,intra-ui,974,312,236,219,236,128,93,43,44,1081,1603,4969,2577,2889,FALSE,0.581404709197022,2020,2020-2021
AL,2021-06-30,inter-total,4,4,2,2,1,1,1,2,1,19,9,46,13,17,FALSE,0.369565217391304,2020,2020-2021
AL,2021-06-30,inter-ucfe,0,0,0,0,0,0,0,0,0,0,0,0,0,0,FALSE,0,2020,2020-2021
AL,2021-06-30,inter-ucx,0,0,0,0,0,0,0,0,0,0,0,0,0,0,FALSE,0,2020,2020-2021
AL,2021-06-30,inter-ui,4,4,2,2,1,1,1,2,1,19,9,46,13,17,FALSE,0.369565217391304,2020,2020-2021
AL,2021-06-30,intra-total,856,329,187,158,138,111,75,70,55,996,1165,4140,2021,2350,FALSE,0.567632850241546,2020,2020-2021
AL,2021-06-30,intra-ucfe,0,0,1,1,0,0,2,0,0,3,0,7,0,0,FALSE,0,2020,2020-2021
AL,2021-06-30,intra-ucx,0,0,0,0,0,0,0,0,0,0,0,0,0,0,FALSE,0,2020,2020-2021
AL,2021-06-30,intra-ui,856,329,186,157,138,111,73,70,55,993,1165,4133,2021,2350,FALSE,0.568594241471086,2020,2020-2021
AL,2021-07-31,inter-total,8,2,2,2,11,1,3,0,2,31,4,66,12,14,FALSE,0.212121212121212,2021,2021-2022
AL,2021-07-31,inter-ucfe,0,0,0,0,0,0,0,0,0,0,0,0,0,0,FALSE,0,2021,2021-2022
AL,2021-07-31,inter-ucx,0,0,0,0,0,0,0,0,0,0,0,0,0,0,FALSE,0,2021,2021-2022
AL,2021-07-31,inter-ui,8,2,2,2,11,1,3,0,2,31,4,66,12,14,FALSE,0.212121212121212,2021,2021-2022
AL,2021-07-31,intra-total,1519,423,245,203,134,118,89,73,52,1115,1506,5477,3025,3448,FALSE,0.629541719919664,2021,2021-2022
AL,2021-07-31,intra-ucfe,3,0,0,0,1,0,0,0,1,6,0,11,3,3,FALSE,0.272727272727273,2021,2021-2022
AL,2021-07-31,intra-ucx,2,0,0,1,0,0,0,0,0,1,0,4,2,2,FALSE,0.5,2021,2021-2022
AL,2021-07-31,intra-ui,1514,423,245,202,133,118,89,73,51,1108,1506,5462,3020,3443,FALSE,0.630355181252289,2021,2021-2022
AL,2021-08-31,inter-total,3,4,0,0,2,3,4,2,1,20,2,41,5,9,FALSE,0.219512195121951,2021,2021-2022
AL,2021-08-31,inter-ucfe,0,0,0,0,0,0,0,0,0,0,0,0,0,0,FALSE,0,2021,2021-2022
AL,2021-08-31,inter-ucx,0,0,0,0,0,0,0,0,0,0,0,0,0,0,FALSE,0,2021,2021-2022
AL,2021-08-31,inter-ui,3,4,0,0,2,3,4,2,1,20,2,41,5,9,FALSE,0.219512195121951,2021,2021-2022
AL,2021-08-31,intra-total,733,146,141,104,115,420,111,88,90,1202,199,3349,932,1078,FALSE,0.321887130486712,2021,2021-2022
AL,2021-08-31,intra-ucfe,2,0,1,0,4,1,1,1,0,11,2,23,4,4,FALSE,0.173913043478261,2021,2021-2022
AL,2021-08-31,intra-ucx,1,0,0,1,1,0,0,0,0,2,2,7,3,3,FALSE,0.428571428571429,2021,2021-2022
AL,2021-08-31,intra-ui,730,146,140,103,110,419,110,87,90,1189,195,3319,925,1071,FALSE,0.32268755649292,2021,2021-2022
AL,2021-09-30,inter-total,3,1,5,1,2,0,2,3,1,38,0,56,3,4,FALSE,0.0714285714285714,2021,2021-2022
AL,2021-09-30,inter-ucfe,0,0,0,0,1,0,0,0,0,0,0,1,0,0,FALSE,0,2021,2021-2022
AL,2021-09-30,inter-ucx,0,0,0,0,0,0,0,0,0,0,0,0,0,0,FALSE,0,2021,2021-2022
AL,2021-09-30,inter-ui,3,1,5,1,1,0,2,3,1,38,0,55,3,4,FALSE,0.0727272727272727,2021,2021-2022
AL,2021-09-30,intra-total,520,144,113,101,97,77,73,83,81,1756,282,3327,802,946,FALSE,0.28434024646829,2021,2021-2022
AL,2021-09-30,intra-ucfe,1,0,0,1,0,0,0,1,0,5,0,8,1,1,FALSE,0.125,2021,2021-2022
AL,2021-09-30,intra-ucx,2,2,1,1,0,1,0,0,0,2,2,11,4,6,FALSE,0.545454545454545,2021,2021-2022
AL,2021-09-30,intra-ui,517,142,112,99,97,76,73,82,81,1749,280,3308,797,939,FALSE,0.283857315598549,2021,2021-2022
AL,2021-10-31,inter-total,0,0,1,1,0,3,0,1,2,22,0,30,0,0,FALSE,0,2021,2021-2022
AL,2021-10-31,inter-ucfe,0,0,0,0,0,0,0,0,0,0,0,0,0,0,FALSE,0,2021,2021-2022
AL,2021-10-31,inter-ucx,0,0,0,0,0,0,0,0,0,0,0,0,0,0,FALSE,0,2021,2021-2022
AL,2021-10-31,inter-ui,0,0,1,1,0,3,0,1,2,22,0,30,0,0,FALSE,0,2021,2021-2022
AL,2021-10-31,intra-total,883,116,114,94,73,68,57,56,43,1602,253,3359,1136,1252,FALSE,0.372729979160464,2021,2021-2022
AL,2021-10-31,intra-ucfe,0,0,0,0,0,0,0,0,0,3,0,3,0,0,FALSE,0,2021,2021-2022
AL,2021-10-31,intra-ucx,3,0,1,0,0,0,0,0,0,0,0,4,3,3,FALSE,0.75,2021,2021-2022
AL,2021-10-31,intra-ui,880,116,113,94,73,68,57,56,43,1599,253,3352,1133,1249,FALSE,0.372613365155131,2021,2021-2022
AL,2021-11-30,inter-total,3,3,0,0,0,0,0,0,1,24,2,33,5,8,FALSE,0.242424242424242,2021,2021-2022
AL,2021-11-30,inter-ucfe,0,0,0,0,0,0,0,0,0,0,0,0,0,0,FALSE,0,2021,2021-2022
AL,2021-11-30,inter-ucx,0,0,0,0,0,0,0,0,0,0,0,0,0,0,FALSE,0,2021,2021-2022
AL,2021-11-30,inter-ui,3,3,0,0,0,0,0,0,1,24,2,33,5,8,FALSE,0.242424242424242,2021,2021-2022
AL,2021-11-30,intra-total,842,118,99,82,72,52,46,38,29,1662,262,3302,1104,1222,FALSE,0.37007874015748,2021,2021-2022
AL,2021-11-30,intra-ucfe,3,1,0,1,1,0,1,0,0,6,1,14,4,5,FALSE,0.357142857142857,2021,2021-2022
AL,2021-11-30,intra-ucx,8,2,0,0,0,0,0,2,0,0,0,12,8,10,FALSE,0.833333333333333,2021,2021-2022
AL,2021-11-30,intra-ui,831,115,99,81,71,52,45,36,29,1656,261,3276,1092,1207,FALSE,0.368437118437118,2021,2021-2022
AL,2021-12-31,inter-total,4,0,1,2,1,1,1,0,0,34,3,47,7,7,FALSE,0.148936170212766,2021,2021-2022
AL,2021-12-31,inter-ucfe,0,0,0,0,0,0,0,0,0,0,0,0,0,0,FALSE,0,2021,2021-2022
AL,2021-12-31,inter-ucx,0,0,0,0,0,0,0,0,0,0,0,0,0,0,FALSE,0,2021,2021-2022
AL,2021-12-31,inter-ui,4,0,1,2,1,1,1,0,0,34,3,47,7,7,FALSE,0.148936170212766,2021,2021-2022
AL,2021-12-31,intra-total,646,173,136,92,72,58,53,30,29,1296,375,2960,1021,1194,FALSE,0.403378378378378,2021,2021-2022
AL,2021-12-31,intra-ucfe,3,0,0,2,0,0,0,0,0,8,1,14,4,4,FALSE,0.285714285714286,2021,2021-2022
AL,2021-12-31,intra-ucx,3,0,0,0,0,0,0,0,0,1,1,5,4,4,FALSE,0.8,2021,2021-2022
AL,2021-12-31,intra-ui,640,173,136,90,72,58,53,30,29,1287,373,2941,1013,1186,FALSE,0.403264195851751,2021,2021-2022
AL,2022-01-31,inter-total,6,5,1,2,0,2,0,0,0,29,4,49,10,15,FALSE,0.306122448979592,2021,2021-2022
AL,2022-01-31,inter-ucfe,0,0,0,0,0,0,0,0,0,0,0,0,0,0,FALSE,0,2021,2021-2022
AL,2022-01-31,inter-ucx,0,0,0,0,0,0,0,0,0,1,0,1,0,0,FALSE,0,2021,2021-2022
AL,2022-01-31,inter-ui,6,5,1,2,0,2,0,0,0,28,4,48,10,15,FALSE,0.3125,2021,2021-2022
AL,2022-01-31,intra-total,1029,187,137,103,80,59,51,32,36,1058,419,3191,1448,1635,FALSE,0.512378564713256,2021,2021-2022
AL,2022-01-31,intra-ucfe,0,2,0,0,0,1,0,1,0,3,1,8,1,3,FALSE,0.375,2021,2021-2022
AL,2022-01-31,intra-ucx,7,2,1,1,1,0,0,0,0,0,3,15,10,12,FALSE,0.8,2021,2021-2022
AL,2022-01-31,intra-ui,1022,183,136,102,79,58,51,31,36,1055,415,3168,1437,1620,FALSE,0.511363636363636,2021,2021-2022
AL,2022-02-28,inter-total,3,1,1,1,0,0,0,1,0,16,3,26,6,7,FALSE,0.269230769230769,2021,2021-2022
AL,2022-02-28,inter-ucfe,0,0,0,0,0,0,0,0,0,0,0,0,0,0,FALSE,0,2021,2021-2022
AL,2022-02-28,inter-ucx,0,0,0,0,0,0,0,0,0,0,0,0,0,0,FALSE,0,2021,2021-2022
AL,2022-02-28,inter-ui,3,1,1,1,0,0,0,1,0,16,3,26,6,7,FALSE,0.269230769230769,2021,2021-2022
AL,2022-02-28,intra-total,451,136,136,102,92,55,36,52,34,901,190,2185,641,777,FALSE,0.355606407322655,2021,2021-2022
AL,2022-02-28,intra-ucfe,3,0,1,0,0,0,0,1,0,7,0,12,3,3,FALSE,0.25,2021,2021-2022
AL,2022-02-28,intra-ucx,4,2,1,0,1,0,0,0,0,2,0,10,4,6,FALSE,0.6,2021,2021-2022
AL,2022-02-28,intra-ui,444,134,134,102,91,55,36,51,34,892,190,2163,634,768,FALSE,0.355062413314841,2021,2021-2022
AL,2022-03-31,inter-total,4,3,1,0,1,2,1,0,0,16,1,29,5,8,FALSE,0.275862068965517,2021,2021-2022
AL,2022-03-31,inter-ucfe,0,0,0,0,0,0,0,0,0,0,0,0,0,0,FALSE,0,2021,2021-2022
AL,2022-03-31,inter-ucx,0,0,0,0,0,0,0,0,0,0,0,0,0,0,FALSE,0,2021,2021-2022
AL,2022-03-31,inter-ui,4,3,1,0,1,2,1,0,0,16,1,29,5,8,FALSE,0.275862068965517,2021,2021-2022
AL,2022-03-31,intra-total,563,128,88,77,65,58,48,41,25,1148,155,2396,718,846,FALSE,0.353088480801336,2021,2021-2022
AL,2022-03-31,intra-ucfe,2,2,2,0,1,0,0,2,0,12,0,21,2,4,FALSE,0.19047619047619,2021,2021-2022
AL,2022-03-31,intra-ucx,5,1,0,0,0,0,0,0,0,1,0,7,5,6,FALSE,0.857142857142857,2021,2021-2022
AL,2022-03-31,intra-ui,556,125,86,77,64,58,48,39,25,1135,155,2368,711,836,FALSE,0.353040540540541,2021,2021-2022
AL,2022-04-30,inter-total,4,1,1,2,0,1,0,0,0,13,3,25,7,8,FALSE,0.32,2021,2021-2022
AL,2022-04-30,inter-ucfe,0,0,0,0,0,0,0,0,0,0,0,0,0,0,FALSE,0,2021,2021-2022
AL,2022-04-30,inter-ucx,0,0,0,0,0,0,0,0,0,0,0,0,0,0,FALSE,0,2021,2021-2022
AL,2022-04-30,inter-ui,4,1,1,2,0,1,0,0,0,13,3,25,7,8,FALSE,0.32,2021,2021-2022
AL,2022-04-30,intra-total,682,133,75,66,49,31,38,30,26,866,207,2203,889,1022,FALSE,0.463912846118929,2021,2021-2022
AL,2022-04-30,intra-ucfe,5,1,0,0,2,0,0,2,1,6,0,17,5,6,FALSE,0.352941176470588,2021,2021-2022
AL,2022-04-30,intra-ucx,3,0,0,0,0,0,0,0,0,1,0,4,3,3,FALSE,0.75,2021,2021-2022
AL,2022-04-30,intra-ui,674,132,75,66,47,31,38,28,25,859,207,2182,881,1013,FALSE,0.464252978918424,2021,2021-2022
AL,2022-05-31,inter-total,3,3,0,1,1,3,1,1,0,20,6,39,9,12,FALSE,0.307692307692308,2021,2021-2022
AL,2022-05-31,inter-ucfe,0,0,0,0,0,0,0,0,0,1,0,1,0,0,FALSE,0,2021,2021-2022
AL,2022-05-31,inter-ucx,0,0,0,0,0,0,0,0,0,0,0,0,0,0,FALSE,0,2021,2021-2022
AL,2022-05-31,inter-ui,3,3,0,1,1,3,1,1,0,19,6,38,9,12,FALSE,0.315789473684211,2021,2021-2022
AL,2022-05-31,intra-total,834,156,99,94,83,47,35,30,35,2162,196,3771,1030,1186,FALSE,0.314505436223813,2021,2021-2022
AL,2022-05-31,intra-ucfe,6,3,1,1,1,1,1,0,0,5,1,20,7,10,FALSE,0.5,2021,2021-2022
AL,2022-05-31,intra-ucx,7,0,0,0,0,0,0,0,0,7,3,17,10,10,FALSE,0.588235294117647,2021,2021-2022
AL,2022-05-31,intra-ui,821,153,98,93,82,46,34,30,35,2150,192,3734,1013,1166,FALSE,0.312265666845206,2021,2021-2022
AL,2022-06-30,inter-total,11,2,2,1,0,2,1,0,0,15,0,34,11,13,FALSE,0.382352941176471,2021,2021-2022
AL,2022-06-30,inter-ucfe,0,0,0,0,0,0,0,0,0,0,0,0,0,0,FALSE,0,2021,2021-2022
AL,2022-06-30,inter-ucx,0,0,0,0,0,0,0,0,0,0,0,0,0,0,FALSE,0,2021,2021-2022
AL,2022-06-30,inter-ui,11,2,2,1,0,2,1,0,0,15,0,34,11,13,FALSE,0.382352941176471,2021,2021-2022
AL,2022-06-30,intra-total,1199,145,121,73,56,51,52,25,27,668,245,2662,1444,1589,FALSE,0.596919609316304,2021,2021-2022
AL,2022-06-30,intra-ucfe,5,1,0,1,0,0,0,0,1,0,3,11,8,9,FALSE,0.818181818181818,2021,2021-2022
AL,2022-06-30,intra-ucx,2,0,0,0,0,0,0,0,0,1,0,3,2,2,FALSE,0.666666666666667,2021,2021-2022
AL,2022-06-30,intra-ui,1192,144,121,72,56,51,52,25,26,667,242,2648,1434,1578,FALSE,0.595921450151057,2021,2021-2022
AL,2022-07-31,inter-total,18,2,0,5,2,1,0,0,0,16,1,45,19,21,FALSE,0.466666666666667,2022,2022-2023
AL,2022-07-31,inter-ucfe,0,0,0,0,0,0,0,0,0,0,0,0,0,0,FALSE,0,2022,2022-2023
AL,2022-07-31,inter-ucx,0,0,0,0,0,0,0,0,0,0,0,0,0,0,FALSE,0,2022,2022-2023
AL,2022-07-31,inter-ui,18,2,0,5,2,1,0,0,0,16,1,45,19,21,FALSE,0.466666666666667,2022,2022-2023
AL,2022-07-31,intra-total,1370,213,151,121,96,63,48,39,33,957,332,3423,1702,1915,FALSE,0.559450774174701,2022,2022-2023
AL,2022-07-31,intra-ucfe,2,0,2,0,1,0,1,1,1,5,2,15,4,4,FALSE,0.266666666666667,2022,2022-2023
AL,2022-07-31,intra-ucx,6,1,1,3,1,0,0,0,0,3,1,16,7,8,FALSE,0.5,2022,2022-2023
AL,2022-07-31,intra-ui,1362,212,148,118,94,63,47,38,32,949,329,3392,1691,1903,FALSE,0.561025943396226,2022,2022-2023
AL,2022-08-31,inter-total,5,2,1,2,3,0,0,0,0,6,4,23,9,11,FALSE,0.478260869565217,2022,2022-2023
AL,2022-08-31,inter-ucfe,0,0,0,0,0,0,0,0,0,0,0,0,0,0,FALSE,0,2022,2022-2023
AL,2022-08-31,inter-ucx,0,0,0,0,0,0,0,0,0,0,0,0,0,0,FALSE,0,2022,2022-2023
AL,2022-08-31,inter-ui,5,2,1,2,3,0,0,0,0,6,4,23,9,11,FALSE,0.478260869565217,2022,2022-2023
AL,2022-08-31,intra-total,679,127,137,78,62,65,40,22,26,667,177,2080,856,983,FALSE,0.472596153846154,2022,2022-2023
AL,2022-08-31,intra-ucfe,4,7,4,2,1,4,1,0,0,3,1,27,5,12,FALSE,0.444444444444444,2022,2022-2023
AL,2022-08-31,intra-ucx,8,0,1,0,0,0,0,0,0,0,0,9,8,8,FALSE,0.888888888888889,2022,2022-2023
AL,2022-08-31,intra-ui,667,120,132,76,61,61,39,22,26,664,176,2044,843,963,FALSE,0.471135029354208,2022,2022-2023
AL,2022-09-30,inter-total,1,3,0,1,1,0,0,0,1,11,1,19,2,5,FALSE,0.263157894736842,2022,2022-2023
AL,2022-09-30,inter-ucfe,0,0,0,0,0,0,0,0,0,0,0,0,0,0,FALSE,0,2022,2022-2023
AL,2022-09-30,inter-ucx,0,0,0,0,0,0,0,0,0,0,0,0,0,0,FALSE,0,2022,2022-2023
AL,2022-09-30,inter-ui,1,3,0,1,1,0,0,0,1,11,1,19,2,5,FALSE,0.263157894736842,2022,2022-2023
AL,2022-09-30,intra-total,490,80,60,70,49,54,48,45,40,673,146,1755,636,716,FALSE,0.407977207977208,2022,2022-2023
AL,2022-09-30,intra-ucfe,6,1,0,1,1,1,0,1,0,4,3,18,9,10,FALSE,0.555555555555556,2022,2022-2023
AL,2022-09-30,intra-ucx,4,1,0,0,0,0,0,0,0,3,0,8,4,5,FALSE,0.625,2022,2022-2023
AL,2022-09-30,intra-ui,480,78,60,69,48,53,48,44,40,666,143,1729,623,701,FALSE,0.405436668594563,2022,2022-2023
AL,2022-10-31,inter-total,0,5,0,0,1,0,0,0,1,3,1,11,1,6,FALSE,0.545454545454545,2022,2022-2023
AL,2022-10-31,inter-ucfe,0,0,0,0,0,0,0,0,0,0,0,0,0,0,FALSE,0,2022,2022-2023
AL,2022-10-31,inter-ucx,0,0,0,0,0,0,0,0,0,0,0,0,0,0,FALSE,0,2022,2022-2023
AL,2022-10-31,inter-ui,0,5,0,0,1,0,0,0,1,3,1,11,1,6,FALSE,0.545454545454545,2022,2022-2023
AL,2022-10-31,intra-total,504,80,67,57,37,30,18,30,28,725,149,1725,653,733,FALSE,0.424927536231884,2022,2022-2023
AL,2022-10-31,intra-ucfe,1,0,1,1,0,1,0,0,0,5,0,9,1,1,FALSE,0.111111111111111,2022,2022-2023
AL,2022-10-31,intra-ucx,8,0,0,1,0,0,0,0,0,4,0,13,8,8,FALSE,0.615384615384615,2022,2022-2023
AL,2022-10-31,intra-ui,495,80,66,55,37,29,18,30,28,716,149,1703,644,724,FALSE,0.425132119788608,2022,2022-2023
AL,2022-11-30,inter-total,7,3,1,0,0,0,1,0,0,9,1,22,8,11,FALSE,0.5,2022,2022-2023
AL,2022-11-30,inter-ucfe,0,0,0,0,0,0,0,0,0,0,0,0,0,0,FALSE,0,2022,2022-2023
AL,2022-11-30,inter-ucx,0,0,0,0,0,0,0,0,0,0,0,0,0,0,FALSE,0,2022,2022-2023
AL,2022-11-30,inter-ui,7,3,1,0,0,0,1,0,0,9,1,22,8,11,FALSE,0.5,2022,2022-2023
AL,2022-11-30,intra-total,649,75,65,63,38,29,30,28,18,655,139,1789,788,863,FALSE,0.482392397987703,2022,2022-2023
AL,2022-11-30,intra-ucfe,1,1,0,1,3,0,0,1,0,6,1,14,2,3,FALSE,0.214285714285714,2022,2022-2023
AL,2022-11-30,intra-ucx,2,1,1,0,0,1,0,0,0,0,0,5,2,3,FALSE,0.6,2022,2022-2023
AL,2022-11-30,intra-ui,646,73,64,62,35,28,30,27,18,649,138,1770,784,857,FALSE,0.484180790960452,2022,2022-2023
AL,2022-12-31,inter-total,9,3,2,2,0,1,0,0,0,16,6,39,15,18,FALSE,0.461538461538462,2022,2022-2023
AL,2022-12-31,inter-ucfe,0,0,0,0,0,0,0,0,0,0,0,0,0,0,FALSE,0,2022,2022-2023
AL,2022-12-31,inter-ucx,0,0,0,0,0,0,0,0,0,0,0,0,0,0,FALSE,0,2022,2022-2023
AL,2022-12-31,inter-ui,9,3,2,2,0,1,0,0,0,16,6,39,15,18,FALSE,0.461538461538462,2022,2022-2023
AL,2022-12-31,intra-total,1147,113,81,72,55,72,44,41,29,1026,181,2861,1328,1441,FALSE,0.503670045438658,2022,2022-2023
AL,2022-12-31,intra-ucfe,4,1,0,1,0,0,1,0,0,2,1,10,5,6,FALSE,0.6,2022,2022-2023
AL,2022-12-31,intra-ucx,4,0,0,1,0,1,0,0,0,3,1,10,5,5,FALSE,0.5,2022,2022-2023
AL,2022-12-31,intra-ui,1139,112,81,70,55,71,43,41,29,1021,179,2841,1318,1430,FALSE,0.503343892995424,2022,2022-2023
AL,2023-01-31,inter-total,13,6,9,3,2,3,2,0,0,14,8,60,21,27,FALSE,0.45,2022,2022-2023
AL,2023-01-31,inter-ucfe,0,0,0,0,0,0,0,0,0,0,0,0,0,0,FALSE,0,2022,2022-2023
AL,2023-01-31,inter-ucx,0,0,0,0,0,0,0,0,0,0,0,0,0,0,FALSE,0,2022,2022-2023
AL,2023-01-31,inter-ui,13,6,9,3,2,3,2,0,0,14,8,60,21,27,FALSE,0.45,2022,2022-2023
AL,2023-01-31,intra-total,1752,259,167,116,70,57,47,23,30,1218,461,4200,2213,2472,FALSE,0.588571428571429,2022,2022-2023
AL,2023-01-31,intra-ucfe,2,0,0,0,0,0,0,0,1,7,2,12,4,4,FALSE,0.333333333333333,2022,2022-2023
AL,2023-01-31,intra-ucx,1,0,0,0,0,0,0,0,0,2,0,3,1,1,FALSE,0.333333333333333,2022,2022-2023
AL,2023-01-31,intra-ui,1749,259,167,116,70,57,47,23,29,1209,459,4185,2208,2467,FALSE,0.589486260454002,2022,2022-2023
AL,2023-02-28,inter-total,1,4,0,0,1,1,0,0,2,59,2,70,3,7,FALSE,0.1,2022,2022-2023
AL,2023-02-28,inter-ucfe,0,0,0,0,0,0,0,0,0,0,0,0,0,0,FALSE,0,2022,2022-2023
AL,2023-02-28,inter-ucx,0,0,0,0,0,0,0,0,0,0,0,0,0,0,FALSE,0,2022,2022-2023
AL,2023-02-28,inter-ui,1,4,0,0,1,1,0,0,2,59,2,70,3,7,FALSE,0.1,2022,2022-2023
AL,2023-02-28,intra-total,650,116,112,87,116,86,71,52,51,2180,172,3693,822,938,FALSE,0.253994042783645,2022,2022-2023
AL,2023-02-28,intra-ucfe,5,0,0,0,0,0,0,0,0,11,1,17,6,6,FALSE,0.352941176470588,2022,2022-2023
AL,2023-02-28,intra-ucx,3,0,0,0,0,0,0,0,0,3,0,6,3,3,FALSE,0.5,2022,2022-2023
AL,2023-02-28,intra-ui,642,116,112,87,116,86,71,52,51,2166,171,3670,813,929,FALSE,0.253133514986376,2022,2022-2023
AL,2023-03-31,inter-total,0,0,0,0,0,2,1,1,0,9,1,14,1,1,FALSE,0.0714285714285714,2022,2022-2023
AL,2023-03-31,inter-ucfe,0,0,0,0,0,0,0,0,0,0,0,0,0,0,FALSE,0,2022,2022-2023
AL,2023-03-31,inter-ucx,0,0,0,0,0,0,0,0,0,0,0,0,0,0,FALSE,0,2022,2022-2023
AL,2023-03-31,inter-ui,0,0,0,0,0,2,1,1,0,9,1,14,1,1,FALSE,0.0714285714285714,2022,2022-2023
AL,2023-03-31,intra-total,497,75,56,54,42,38,38,38,36,733,93,1700,590,665,FALSE,0.391176470588235,2022,2022-2023
AL,2023-03-31,intra-ucfe,2,0,0,0,0,0,0,0,0,5,1,8,3,3,FALSE,0.375,2022,2022-2023
AL,2023-03-31,intra-ucx,4,0,0,0,0,0,0,0,0,10,0,14,4,4,FALSE,0.285714285714286,2022,2022-2023
AL,2023-03-31,intra-ui,491,75,56,54,42,38,38,38,36,718,92,1678,583,658,FALSE,0.392133492252682,2022,2022-2023
AL,2023-04-30,inter-total,10,0,0,0,0,0,0,0,0,14,2,26,12,12,FALSE,0.461538461538462,2022,2022-2023
AL,2023-04-30,inter-ucfe,0,0,0,0,0,0,0,0,0,1,0,1,0,0,FALSE,0,2022,2022-2023
AL,2023-04-30,inter-ucx,0,0,0,0,0,0,0,0,0,1,0,1,0,0,FALSE,0,2022,2022-2023
AL,2023-04-30,inter-ui,10,0,0,0,0,0,0,0,0,12,2,24,12,12,FALSE,0.5,2022,2022-2023
AL,2023-04-30,intra-total,501,67,36,40,34,25,20,30,24,780,75,1632,576,643,FALSE,0.393995098039216,2022,2022-2023
AL,2023-04-30,intra-ucfe,2,1,0,0,1,0,0,1,0,3,1,9,3,4,FALSE,0.444444444444444,2022,2022-2023
AL,2023-04-30,intra-ucx,3,0,0,0,1,0,0,0,0,1,0,5,3,3,FALSE,0.6,2022,2022-2023
AL,2023-04-30,intra-ui,496,66,36,40,32,25,20,29,24,776,74,1618,570,636,FALSE,0.393077873918418,2022,2022-2023
AL,2023-05-31,inter-total,7,1,2,0,1,0,2,0,0,12,3,28,10,11,FALSE,0.392857142857143,2022,2022-2023
AL,2023-05-31,inter-ucfe,0,0,0,0,0,0,0,0,0,0,0,0,0,0,FALSE,0,2022,2022-2023
AL,2023-05-31,inter-ucx,0,0,0,0,0,0,0,0,0,0,0,0,0,0,FALSE,0,2022,2022-2023
AL,2023-05-31,inter-ui,7,1,2,0,1,0,2,0,0,12,3,28,10,11,FALSE,0.392857142857143,2022,2022-2023
AL,2023-05-31,intra-total,691,69,46,37,31,25,28,38,34,705,86,1790,777,846,FALSE,0.472625698324022,2022,2022-2023
AL,2023-05-31,intra-ucfe,1,0,0,0,0,0,0,0,0,1,1,3,2,2,FALSE,0.666666666666667,2022,2022-2023
AL,2023-05-31,intra-ucx,3,1,1,0,0,0,0,0,0,0,1,6,4,5,FALSE,0.833333333333333,2022,2022-2023
AL,2023-05-31,intra-ui,687,68,45,37,31,25,28,38,34,704,84,1781,771,839,FALSE,0.471083660864683,2022,2022-2023
AL,2023-06-30,inter-total,4,1,1,0,0,1,0,0,1,10,4,22,8,9,FALSE,0.409090909090909,2022,2022-2023
AL,2023-06-30,inter-ucfe,0,0,0,0,0,0,0,0,0,0,0,0,0,0,FALSE,0,2022,2022-2023
AL,2023-06-30,inter-ucx,0,0,0,0,0,0,0,0,0,0,0,0,0,0,FALSE,0,2022,2022-2023
AL,2023-06-30,inter-ui,4,1,1,0,0,1,0,0,1,10,4,22,8,9,FALSE,0.409090909090909,2022,2022-2023
AL,2023-06-30,intra-total,745,90,61,42,28,34,33,27,25,867,173,2125,918,1008,FALSE,0.474352941176471,2022,2022-2023
AL,2023-06-30,intra-ucfe,4,0,0,0,0,0,0,0,0,0,2,6,6,6,FALSE,1,2022,2022-2023
AL,2023-06-30,intra-ucx,1,0,0,0,0,0,1,0,0,0,0,2,1,1,FALSE,0.5,2022,2022-2023
AL,2023-06-30,intra-ui,740,90,61,42,28,34,32,27,25,867,171,2117,911,1001,FALSE,0.472838923004251,2022,2022-2023
AL,2023-07-31,inter-total,4,0,1,5,0,2,1,1,0,10,1,25,5,5,FALSE,0.2,2023,2023-2024
AL,2023-07-31,inter-ucfe,0,0,0,0,0,0,0,0,0,0,0,0,0,0,FALSE,0,2023,2023-2024
AL,2023-07-31,inter-ucx,0,0,0,0,0,0,0,0,0,0,0,0,0,0,FALSE,0,2023,2023-2024
AL,2023-07-31,inter-ui,4,0,1,5,0,2,1,1,0,10,1,25,5,5,FALSE,0.2,2023,2023-2024
AL,2023-07-31,intra-total,1049,205,75,69,42,52,32,19,17,688,273,2521,1322,1527,FALSE,0.605712019040063,2023,2023-2024
AL,2023-07-31,intra-ucfe,5,0,0,0,0,0,0,0,0,1,1,7,6,6,FALSE,0.857142857142857,2023,2023-2024
AL,2023-07-31,intra-ucx,1,0,0,0,0,1,0,0,0,0,0,2,1,1,FALSE,0.5,2023,2023-2024
AL,2023-07-31,intra-ui,1043,205,75,69,42,51,32,19,17,687,272,2512,1315,1520,FALSE,0.605095541401274,2023,2023-2024
AL,2023-08-31,inter-total,10,2,1,1,0,0,0,0,0,10,8,32,18,20,FALSE,0.625,2023,2023-2024
AL,2023-08-31,inter-ucfe,0,0,0,0,0,0,0,0,0,0,0,0,0,0,FALSE,0,2023,2023-2024
AL,2023-08-31,inter-ucx,0,0,0,0,0,0,0,0,0,0,0,0,0,0,FALSE,0,2023,2023-2024
AL,2023-08-31,inter-ui,10,2,1,1,0,0,0,0,0,10,8,32,18,20,FALSE,0.625,2023,2023-2024
AL,2023-08-31,intra-total,815,92,83,67,70,65,60,64,36,873,140,2365,955,1047,FALSE,0.442706131078224,2023,2023-2024
AL,2023-08-31,intra-ucfe,2,0,0,0,1,0,0,0,0,1,1,5,3,3,FALSE,0.6,2023,2023-2024
AL,2023-08-31,intra-ucx,2,0,0,1,0,0,1,0,0,4,0,8,2,2,FALSE,0.25,2023,2023-2024
AL,2023-08-31,intra-ui,811,92,83,66,69,65,59,64,36,868,139,2352,950,1042,FALSE,0.443027210884354,2023,2023-2024
AL,2023-09-30,inter-total,3,2,0,0,2,0,0,0,1,16,1,25,4,6,FALSE,0.24,2023,2023-2024
AL,2023-09-30,inter-ucfe,0,0,0,0,0,0,0,0,0,0,0,0,0,0,FALSE,0,2023,2023-2024
AL,2023-09-30,inter-ucx,0,0,0,0,0,0,0,0,0,0,0,0,0,0,FALSE,0,2023,2023-2024
AL,2023-09-30,inter-ui,3,2,0,0,2,0,0,0,1,16,1,25,4,6,FALSE,0.24,2023,2023-2024
AL,2023-09-30,intra-total,512,71,72,57,51,43,52,62,56,1676,108,2760,620,691,FALSE,0.25036231884058,2023,2023-2024
AL,2023-09-30,intra-ucfe,1,0,1,0,0,0,0,0,0,0,2,4,3,3,FALSE,0.75,2023,2023-2024
AL,2023-09-30,intra-ucx,3,0,1,0,0,1,0,0,0,3,1,9,4,4,FALSE,0.444444444444444,2023,2023-2024
AL,2023-09-30,intra-ui,508,71,70,57,51,42,52,62,56,1673,105,2747,613,684,FALSE,0.248998907899527,2023,2023-2024
AL,2023-10-31,inter-total,14,1,4,2,1,0,1,0,0,28,4,55,18,19,FALSE,0.345454545454545,2023,2023-2024
AL,2023-10-31,inter-ucfe,0,0,0,0,0,0,0,0,0,0,0,0,0,0,FALSE,0,2023,2023-2024
AL,2023-10-31,inter-ucx,0,0,0,1,0,0,0,0,0,0,1,2,1,1,FALSE,0.5,2023,2023-2024
AL,2023-10-31,inter-ui,14,1,4,1,1,0,1,0,0,28,3,53,17,18,FALSE,0.339622641509434,2023,2023-2024
AL,2023-10-31,intra-total,711,66,42,45,47,30,34,17,36,1950,126,3104,837,903,FALSE,0.290914948453608,2023,2023-2024
AL,2023-10-31,intra-ucfe,0,0,1,0,0,1,0,0,0,0,3,5,3,3,FALSE,0.6,2023,2023-2024
AL,2023-10-31,intra-ucx,2,0,0,0,0,0,0,0,0,2,0,4,2,2,FALSE,0.5,2023,2023-2024
AL,2023-10-31,intra-ui,709,66,41,45,47,29,34,17,36,1948,123,3095,832,898,FALSE,0.290145395799677,2023,2023-2024
AL,2023-11-30,inter-total,12,2,1,2,0,3,0,0,0,12,4,36,16,18,FALSE,0.5,2023,2023-2024
AL,2023-11-30,inter-ucfe,0,0,0,0,0,0,0,0,0,0,0,0,0,0,FALSE,0,2023,2023-2024
AL,2023-11-30,inter-ucx,0,0,0,0,0,0,0,0,0,0,0,0,0,0,FALSE,0,2023,2023-2024
AL,2023-11-30,inter-ui,12,2,1,2,0,3,0,0,0,12,4,36,16,18,FALSE,0.5,2023,2023-2024
AL,2023-11-30,intra-total,769,60,42,46,37,26,21,15,20,1459,111,2606,880,940,FALSE,0.360706062931696,2023,2023-2024
AL,2023-11-30,intra-ucfe,2,1,0,0,0,0,1,0,0,0,0,4,2,3,FALSE,0.75,2023,2023-2024
AL,2023-11-30,intra-ucx,4,0,0,0,0,0,0,0,0,2,1,7,5,5,FALSE,0.714285714285714,2023,2023-2024
AL,2023-11-30,intra-ui,763,59,42,46,37,26,20,15,20,1457,110,2595,873,932,FALSE,0.359152215799615,2023,2023-2024
AL,2023-12-31,inter-total,10,3,0,0,2,3,2,1,0,64,3,88,13,16,FALSE,0.181818181818182,2023,2023-2024
AL,2023-12-31,inter-ucfe,0,0,0,0,0,0,0,0,0,0,0,0,0,0,FALSE,0,2023,2023-2024
AL,2023-12-31,inter-ucx,0,0,0,0,0,0,0,0,0,0,0,0,0,0,FALSE,0,2023,2023-2024
AL,2023-12-31,inter-ui,10,3,0,0,2,3,2,1,0,64,3,88,13,16,FALSE,0.181818181818182,2023,2023-2024
AL,2023-12-31,intra-total,815,91,66,64,39,48,35,29,35,2664,142,4028,957,1048,FALSE,0.260178748758689,2023,2023-2024
AL,2023-12-31,intra-ucfe,3,0,1,1,0,0,0,0,0,4,0,9,3,3,FALSE,0.333333333333333,2023,2023-2024
AL,2023-12-31,intra-ucx,7,0,0,0,0,0,0,0,1,5,0,13,7,7,FALSE,0.538461538461538,2023,2023-2024
AL,2023-12-31,intra-ui,805,91,65,63,39,48,35,29,34,2655,142,4006,947,1038,FALSE,0.259111333000499,2023,2023-2024
AL,2024-01-31,inter-total,30,4,3,3,1,1,2,2,1,29,1,77,31,35,FALSE,0.454545454545455,2023,2023-2024
AL,2024-01-31,inter-ucfe,0,0,0,0,0,0,0,0,0,0,0,0,0,0,FALSE,0,2023,2023-2024
AL,2024-01-31,inter-ucx,0,0,0,0,0,0,0,0,0,0,0,0,0,0,FALSE,0,2023,2023-2024
AL,2024-01-31,inter-ui,30,4,3,3,1,1,2,2,1,29,1,77,31,35,FALSE,0.454545454545455,2023,2023-2024
AL,2024-01-31,intra-total,1696,202,130,95,73,64,41,38,29,1694,308,4370,2004,2206,FALSE,0.504805491990847,2023,2023-2024
AL,2024-01-31,intra-ucfe,3,0,0,0,0,0,0,0,0,3,0,6,3,3,FALSE,0.5,2023,2023-2024
AL,2024-01-31,intra-ucx,2,0,0,0,0,0,1,1,1,1,2,8,4,4,FALSE,0.5,2023,2023-2024
AL,2024-01-31,intra-ui,1691,202,130,95,73,64,40,37,28,1690,306,4356,1997,2199,FALSE,0.504820936639118,2023,2023-2024
AL,2024-02-29,inter-total,3,0,2,1,1,1,2,2,1,25,3,41,6,6,FALSE,0.146341463414634,2023,2023-2024
AL,2024-02-29,inter-ucfe,0,0,0,0,0,0,0,0,0,0,0,0,0,0,FALSE,0,2023,2023-2024
AL,2024-02-29,inter-ucx,0,0,0,0,0,0,0,0,0,0,0,0,0,0,FALSE,0,2023,2023-2024
AL,2024-02-29,inter-ui,3,0,2,1,1,1,2,2,1,25,3,41,6,6,FALSE,0.146341463414634,2023,2023-2024
AL,2024-02-29,intra-total,616,107,74,63,63,46,47,39,41,1694,165,2955,781,888,FALSE,0.300507614213198,2023,2023-2024
AL,2024-02-29,intra-ucfe,1,0,1,0,1,0,0,0,0,1,2,6,3,3,FALSE,0.5,2023,2023-2024
AL,2024-02-29,intra-ucx,4,0,0,0,0,0,0,0,0,2,0,6,4,4,FALSE,0.666666666666667,2023,2023-2024
AL,2024-02-29,intra-ui,611,107,73,63,62,46,47,39,41,1691,163,2943,774,881,FALSE,0.299354400271831,2023,2023-2024
AL,2024-03-31,inter-total,3,1,0,1,1,1,1,1,0,21,1,31,4,5,FALSE,0.161290322580645,2023,2023-2024
AL,2024-03-31,inter-ucfe,0,0,0,0,0,0,0,0,0,1,0,1,0,0,FALSE,0,2023,2023-2024
AL,2024-03-31,inter-ucx,0,0,0,0,0,0,0,0,0,0,0,0,0,0,FALSE,0,2023,2023-2024
AL,2024-03-31,inter-ui,3,1,0,1,1,1,1,1,0,20,1,30,4,5,FALSE,0.166666666666667,2023,2023-2024
AL,2024-03-31,intra-total,513,98,92,72,43,42,34,20,24,1667,130,2735,643,741,FALSE,0.270932358318099,2023,2023-2024
AL,2024-03-31,intra-ucfe,3,0,0,1,0,0,0,0,0,0,0,4,3,3,FALSE,0.75,2023,2023-2024
AL,2024-03-31,intra-ucx,1,0,0,0,0,0,0,0,0,0,0,1,1,1,FALSE,1,2023,2023-2024
AL,2024-03-31,intra-ui,509,98,92,71,43,42,34,20,24,1667,130,2730,639,737,FALSE,0.26996336996337,2023,2023-2024
AL,2024-04-30,inter-total,4,0,0,0,0,0,0,0,1,28,1,34,5,5,FALSE,0.147058823529412,2023,2023-2024
AL,2024-04-30,inter-ucfe,0,0,0,0,0,0,0,0,0,0,0,0,0,0,FALSE,0,2023,2023-2024
AL,2024-04-30,inter-ucx,0,0,0,0,0,0,0,0,0,0,0,0,0,0,FALSE,0,2023,2023-2024
AL,2024-04-30,inter-ui,4,0,0,0,0,0,0,0,1,28,1,34,5,5,FALSE,0.147058823529412,2023,2023-2024
AL,2024-04-30,intra-total,762,102,77,69,48,43,41,32,26,1513,141,2854,903,1005,FALSE,0.352137351086195,2023,2023-2024
AL,2024-04-30,intra-ucfe,3,0,0,0,0,0,0,0,0,2,1,6,4,4,FALSE,0.666666666666667,2023,2023-2024
AL,2024-04-30,intra-ucx,2,0,0,0,0,0,0,0,0,1,0,3,2,2,FALSE,0.666666666666667,2023,2023-2024
AL,2024-04-30,intra-ui,757,102,77,69,48,43,41,32,26,1510,140,2845,897,999,FALSE,0.351142355008787,2023,2023-2024
AL,2024-05-31,inter-total,8,1,1,1,0,0,0,0,0,18,3,32,11,12,FALSE,0.375,2023,2023-2024
AL,2024-05-31,inter-ucfe,0,0,0,0,0,0,0,0,0,0,0,0,0,0,FALSE,0,2023,2023-2024
AL,2024-05-31,inter-ucx,0,0,0,0,0,0,0,0,0,0,0,0,0,0,FALSE,0,2023,2023-2024
AL,2024-05-31,inter-ui,8,1,1,1,0,0,0,0,0,18,3,32,11,12,FALSE,0.375,2023,2023-2024
AL,2024-05-31,intra-total,891,153,94,79,57,41,46,41,26,1736,206,3370,1097,1250,FALSE,0.370919881305638,2023,2023-2024
AL,2024-05-31,intra-ucfe,0,2,0,0,0,1,0,0,0,0,0,3,0,2,FALSE,0.666666666666667,2023,2023-2024
AL,2024-05-31,intra-ucx,2,0,1,1,0,0,0,0,0,1,0,5,2,2,FALSE,0.4,2023,2023-2024
AL,2024-05-31,intra-ui,889,151,93,78,57,40,46,41,26,1735,206,3362,1095,1246,FALSE,0.370612730517549,2023,2023-2024
AL,2024-06-30,inter-total,7,1,0,1,0,0,0,0,1,19,0,29,7,8,FALSE,0.275862068965517,2023,2023-2024
AL,2024-06-30,inter-ucfe,0,0,0,0,0,0,0,0,0,0,0,0,0,0,FALSE,0,2023,2023-2024
AL,2024-06-30,inter-ucx,0,0,0,0,0,0,0,0,0,0,0,0,0,0,FALSE,0,2023,2023-2024
AL,2024-06-30,inter-ui,7,1,0,1,0,0,0,0,1,19,0,29,7,8,FALSE,0.275862068965517,2023,2023-2024
AL,2024-06-30,intra-total,995,166,100,82,70,40,57,39,36,1673,221,3479,1216,1382,FALSE,0.397240586375395,2023,2023-2024
AL,2024-06-30,intra-ucfe,2,2,0,1,0,0,0,0,0,1,0,6,2,4,FALSE,0.666666666666667,2023,2023-2024
AL,2024-06-30,intra-ucx,1,0,0,0,1,0,0,0,0,1,0,3,1,1,FALSE,0.333333333333333,2023,2023-2024
AL,2024-06-30,intra-ui,992,164,100,81,69,40,57,39,36,1671,221,3470,1213,1377,FALSE,0.396829971181556,2023,2023-2024
AL,2024-07-31,inter-total,15,2,3,1,1,0,1,0,0,19,2,44,17,19,FALSE,0.431818181818182,2024,2024-2025
AL,2024-07-31,inter-ucfe,0,0,0,0,0,0,0,0,0,0,0,0,0,0,FALSE,0,2024,2024-2025
AL,2024-07-31,inter-ucx,0,0,0,0,0,0,0,0,0,0,0,0,0,0,FALSE,0,2024,2024-2025
AL,2024-07-31,inter-ui,15,2,3,1,1,0,1,0,0,19,2,44,17,19,FALSE,0.431818181818182,2024,2024-2025
AL,2024-07-31,intra-total,1539,227,135,115,81,51,40,37,31,2367,296,4919,1835,2062,FALSE,0.419190892457817,2024,2024-2025
AL,2024-07-31,intra-ucfe,3,1,0,0,0,0,0,0,0,2,0,6,3,4,FALSE,0.666666666666667,2024,2024-2025
AL,2024-07-31,intra-ucx,3,0,0,0,0,0,0,0,0,0,0,3,3,3,FALSE,1,2024,2024-2025
AL,2024-07-31,intra-ui,1533,226,135,115,81,51,40,37,31,2365,296,4910,1829,2055,FALSE,0.418533604887984,2024,2024-2025
AL,2024-08-31,inter-total,4,1,2,5,1,0,0,1,0,20,0,34,4,5,FALSE,0.147058823529412,2024,2024-2025
AL,2024-08-31,inter-ucfe,0,0,0,0,0,0,0,0,0,0,0,0,0,0,FALSE,0,2024,2024-2025
AL,2024-08-31,inter-ucx,0,0,0,0,0,0,0,0,0,0,0,0,0,0,FALSE,0,2024,2024-2025
AL,2024-08-31,inter-ui,4,1,2,5,1,0,0,1,0,20,0,34,4,5,FALSE,0.147058823529412,2024,2024-2025
AL,2024-08-31,intra-total,754,144,150,130,108,96,124,83,84,2331,166,4170,920,1064,FALSE,0.25515587529976,2024,2024-2025
AL,2024-08-31,intra-ucfe,4,1,0,0,0,1,0,0,0,3,2,11,6,7,FALSE,0.636363636363636,2024,2024-2025
AL,2024-08-31,intra-ucx,6,0,0,0,1,0,0,0,0,1,0,8,6,6,FALSE,0.75,2024,2024-2025
AL,2024-08-31,intra-ui,744,143,150,130,107,95,124,83,84,2327,164,4151,908,1051,FALSE,0.253192001927246,2024,2024-2025
AL,2024-09-30,inter-total,5,1,3,0,0,1,0,1,0,11,1,23,6,7,FALSE,0.304347826086957,2024,2024-2025
AL,2024-09-30,inter-ucfe,0,0,0,0,0,0,0,0,0,0,0,0,0,0,FALSE,0,2024,2024-2025
AL,2024-09-30,inter-ucx,0,0,0,0,0,0,0,0,0,0,0,0,0,0,FALSE,0,2024,2024-2025
AL,2024-09-30,inter-ui,5,1,3,0,0,1,0,1,0,11,1,23,6,7,FALSE,0.304347826086957,2024,2024-2025
AL,2024-09-30,intra-total,801,166,150,107,98,95,101,106,102,1125,229,3080,1030,1196,FALSE,0.388311688311688,2024,2024-2025
AL,2024-09-30,intra-ucfe,1,1,0,0,0,0,0,1,0,1,2,6,3,4,FALSE,0.666666666666667,2024,2024-2025
AL,2024-09-30,intra-ucx,4,0,1,0,0,0,0,0,0,5,0,10,4,4,FALSE,0.4,2024,2024-2025
AL,2024-09-30,intra-ui,796,165,149,107,98,95,101,105,102,1119,227,3064,1023,1188,FALSE,0.387728459530026,2024,2024-2025
AL,2024-10-31,inter-total,6,3,2,2,0,0,0,2,0,5,2,22,8,11,FALSE,0.5,2024,2024-2025
AL,2024-10-31,inter-ucfe,0,0,0,0,0,0,0,0,0,0,0,0,0,0,FALSE,0,2024,2024-2025
AL,2024-10-31,inter-ucx,0,0,0,0,0,0,0,0,0,0,0,0,0,0,FALSE,0,2024,2024-2025
AL,2024-10-31,inter-ui,6,3,2,2,0,0,0,2,0,5,2,22,8,11,FALSE,0.5,2024,2024-2025
AL,2024-10-31,intra-total,742,163,143,121,113,117,101,114,99,585,228,2526,970,1133,FALSE,0.448535233570863,2024,2024-2025
AL,2024-10-31,intra-ucfe,1,0,1,0,0,0,0,0,0,2,1,5,2,2,FALSE,0.4,2024,2024-2025
AL,2024-10-31,intra-ucx,3,1,0,0,0,1,0,0,0,0,1,6,4,5,FALSE,0.833333333333333,2024,2024-2025
AL,2024-10-31,intra-ui,738,162,142,121,113,116,101,114,99,583,226,2515,964,1126,FALSE,0.447713717693837,2024,2024-2025
AL,2024-11-30,inter-total,4,1,1,3,3,1,0,0,1,15,0,29,4,5,FALSE,0.172413793103448,2024,2024-2025
AL,2024-11-30,inter-ucfe,0,0,0,0,0,0,0,0,0,0,0,0,0,0,FALSE,0,2024,2024-2025
AL,2024-11-30,inter-ucx,0,0,0,0,0,0,0,0,0,0,0,0,0,0,FALSE,0,2024,2024-2025
AL,2024-11-30,inter-ui,4,1,1,3,3,1,0,0,1,15,0,29,4,5,FALSE,0.172413793103448,2024,2024-2025
AL,2024-11-30,intra-total,673,108,129,166,180,148,90,56,33,682,186,2451,859,967,FALSE,0.39453284373725,2024,2024-2025
AL,2024-11-30,intra-ucfe,2,1,0,0,0,0,0,0,1,1,1,6,3,4,FALSE,0.666666666666667,2024,2024-2025
AL,2024-11-30,intra-ucx,5,1,0,0,0,0,0,0,0,0,0,6,5,6,FALSE,1,2024,2024-2025
AL,2024-11-30,intra-ui,666,106,129,166,180,148,90,56,32,681,185,2439,851,957,FALSE,0.392373923739237,2024,2024-2025
AL,2024-12-31,inter-total,24,3,2,2,1,1,1,1,0,6,5,46,29,32,FALSE,0.695652173913044,2024,2024-2025
AL,2024-12-31,inter-ucfe,0,0,0,0,0,0,0,0,0,0,0,0,0,0,FALSE,0,2024,2024-2025
AL,2024-12-31,inter-ucx,0,0,0,0,0,0,0,0,0,0,0,0,0,0,FALSE,0,2024,2024-2025
AL,2024-12-31,inter-ui,24,3,2,2,1,1,1,1,0,6,5,46,29,32,FALSE,0.695652173913044,2024,2024-2025
AL,2024-12-31,intra-total,1638,287,226,193,146,111,73,35,35,448,429,3621,2067,2354,FALSE,0.650096658381663,2024,2024-2025
AL,2024-12-31,intra-ucfe,2,1,0,0,0,0,0,0,0,3,0,6,2,3,FALSE,0.5,2024,2024-2025
AL,2024-12-31,intra-ucx,3,0,0,0,0,0,0,0,0,0,0,3,3,3,FALSE,1,2024,2024-2025
AL,2024-12-31,intra-ui,1633,286,226,193,146,111,73,35,35,445,429,3612,2062,2348,FALSE,0.650055370985604,2024,2024-2025
AR,2019-01-31,inter-total,70,0,0,0,0,0,0,0,0,0,26,96,96,96,FALSE,1,2018,2018-2019
AR,2019-01-31,inter-ucfe,2,0,0,0,0,0,0,0,0,0,0,2,2,2,FALSE,1,2018,2018-2019
AR,2019-01-31,inter-ucx,0,0,0,0,0,0,0,0,0,0,0,0,0,0,FALSE,0,2018,2018-2019
AR,2019-01-31,inter-ui,68,0,0,0,0,0,0,0,0,0,26,94,94,94,FALSE,1,2018,2018-2019
AR,2019-01-31,intra-total,3944,133,27,18,18,16,12,1,2,11,795,4977,4739,4872,FALSE,0.978902953586498,2018,2018-2019
AR,2019-01-31,intra-ucfe,291,3,0,0,0,0,0,0,0,0,45,339,336,339,FALSE,1,2018,2018-2019
AR,2019-01-31,intra-ucx,11,0,0,0,0,0,0,0,0,0,3,14,14,14,FALSE,1,2018,2018-2019
AR,2019-01-31,intra-ui,3642,130,27,18,18,16,12,1,2,11,747,4624,4389,4519,FALSE,0.977292387543253,2018,2018-2019
AR,2019-02-28,inter-total,52,2,0,0,0,0,0,0,0,0,14,68,66,68,FALSE,1,2018,2018-2019
AR,2019-02-28,inter-ucfe,1,0,0,0,0,0,0,0,0,0,0,1,1,1,FALSE,1,2018,2018-2019
AR,2019-02-28,inter-ucx,1,0,0,0,0,0,0,0,0,0,0,1,1,1,FALSE,1,2018,2018-2019
AR,2019-02-28,inter-ui,50,2,0,0,0,0,0,0,0,0,14,66,64,66,FALSE,1,2018,2018-2019
AR,2019-02-28,intra-total,1830,105,25,22,14,8,7,5,5,14,544,2579,2374,2479,FALSE,0.961225281116712,2018,2018-2019
AR,2019-02-28,intra-ucfe,10,2,0,1,0,0,0,0,0,0,5,18,15,17,FALSE,0.944444444444444,2018,2018-2019
AR,2019-02-28,intra-ucx,11,0,0,0,0,0,0,0,0,1,3,15,14,14,FALSE,0.933333333333333,2018,2018-2019
AR,2019-02-28,intra-ui,1809,103,25,21,14,8,7,5,5,13,536,2546,2345,2448,FALSE,0.961508248232522,2018,2018-2019
AR,2019-03-31,inter-total,34,2,0,0,0,0,0,0,0,0,9,45,43,45,FALSE,1,2018,2018-2019
AR,2019-03-31,inter-ucfe,0,0,0,0,0,0,0,0,0,0,0,0,0,0,FALSE,0,2018,2018-2019
AR,2019-03-31,inter-ucx,0,0,0,0,0,0,0,0,0,0,0,0,0,0,FALSE,0,2018,2018-2019
AR,2019-03-31,inter-ui,34,2,0,0,0,0,0,0,0,0,9,45,43,45,FALSE,1,2018,2018-2019
AR,2019-03-31,intra-total,1763,53,17,14,26,15,8,1,2,12,376,2287,2139,2192,FALSE,0.958460865763008,2018,2018-2019
AR,2019-03-31,intra-ucfe,5,0,0,0,0,0,0,0,1,0,3,9,8,8,FALSE,0.888888888888889,2018,2018-2019
AR,2019-03-31,intra-ucx,8,0,0,0,0,1,0,0,0,0,2,11,10,10,FALSE,0.909090909090909,2018,2018-2019
AR,2019-03-31,intra-ui,1750,53,17,14,26,14,8,1,1,12,371,2267,2121,2174,FALSE,0.958976621085134,2018,2018-2019
AR,2019-04-30,inter-total,49,0,0,0,0,0,0,0,0,1,15,65,64,64,FALSE,0.984615384615385,2018,2018-2019
AR,2019-04-30,inter-ucfe,0,0,0,0,0,0,0,0,0,0,0,0,0,0,FALSE,0,2018,2018-2019
AR,2019-04-30,inter-ucx,0,0,0,0,0,0,0,0,0,0,0,0,0,0,FALSE,0,2018,2018-2019
AR,2019-04-30,inter-ui,49,0,0,0,0,0,0,0,0,1,15,65,64,64,FALSE,0.984615384615385,2018,2018-2019
AR,2019-04-30,intra-total,1774,56,11,15,23,15,3,4,0,10,418,2329,2192,2248,FALSE,0.965221124946329,2018,2018-2019
AR,2019-04-30,intra-ucfe,13,0,0,0,0,0,0,0,0,1,2,16,15,15,FALSE,0.9375,2018,2018-2019
AR,2019-04-30,intra-ucx,3,0,0,0,0,0,0,0,0,0,1,4,4,4,FALSE,1,2018,2018-2019
AR,2019-04-30,intra-ui,1758,56,11,15,23,15,3,4,0,9,415,2309,2173,2229,FALSE,0.96535296665223,2018,2018-2019
AR,2019-05-31,inter-total,50,1,0,0,0,0,0,0,0,0,13,64,63,64,FALSE,1,2018,2018-2019
AR,2019-05-31,inter-ucfe,1,0,0,0,0,0,0,0,0,0,0,1,1,1,FALSE,1,2018,2018-2019
AR,2019-05-31,inter-ucx,0,0,0,0,0,0,0,0,0,0,0,0,0,0,FALSE,0,2018,2018-2019
AR,2019-05-31,inter-ui,49,1,0,0,0,0,0,0,0,0,13,63,62,63,FALSE,1,2018,2018-2019
AR,2019-05-31,intra-total,1975,49,19,18,20,16,3,4,3,8,353,2468,2328,2377,FALSE,0.963128038897893,2018,2018-2019
AR,2019-05-31,intra-ucfe,3,0,0,1,1,0,0,0,0,0,0,5,3,3,FALSE,0.6,2018,2018-2019
AR,2019-05-31,intra-ucx,5,0,0,0,0,0,0,0,0,0,1,6,6,6,FALSE,1,2018,2018-2019
AR,2019-05-31,intra-ui,1967,49,19,17,19,16,3,4,3,8,352,2457,2319,2368,FALSE,0.963776963776964,2018,2018-2019
AR,2019-06-30,inter-total,52,0,0,0,0,0,0,0,0,1,21,74,73,73,FALSE,0.986486486486486,2018,2018-2019
AR,2019-06-30,inter-ucfe,1,0,0,0,0,0,0,0,0,1,0,2,1,1,FALSE,0.5,2018,2018-2019
AR,2019-06-30,inter-ucx,0,0,0,0,0,0,0,0,0,0,0,0,0,0,FALSE,0,2018,2018-2019
AR,2019-06-30,inter-ui,51,0,0,0,0,0,0,0,0,0,21,72,72,72,FALSE,1,2018,2018-2019
AR,2019-06-30,intra-total,3224,61,22,10,12,15,5,6,0,10,546,3911,3770,3831,FALSE,0.979544873433904,2018,2018-2019
AR,2019-06-30,intra-ucfe,8,1,0,0,0,0,0,1,0,0,3,13,11,12,FALSE,0.923076923076923,2018,2018-2019
AR,2019-06-30,intra-ucx,8,0,0,0,0,0,0,0,0,0,2,10,10,10,FALSE,1,2018,2018-2019
AR,2019-06-30,intra-ui,3208,60,22,10,12,15,5,5,0,10,541,3888,3749,3809,FALSE,0.979681069958848,2018,2018-2019
AR,2019-07-31,inter-total,64,1,0,0,0,0,0,0,0,0,21,86,85,86,FALSE,1,2019,2019-2020
AR,2019-07-31,inter-ucfe,1,0,0,0,0,0,0,0,0,0,0,1,1,1,FALSE,1,2019,2019-2020
AR,2019-07-31,inter-ucx,0,0,0,0,0,0,0,0,0,0,0,0,0,0,FALSE,0,2019,2019-2020
AR,2019-07-31,inter-ui,63,1,0,0,0,0,0,0,0,0,21,85,84,85,FALSE,1,2019,2019-2020
AR,2019-07-31,intra-total,3007,117,28,15,17,10,12,4,1,9,620,3840,3627,3744,FALSE,0.975,2019,2019-2020
AR,2019-07-31,intra-ucfe,4,0,0,0,0,0,0,0,0,0,1,5,5,5,FALSE,1,2019,2019-2020
AR,2019-07-31,intra-ucx,10,0,0,0,0,0,0,0,0,0,1,11,11,11,FALSE,1,2019,2019-2020
AR,2019-07-31,intra-ui,2993,117,28,15,17,10,12,4,1,9,618,3824,3611,3728,FALSE,0.97489539748954,2019,2019-2020
AR,2019-08-31,inter-total,48,0,0,0,0,0,0,0,0,1,17,66,65,65,FALSE,0.984848484848485,2019,2019-2020
AR,2019-08-31,inter-ucfe,1,0,0,0,0,0,0,0,0,0,0,1,1,1,FALSE,1,2019,2019-2020
AR,2019-08-31,inter-ucx,0,0,0,0,0,0,0,0,0,0,0,0,0,0,FALSE,0,2019,2019-2020
AR,2019-08-31,inter-ui,47,0,0,0,0,0,0,0,0,1,17,65,64,64,FALSE,0.984615384615385,2019,2019-2020
AR,2019-08-31,intra-total,1476,101,22,12,24,20,7,6,1,10,482,2161,1958,2059,FALSE,0.952799629801018,2019,2019-2020
AR,2019-08-31,intra-ucfe,5,0,0,0,0,1,0,0,0,1,1,8,6,6,FALSE,0.75,2019,2019-2020
AR,2019-08-31,intra-ucx,12,0,0,0,0,0,0,0,0,0,1,13,13,13,FALSE,1,2019,2019-2020
AR,2019-08-31,intra-ui,1459,101,22,12,24,19,7,6,1,9,480,2140,1939,2040,FALSE,0.953271028037383,2019,2019-2020
AR,2019-09-30,inter-total,39,0,0,0,0,0,0,0,0,0,14,53,53,53,FALSE,1,2019,2019-2020
AR,2019-09-30,inter-ucfe,0,0,0,0,0,0,0,0,0,0,0,0,0,0,FALSE,0,2019,2019-2020
AR,2019-09-30,inter-ucx,0,0,0,0,0,0,0,0,0,0,0,0,0,0,FALSE,0,2019,2019-2020
AR,2019-09-30,inter-ui,39,0,0,0,0,0,0,0,0,0,14,53,53,53,FALSE,1,2019,2019-2020
AR,2019-09-30,intra-total,1549,83,24,8,20,16,13,0,5,12,537,2267,2086,2169,FALSE,0.956771063078959,2019,2019-2020
AR,2019-09-30,intra-ucfe,6,0,0,0,0,0,1,0,0,0,1,8,7,7,FALSE,0.875,2019,2019-2020
AR,2019-09-30,intra-ucx,3,1,0,0,0,0,0,0,0,0,5,9,8,9,FALSE,1,2019,2019-2020
AR,2019-09-30,intra-ui,1540,82,24,8,20,16,12,0,5,12,531,2250,2071,2153,FALSE,0.956888888888889,2019,2019-2020
AR,2019-10-31,inter-total,35,1,0,0,0,0,0,0,0,0,21,57,56,57,FALSE,1,2019,2019-2020
AR,2019-10-31,inter-ucfe,1,0,0,0,0,0,0,0,0,0,0,1,1,1,FALSE,1,2019,2019-2020
AR,2019-10-31,inter-ucx,0,0,0,0,0,0,0,0,0,0,0,0,0,0,FALSE,0,2019,2019-2020
AR,2019-10-31,inter-ui,34,1,0,0,0,0,0,0,0,0,21,56,55,56,FALSE,1,2019,2019-2020
AR,2019-10-31,intra-total,1869,101,28,10,23,17,10,3,2,14,534,2611,2403,2504,FALSE,0.959019532746074,2019,2019-2020
AR,2019-10-31,intra-ucfe,13,0,0,0,0,0,1,0,0,0,1,15,14,14,FALSE,0.933333333333333,2019,2019-2020
AR,2019-10-31,intra-ucx,9,0,0,0,0,0,0,0,0,0,2,11,11,11,FALSE,1,2019,2019-2020
AR,2019-10-31,intra-ui,1847,101,28,10,23,17,9,3,2,14,531,2585,2378,2479,FALSE,0.95899419729207,2019,2019-2020
AR,2019-11-30,inter-total,35,2,1,0,0,0,0,0,1,0,13,52,48,50,FALSE,0.961538461538461,2019,2019-2020
AR,2019-11-30,inter-ucfe,0,0,0,0,0,0,0,0,0,0,0,0,0,0,FALSE,0,2019,2019-2020
AR,2019-11-30,inter-ucx,0,0,0,0,0,0,0,0,0,0,0,0,0,0,FALSE,0,2019,2019-2020
AR,2019-11-30,inter-ui,35,2,1,0,0,0,0,0,1,0,13,52,48,50,FALSE,0.961538461538461,2019,2019-2020
AR,2019-11-30,intra-total,1799,84,25,12,14,17,7,6,0,15,460,2439,2259,2343,FALSE,0.960639606396064,2019,2019-2020
AR,2019-11-30,intra-ucfe,5,0,0,0,0,0,0,0,0,0,3,8,8,8,FALSE,1,2019,2019-2020
AR,2019-11-30,intra-ucx,9,0,0,0,0,0,0,0,0,0,0,9,9,9,FALSE,1,2019,2019-2020
AR,2019-11-30,intra-ui,1785,84,25,12,14,17,7,6,0,15,457,2422,2242,2326,FALSE,0.960363336085879,2019,2019-2020
AR,2019-12-31,inter-total,70,2,0,0,0,0,0,0,0,0,18,90,88,90,FALSE,1,2019,2019-2020
AR,2019-12-31,inter-ucfe,0,0,0,0,0,0,0,0,0,0,0,0,0,0,FALSE,0,2019,2019-2020
AR,2019-12-31,inter-ucx,0,0,0,0,0,0,0,0,0,0,0,0,0,0,FALSE,0,2019,2019-2020
AR,2019-12-31,inter-ui,70,2,0,0,0,0,0,0,0,0,18,90,88,90,FALSE,1,2019,2019-2020
AR,2019-12-31,intra-total,3624,84,27,7,32,17,6,4,5,12,544,4362,4168,4252,FALSE,0.974782209995415,2019,2019-2020
AR,2019-12-31,intra-ucfe,7,0,0,0,0,0,0,0,0,0,7,14,14,14,FALSE,1,2019,2019-2020
AR,2019-12-31,intra-ucx,13,0,1,0,1,0,0,0,0,0,0,15,13,13,FALSE,0.866666666666667,2019,2019-2020
AR,2019-12-31,intra-ui,3604,84,26,7,31,17,6,4,5,12,537,4333,4141,4225,FALSE,0.975075005769675,2019,2019-2020
AR,2020-01-31,inter-total,53,0,0,0,0,0,0,0,0,0,27,80,80,80,FALSE,1,2019,2019-2020
AR,2020-01-31,inter-ucfe,0,0,0,0,0,0,0,0,0,0,0,0,0,0,FALSE,0,2019,2019-2020
AR,2020-01-31,inter-ucx,0,0,0,0,0,0,0,0,0,0,1,1,1,1,FALSE,1,2019,2019-2020
AR,2020-01-31,inter-ui,53,0,0,0,0,0,0,0,0,0,26,79,79,79,FALSE,1,2019,2019-2020
AR,2020-01-31,intra-total,3357,130,34,13,20,16,13,10,1,9,642,4245,3999,4129,FALSE,0.972673733804476,2019,2019-2020
AR,2020-01-31,intra-ucfe,16,0,0,0,1,0,0,0,0,0,3,20,19,19,FALSE,0.95,2019,2019-2020
AR,2020-01-31,intra-ucx,4,0,0,0,0,0,0,0,0,0,1,5,5,5,FALSE,1,2019,2019-2020
AR,2020-01-31,intra-ui,3337,130,34,13,19,16,13,10,1,9,638,4220,3975,4105,FALSE,0.972748815165877,2019,2019-2020
AR,2020-02-29,inter-total,41,2,0,0,0,1,1,0,0,0,14,59,55,57,FALSE,0.966101694915254,2019,2019-2020
AR,2020-02-29,inter-ucfe,0,0,0,0,0,0,0,0,0,0,0,0,0,0,FALSE,0,2019,2019-2020
AR,2020-02-29,inter-ucx,0,0,0,0,0,0,0,0,0,0,0,0,0,0,FALSE,0,2019,2019-2020
AR,2020-02-29,inter-ui,41,2,0,0,0,1,1,0,0,0,14,59,55,57,FALSE,0.966101694915254,2019,2019-2020
AR,2020-02-29,intra-total,2093,98,29,17,20,19,4,3,3,10,499,2795,2592,2690,FALSE,0.962432915921288,2019,2019-2020
AR,2020-02-29,intra-ucfe,8,0,0,0,0,0,0,0,0,0,2,10,10,10,FALSE,1,2019,2019-2020
AR,2020-02-29,intra-ucx,5,2,0,0,0,0,0,0,0,0,2,9,7,9,FALSE,1,2019,2019-2020
AR,2020-02-29,intra-ui,2080,96,29,17,20,19,4,3,3,10,495,2776,2575,2671,FALSE,0.962175792507205,2019,2019-2020
AR,2020-03-31,inter-total,112,0,0,0,0,0,0,0,0,0,16,128,128,128,FALSE,1,2019,2019-2020
AR,2020-03-31,inter-ucfe,0,0,0,0,0,0,0,0,0,0,0,0,0,0,FALSE,0,2019,2019-2020
AR,2020-03-31,inter-ucx,0,0,0,0,0,0,0,0,0,0,0,0,0,0,FALSE,0,2019,2019-2020
AR,2020-03-31,inter-ui,112,0,0,0,0,0,0,0,0,0,16,128,128,128,FALSE,1,2019,2019-2020
AR,2020-03-31,intra-total,15059,64,17,18,20,25,4,7,4,17,1473,16708,16532,16596,FALSE,0.993296624371559,2019,2019-2020
AR,2020-03-31,intra-ucfe,9,0,0,0,1,0,0,0,0,1,4,15,13,13,FALSE,0.866666666666667,2019,2019-2020
AR,2020-03-31,intra-ucx,6,0,1,0,0,0,0,0,0,0,3,10,9,9,FALSE,0.9,2019,2019-2020
AR,2020-03-31,intra-ui,15044,64,16,18,19,25,4,7,4,16,1466,16683,16510,16574,FALSE,0.993466402925133,2019,2019-2020
AR,2020-04-30,inter-total,398,39,19,3,0,0,0,0,0,0,155,614,553,592,FALSE,0.964169381107492,2019,2019-2020
AR,2020-04-30,inter-ucfe,0,0,0,0,0,0,0,0,0,0,1,1,1,1,FALSE,1,2019,2019-2020
AR,2020-04-30,inter-ucx,0,0,0,0,0,0,0,0,0,0,0,0,0,0,FALSE,0,2019,2019-2020
AR,2020-04-30,inter-ui,398,39,19,3,0,0,0,0,0,0,154,613,552,591,FALSE,0.964110929853181,2019,2019-2020
AR,2020-04-30,intra-total,48786,6051,3258,928,138,11,10,2,3,8,18180,77375,66966,73017,FALSE,0.94367689822294,2019,2019-2020
AR,2020-04-30,intra-ucfe,6,10,3,0,0,0,0,0,0,0,13,32,19,29,FALSE,0.90625,2019,2019-2020
AR,2020-04-30,intra-ucx,6,2,1,1,0,0,0,0,0,0,4,14,10,12,FALSE,0.857142857142857,2019,2019-2020
AR,2020-04-30,intra-ui,48774,6039,3254,927,138,11,10,2,3,8,18163,77329,66937,72976,FALSE,0.943708052606396,2019,2019-2020
AR,2020-05-31,inter-total,188,34,16,12,14,12,3,1,0,0,120,400,308,342,FALSE,0.855,2019,2019-2020
AR,2020-05-31,inter-ucfe,0,0,0,0,1,0,0,0,0,0,0,1,0,0,FALSE,0,2019,2019-2020
AR,2020-05-31,inter-ucx,0,0,0,0,0,0,0,0,0,0,0,0,0,0,FALSE,0,2019,2019-2020
AR,2020-05-31,inter-ui,188,34,16,12,13,12,3,1,0,0,120,399,308,342,FALSE,0.857142857142857,2019,2019-2020
AR,2020-05-31,intra-total,16007,2028,2381,2780,1853,1120,779,279,53,17,3979,31276,19986,22014,FALSE,0.703862386494437,2019,2019-2020
AR,2020-05-31,intra-ucfe,4,6,9,6,3,3,3,0,0,0,3,37,7,13,FALSE,0.351351351351351,2019,2019-2020
AR,2020-05-31,intra-ucx,6,2,4,1,3,1,2,1,0,0,6,26,12,14,FALSE,0.538461538461538,2019,2019-2020
AR,2020-05-31,intra-ui,15997,2020,2368,2773,1847,1116,774,278,53,17,3970,31213,19967,21987,FALSE,0.704418030948643,2019,2019-2020
AR,2020-06-30,inter-total,107,23,6,9,7,2,4,7,7,9,83,264,190,213,FALSE,0.806818181818182,2019,2019-2020
AR,2020-06-30,inter-ucfe,1,1,0,0,0,0,0,0,0,0,0,2,1,2,FALSE,1,2019,2019-2020
AR,2020-06-30,inter-ucx,1,0,0,0,0,0,0,0,0,0,0,1,1,1,FALSE,1,2019,2019-2020
AR,2020-06-30,inter-ui,105,22,6,9,7,2,4,7,7,9,83,261,188,210,FALSE,0.804597701149425,2019,2019-2020
AR,2020-06-30,intra-total,9227,735,428,663,992,462,360,574,478,613,1849,16381,11076,11811,FALSE,0.721018252853916,2019,2019-2020
AR,2020-06-30,intra-ucfe,5,2,1,3,1,3,2,2,2,0,12,33,17,19,FALSE,0.575757575757576,2019,2019-2020
AR,2020-06-30,intra-ucx,5,1,3,1,1,0,2,1,2,0,3,19,8,9,FALSE,0.473684210526316,2019,2019-2020
AR,2020-06-30,intra-ui,9217,732,424,659,990,459,356,571,474,613,1834,16329,11051,11783,FALSE,0.721599608059281,2019,2019-2020
AR,2020-07-31,inter-total,109,9,4,3,0,3,0,0,0,4,48,180,157,166,FALSE,0.922222222222222,2020,2020-2021
AR,2020-07-31,inter-ucfe,0,0,0,0,0,0,0,0,0,0,1,1,1,1,FALSE,1,2020,2020-2021
AR,2020-07-31,inter-ucx,0,0,0,0,0,0,0,0,0,0,0,0,0,0,FALSE,0,2020,2020-2021
AR,2020-07-31,inter-ui,109,9,4,3,0,3,0,0,0,4,47,179,156,165,FALSE,0.921787709497207,2020,2020-2021
AR,2020-07-31,intra-total,15443,392,173,174,239,519,344,78,45,349,2024,19780,17467,17859,FALSE,0.902881698685541,2020,2020-2021
AR,2020-07-31,intra-ucfe,5,2,2,4,0,0,0,0,0,2,6,21,11,13,FALSE,0.619047619047619,2020,2020-2021
AR,2020-07-31,intra-ucx,2,1,1,0,0,0,0,0,0,3,8,15,10,11,FALSE,0.733333333333333,2020,2020-2021
AR,2020-07-31,intra-ui,15436,389,170,170,239,519,344,78,45,344,2010,19744,17446,17835,FALSE,0.903312398703403,2020,2020-2021
AR,2020-08-31,inter-total,55,9,6,9,2,0,0,0,0,7,32,120,87,96,FALSE,0.8,2020,2020-2021
AR,2020-08-31,inter-ucfe,0,0,0,0,0,0,0,0,0,0,0,0,0,0,FALSE,0,2020,2020-2021
AR,2020-08-31,inter-ucx,0,0,0,0,0,0,0,0,0,0,0,0,0,0,FALSE,0,2020,2020-2021
AR,2020-08-31,inter-ui,55,9,6,9,2,0,0,0,0,7,32,120,87,96,FALSE,0.8,2020,2020-2021
AR,2020-08-31,intra-total,3706,212,153,155,112,52,162,262,296,394,902,6406,4608,4820,FALSE,0.752419606618795,2020,2020-2021
AR,2020-08-31,intra-ucfe,4,2,1,0,1,0,0,0,0,3,2,13,6,8,FALSE,0.615384615384615,2020,2020-2021
AR,2020-08-31,intra-ucx,7,1,1,1,0,1,0,1,0,0,7,19,14,15,FALSE,0.789473684210526,2020,2020-2021
AR,2020-08-31,intra-ui,3695,209,151,154,111,51,162,261,296,391,893,6374,4588,4797,FALSE,0.752588641355507,2020,2020-2021
AR,2020-09-30,inter-total,42,9,3,0,1,0,3,0,2,9,16,85,58,67,FALSE,0.788235294117647,2020,2020-2021
AR,2020-09-30,inter-ucfe,0,0,0,0,0,0,0,0,0,0,0,0,0,0,FALSE,0,2020,2020-2021
AR,2020-09-30,inter-ucx,0,0,0,0,0,0,0,0,0,0,0,0,0,0,FALSE,0,2020,2020-2021
AR,2020-09-30,inter-ui,42,9,3,0,1,0,3,0,2,9,16,85,58,67,FALSE,0.788235294117647,2020,2020-2021
AR,2020-09-30,intra-total,3455,153,86,65,27,21,30,37,163,1159,481,5677,3936,4089,FALSE,0.720274793024485,2020,2020-2021
AR,2020-09-30,intra-ucfe,1,1,0,0,0,0,0,0,0,1,3,6,4,5,FALSE,0.833333333333333,2020,2020-2021
AR,2020-09-30,intra-ucx,3,1,0,0,0,0,0,0,0,0,4,8,7,8,FALSE,1,2020,2020-2021
AR,2020-09-30,intra-ui,3451,151,86,65,27,21,30,37,163,1158,474,5663,3925,4076,FALSE,0.719759844605333,2020,2020-2021
AR,2020-10-31,inter-total,31,8,3,1,0,1,0,0,1,6,21,72,52,60,FALSE,0.833333333333333,2020,2020-2021
AR,2020-10-31,inter-ucfe,0,0,0,0,0,0,0,0,0,0,0,0,0,0,FALSE,0,2020,2020-2021
AR,2020-10-31,inter-ucx,0,0,0,0,0,0,0,0,0,0,0,0,0,0,FALSE,0,2020,2020-2021
AR,2020-10-31,inter-ui,31,8,3,1,0,1,0,0,1,6,21,72,52,60,FALSE,0.833333333333333,2020,2020-2021
AR,2020-10-31,intra-total,2171,130,43,17,20,24,22,18,11,1054,513,4023,2684,2814,FALSE,0.699478001491424,2020,2020-2021
AR,2020-10-31,intra-ucfe,9,5,0,1,0,0,1,0,1,3,3,23,12,17,FALSE,0.739130434782609,2020,2020-2021
AR,2020-10-31,intra-ucx,5,1,0,0,0,0,0,0,0,1,3,10,8,9,FALSE,0.9,2020,2020-2021
AR,2020-10-31,intra-ui,2157,124,43,16,20,24,21,18,10,1050,507,3990,2664,2788,FALSE,0.69874686716792,2020,2020-2021
AR,2020-11-30,inter-total,21,4,1,1,0,0,0,0,0,8,20,55,41,45,FALSE,0.818181818181818,2020,2020-2021
AR,2020-11-30,inter-ucfe,0,0,0,0,0,0,0,0,0,0,0,0,0,0,FALSE,0,2020,2020-2021
AR,2020-11-30,inter-ucx,0,0,0,0,0,0,0,0,0,0,0,0,0,0,FALSE,0,2020,2020-2021
AR,2020-11-30,inter-ui,21,4,1,1,0,0,0,0,0,8,20,55,41,45,FALSE,0.818181818181818,2020,2020-2021
AR,2020-11-30,intra-total,1934,181,64,35,22,15,5,8,5,805,536,3610,2470,2651,FALSE,0.734349030470914,2020,2020-2021
AR,2020-11-30,intra-ucfe,15,8,4,1,2,1,0,0,0,4,14,49,29,37,FALSE,0.755102040816326,2020,2020-2021
AR,2020-11-30,intra-ucx,3,1,0,0,0,0,0,0,0,1,0,5,3,4,FALSE,0.8,2020,2020-2021
AR,2020-11-30,intra-ui,1916,172,60,34,20,14,5,8,5,800,522,3556,2438,2610,FALSE,0.733970753655793,2020,2020-2021
AR,2020-12-31,inter-total,21,5,1,1,0,1,0,0,0,8,14,51,35,40,FALSE,0.784313725490196,2020,2020-2021
AR,2020-12-31,inter-ucfe,0,0,0,0,0,0,0,0,0,0,0,0,0,0,FALSE,0,2020,2020-2021
AR,2020-12-31,inter-ucx,0,0,0,0,0,0,0,0,0,0,0,0,0,0,FALSE,0,2020,2020-2021
AR,2020-12-31,inter-ui,21,5,1,1,0,1,0,0,0,8,14,51,35,40,FALSE,0.784313725490196,2020,2020-2021
AR,2020-12-31,intra-total,2052,186,52,24,14,16,6,18,11,926,683,3988,2735,2921,FALSE,0.732447342026078,2020,2020-2021
AR,2020-12-31,intra-ucfe,15,9,3,1,1,1,0,0,0,4,8,42,23,32,FALSE,0.761904761904762,2020,2020-2021
AR,2020-12-31,intra-ucx,3,1,1,0,1,0,0,0,0,1,2,9,5,6,FALSE,0.666666666666667,2020,2020-2021
AR,2020-12-31,intra-ui,2034,176,48,23,12,15,6,18,11,921,673,3937,2707,2883,FALSE,0.732283464566929,2020,2020-2021
AR,2021-01-31,inter-total,27,4,1,0,0,0,2,0,1,8,19,62,46,50,FALSE,0.806451612903226,2020,2020-2021
AR,2021-01-31,inter-ucfe,0,0,0,0,0,0,0,0,0,0,0,0,0,0,FALSE,0,2020,2020-2021
AR,2021-01-31,inter-ucx,0,0,0,0,0,0,0,0,0,0,0,0,0,0,FALSE,0,2020,2020-2021
AR,2021-01-31,inter-ui,27,4,1,0,0,0,2,0,1,8,19,62,46,50,FALSE,0.806451612903226,2020,2020-2021
AR,2021-01-31,intra-total,2676,174,44,33,18,18,20,20,41,860,647,4551,3323,3497,FALSE,0.768402548890354,2020,2020-2021
AR,2021-01-31,intra-ucfe,16,5,2,0,0,1,0,0,0,3,18,45,34,39,FALSE,0.866666666666667,2020,2020-2021
AR,2021-01-31,intra-ucx,3,0,0,1,0,0,0,0,0,0,0,4,3,3,FALSE,0.75,2020,2020-2021
AR,2021-01-31,intra-ui,2657,169,42,32,18,17,20,20,41,857,629,4502,3286,3455,FALSE,0.76743669480231,2020,2020-2021
AR,2021-02-28,inter-total,10,0,1,0,0,1,0,0,0,11,7,30,17,17,FALSE,0.566666666666667,2020,2020-2021
AR,2021-02-28,inter-ucfe,0,0,0,0,0,0,0,0,0,0,0,0,0,0,FALSE,0,2020,2020-2021
AR,2021-02-28,inter-ucx,0,0,0,0,0,0,0,0,0,0,0,0,0,0,FALSE,0,2020,2020-2021
AR,2021-02-28,inter-ui,10,0,1,0,0,1,0,0,0,11,7,30,17,17,FALSE,0.566666666666667,2020,2020-2021
AR,2021-02-28,intra-total,1834,213,85,31,37,21,11,17,16,681,458,3404,2292,2505,FALSE,0.735898942420682,2020,2020-2021
AR,2021-02-28,intra-ucfe,7,4,2,2,2,0,0,0,1,1,3,22,10,14,FALSE,0.636363636363636,2020,2020-2021
AR,2021-02-28,intra-ucx,3,0,1,0,0,0,0,0,0,1,2,7,5,5,FALSE,0.714285714285714,2020,2020-2021
AR,2021-02-28,intra-ui,1824,209,82,29,35,21,11,17,15,679,453,3375,2277,2486,FALSE,0.736592592592593,2020,2020-2021
AR,2021-03-31,inter-total,30,5,6,3,1,1,1,0,0,13,9,69,39,44,FALSE,0.63768115942029,2020,2020-2021
AR,2021-03-31,inter-ucfe,0,0,0,0,0,0,0,0,0,0,0,0,0,0,FALSE,0,2020,2020-2021
AR,2021-03-31,inter-ucx,0,0,0,0,0,0,0,0,0,0,0,0,0,0,FALSE,0,2020,2020-2021
AR,2021-03-31,inter-ui,30,5,6,3,1,1,1,0,0,13,9,69,39,44,FALSE,0.63768115942029,2020,2020-2021
AR,2021-03-31,intra-total,1404,174,50,38,25,34,28,22,21,1095,499,3390,1903,2077,FALSE,0.612684365781711,2020,2020-2021
AR,2021-03-31,intra-ucfe,6,2,0,1,1,0,0,1,0,2,1,14,7,9,FALSE,0.642857142857143,2020,2020-2021
AR,2021-03-31,intra-ucx,8,0,0,0,0,0,0,0,0,0,4,12,12,12,FALSE,1,2020,2020-2021
AR,2021-03-31,intra-ui,1390,172,50,37,24,34,28,21,21,1093,494,3364,1884,2056,FALSE,0.611177170035672,2020,2020-2021
AR,2021-04-30,inter-total,29,1,2,3,2,0,0,0,0,18,12,67,41,42,FALSE,0.626865671641791,2020,2020-2021
AR,2021-04-30,inter-ucfe,0,0,0,0,0,0,0,0,0,0,0,0,0,0,FALSE,0,2020,2020-2021
AR,2021-04-30,inter-ucx,0,0,0,0,0,0,0,0,0,0,0,0,0,0,FALSE,0,2020,2020-2021
AR,2021-04-30,inter-ui,29,1,2,3,2,0,0,0,0,18,12,67,41,42,FALSE,0.626865671641791,2020,2020-2021
AR,2021-04-30,intra-total,2023,36,18,9,13,12,13,16,13,979,359,3491,2382,2418,FALSE,0.692638212546548,2020,2020-2021
AR,2021-04-30,intra-ucfe,11,0,0,0,1,0,0,0,1,4,7,24,18,18,FALSE,0.75,2020,2020-2021
AR,2021-04-30,intra-ucx,4,1,0,0,0,0,0,1,0,0,1,7,5,6,FALSE,0.857142857142857,2020,2020-2021
AR,2021-04-30,intra-ui,2008,35,18,9,12,12,13,15,12,975,351,3460,2359,2394,FALSE,0.691907514450867,2020,2020-2021
AR,2021-05-31,inter-total,40,2,1,1,0,1,0,0,0,7,9,61,49,51,FALSE,0.836065573770492,2020,2020-2021
AR,2021-05-31,inter-ucfe,0,0,0,0,0,0,0,0,0,0,0,0,0,0,FALSE,0,2020,2020-2021
AR,2021-05-31,inter-ucx,0,0,0,0,0,0,0,0,0,0,0,0,0,0,FALSE,0,2020,2020-2021
AR,2021-05-31,inter-ui,40,2,1,1,0,1,0,0,0,7,9,61,49,51,FALSE,0.836065573770492,2020,2020-2021
AR,2021-05-31,intra-total,2098,88,39,18,16,4,10,3,8,997,278,3559,2376,2464,FALSE,0.692329305984827,2020,2020-2021
AR,2021-05-31,intra-ucfe,16,2,2,0,0,0,0,0,0,0,6,26,22,24,FALSE,0.923076923076923,2020,2020-2021
AR,2021-05-31,intra-ucx,5,0,0,0,0,0,0,0,0,0,1,6,6,6,FALSE,1,2020,2020-2021
AR,2021-05-31,intra-ui,2077,86,37,18,16,4,10,3,8,997,271,3527,2348,2434,FALSE,0.690104905018429,2020,2020-2021
AR,2021-06-30,inter-total,39,1,1,0,0,1,1,0,1,15,7,66,46,47,FALSE,0.712121212121212,2020,2020-2021
AR,2021-06-30,inter-ucfe,0,0,0,0,0,0,0,0,0,0,0,0,0,0,FALSE,0,2020,2020-2021
AR,2021-06-30,inter-ucx,0,0,0,0,0,0,0,0,0,0,0,0,0,0,FALSE,0,2020,2020-2021
AR,2021-06-30,inter-ui,39,1,1,0,0,1,1,0,1,15,7,66,46,47,FALSE,0.712121212121212,2020,2020-2021
AR,2021-06-30,intra-total,2053,57,36,20,12,14,11,17,21,953,312,3506,2365,2422,FALSE,0.690815744438106,2020,2020-2021
AR,2021-06-30,intra-ucfe,8,0,0,0,0,1,0,0,0,5,2,16,10,10,FALSE,0.625,2020,2020-2021
AR,2021-06-30,intra-ucx,2,0,0,0,0,0,0,0,0,0,5,7,7,7,FALSE,1,2020,2020-2021
AR,2021-06-30,intra-ui,2043,57,36,20,12,13,11,17,21,948,305,3483,2348,2405,FALSE,0.690496698248636,2020,2020-2021
AR,2021-07-31,inter-total,42,3,1,0,0,0,0,0,0,12,18,76,60,63,FALSE,0.828947368421053,2021,2021-2022
AR,2021-07-31,inter-ucfe,0,0,0,0,0,0,0,0,0,0,0,0,0,0,FALSE,0,2021,2021-2022
AR,2021-07-31,inter-ucx,0,0,0,0,0,0,0,0,0,0,0,0,0,0,FALSE,0,2021,2021-2022
AR,2021-07-31,inter-ui,42,3,1,0,0,0,0,0,0,12,18,76,60,63,FALSE,0.828947368421053,2021,2021-2022
AR,2021-07-31,intra-total,2812,50,10,15,13,9,10,10,6,785,305,4025,3117,3167,FALSE,0.786832298136646,2021,2021-2022
AR,2021-07-31,intra-ucfe,9,0,0,0,0,0,0,0,0,4,1,14,10,10,FALSE,0.714285714285714,2021,2021-2022
AR,2021-07-31,intra-ucx,4,0,0,2,0,0,0,0,0,0,4,10,8,8,FALSE,0.8,2021,2021-2022
AR,2021-07-31,intra-ui,2799,50,10,13,13,9,10,10,6,781,300,4001,3099,3149,FALSE,0.787053236690827,2021,2021-2022
AR,2021-08-31,inter-total,28,3,1,2,1,0,0,0,0,7,13,55,41,44,FALSE,0.8,2021,2021-2022
AR,2021-08-31,inter-ucfe,0,0,0,0,0,0,0,0,0,0,0,0,0,0,FALSE,0,2021,2021-2022
AR,2021-08-31,inter-ucx,0,0,0,0,0,0,0,0,0,0,0,0,0,0,FALSE,0,2021,2021-2022
AR,2021-08-31,inter-ui,28,3,1,2,1,0,0,0,0,7,13,55,41,44,FALSE,0.8,2021,2021-2022
AR,2021-08-31,intra-total,1205,42,29,26,20,19,21,20,13,777,160,2332,1365,1407,FALSE,0.603344768439108,2021,2021-2022
AR,2021-08-31,intra-ucfe,7,1,0,0,0,0,0,0,0,1,4,13,11,12,FALSE,0.923076923076923,2021,2021-2022
AR,2021-08-31,intra-ucx,5,0,0,0,0,0,0,0,0,2,2,9,7,7,FALSE,0.777777777777778,2021,2021-2022
AR,2021-08-31,intra-ui,1193,41,29,26,20,19,21,20,13,774,154,2310,1347,1388,FALSE,0.600865800865801,2021,2021-2022
AR,2021-09-30,inter-total,14,4,0,2,0,0,0,0,0,7,6,33,20,24,FALSE,0.727272727272727,2021,2021-2022
AR,2021-09-30,inter-ucfe,1,0,0,0,0,0,0,0,0,0,0,1,1,1,FALSE,1,2021,2021-2022
AR,2021-09-30,inter-ucx,0,0,0,0,0,0,0,0,0,0,0,0,0,0,FALSE,0,2021,2021-2022
AR,2021-09-30,inter-ui,13,4,0,2,0,0,0,0,0,7,6,32,19,23,FALSE,0.71875,2021,2021-2022
AR,2021-09-30,intra-total,561,22,12,11,11,13,21,17,21,897,86,1672,647,669,FALSE,0.40011961722488,2021,2021-2022
AR,2021-09-30,intra-ucfe,3,2,0,0,0,0,0,0,0,0,0,5,3,5,FALSE,1,2021,2021-2022
AR,2021-09-30,intra-ucx,2,0,0,0,0,0,0,0,0,0,1,3,3,3,FALSE,1,2021,2021-2022
AR,2021-09-30,intra-ui,556,20,12,11,11,13,21,17,21,897,85,1664,641,661,FALSE,0.397235576923077,2021,2021-2022
AR,2021-10-31,inter-total,19,4,1,1,0,0,0,0,0,12,7,44,26,30,FALSE,0.681818181818182,2021,2021-2022
AR,2021-10-31,inter-ucfe,0,0,0,0,0,0,0,0,0,0,0,0,0,0,FALSE,0,2021,2021-2022
AR,2021-10-31,inter-ucx,0,0,0,0,0,0,0,0,0,0,0,0,0,0,FALSE,0,2021,2021-2022
AR,2021-10-31,inter-ui,19,4,1,1,0,0,0,0,0,12,7,44,26,30,FALSE,0.681818181818182,2021,2021-2022
AR,2021-10-31,intra-total,885,16,10,6,13,9,7,17,13,820,98,1894,983,999,FALSE,0.527455121436114,2021,2021-2022
AR,2021-10-31,intra-ucfe,12,2,0,0,0,0,0,0,0,3,5,22,17,19,FALSE,0.863636363636364,2021,2021-2022
AR,2021-10-31,intra-ucx,1,1,0,0,0,0,0,0,0,0,0,2,1,2,FALSE,1,2021,2021-2022
AR,2021-10-31,intra-ui,872,13,10,6,13,9,7,17,13,817,93,1870,965,978,FALSE,0.522994652406417,2021,2021-2022
AR,2021-11-30,inter-total,37,2,0,1,0,0,0,0,1,9,8,58,45,47,FALSE,0.810344827586207,2021,2021-2022
AR,2021-11-30,inter-ucfe,0,0,0,1,0,0,0,0,0,0,0,1,0,0,FALSE,0,2021,2021-2022
AR,2021-11-30,inter-ucx,0,0,0,0,0,0,0,0,0,0,0,0,0,0,FALSE,0,2021,2021-2022
AR,2021-11-30,inter-ui,37,2,0,0,0,0,0,0,1,9,8,57,45,47,FALSE,0.824561403508772,2021,2021-2022
AR,2021-11-30,intra-total,888,16,12,8,7,9,4,6,11,815,85,1861,973,989,FALSE,0.531434712520151,2021,2021-2022
AR,2021-11-30,intra-ucfe,10,1,0,0,0,0,0,0,0,2,2,15,12,13,FALSE,0.866666666666667,2021,2021-2022
AR,2021-11-30,intra-ucx,6,1,0,0,0,0,0,0,0,1,0,8,6,7,FALSE,0.875,2021,2021-2022
AR,2021-11-30,intra-ui,872,14,12,8,7,9,4,6,11,812,83,1838,955,969,FALSE,0.527203482045702,2021,2021-2022
AR,2021-12-31,inter-total,35,4,1,1,0,0,0,0,0,7,15,63,50,54,FALSE,0.857142857142857,2021,2021-2022
AR,2021-12-31,inter-ucfe,0,0,0,0,0,0,0,0,0,0,0,0,0,0,FALSE,0,2021,2021-2022
AR,2021-12-31,inter-ucx,0,0,0,0,0,0,0,0,0,0,0,0,0,0,FALSE,0,2021,2021-2022
AR,2021-12-31,inter-ui,35,4,1,1,0,0,0,0,0,7,15,63,50,54,FALSE,0.857142857142857,2021,2021-2022
AR,2021-12-31,intra-total,1223,21,14,4,2,10,7,6,6,551,140,1984,1363,1384,FALSE,0.69758064516129,2021,2021-2022
AR,2021-12-31,intra-ucfe,1,0,1,0,0,0,0,0,0,0,2,4,3,3,FALSE,0.75,2021,2021-2022
AR,2021-12-31,intra-ucx,1,2,0,0,0,0,0,0,0,0,1,4,2,4,FALSE,1,2021,2021-2022
AR,2021-12-31,intra-ui,1221,19,13,4,2,10,7,6,6,551,137,1976,1358,1377,FALSE,0.696862348178138,2021,2021-2022
AR,2022-01-31,inter-total,41,1,1,0,0,0,0,0,1,5,12,61,53,54,FALSE,0.885245901639344,2021,2021-2022
AR,2022-01-31,inter-ucfe,0,0,0,0,0,0,0,0,0,0,0,0,0,0,FALSE,0,2021,2021-2022
AR,2022-01-31,inter-ucx,0,0,0,0,0,0,0,0,0,0,0,0,0,0,FALSE,0,2021,2021-2022
AR,2022-01-31,inter-ui,41,1,1,0,0,0,0,0,1,5,12,61,53,54,FALSE,0.885245901639344,2021,2021-2022
AR,2022-01-31,intra-total,2151,47,17,12,13,15,13,20,16,903,309,3516,2460,2507,FALSE,0.713026166097838,2021,2021-2022
AR,2022-01-31,intra-ucfe,13,1,1,1,0,0,0,0,0,0,1,17,14,15,FALSE,0.882352941176471,2021,2021-2022
AR,2022-01-31,intra-ucx,1,1,0,0,0,0,0,0,0,0,1,3,2,3,FALSE,1,2021,2021-2022
AR,2022-01-31,intra-ui,2137,45,16,11,13,15,13,20,16,903,307,3496,2444,2489,FALSE,0.711956521739131,2021,2021-2022
AR,2022-02-28,inter-total,19,0,3,3,0,1,1,0,1,6,5,39,24,24,FALSE,0.615384615384615,2021,2021-2022
AR,2022-02-28,inter-ucfe,0,0,0,0,0,0,0,0,0,0,0,0,0,0,FALSE,0,2021,2021-2022
AR,2022-02-28,inter-ucx,0,0,0,0,0,0,0,0,0,0,0,0,0,0,FALSE,0,2021,2021-2022
AR,2022-02-28,inter-ui,19,0,3,3,0,1,1,0,1,6,5,39,24,24,FALSE,0.615384615384615,2021,2021-2022
AR,2022-02-28,intra-total,714,47,29,23,25,34,60,111,118,423,130,1714,844,891,FALSE,0.519836639439907,2021,2021-2022
AR,2022-02-28,intra-ucfe,6,0,0,0,0,1,0,0,0,2,1,10,7,7,FALSE,0.7,2021,2021-2022
AR,2022-02-28,intra-ucx,1,1,0,0,0,0,0,0,0,1,2,5,3,4,FALSE,0.8,2021,2021-2022
AR,2022-02-28,intra-ui,707,46,29,23,25,33,60,111,118,420,127,1699,834,880,FALSE,0.51795173631548,2021,2021-2022
AR,2022-03-31,inter-total,17,3,3,3,0,4,2,2,0,5,10,49,27,30,FALSE,0.612244897959184,2021,2021-2022
AR,2022-03-31,inter-ucfe,0,0,0,0,0,0,0,0,0,0,0,0,0,0,FALSE,0,2021,2021-2022
AR,2022-03-31,inter-ucx,0,0,0,0,0,0,0,0,0,0,0,0,0,0,FALSE,0,2021,2021-2022
AR,2022-03-31,inter-ui,17,3,3,3,0,4,2,2,0,5,10,49,27,30,FALSE,0.612244897959184,2021,2021-2022
AR,2022-03-31,intra-total,609,57,116,140,182,192,110,61,29,133,123,1752,732,789,FALSE,0.450342465753425,2021,2021-2022
AR,2022-03-31,intra-ucfe,6,1,0,0,0,1,2,0,0,1,0,11,6,7,FALSE,0.636363636363636,2021,2021-2022
AR,2022-03-31,intra-ucx,4,0,0,0,0,0,0,0,0,0,0,4,4,4,FALSE,1,2021,2021-2022
AR,2022-03-31,intra-ui,599,56,116,140,182,191,108,61,29,132,123,1737,722,778,FALSE,0.447898675877951,2021,2021-2022
AR,2022-04-30,inter-total,16,3,2,4,0,3,0,0,0,2,9,39,25,28,FALSE,0.717948717948718,2021,2021-2022
AR,2022-04-30,inter-ucfe,0,0,0,0,0,0,0,0,0,0,0,0,0,0,FALSE,0,2021,2021-2022
AR,2022-04-30,inter-ucx,0,0,0,0,0,0,0,0,0,0,0,0,0,0,FALSE,0,2021,2021-2022
AR,2022-04-30,inter-ui,16,3,2,4,0,3,0,0,0,2,9,39,25,28,FALSE,0.717948717948718,2021,2021-2022
AR,2022-04-30,intra-total,747,192,134,61,35,15,5,7,1,56,325,1578,1072,1264,FALSE,0.801013941698352,2021,2021-2022
AR,2022-04-30,intra-ucfe,4,2,0,1,0,0,0,0,0,0,0,7,4,6,FALSE,0.857142857142857,2021,2021-2022
AR,2022-04-30,intra-ucx,1,0,0,0,0,0,0,0,0,0,0,1,1,1,FALSE,1,2021,2021-2022
AR,2022-04-30,intra-ui,742,190,134,60,35,15,5,7,1,56,325,1570,1067,1257,FALSE,0.800636942675159,2021,2021-2022
AR,2022-05-31,inter-total,29,2,1,0,0,0,1,0,0,0,17,50,46,48,FALSE,0.96,2021,2021-2022
AR,2022-05-31,inter-ucfe,0,0,0,0,0,0,0,0,0,0,0,0,0,0,FALSE,0,2021,2021-2022
AR,2022-05-31,inter-ucx,0,0,0,0,0,0,0,0,0,0,0,0,0,0,FALSE,0,2021,2021-2022
AR,2022-05-31,inter-ui,29,2,1,0,0,0,1,0,0,0,17,50,46,48,FALSE,0.96,2021,2021-2022
AR,2022-05-31,intra-total,1415,113,45,11,2,5,3,3,7,48,423,2075,1838,1951,FALSE,0.940240963855422,2021,2021-2022
AR,2022-05-31,intra-ucfe,2,1,0,0,0,0,0,0,0,0,3,6,5,6,FALSE,1,2021,2021-2022
AR,2022-05-31,intra-ucx,9,0,0,0,0,0,0,0,0,0,0,9,9,9,FALSE,1,2021,2021-2022
AR,2022-05-31,intra-ui,1404,112,45,11,2,5,3,3,7,48,420,2060,1824,1936,FALSE,0.939805825242719,2021,2021-2022
AR,2022-06-30,inter-total,23,3,3,0,0,0,0,0,0,0,11,40,34,37,FALSE,0.925,2021,2021-2022
AR,2022-06-30,inter-ucfe,0,0,0,0,0,0,0,0,0,0,0,0,0,0,FALSE,0,2021,2021-2022
AR,2022-06-30,inter-ucx,0,0,0,0,0,0,0,0,0,0,0,0,0,0,FALSE,0,2021,2021-2022
AR,2022-06-30,inter-ui,23,3,3,0,0,0,0,0,0,0,11,40,34,37,FALSE,0.925,2021,2021-2022
AR,2022-06-30,intra-total,1760,188,54,16,8,3,2,4,3,27,505,2570,2265,2453,FALSE,0.954474708171206,2021,2021-2022
AR,2022-06-30,intra-ucfe,7,0,0,0,0,0,0,0,0,0,2,9,9,9,FALSE,1,2021,2021-2022
AR,2022-06-30,intra-ucx,2,2,0,0,0,0,0,0,0,0,3,7,5,7,FALSE,1,2021,2021-2022
AR,2022-06-30,intra-ui,1751,186,54,16,8,3,2,4,3,27,500,2554,2251,2437,FALSE,0.954189506656225,2021,2021-2022
AR,2022-07-31,inter-total,21,9,2,3,0,0,0,1,0,1,4,41,25,34,FALSE,0.829268292682927,2022,2022-2023
AR,2022-07-31,inter-ucfe,0,0,0,0,0,0,0,0,0,0,0,0,0,0,FALSE,0,2022,2022-2023
AR,2022-07-31,inter-ucx,0,0,0,0,0,0,0,0,0,0,0,0,0,0,FALSE,0,2022,2022-2023
AR,2022-07-31,inter-ui,21,9,2,3,0,0,0,1,0,1,4,41,25,34,FALSE,0.829268292682927,2022,2022-2023
AR,2022-07-31,intra-total,1550,264,102,32,11,7,3,9,7,15,352,2352,1902,2166,FALSE,0.920918367346939,2022,2022-2023
AR,2022-07-31,intra-ucfe,6,3,0,0,0,0,0,0,0,0,1,10,7,10,FALSE,1,2022,2022-2023
AR,2022-07-31,intra-ucx,4,0,0,0,0,0,0,0,0,0,2,6,6,6,FALSE,1,2022,2022-2023
AR,2022-07-31,intra-ui,1540,261,102,32,11,7,3,9,7,15,349,2336,1889,2150,FALSE,0.920376712328767,2022,2022-2023
AR,2022-08-31,inter-total,31,5,1,0,0,0,0,0,0,1,15,53,46,51,FALSE,0.962264150943396,2022,2022-2023
AR,2022-08-31,inter-ucfe,0,0,0,0,0,0,0,0,0,0,0,0,0,0,FALSE,0,2022,2022-2023
AR,2022-08-31,inter-ucx,0,0,0,0,0,0,0,0,0,0,0,0,0,0,FALSE,0,2022,2022-2023
AR,2022-08-31,inter-ui,31,5,1,0,0,0,0,0,0,1,15,53,46,51,FALSE,0.962264150943396,2022,2022-2023
AR,2022-08-31,intra-total,1423,197,45,17,5,4,4,2,2,31,580,2310,2003,2200,FALSE,0.952380952380952,2022,2022-2023
AR,2022-08-31,intra-ucfe,7,1,0,0,0,0,0,0,0,0,2,10,9,10,FALSE,1,2022,2022-2023
AR,2022-08-31,intra-ucx,4,0,0,0,0,0,0,0,0,0,1,5,5,5,FALSE,1,2022,2022-2023
AR,2022-08-31,intra-ui,1412,196,45,17,5,4,4,2,2,31,577,2295,1989,2185,FALSE,0.952069716775599,2022,2022-2023
AR,2022-09-30,inter-total,20,4,1,0,1,0,0,0,0,1,16,43,36,40,FALSE,0.930232558139535,2022,2022-2023
AR,2022-09-30,inter-ucfe,0,0,0,0,0,0,0,0,0,0,0,0,0,0,FALSE,0,2022,2022-2023
AR,2022-09-30,inter-ucx,1,0,0,0,0,0,0,0,0,0,0,1,1,1,FALSE,1,2022,2022-2023
AR,2022-09-30,inter-ui,19,4,1,0,1,0,0,0,0,1,16,42,35,39,FALSE,0.928571428571429,2022,2022-2023
AR,2022-09-30,intra-total,953,113,24,18,9,6,8,8,5,35,485,1664,1438,1551,FALSE,0.932091346153846,2022,2022-2023
AR,2022-09-30,intra-ucfe,1,0,0,0,0,0,0,0,0,0,2,3,3,3,FALSE,1,2022,2022-2023
AR,2022-09-30,intra-ucx,4,0,0,0,0,0,0,0,0,0,1,5,5,5,FALSE,1,2022,2022-2023
AR,2022-09-30,intra-ui,948,113,24,18,9,6,8,8,5,35,482,1656,1430,1543,FALSE,0.931763285024155,2022,2022-2023
AR,2022-10-31,inter-total,21,2,1,2,1,0,1,0,0,1,9,38,30,32,FALSE,0.842105263157895,2022,2022-2023
AR,2022-10-31,inter-ucfe,0,0,0,0,0,0,0,0,0,0,0,0,0,0,FALSE,0,2022,2022-2023
AR,2022-10-31,inter-ucx,0,0,0,0,0,0,0,0,0,0,0,0,0,0,FALSE,0,2022,2022-2023
AR,2022-10-31,inter-ui,21,2,1,2,1,0,1,0,0,1,9,38,30,32,FALSE,0.842105263157895,2022,2022-2023
AR,2022-10-31,intra-total,1160,82,30,6,3,3,11,9,5,33,371,1713,1531,1613,FALSE,0.941622883829539,2022,2022-2023
AR,2022-10-31,intra-ucfe,5,0,0,0,0,0,0,0,0,1,2,8,7,7,FALSE,0.875,2022,2022-2023
AR,2022-10-31,intra-ucx,4,2,0,0,0,0,0,0,0,0,1,7,5,7,FALSE,1,2022,2022-2023
AR,2022-10-31,intra-ui,1151,80,30,6,3,3,11,9,5,32,368,1698,1519,1599,FALSE,0.941696113074205,2022,2022-2023
AR,2022-11-30,inter-total,32,1,0,0,0,0,0,0,0,0,12,45,44,45,FALSE,1,2022,2022-2023
AR,2022-11-30,inter-ucfe,0,0,0,0,0,0,0,0,0,0,0,0,0,0,FALSE,0,2022,2022-2023
AR,2022-11-30,inter-ucx,0,0,0,0,0,0,0,0,0,0,0,0,0,0,FALSE,0,2022,2022-2023
AR,2022-11-30,inter-ui,32,1,0,0,0,0,0,0,0,0,12,45,44,45,FALSE,1,2022,2022-2023
AR,2022-11-30,intra-total,1263,162,41,23,11,11,9,7,3,15,394,1939,1657,1819,FALSE,0.938112429087158,2022,2022-2023
AR,2022-11-30,intra-ucfe,5,0,0,0,0,0,0,0,0,0,0,5,5,5,FALSE,1,2022,2022-2023
AR,2022-11-30,intra-ucx,2,0,0,0,0,0,0,0,0,1,0,3,2,2,FALSE,0.666666666666667,2022,2022-2023
AR,2022-11-30,intra-ui,1256,162,41,23,11,11,9,7,3,14,394,1931,1650,1812,FALSE,0.93837389953392,2022,2022-2023
AR,2022-12-31,inter-total,34,9,3,1,0,0,0,0,0,0,13,60,47,56,FALSE,0.933333333333333,2022,2022-2023
AR,2022-12-31,inter-ucfe,0,1,0,0,0,0,0,0,0,0,0,1,0,1,FALSE,1,2022,2022-2023
AR,2022-12-31,inter-ucx,0,0,0,0,0,0,0,0,0,0,0,0,0,0,FALSE,0,2022,2022-2023
AR,2022-12-31,inter-ui,34,8,3,1,0,0,0,0,0,0,13,59,47,55,FALSE,0.932203389830508,2022,2022-2023
AR,2022-12-31,intra-total,1042,166,42,12,6,6,7,3,5,17,420,1726,1462,1628,FALSE,0.943221320973349,2022,2022-2023
AR,2022-12-31,intra-ucfe,6,0,0,0,0,0,0,0,0,0,5,11,11,11,FALSE,1,2022,2022-2023
AR,2022-12-31,intra-ucx,0,1,0,0,0,0,0,0,0,0,1,2,1,2,FALSE,1,2022,2022-2023
AR,2022-12-31,intra-ui,1036,165,42,12,6,6,7,3,5,17,414,1713,1450,1615,FALSE,0.942790426152948,2022,2022-2023
AR,2023-01-31,inter-total,9,11,2,3,0,0,0,0,0,0,21,46,30,41,FALSE,0.891304347826087,2022,2022-2023
AR,2023-01-31,inter-ucfe,0,0,0,0,0,0,0,0,0,0,0,0,0,0,FALSE,0,2022,2022-2023
AR,2023-01-31,inter-ucx,0,0,0,0,0,0,0,0,0,0,0,0,0,0,FALSE,0,2022,2022-2023
AR,2023-01-31,inter-ui,9,11,2,3,0,0,0,0,0,0,21,46,30,41,FALSE,0.891304347826087,2022,2022-2023
AR,2023-01-31,intra-total,600,364,248,80,14,14,7,4,2,14,618,1965,1218,1582,FALSE,0.805089058524173,2022,2022-2023
AR,2023-01-31,intra-ucfe,0,3,2,0,0,0,0,0,0,0,1,6,1,4,FALSE,0.666666666666667,2022,2022-2023
AR,2023-01-31,intra-ucx,2,2,0,0,0,0,0,0,0,0,0,4,2,4,FALSE,1,2022,2022-2023
AR,2023-01-31,intra-ui,598,359,246,80,14,14,7,4,2,14,617,1955,1215,1574,FALSE,0.805115089514067,2022,2022-2023
AR,2023-02-28,inter-total,8,10,6,6,1,1,0,0,0,1,11,44,19,29,FALSE,0.659090909090909,2022,2022-2023
AR,2023-02-28,inter-ucfe,0,0,0,0,0,0,0,0,0,0,0,0,0,0,FALSE,0,2022,2022-2023
AR,2023-02-28,inter-ucx,0,0,0,0,0,0,0,0,0,0,0,0,0,0,FALSE,0,2022,2022-2023
AR,2023-02-28,inter-ui,8,10,6,6,1,1,0,0,0,1,11,44,19,29,FALSE,0.659090909090909,2022,2022-2023
AR,2023-02-28,intra-total,227,379,366,288,141,70,19,7,3,20,276,1796,503,882,FALSE,0.49109131403118,2022,2022-2023
AR,2023-02-28,intra-ucfe,1,1,2,1,0,0,0,0,0,0,0,5,1,2,FALSE,0.4,2022,2022-2023
AR,2023-02-28,intra-ucx,0,1,3,1,1,0,0,0,0,0,0,6,0,1,FALSE,0.166666666666667,2022,2022-2023
AR,2023-02-28,intra-ui,226,377,361,286,140,70,19,7,3,20,276,1785,502,879,FALSE,0.492436974789916,2022,2022-2023
AR,2023-03-31,inter-total,10,3,7,6,1,4,3,0,0,1,12,47,22,25,FALSE,0.531914893617021,2022,2022-2023
AR,2023-03-31,inter-ucfe,0,0,0,0,0,0,0,0,0,0,0,0,0,0,FALSE,0,2022,2022-2023
AR,2023-03-31,inter-ucx,0,0,0,0,0,0,0,0,0,0,0,0,0,0,FALSE,0,2022,2022-2023
AR,2023-03-31,inter-ui,10,3,7,6,1,4,3,0,0,1,12,47,22,25,FALSE,0.531914893617021,2022,2022-2023
AR,2023-03-31,intra-total,360,180,232,237,180,120,32,19,10,30,282,1682,642,822,FALSE,0.488703923900119,2022,2022-2023
AR,2023-03-31,intra-ucfe,1,0,1,0,1,1,0,0,1,0,0,5,1,1,FALSE,0.2,2022,2022-2023
AR,2023-03-31,intra-ucx,0,0,1,1,0,0,0,0,0,0,0,2,0,0,FALSE,0,2022,2022-2023
AR,2023-03-31,intra-ui,359,180,230,236,179,119,32,19,9,30,282,1675,641,821,FALSE,0.490149253731343,2022,2022-2023
AR,2023-04-30,inter-total,5,6,3,2,1,0,3,0,0,0,13,33,18,24,FALSE,0.727272727272727,2022,2022-2023
AR,2023-04-30,inter-ucfe,0,0,0,0,0,0,0,0,0,0,0,0,0,0,FALSE,0,2022,2022-2023
AR,2023-04-30,inter-ucx,0,0,0,0,0,0,0,0,0,0,0,0,0,0,FALSE,0,2022,2022-2023
AR,2023-04-30,inter-ui,5,6,3,2,1,0,3,0,0,0,13,33,18,24,FALSE,0.727272727272727,2022,2022-2023
AR,2023-04-30,intra-total,402,89,133,172,67,63,23,20,16,35,325,1345,727,816,FALSE,0.606691449814126,2022,2022-2023
AR,2023-04-30,intra-ucfe,3,0,1,0,0,0,0,0,0,0,3,7,6,6,FALSE,0.857142857142857,2022,2022-2023
AR,2023-04-30,intra-ucx,2,1,0,0,0,0,0,0,0,0,0,3,2,3,FALSE,1,2022,2022-2023
AR,2023-04-30,intra-ui,397,88,132,172,67,63,23,20,16,35,322,1335,719,807,FALSE,0.604494382022472,2022,2022-2023
AR,2023-05-31,inter-total,15,3,3,6,1,1,1,0,0,2,14,46,29,32,FALSE,0.695652173913044,2022,2022-2023
AR,2023-05-31,inter-ucfe,0,0,0,0,0,0,0,0,0,0,0,0,0,0,FALSE,0,2022,2022-2023
AR,2023-05-31,inter-ucx,0,0,0,0,0,0,0,0,0,0,0,0,0,0,FALSE,0,2022,2022-2023
AR,2023-05-31,inter-ui,15,3,3,6,1,1,1,0,0,2,14,46,29,32,FALSE,0.695652173913044,2022,2022-2023
AR,2023-05-31,intra-total,863,167,123,176,165,41,17,8,10,29,394,1993,1257,1424,FALSE,0.71450075263422,2022,2022-2023
AR,2023-05-31,intra-ucfe,1,1,2,0,0,0,0,0,0,0,3,7,4,5,FALSE,0.714285714285714,2022,2022-2023
AR,2023-05-31,intra-ucx,2,1,0,0,0,0,0,0,0,0,0,3,2,3,FALSE,1,2022,2022-2023
AR,2023-05-31,intra-ui,860,165,121,176,165,41,17,8,10,29,391,1983,1251,1416,FALSE,0.714069591527988,2022,2022-2023
AR,2023-06-30,inter-total,16,12,4,1,1,0,1,0,0,0,12,47,28,40,FALSE,0.851063829787234,2022,2022-2023
AR,2023-06-30,inter-ucfe,0,0,0,0,0,0,0,0,0,0,0,0,0,0,FALSE,0,2022,2022-2023
AR,2023-06-30,inter-ucx,0,0,0,0,0,0,0,0,0,0,0,0,0,0,FALSE,0,2022,2022-2023
AR,2023-06-30,inter-ui,16,12,4,1,1,0,1,0,0,0,12,47,28,40,FALSE,0.851063829787234,2022,2022-2023
AR,2023-06-30,intra-total,1030,244,90,116,192,145,56,19,11,30,953,2886,1983,2227,FALSE,0.771656271656272,2022,2022-2023
AR,2023-06-30,intra-ucfe,1,1,0,0,1,0,0,0,0,0,2,5,3,4,FALSE,0.8,2022,2022-2023
AR,2023-06-30,intra-ucx,0,1,0,0,1,0,0,0,0,0,3,5,3,4,FALSE,0.8,2022,2022-2023
AR,2023-06-30,intra-ui,1029,242,90,116,190,145,56,19,11,30,948,2876,1977,2219,FALSE,0.771557719054242,2022,2022-2023
AR,2023-07-31,inter-total,34,6,4,1,3,1,0,1,0,0,11,61,45,51,FALSE,0.836065573770492,2023,2023-2024
AR,2023-07-31,inter-ucfe,0,0,0,0,0,0,0,0,0,0,0,0,0,0,FALSE,0,2023,2023-2024
AR,2023-07-31,inter-ucx,0,0,0,0,0,0,0,0,0,0,0,0,0,0,FALSE,0,2023,2023-2024
AR,2023-07-31,inter-ui,34,6,4,1,3,1,0,1,0,0,11,61,45,51,FALSE,0.836065573770492,2023,2023-2024
AR,2023-07-31,intra-total,1479,157,122,166,213,248,87,36,18,49,438,3013,1917,2074,FALSE,0.688350481247926,2023,2023-2024
AR,2023-07-31,intra-ucfe,2,0,0,0,1,1,0,0,0,1,3,8,5,5,FALSE,0.625,2023,2023-2024
AR,2023-07-31,intra-ucx,0,0,0,0,0,0,0,0,0,2,0,2,0,0,FALSE,0,2023,2023-2024
AR,2023-07-31,intra-ui,1477,157,122,166,212,247,87,36,18,46,435,3003,1912,2069,FALSE,0.688977688977689,2023,2023-2024
AR,2023-08-31,inter-total,35,0,3,3,7,5,1,1,0,2,12,69,47,47,FALSE,0.681159420289855,2023,2023-2024
AR,2023-08-31,inter-ucfe,0,0,0,0,0,0,0,0,0,0,1,1,1,1,FALSE,1,2023,2023-2024
AR,2023-08-31,inter-ucx,0,0,0,0,0,0,0,0,0,0,0,0,0,0,FALSE,0,2023,2023-2024
AR,2023-08-31,inter-ui,35,0,3,3,7,5,1,1,0,2,11,68,46,46,FALSE,0.676470588235294,2023,2023-2024
AR,2023-08-31,intra-total,880,82,78,256,280,148,70,25,16,60,201,2096,1081,1163,FALSE,0.554866412213741,2023,2023-2024
AR,2023-08-31,intra-ucfe,4,2,0,0,2,0,0,0,0,0,1,9,5,7,FALSE,0.777777777777778,2023,2023-2024
AR,2023-08-31,intra-ucx,4,1,0,1,0,0,0,0,0,0,2,8,6,7,FALSE,0.875,2023,2023-2024
AR,2023-08-31,intra-ui,872,79,78,255,278,148,70,25,16,60,198,2079,1070,1149,FALSE,0.552669552669553,2023,2023-2024
AR,2023-09-30,inter-total,20,4,2,0,4,7,0,0,1,0,12,50,32,36,FALSE,0.72,2023,2023-2024
AR,2023-09-30,inter-ucfe,0,0,0,0,0,0,0,0,0,0,1,1,1,1,FALSE,1,2023,2023-2024
AR,2023-09-30,inter-ucx,0,0,0,0,0,0,0,0,0,0,0,0,0,0,FALSE,0,2023,2023-2024
AR,2023-09-30,inter-ui,20,4,2,0,4,7,0,0,1,0,11,49,31,35,FALSE,0.714285714285714,2023,2023-2024
AR,2023-09-30,intra-total,777,36,76,192,244,87,40,16,6,66,171,1711,948,984,FALSE,0.57510227936879,2023,2023-2024
AR,2023-09-30,intra-ucfe,1,0,0,0,1,0,0,1,0,1,1,5,2,2,FALSE,0.4,2023,2023-2024
AR,2023-09-30,intra-ucx,0,1,0,0,1,0,0,0,0,0,1,3,1,2,FALSE,0.666666666666667,2023,2023-2024
AR,2023-09-30,intra-ui,776,35,76,192,242,87,40,15,6,65,169,1703,945,980,FALSE,0.575455079271873,2023,2023-2024
AR,2023-10-31,inter-total,30,3,0,1,3,2,0,0,1,0,6,46,36,39,FALSE,0.847826086956522,2023,2023-2024
AR,2023-10-31,inter-ucfe,0,0,0,0,0,0,0,0,0,0,1,1,1,1,FALSE,1,2023,2023-2024
AR,2023-10-31,inter-ucx,0,0,0,0,0,0,0,0,0,0,0,0,0,0,FALSE,0,2023,2023-2024
AR,2023-10-31,inter-ui,30,3,0,1,3,2,0,0,1,0,5,45,35,38,FALSE,0.844444444444445,2023,2023-2024
AR,2023-10-31,intra-total,928,37,25,32,158,202,75,19,8,45,170,1699,1098,1135,FALSE,0.668040023543261,2023,2023-2024
AR,2023-10-31,intra-ucfe,1,0,0,0,0,0,0,0,0,0,3,4,4,4,FALSE,1,2023,2023-2024
AR,2023-10-31,intra-ucx,2,0,0,0,1,0,0,0,0,0,1,4,3,3,FALSE,0.75,2023,2023-2024
AR,2023-10-31,intra-ui,925,37,25,32,157,202,75,19,8,45,166,1691,1091,1128,FALSE,0.667060910703726,2023,2023-2024
AR,2023-11-30,inter-total,32,2,2,3,1,3,1,1,1,2,10,58,42,44,FALSE,0.758620689655172,2023,2023-2024
AR,2023-11-30,inter-ucfe,0,1,0,0,0,0,0,0,0,0,0,1,0,1,FALSE,1,2023,2023-2024
AR,2023-11-30,inter-ucx,0,0,0,0,0,0,0,0,0,0,0,0,0,0,FALSE,0,2023,2023-2024
AR,2023-11-30,inter-ui,32,1,2,3,1,3,1,1,1,2,10,57,42,43,FALSE,0.754385964912281,2023,2023-2024
AR,2023-11-30,intra-total,927,43,27,32,42,182,217,60,18,62,153,1763,1080,1123,FALSE,0.636982416335791,2023,2023-2024
AR,2023-11-30,intra-ucfe,5,1,1,0,0,0,0,0,0,1,1,9,6,7,FALSE,0.777777777777778,2023,2023-2024
AR,2023-11-30,intra-ucx,4,0,1,0,0,0,0,0,0,0,1,6,5,5,FALSE,0.833333333333333,2023,2023-2024
AR,2023-11-30,intra-ui,918,42,25,32,42,182,217,60,18,61,151,1748,1069,1111,FALSE,0.63558352402746,2023,2023-2024
AR,2023-12-31,inter-total,31,1,5,2,2,3,0,2,0,2,16,64,47,48,FALSE,0.75,2023,2023-2024
AR,2023-12-31,inter-ucfe,0,0,0,0,0,0,0,0,0,0,0,0,0,0,FALSE,0,2023,2023-2024
AR,2023-12-31,inter-ucx,0,0,0,0,0,0,0,0,0,0,0,0,0,0,FALSE,0,2023,2023-2024
AR,2023-12-31,inter-ui,31,1,5,2,2,3,0,2,0,2,16,64,47,48,FALSE,0.75,2023,2023-2024
AR,2023-12-31,intra-total,1532,67,51,43,56,67,245,98,37,63,287,2546,1819,1886,FALSE,0.74076983503535,2023,2023-2024
AR,2023-12-31,intra-ucfe,7,0,0,0,0,0,0,0,0,0,1,8,8,8,FALSE,1,2023,2023-2024
AR,2023-12-31,intra-ucx,2,0,0,1,0,0,1,0,0,0,1,5,3,3,FALSE,0.6,2023,2023-2024
AR,2023-12-31,intra-ui,1523,67,51,42,56,67,244,98,37,63,285,2533,1808,1875,FALSE,0.740228977497039,2023,2023-2024
AR,2024-01-31,inter-total,21,6,3,2,4,2,1,3,3,0,14,59,35,41,FALSE,0.694915254237288,2023,2023-2024
AR,2024-01-31,inter-ucfe,0,0,0,0,0,0,0,0,0,0,0,0,0,0,FALSE,0,2023,2023-2024
AR,2024-01-31,inter-ucx,0,0,0,0,0,0,0,0,0,0,0,0,0,0,FALSE,0,2023,2023-2024
AR,2024-01-31,inter-ui,21,6,3,2,4,2,1,3,3,0,14,59,35,41,FALSE,0.694915254237288,2023,2023-2024
AR,2024-01-31,intra-total,1499,81,53,47,38,40,56,195,192,132,556,2889,2055,2136,FALSE,0.739356178608515,2023,2023-2024
AR,2024-01-31,intra-ucfe,3,0,0,0,0,0,0,0,0,0,3,6,6,6,FALSE,1,2023,2023-2024
AR,2024-01-31,intra-ucx,0,0,0,0,0,0,0,0,0,0,0,0,0,0,FALSE,0,2023,2023-2024
AR,2024-01-31,intra-ui,1496,81,53,47,38,40,56,195,192,132,553,2883,2049,2130,FALSE,0.738813735691988,2023,2023-2024
AR,2024-02-29,inter-total,25,9,3,3,3,2,2,2,4,5,12,70,37,46,FALSE,0.657142857142857,2023,2023-2024
AR,2024-02-29,inter-ucfe,0,0,0,0,0,0,0,0,0,0,0,0,0,0,FALSE,0,2023,2023-2024
AR,2024-02-29,inter-ucx,0,0,0,0,0,0,0,0,0,0,0,0,0,0,FALSE,0,2023,2023-2024
AR,2024-02-29,inter-ui,25,9,3,3,3,2,2,2,4,5,12,70,37,46,FALSE,0.657142857142857,2023,2023-2024
AR,2024-02-29,intra-total,851,64,40,27,29,28,108,231,156,189,354,2077,1205,1269,FALSE,0.610977371208474,2023,2023-2024
AR,2024-02-29,intra-ucfe,1,1,1,0,0,0,0,0,1,0,1,5,2,3,FALSE,0.6,2023,2023-2024
AR,2024-02-29,intra-ucx,1,0,0,1,0,0,0,0,0,0,0,2,1,1,FALSE,0.5,2023,2023-2024
AR,2024-02-29,intra-ui,849,63,39,26,29,28,108,231,155,189,353,2070,1202,1265,FALSE,0.611111111111111,2023,2023-2024
AR,2024-03-31,inter-total,20,3,7,2,4,1,1,1,1,1,3,44,23,26,FALSE,0.590909090909091,2023,2023-2024
AR,2024-03-31,inter-ucfe,0,0,0,0,0,0,0,0,0,0,0,0,0,0,FALSE,0,2023,2023-2024
AR,2024-03-31,inter-ucx,0,0,0,0,0,0,0,0,0,0,0,0,0,0,FALSE,0,2023,2023-2024
AR,2024-03-31,inter-ui,20,3,7,2,4,1,1,1,1,1,3,44,23,26,FALSE,0.590909090909091,2023,2023-2024
AR,2024-03-31,intra-total,730,48,34,35,67,229,254,129,46,107,177,1856,907,955,FALSE,0.514547413793103,2023,2023-2024
AR,2024-03-31,intra-ucfe,8,1,1,0,0,1,0,0,0,0,2,13,10,11,FALSE,0.846153846153846,2023,2023-2024
AR,2024-03-31,intra-ucx,1,0,0,0,0,0,0,0,0,0,3,4,4,4,FALSE,1,2023,2023-2024
AR,2024-03-31,intra-ui,721,47,33,35,67,228,254,129,46,107,172,1839,893,940,FALSE,0.511147362697118,2023,2023-2024
AR,2024-04-30,inter-total,23,8,6,6,5,3,0,0,0,4,5,60,28,36,FALSE,0.6,2023,2023-2024
AR,2024-04-30,inter-ucfe,0,0,0,0,0,0,0,0,0,0,0,0,0,0,FALSE,0,2023,2023-2024
AR,2024-04-30,inter-ucx,1,0,0,0,0,0,0,0,0,0,0,1,1,1,FALSE,1,2023,2023-2024
AR,2024-04-30,inter-ui,22,8,6,6,5,3,0,0,0,4,5,59,27,35,FALSE,0.593220338983051,2023,2023-2024
AR,2024-04-30,intra-total,721,37,48,99,248,271,124,42,18,67,140,1815,861,898,FALSE,0.494765840220386,2023,2023-2024
AR,2024-04-30,intra-ucfe,1,0,1,0,0,0,0,0,0,0,0,2,1,1,FALSE,0.5,2023,2023-2024
AR,2024-04-30,intra-ucx,1,0,0,0,0,0,0,0,0,0,2,3,3,3,FALSE,1,2023,2023-2024
AR,2024-04-30,intra-ui,719,37,47,99,248,271,124,42,18,67,138,1810,857,894,FALSE,0.493922651933702,2023,2023-2024
AR,2024-05-31,inter-total,18,6,8,2,0,1,0,1,0,3,9,48,27,33,FALSE,0.6875,2023,2023-2024
AR,2024-05-31,inter-ucfe,0,0,0,0,0,0,0,0,0,0,0,0,0,0,FALSE,0,2023,2023-2024
AR,2024-05-31,inter-ucx,0,0,0,0,0,0,0,0,0,0,0,0,0,0,FALSE,0,2023,2023-2024
AR,2024-05-31,inter-ui,18,6,8,2,0,1,0,1,0,3,9,48,27,33,FALSE,0.6875,2023,2023-2024
AR,2024-05-31,intra-total,896,141,385,287,99,54,11,15,4,76,175,2143,1071,1212,FALSE,0.565562295846944,2023,2023-2024
AR,2024-05-31,intra-ucfe,4,0,0,0,1,0,0,0,0,0,1,6,5,5,FALSE,0.833333333333333,2023,2023-2024
AR,2024-05-31,intra-ucx,1,0,0,0,0,0,0,0,0,0,0,1,1,1,FALSE,1,2023,2023-2024
AR,2024-05-31,intra-ui,891,141,385,287,98,54,11,15,4,76,174,2136,1065,1206,FALSE,0.564606741573034,2023,2023-2024
AR,2024-06-30,inter-total,18,7,3,0,0,1,0,0,0,3,23,55,41,48,FALSE,0.872727272727273,2023,2023-2024
AR,2024-06-30,inter-ucfe,0,0,0,0,0,0,0,0,0,0,0,0,0,0,FALSE,0,2023,2023-2024
AR,2024-06-30,inter-ucx,0,0,0,0,0,0,0,0,0,0,0,0,0,0,FALSE,0,2023,2023-2024
AR,2024-06-30,inter-ui,18,7,3,0,0,1,0,0,0,3,23,55,41,48,FALSE,0.872727272727273,2023,2023-2024
AR,2024-06-30,intra-total,1363,312,178,56,25,9,6,5,11,53,738,2756,2101,2413,FALSE,0.875544267053701,2023,2023-2024
AR,2024-06-30,intra-ucfe,1,0,0,0,0,0,0,0,0,0,0,1,1,1,FALSE,1,2023,2023-2024
AR,2024-06-30,intra-ucx,1,0,0,0,0,0,0,0,0,0,1,2,2,2,FALSE,1,2023,2023-2024
AR,2024-06-30,intra-ui,1361,312,178,56,25,9,6,5,11,53,737,2753,2098,2410,FALSE,0.875408645114421,2023,2023-2024
AR,2024-07-31,inter-total,24,13,7,3,1,0,0,1,1,1,14,65,38,51,FALSE,0.784615384615385,2024,2024-2025
AR,2024-07-31,inter-ucfe,0,0,0,0,0,0,0,0,0,0,0,0,0,0,FALSE,0,2024,2024-2025
AR,2024-07-31,inter-ucx,0,0,0,0,0,0,0,0,0,0,0,0,0,0,FALSE,0,2024,2024-2025
AR,2024-07-31,inter-ui,24,13,7,3,1,0,0,1,1,1,14,65,38,51,FALSE,0.784615384615385,2024,2024-2025
AR,2024-07-31,intra-total,1295,313,117,44,10,3,4,13,14,57,485,2355,1780,2093,FALSE,0.888747346072187,2024,2024-2025
AR,2024-07-31,intra-ucfe,1,0,0,0,0,0,0,0,0,0,0,1,1,1,FALSE,1,2024,2024-2025
AR,2024-07-31,intra-ucx,3,1,0,0,0,0,0,0,0,0,0,4,3,4,FALSE,1,2024,2024-2025
AR,2024-07-31,intra-ui,1291,312,117,44,10,3,4,13,14,57,485,2350,1776,2088,FALSE,0.888510638297872,2024,2024-2025
AR,2024-08-31,inter-total,23,5,4,1,0,0,1,0,0,1,21,56,44,49,FALSE,0.875,2024,2024-2025
AR,2024-08-31,inter-ucfe,0,0,0,0,0,0,0,0,0,0,0,0,0,0,FALSE,0,2024,2024-2025
AR,2024-08-31,inter-ucx,0,0,0,0,0,0,0,0,0,0,0,0,0,0,FALSE,0,2024,2024-2025
AR,2024-08-31,inter-ui,23,5,4,1,0,0,1,0,0,1,21,56,44,49,FALSE,0.875,2024,2024-2025
AR,2024-08-31,intra-total,886,277,216,69,24,13,13,15,13,32,250,1808,1136,1413,FALSE,0.781526548672566,2024,2024-2025
AR,2024-08-31,intra-ucfe,3,0,0,0,0,0,0,0,0,0,4,7,7,7,FALSE,1,2024,2024-2025
AR,2024-08-31,intra-ucx,0,0,0,0,0,0,0,0,0,0,1,1,1,1,FALSE,1,2024,2024-2025
AR,2024-08-31,intra-ui,883,277,216,69,24,13,13,15,13,32,245,1800,1128,1405,FALSE,0.780555555555556,2024,2024-2025
AR,2024-09-30,inter-total,33,9,6,5,0,2,1,1,0,0,20,77,53,62,FALSE,0.805194805194805,2024,2024-2025
AR,2024-09-30,inter-ucfe,1,0,0,0,0,0,0,0,0,0,0,1,1,1,FALSE,1,2024,2024-2025
AR,2024-09-30,inter-ucx,0,0,0,0,0,0,0,0,0,0,0,0,0,0,FALSE,0,2024,2024-2025
AR,2024-09-30,inter-ui,32,9,6,5,0,2,1,1,0,0,20,76,52,61,FALSE,0.802631578947369,2024,2024-2025
AR,2024-09-30,intra-total,792,90,293,234,49,20,15,10,8,33,218,1762,1010,1100,FALSE,0.624290578887628,2024,2024-2025
AR,2024-09-30,intra-ucfe,4,0,0,0,0,0,0,0,0,0,0,4,4,4,FALSE,1,2024,2024-2025
AR,2024-09-30,intra-ucx,2,1,0,1,0,0,0,0,0,0,1,5,3,4,FALSE,0.8,2024,2024-2025
AR,2024-09-30,intra-ui,786,89,293,233,49,20,15,10,8,33,217,1753,1003,1092,FALSE,0.622932116371934,2024,2024-2025
AR,2024-10-31,inter-total,29,8,4,1,1,0,0,0,0,1,14,58,43,51,FALSE,0.879310344827586,2024,2024-2025
AR,2024-10-31,inter-ucfe,0,0,0,0,0,0,0,0,0,0,0,0,0,0,FALSE,0,2024,2024-2025
AR,2024-10-31,inter-ucx,0,0,0,0,0,0,0,0,0,0,0,0,0,0,FALSE,0,2024,2024-2025
AR,2024-10-31,inter-ui,29,8,4,1,1,0,0,0,0,1,14,58,43,51,FALSE,0.879310344827586,2024,2024-2025
AR,2024-10-31,intra-total,937,261,198,65,36,15,10,7,8,36,173,1746,1110,1371,FALSE,0.785223367697595,2024,2024-2025
AR,2024-10-31,intra-ucfe,4,0,0,0,0,0,0,0,0,0,1,5,5,5,FALSE,1,2024,2024-2025
AR,2024-10-31,intra-ucx,1,1,0,0,0,0,0,0,0,0,0,2,1,2,FALSE,1,2024,2024-2025
AR,2024-10-31,intra-ui,932,260,198,65,36,15,10,7,8,36,172,1739,1104,1364,FALSE,0.784358826912018,2024,2024-2025
AR,2024-11-30,inter-total,41,2,2,1,1,0,0,0,0,0,10,57,51,53,FALSE,0.929824561403509,2024,2024-2025
AR,2024-11-30,inter-ucfe,0,0,0,0,0,0,0,0,0,0,0,0,0,0,FALSE,0,2024,2024-2025
AR,2024-11-30,inter-ucx,0,0,0,0,0,0,0,0,0,0,0,0,0,0,FALSE,0,2024,2024-2025
AR,2024-11-30,inter-ui,41,2,2,1,1,0,0,0,0,0,10,57,51,53,FALSE,0.929824561403509,2024,2024-2025
AR,2024-11-30,intra-total,808,80,251,130,32,12,2,8,15,32,127,1497,935,1015,FALSE,0.678022712090848,2024,2024-2025
AR,2024-11-30,intra-ucfe,2,0,0,0,0,0,0,0,1,0,0,3,2,2,FALSE,0.666666666666667,2024,2024-2025
AR,2024-11-30,intra-ucx,3,0,0,0,0,0,0,0,0,0,0,3,3,3,FALSE,1,2024,2024-2025
AR,2024-11-30,intra-ui,803,80,251,130,32,12,2,8,14,32,127,1491,930,1010,FALSE,0.677397719651241,2024,2024-2025
AR,2024-12-31,inter-total,40,11,3,3,2,0,0,0,0,1,16,76,56,67,FALSE,0.881578947368421,2024,2024-2025
AR,2024-12-31,inter-ucfe,0,0,0,0,1,0,0,0,0,0,0,1,0,0,FALSE,0,2024,2024-2025
AR,2024-12-31,inter-ucx,0,0,0,0,0,0,0,0,0,0,0,0,0,0,FALSE,0,2024,2024-2025
AR,2024-12-31,inter-ui,40,11,3,3,1,0,0,0,0,1,16,75,56,67,FALSE,0.893333333333333,2024,2024-2025
AR,2024-12-31,intra-total,1445,67,68,193,119,35,14,7,7,39,241,2235,1686,1753,FALSE,0.784340044742729,2024,2024-2025
AR,2024-12-31,intra-ucfe,3,0,2,0,0,0,1,0,0,1,2,9,5,5,FALSE,0.555555555555556,2024,2024-2025
AR,2024-12-31,intra-ucx,0,0,0,0,0,0,0,0,0,0,1,1,1,1,FALSE,1,2024,2024-2025
AR,2024-12-31,intra-ui,1442,67,66,193,119,35,13,7,7,38,238,2225,1680,1747,FALSE,0.785168539325843,2024,2024-2025
AZ,2019-01-31,inter-total,73,5,4,5,3,2,4,0,0,6,25,127,98,103,FALSE,0.811023622047244,2018,2018-2019
AZ,2019-01-31,inter-ucfe,8,0,1,3,1,0,1,0,0,1,3,18,11,11,FALSE,0.611111111111111,2018,2018-2019
AZ,2019-01-31,inter-ucx,0,0,0,0,0,0,0,0,0,0,0,0,0,0,FALSE,0,2018,2018-2019
AZ,2019-01-31,inter-ui,65,5,3,2,2,2,3,0,0,5,22,109,87,92,FALSE,0.844036697247707,2018,2018-2019
AZ,2019-01-31,intra-total,1705,199,126,58,32,37,20,20,9,77,967,3250,2672,2871,FALSE,0.883384615384616,2018,2018-2019
AZ,2019-01-31,intra-ucfe,173,19,3,2,1,1,1,0,2,3,33,238,206,225,FALSE,0.945378151260504,2018,2018-2019
AZ,2019-01-31,intra-ucx,2,0,0,0,0,1,0,0,0,0,4,7,6,6,FALSE,0.857142857142857,2018,2018-2019
AZ,2019-01-31,intra-ui,1530,180,123,56,31,35,19,20,7,74,930,3005,2460,2640,FALSE,0.878535773710483,2018,2018-2019
AZ,2019-02-28,inter-total,48,7,2,2,0,2,1,0,3,3,32,100,80,87,FALSE,0.87,2018,2018-2019
AZ,2019-02-28,inter-ucfe,4,0,1,0,0,0,0,0,0,2,1,8,5,5,FALSE,0.625,2018,2018-2019
AZ,2019-02-28,inter-ucx,0,0,0,0,0,0,0,0,0,0,0,0,0,0,FALSE,0,2018,2018-2019
AZ,2019-02-28,inter-ui,44,7,1,2,0,2,1,0,3,1,31,92,75,82,FALSE,0.891304347826087,2018,2018-2019
AZ,2019-02-28,intra-total,1593,240,110,54,38,33,39,28,7,68,1014,3224,2607,2847,FALSE,0.883064516129032,2018,2018-2019
AZ,2019-02-28,intra-ucfe,11,7,3,2,2,0,2,0,0,1,7,35,18,25,FALSE,0.714285714285714,2018,2018-2019
AZ,2019-02-28,intra-ucx,3,2,0,0,0,0,0,0,0,1,1,7,4,6,FALSE,0.857142857142857,2018,2018-2019
AZ,2019-02-28,intra-ui,1579,231,107,52,36,33,37,28,7,66,1006,3182,2585,2816,FALSE,0.884978001257071,2018,2018-2019
AZ,2019-03-31,inter-total,41,3,2,2,1,2,1,1,1,0,27,81,68,71,FALSE,0.876543209876543,2018,2018-2019
AZ,2019-03-31,inter-ucfe,0,0,0,0,0,0,0,0,0,0,0,0,0,0,FALSE,0,2018,2018-2019
AZ,2019-03-31,inter-ucx,0,0,0,0,0,0,0,0,0,0,0,0,0,0,FALSE,0,2018,2018-2019
AZ,2019-03-31,inter-ui,41,3,2,2,1,2,1,1,1,0,27,81,68,71,FALSE,0.876543209876543,2018,2018-2019
AZ,2019-03-31,intra-total,1357,161,98,57,41,42,35,17,6,54,886,2754,2243,2404,FALSE,0.872912127814089,2018,2018-2019
AZ,2019-03-31,intra-ucfe,9,5,2,2,1,1,3,1,0,2,2,28,11,16,FALSE,0.571428571428571,2018,2018-2019
AZ,2019-03-31,intra-ucx,3,1,0,0,0,0,0,0,0,0,0,4,3,4,FALSE,1,2018,2018-2019
AZ,2019-03-31,intra-ui,1345,155,96,55,40,41,32,16,6,52,884,2722,2229,2384,FALSE,0.87582659808964,2018,2018-2019
AZ,2019-04-30,inter-total,63,2,2,0,1,2,4,1,1,5,30,111,93,95,FALSE,0.855855855855856,2018,2018-2019
AZ,2019-04-30,inter-ucfe,1,0,1,0,0,0,0,0,0,0,0,2,1,1,FALSE,0.5,2018,2018-2019
AZ,2019-04-30,inter-ucx,0,0,0,0,0,0,0,0,0,0,1,1,1,1,FALSE,1,2018,2018-2019
AZ,2019-04-30,inter-ui,62,2,1,0,1,2,4,1,1,5,29,108,91,93,FALSE,0.861111111111111,2018,2018-2019
AZ,2019-04-30,intra-total,3570,154,69,42,34,37,30,13,13,80,1113,5155,4683,4837,FALSE,0.93831231813773,2018,2018-2019
AZ,2019-04-30,intra-ucfe,4,1,0,0,1,2,0,0,0,2,1,11,5,6,FALSE,0.545454545454545,2018,2018-2019
AZ,2019-04-30,intra-ucx,3,2,0,0,0,0,0,0,0,1,3,9,6,8,FALSE,0.888888888888889,2018,2018-2019
AZ,2019-04-30,intra-ui,3563,151,69,42,33,35,30,13,13,77,1109,5135,4672,4823,FALSE,0.939240506329114,2018,2018-2019
AZ,2019-05-31,inter-total,70,5,1,1,1,0,2,0,1,3,34,118,104,109,FALSE,0.923728813559322,2018,2018-2019
AZ,2019-05-31,inter-ucfe,2,0,0,0,0,0,0,0,0,0,0,2,2,2,FALSE,1,2018,2018-2019
AZ,2019-05-31,inter-ucx,0,0,0,0,0,0,0,0,0,0,0,0,0,0,FALSE,0,2018,2018-2019
AZ,2019-05-31,inter-ui,68,5,1,1,1,0,2,0,1,3,34,116,102,107,FALSE,0.922413793103448,2018,2018-2019
AZ,2019-05-31,intra-total,3058,256,113,57,31,24,16,15,11,74,1265,4920,4323,4579,FALSE,0.930691056910569,2018,2018-2019
AZ,2019-05-31,intra-ucfe,2,1,1,0,0,0,0,0,1,1,2,8,4,5,FALSE,0.625,2018,2018-2019
AZ,2019-05-31,intra-ucx,3,2,0,0,0,0,0,0,0,0,1,6,4,6,FALSE,1,2018,2018-2019
AZ,2019-05-31,intra-ui,3053,253,112,57,31,24,16,15,10,73,1262,4906,4315,4568,FALSE,0.931104769669792,2018,2018-2019
AZ,2019-06-30,inter-total,58,8,4,2,0,3,2,2,1,3,23,106,81,89,FALSE,0.839622641509434,2018,2018-2019
AZ,2019-06-30,inter-ucfe,3,0,0,0,0,0,0,0,0,1,1,5,4,4,FALSE,0.8,2018,2018-2019
AZ,2019-06-30,inter-ucx,0,1,1,0,0,0,0,0,0,0,1,3,1,2,FALSE,0.666666666666667,2018,2018-2019
AZ,2019-06-30,inter-ui,55,7,3,2,0,3,2,2,1,2,21,98,76,83,FALSE,0.846938775510204,2018,2018-2019
AZ,2019-06-30,intra-total,2262,214,114,57,37,33,22,27,16,71,1075,3928,3337,3551,FALSE,0.904022403258656,2018,2018-2019
AZ,2019-06-30,intra-ucfe,37,3,0,0,0,0,1,1,0,1,15,58,52,55,FALSE,0.948275862068965,2018,2018-2019
AZ,2019-06-30,intra-ucx,2,2,1,0,1,0,0,0,0,0,4,10,6,8,FALSE,0.8,2018,2018-2019
AZ,2019-06-30,intra-ui,2223,209,113,57,36,33,21,26,16,70,1056,3860,3279,3488,FALSE,0.903626943005181,2018,2018-2019
AZ,2019-07-31,inter-total,82,14,6,3,3,2,0,2,1,1,41,155,123,137,FALSE,0.883870967741936,2019,2019-2020
AZ,2019-07-31,inter-ucfe,1,0,0,0,0,0,0,0,0,0,2,3,3,3,FALSE,1,2019,2019-2020
AZ,2019-07-31,inter-ucx,0,0,0,0,0,0,0,0,0,0,0,0,0,0,FALSE,0,2019,2019-2020
AZ,2019-07-31,inter-ui,81,14,6,3,3,2,0,2,1,1,39,152,120,134,FALSE,0.881578947368421,2019,2019-2020
AZ,2019-07-31,intra-total,4335,393,212,101,47,28,26,15,26,82,1204,6469,5539,5932,FALSE,0.916988715411965,2019,2019-2020
AZ,2019-07-31,intra-ucfe,74,5,3,2,2,3,1,0,0,3,30,123,104,109,FALSE,0.886178861788618,2019,2019-2020
AZ,2019-07-31,intra-ucx,6,2,0,2,0,0,0,0,0,0,2,12,8,10,FALSE,0.833333333333333,2019,2019-2020
AZ,2019-07-31,intra-ui,4255,386,209,97,45,25,25,15,26,79,1172,6334,5427,5813,FALSE,0.917745500473634,2019,2019-2020
AZ,2019-08-31,inter-total,62,13,7,1,2,1,2,1,1,3,29,122,91,104,FALSE,0.852459016393443,2019,2019-2020
AZ,2019-08-31,inter-ucfe,0,2,2,0,0,0,0,0,0,0,0,4,0,2,FALSE,0.5,2019,2019-2020
AZ,2019-08-31,inter-ucx,0,0,0,0,0,0,0,0,0,0,0,0,0,0,FALSE,0,2019,2019-2020
AZ,2019-08-31,inter-ui,62,11,5,1,2,1,2,1,1,3,29,118,91,102,FALSE,0.864406779661017,2019,2019-2020
AZ,2019-08-31,intra-total,2106,295,147,88,62,25,45,46,16,85,1117,4032,3223,3518,FALSE,0.872519841269841,2019,2019-2020
AZ,2019-08-31,intra-ucfe,3,5,1,2,1,1,1,0,0,0,3,17,6,11,FALSE,0.647058823529412,2019,2019-2020
AZ,2019-08-31,intra-ucx,3,0,2,0,0,0,0,0,0,1,3,9,6,6,FALSE,0.666666666666667,2019,2019-2020
AZ,2019-08-31,intra-ui,2100,290,144,86,61,24,44,46,16,84,1111,4006,3211,3501,FALSE,0.873939091362956,2019,2019-2020
AZ,2019-09-30,inter-total,36,7,3,3,2,1,1,1,2,3,37,96,73,80,FALSE,0.833333333333333,2019,2019-2020
AZ,2019-09-30,inter-ucfe,0,0,0,0,0,0,0,0,0,0,0,0,0,0,FALSE,0,2019,2019-2020
AZ,2019-09-30,inter-ucx,0,0,0,0,0,0,0,0,0,0,0,0,0,0,FALSE,0,2019,2019-2020
AZ,2019-09-30,inter-ui,36,7,3,3,2,1,1,1,2,3,37,96,73,80,FALSE,0.833333333333333,2019,2019-2020
AZ,2019-09-30,intra-total,1415,205,114,61,44,25,38,16,14,55,1058,3045,2473,2678,FALSE,0.879474548440066,2019,2019-2020
AZ,2019-09-30,intra-ucfe,1,2,1,0,0,0,0,0,0,0,0,4,1,3,FALSE,0.75,2019,2019-2020
AZ,2019-09-30,intra-ucx,2,1,0,1,0,0,0,0,0,0,2,6,4,5,FALSE,0.833333333333333,2019,2019-2020
AZ,2019-09-30,intra-ui,1412,202,113,60,44,25,38,16,14,55,1056,3035,2468,2670,FALSE,0.879736408566722,2019,2019-2020
AZ,2019-10-31,inter-total,59,3,1,2,2,4,2,0,1,3,29,106,88,91,FALSE,0.858490566037736,2019,2019-2020
AZ,2019-10-31,inter-ucfe,4,0,0,0,0,0,0,0,0,0,1,5,5,5,FALSE,1,2019,2019-2020
AZ,2019-10-31,inter-ucx,0,0,0,0,0,0,0,0,0,0,0,0,0,0,FALSE,0,2019,2019-2020
AZ,2019-10-31,inter-ui,55,3,1,2,2,4,2,0,1,3,28,101,83,86,FALSE,0.851485148514852,2019,2019-2020
AZ,2019-10-31,intra-total,1461,168,82,53,28,25,37,21,9,64,1091,3039,2552,2720,FALSE,0.895031260282988,2019,2019-2020
AZ,2019-10-31,intra-ucfe,13,1,2,0,0,0,0,0,0,0,2,18,15,16,FALSE,0.888888888888889,2019,2019-2020
AZ,2019-10-31,intra-ucx,7,1,0,0,0,0,0,1,0,0,2,11,9,10,FALSE,0.909090909090909,2019,2019-2020
AZ,2019-10-31,intra-ui,1441,166,80,53,28,25,37,20,9,64,1087,3010,2528,2694,FALSE,0.895016611295681,2019,2019-2020
AZ,2019-11-30,inter-total,51,8,3,3,1,0,2,1,2,4,21,96,72,80,FALSE,0.833333333333333,2019,2019-2020
AZ,2019-11-30,inter-ucfe,1,0,1,0,0,0,0,0,0,0,3,5,4,4,FALSE,0.8,2019,2019-2020
AZ,2019-11-30,inter-ucx,0,0,0,0,0,0,0,0,0,0,0,0,0,0,FALSE,0,2019,2019-2020
AZ,2019-11-30,inter-ui,50,8,2,3,1,0,2,1,2,4,18,91,68,76,FALSE,0.835164835164835,2019,2019-2020
AZ,2019-11-30,intra-total,1278,144,77,43,20,17,9,20,14,62,927,2611,2205,2349,FALSE,0.899655304481042,2019,2019-2020
AZ,2019-11-30,intra-ucfe,8,0,1,0,2,2,0,0,0,0,7,20,15,15,FALSE,0.75,2019,2019-2020
AZ,2019-11-30,intra-ucx,2,0,0,0,0,0,0,0,0,0,0,2,2,2,FALSE,1,2019,2019-2020
AZ,2019-11-30,intra-ui,1268,144,76,43,18,15,9,20,14,62,920,2589,2188,2332,FALSE,0.900733874082657,2019,2019-2020
AZ,2019-12-31,inter-total,72,5,6,0,1,1,4,2,2,4,35,132,107,112,FALSE,0.848484848484848,2019,2019-2020
AZ,2019-12-31,inter-ucfe,3,1,0,0,0,0,0,0,0,0,4,8,7,8,FALSE,1,2019,2019-2020
AZ,2019-12-31,inter-ucx,0,0,0,0,0,0,0,0,0,0,0,0,0,0,FALSE,0,2019,2019-2020
AZ,2019-12-31,inter-ui,69,4,6,0,1,1,4,2,2,4,31,124,100,104,FALSE,0.838709677419355,2019,2019-2020
AZ,2019-12-31,intra-total,1332,150,76,52,23,24,44,10,9,72,998,2790,2330,2480,FALSE,0.888888888888889,2019,2019-2020
AZ,2019-12-31,intra-ucfe,16,3,2,3,1,1,0,0,0,0,7,33,23,26,FALSE,0.787878787878788,2019,2019-2020
AZ,2019-12-31,intra-ucx,0,0,1,0,0,0,0,0,0,1,0,2,0,0,FALSE,0,2019,2019-2020
AZ,2019-12-31,intra-ui,1316,147,73,49,22,23,44,10,9,71,991,2755,2307,2454,FALSE,0.890744101633394,2019,2019-2020
AZ,2020-01-31,inter-total,63,8,2,2,0,1,2,3,1,2,22,106,85,93,FALSE,0.877358490566038,2019,2019-2020
AZ,2020-01-31,inter-ucfe,5,0,1,1,0,1,0,0,0,0,2,10,7,7,FALSE,0.7,2019,2019-2020
AZ,2020-01-31,inter-ucx,0,0,0,0,0,0,0,0,0,0,0,0,0,0,FALSE,0,2019,2019-2020
AZ,2020-01-31,inter-ui,58,8,1,1,0,0,2,3,1,2,20,96,78,86,FALSE,0.895833333333333,2019,2019-2020
AZ,2020-01-31,intra-total,1590,143,81,41,27,28,25,16,8,61,967,2987,2557,2700,FALSE,0.903916973552059,2019,2019-2020
AZ,2020-01-31,intra-ucfe,23,2,4,1,1,0,1,0,1,1,13,47,36,38,FALSE,0.808510638297872,2019,2019-2020
AZ,2020-01-31,intra-ucx,3,1,0,0,0,1,0,0,0,0,1,6,4,5,FALSE,0.833333333333333,2019,2019-2020
AZ,2020-01-31,intra-ui,1564,140,77,40,26,27,24,16,7,60,953,2934,2517,2657,FALSE,0.905589638718473,2019,2019-2020
AZ,2020-02-29,inter-total,41,5,3,3,2,1,3,0,0,2,21,81,62,67,FALSE,0.82716049382716,2019,2019-2020
AZ,2020-02-29,inter-ucfe,6,0,0,0,2,0,0,0,0,0,0,8,6,6,FALSE,0.75,2019,2019-2020
AZ,2020-02-29,inter-ucx,0,0,0,0,0,0,0,0,0,0,0,0,0,0,FALSE,0,2019,2019-2020
AZ,2020-02-29,inter-ui,35,5,3,3,0,1,3,0,0,2,21,73,56,61,FALSE,0.835616438356164,2019,2019-2020
AZ,2020-02-29,intra-total,1394,212,99,60,44,24,24,19,6,68,940,2890,2334,2546,FALSE,0.880968858131488,2019,2019-2020
AZ,2020-02-29,intra-ucfe,13,2,0,1,0,1,2,0,1,2,7,29,20,22,FALSE,0.758620689655172,2019,2019-2020
AZ,2020-02-29,intra-ucx,3,0,1,0,0,0,0,0,0,0,5,9,8,8,FALSE,0.888888888888889,2019,2019-2020
AZ,2020-02-29,intra-ui,1378,210,98,59,44,23,22,19,5,66,928,2852,2306,2516,FALSE,0.88218793828892,2019,2019-2020
AZ,2020-03-31,inter-total,94,7,2,1,1,0,2,0,1,4,35,147,129,136,FALSE,0.925170068027211,2019,2019-2020
AZ,2020-03-31,inter-ucfe,3,0,0,0,0,0,0,0,0,0,0,3,3,3,FALSE,1,2019,2019-2020
AZ,2020-03-31,inter-ucx,0,0,0,0,0,0,0,0,0,0,0,0,0,0,FALSE,0,2019,2019-2020
AZ,2020-03-31,inter-ui,91,7,2,1,1,0,2,0,1,4,35,144,126,133,FALSE,0.923611111111111,2019,2019-2020
AZ,2020-03-31,intra-total,5062,153,85,51,48,47,23,15,15,99,1108,6706,6170,6323,FALSE,0.942886966895318,2019,2019-2020
AZ,2020-03-31,intra-ucfe,5,1,3,0,0,0,0,0,1,1,6,17,11,12,FALSE,0.705882352941177,2019,2019-2020
AZ,2020-03-31,intra-ucx,4,1,0,0,0,0,0,0,0,1,4,10,8,9,FALSE,0.9,2019,2019-2020
AZ,2020-03-31,intra-ui,5053,151,82,51,48,47,23,15,14,97,1098,6679,6151,6302,FALSE,0.943554424315017,2019,2019-2020
AZ,2020-04-30,inter-total,1170,148,52,16,6,2,3,1,1,2,517,1918,1687,1835,FALSE,0.956725755995829,2019,2019-2020
AZ,2020-04-30,inter-ucfe,2,1,0,0,0,1,0,0,0,0,1,5,3,4,FALSE,0.8,2019,2019-2020
AZ,2020-04-30,inter-ucx,0,0,1,0,0,0,0,0,0,0,1,2,1,1,FALSE,0.5,2019,2019-2020
AZ,2020-04-30,inter-ui,1168,147,51,16,6,1,3,1,1,2,515,1911,1683,1830,FALSE,0.957613814756672,2019,2019-2020
AZ,2020-04-30,intra-total,87638,10150,3100,1168,198,65,22,16,5,174,41510,144046,129148,139298,FALSE,0.96703830720742,2019,2019-2020
AZ,2020-04-30,intra-ucfe,5,3,2,0,0,1,1,0,0,1,22,35,27,30,FALSE,0.857142857142857,2019,2019-2020
AZ,2020-04-30,intra-ucx,16,14,6,3,0,0,0,0,0,0,30,69,46,60,FALSE,0.869565217391304,2019,2019-2020
AZ,2020-04-30,intra-ui,87617,10133,3092,1165,198,64,21,16,5,173,41458,143942,129075,139208,FALSE,0.967111753345097,2019,2019-2020
AZ,2020-05-31,inter-total,562,21,20,39,51,33,18,8,0,0,127,879,689,710,FALSE,0.80773606370876,2019,2019-2020
AZ,2020-05-31,inter-ucfe,0,1,0,0,1,0,0,0,0,0,2,4,2,3,FALSE,0.75,2019,2019-2020
AZ,2020-05-31,inter-ucx,0,1,0,0,0,0,0,0,0,0,0,1,0,1,FALSE,1,2019,2019-2020
AZ,2020-05-31,inter-ui,562,19,20,39,50,33,18,8,0,0,125,874,687,706,FALSE,0.807780320366133,2019,2019-2020
AZ,2020-05-31,intra-total,24286,1323,1613,2902,4121,2712,1080,211,44,27,5244,43563,29530,30853,FALSE,0.708238642885017,2019,2019-2020
AZ,2020-05-31,intra-ucfe,9,1,3,3,3,0,2,0,0,0,3,24,12,13,FALSE,0.541666666666667,2019,2019-2020
AZ,2020-05-31,intra-ucx,4,15,7,6,0,1,1,0,0,0,3,37,7,22,FALSE,0.594594594594595,2019,2019-2020
AZ,2020-05-31,intra-ui,24273,1307,1603,2893,4118,2711,1077,211,44,27,5238,43502,29511,30818,FALSE,0.708427198749483,2019,2019-2020
AZ,2020-06-30,inter-total,541,121,125,128,118,179,142,41,16,17,234,1662,775,896,FALSE,0.539109506618532,2019,2019-2020
AZ,2020-06-30,inter-ucfe,1,1,1,2,1,2,2,1,1,0,0,12,1,2,FALSE,0.166666666666667,2019,2019-2020
AZ,2020-06-30,inter-ucx,0,0,0,0,0,1,0,0,0,0,0,1,0,0,FALSE,0,2019,2019-2020
AZ,2020-06-30,inter-ui,540,120,124,126,117,176,140,40,15,17,234,1649,774,894,FALSE,0.54214675560946,2019,2019-2020
AZ,2020-06-30,intra-total,17563,3419,3498,3985,4365,5292,5895,2388,928,819,6251,54403,23814,27233,FALSE,0.500579012186828,2019,2019-2020
AZ,2020-06-30,intra-ucfe,50,6,4,9,6,5,7,3,1,4,32,127,82,88,FALSE,0.692913385826772,2019,2019-2020
AZ,2020-06-30,intra-ucx,4,5,18,13,11,11,6,1,3,0,2,74,6,11,FALSE,0.148648648648649,2019,2019-2020
AZ,2020-06-30,intra-ui,17509,3408,3476,3963,4348,5276,5882,2384,924,815,6217,54202,23726,27134,FALSE,0.500608833622376,2019,2019-2020
AZ,2020-07-31,inter-total,509,19,6,7,9,8,16,7,3,33,97,714,606,625,FALSE,0.875350140056023,2020,2020-2021
AZ,2020-07-31,inter-ucfe,1,0,0,0,1,1,0,0,0,1,1,5,2,2,FALSE,0.4,2020,2020-2021
AZ,2020-07-31,inter-ucx,0,0,0,1,0,0,0,0,0,1,0,2,0,0,FALSE,0,2020,2020-2021
AZ,2020-07-31,inter-ui,508,19,6,6,8,7,16,7,3,31,96,707,604,623,FALSE,0.881188118811881,2020,2020-2021
AZ,2020-07-31,intra-total,12430,854,440,338,296,320,297,138,189,1014,2996,19312,15426,16280,FALSE,0.842999171499586,2020,2020-2021
AZ,2020-07-31,intra-ucfe,10,6,7,3,10,6,10,4,0,3,20,79,30,36,FALSE,0.455696202531646,2020,2020-2021
AZ,2020-07-31,intra-ucx,4,1,2,3,4,7,1,3,3,3,3,34,7,8,FALSE,0.235294117647059,2020,2020-2021
AZ,2020-07-31,intra-ui,12416,847,431,332,282,307,286,131,186,1008,2973,19199,15389,16236,FALSE,0.845669045262774,2020,2020-2021
AZ,2020-08-31,inter-total,679,66,68,68,84,80,105,77,40,78,97,1442,776,842,FALSE,0.583911234396671,2020,2020-2021
AZ,2020-08-31,inter-ucfe,1,1,0,1,0,1,0,1,0,6,1,12,2,3,FALSE,0.25,2020,2020-2021
AZ,2020-08-31,inter-ucx,2,0,0,0,0,0,0,0,0,0,0,2,2,2,FALSE,1,2020,2020-2021
AZ,2020-08-31,inter-ui,676,65,68,67,84,79,105,76,40,72,96,1428,772,837,FALSE,0.586134453781513,2020,2020-2021
AZ,2020-08-31,intra-total,6015,2001,2502,2259,2618,2427,2939,2281,1522,2522,2124,29210,8139,10140,FALSE,0.347141389934954,2020,2020-2021
AZ,2020-08-31,intra-ucfe,9,6,7,7,10,10,7,3,9,19,37,124,46,52,FALSE,0.419354838709677,2020,2020-2021
AZ,2020-08-31,intra-ucx,10,1,9,3,3,0,3,1,1,15,4,50,14,15,FALSE,0.3,2020,2020-2021
AZ,2020-08-31,intra-ui,5996,1994,2486,2249,2605,2417,2929,2277,1512,2488,2083,29036,8079,10073,FALSE,0.346914175506268,2020,2020-2021
AZ,2020-09-30,inter-total,1662,92,50,30,8,1,6,2,10,27,195,2083,1857,1949,FALSE,0.935669707153144,2020,2020-2021
AZ,2020-09-30,inter-ucfe,0,0,0,0,0,0,0,0,0,1,0,1,0,0,FALSE,0,2020,2020-2021
AZ,2020-09-30,inter-ucx,0,0,0,0,0,0,0,0,0,0,0,0,0,0,FALSE,0,2020,2020-2021
AZ,2020-09-30,inter-ui,1662,92,50,30,8,1,6,2,10,26,195,2082,1857,1949,FALSE,0.93611911623439,2020,2020-2021
AZ,2020-09-30,intra-total,3238,1880,1385,827,125,158,176,173,150,934,1101,10147,4339,6219,FALSE,0.6128905095102,2020,2020-2021
AZ,2020-09-30,intra-ucfe,1,5,6,4,3,7,2,8,1,16,2,55,3,8,FALSE,0.145454545454545,2020,2020-2021
AZ,2020-09-30,intra-ucx,9,3,5,1,1,1,1,0,2,5,6,34,15,18,FALSE,0.529411764705882,2020,2020-2021
AZ,2020-09-30,intra-ui,3228,1872,1374,822,121,150,173,165,147,913,1093,10058,4321,6193,FALSE,0.615728773115928,2020,2020-2021
AZ,2020-10-31,inter-total,2083,59,22,16,12,5,4,1,0,36,215,2453,2298,2357,FALSE,0.960864247859764,2020,2020-2021
AZ,2020-10-31,inter-ucfe,1,0,1,1,0,0,0,0,0,0,2,5,3,3,FALSE,0.6,2020,2020-2021
AZ,2020-10-31,inter-ucx,0,0,0,1,0,0,0,0,0,0,0,1,0,0,FALSE,0,2020,2020-2021
AZ,2020-10-31,inter-ui,2082,59,21,14,12,5,4,1,0,36,213,2447,2295,2354,FALSE,0.961994278708623,2020,2020-2021
AZ,2020-10-31,intra-total,2747,1036,582,378,209,107,59,40,26,788,1195,7167,3942,4978,FALSE,0.694572345472304,2020,2020-2021
AZ,2020-10-31,intra-ucfe,2,6,2,0,0,2,1,0,1,8,11,33,13,19,FALSE,0.575757575757576,2020,2020-2021
AZ,2020-10-31,intra-ucx,3,4,2,0,2,0,1,0,0,21,2,35,5,9,FALSE,0.257142857142857,2020,2020-2021
AZ,2020-10-31,intra-ui,2742,1026,578,378,207,105,57,40,25,759,1182,7099,3924,4950,FALSE,0.69728130722637,2020,2020-2021
AZ,2020-11-30,inter-total,4306,68,22,16,8,7,8,1,3,60,443,4942,4749,4817,FALSE,0.974706596519628,2020,2020-2021
AZ,2020-11-30,inter-ucfe,3,0,0,0,2,0,0,0,1,2,1,9,4,4,FALSE,0.444444444444444,2020,2020-2021
AZ,2020-11-30,inter-ucx,0,0,0,0,0,0,0,0,0,0,0,0,0,0,FALSE,0,2020,2020-2021
AZ,2020-11-30,inter-ui,4303,68,22,16,6,7,8,1,2,58,442,4933,4745,4813,FALSE,0.975674032029191,2020,2020-2021
AZ,2020-11-30,intra-total,2636,936,446,223,130,81,67,47,39,485,1325,6415,3961,4897,FALSE,0.763367108339829,2020,2020-2021
AZ,2020-11-30,intra-ucfe,12,6,11,5,3,1,0,0,0,14,17,69,29,35,FALSE,0.507246376811594,2020,2020-2021
AZ,2020-11-30,intra-ucx,0,0,0,2,2,0,0,0,0,10,2,16,2,2,FALSE,0.125,2020,2020-2021
AZ,2020-11-30,intra-ui,2624,930,435,216,125,80,67,47,39,461,1306,6330,3930,4860,FALSE,0.767772511848341,2020,2020-2021
AZ,2020-12-31,inter-total,3309,44,17,10,4,6,3,4,2,32,640,4071,3949,3993,FALSE,0.980840088430361,2020,2020-2021
AZ,2020-12-31,inter-ucfe,1,0,0,1,1,1,0,1,1,1,0,7,1,1,FALSE,0.142857142857143,2020,2020-2021
AZ,2020-12-31,inter-ucx,0,0,1,0,1,0,0,1,0,0,0,3,0,0,FALSE,0,2020,2020-2021
AZ,2020-12-31,inter-ui,3308,44,16,9,2,5,3,2,1,31,640,4061,3948,3992,FALSE,0.98300911105639,2020,2020-2021
AZ,2020-12-31,intra-total,3158,1138,298,126,75,52,49,45,19,456,1535,6951,4693,5831,FALSE,0.838872104733132,2020,2020-2021
AZ,2020-12-31,intra-ucfe,11,2,1,4,1,7,3,2,1,5,19,56,30,32,FALSE,0.571428571428571,2020,2020-2021
AZ,2020-12-31,intra-ucx,0,2,3,3,5,2,6,4,0,3,1,29,1,3,FALSE,0.103448275862069,2020,2020-2021
AZ,2020-12-31,intra-ui,3147,1134,294,119,69,43,40,39,18,448,1515,6866,4662,5796,FALSE,0.844159627148267,2020,2020-2021
AZ,2021-01-31,inter-total,14784,92,18,3,2,9,4,2,1,32,720,15667,15504,15596,FALSE,0.995468181528053,2020,2020-2021
AZ,2021-01-31,inter-ucfe,0,1,0,0,0,0,0,0,0,1,4,6,4,5,FALSE,0.833333333333333,2020,2020-2021
AZ,2021-01-31,inter-ucx,0,1,0,0,0,0,1,0,0,0,0,2,0,1,FALSE,0.5,2020,2020-2021
AZ,2021-01-31,inter-ui,14784,90,18,3,2,9,3,2,1,31,716,15659,15500,15590,FALSE,0.995593588351747,2020,2020-2021
AZ,2021-01-31,intra-total,5677,1162,277,128,64,31,23,23,15,257,1936,9593,7613,8775,FALSE,0.91472949025331,2020,2020-2021
AZ,2021-01-31,intra-ucfe,7,7,2,2,2,0,0,4,3,8,18,53,25,32,FALSE,0.60377358490566,2020,2020-2021
AZ,2021-01-31,intra-ucx,0,0,1,1,0,0,0,1,0,2,0,5,0,0,FALSE,0,2020,2020-2021
AZ,2021-01-31,intra-ui,5670,1155,274,125,62,31,23,18,12,247,1918,9535,7588,8743,FALSE,0.916937598321972,2020,2020-2021
AZ,2021-02-28,inter-total,13688,36,11,3,3,1,1,5,1,18,508,14275,14196,14232,FALSE,0.996987740805604,2020,2020-2021
AZ,2021-02-28,inter-ucfe,0,0,0,1,0,0,0,2,0,0,2,5,2,2,FALSE,0.4,2020,2020-2021
AZ,2021-02-28,inter-ucx,0,0,0,0,0,0,0,0,0,1,0,1,0,0,FALSE,0,2020,2020-2021
AZ,2021-02-28,inter-ui,13688,36,11,2,3,1,1,3,1,17,506,14269,14194,14230,FALSE,0.997266802158526,2020,2020-2021
AZ,2021-02-28,intra-total,5261,1219,342,165,67,40,36,36,15,224,1730,9135,6991,8210,FALSE,0.898741105637657,2020,2020-2021
AZ,2021-02-28,intra-ucfe,3,1,7,0,0,1,1,2,0,14,3,32,6,7,FALSE,0.21875,2020,2020-2021
AZ,2021-02-28,intra-ucx,1,0,2,0,0,0,2,2,1,9,0,17,1,1,FALSE,0.0588235294117647,2020,2020-2021
AZ,2021-02-28,intra-ui,5257,1218,333,165,67,39,33,32,14,201,1727,9086,6984,8202,FALSE,0.902707462029496,2020,2020-2021
AZ,2021-03-31,inter-total,63,20,10,3,2,4,2,6,1,16,34,161,97,117,FALSE,0.726708074534162,2020,2020-2021
AZ,2021-03-31,inter-ucfe,0,0,0,0,0,0,0,3,0,2,1,6,1,1,FALSE,0.166666666666667,2020,2020-2021
AZ,2021-03-31,inter-ucx,0,0,0,0,0,0,0,0,0,0,0,0,0,0,FALSE,0,2020,2020-2021
AZ,2021-03-31,inter-ui,63,20,10,3,2,4,2,3,1,14,33,155,96,116,FALSE,0.748387096774194,2020,2020-2021
AZ,2021-03-31,intra-total,2555,836,196,102,58,48,48,35,42,278,1406,5604,3961,4797,FALSE,0.855995717344754,2020,2020-2021
AZ,2021-03-31,intra-ucfe,0,1,0,0,0,1,1,1,1,16,1,22,1,2,FALSE,0.0909090909090909,2020,2020-2021
AZ,2021-03-31,intra-ucx,2,0,0,0,0,0,1,1,3,4,2,13,4,4,FALSE,0.307692307692308,2020,2020-2021
AZ,2021-03-31,intra-ui,2553,835,196,102,58,47,46,33,38,258,1403,5569,3956,4791,FALSE,0.860298078649668,2020,2020-2021
AZ,2021-04-30,inter-total,90,29,6,3,0,1,1,2,4,25,41,202,131,160,FALSE,0.792079207920792,2020,2020-2021
AZ,2021-04-30,inter-ucfe,0,1,0,0,0,0,0,0,0,3,1,5,1,2,FALSE,0.4,2020,2020-2021
AZ,2021-04-30,inter-ucx,0,0,0,0,0,0,0,0,0,0,0,0,0,0,FALSE,0,2020,2020-2021
AZ,2021-04-30,inter-ui,90,28,6,3,0,1,1,2,4,22,40,197,130,158,FALSE,0.802030456852792,2020,2020-2021
AZ,2021-04-30,intra-total,4960,1210,322,118,43,18,14,13,16,284,1984,8982,6944,8154,FALSE,0.907815631262525,2020,2020-2021
AZ,2021-04-30,intra-ucfe,3,0,1,2,1,0,0,1,1,6,2,17,5,5,FALSE,0.294117647058824,2020,2020-2021
AZ,2021-04-30,intra-ucx,0,0,0,0,0,0,0,1,0,15,1,17,1,1,FALSE,0.0588235294117647,2020,2020-2021
AZ,2021-04-30,intra-ui,4957,1210,321,116,42,18,14,11,15,263,1981,8948,6938,8148,FALSE,0.910594546267322,2020,2020-2021
AZ,2021-05-31,inter-total,85,39,12,4,2,2,1,2,0,35,48,230,133,172,FALSE,0.747826086956522,2020,2020-2021
AZ,2021-05-31,inter-ucfe,0,1,0,0,0,0,0,0,0,1,1,3,1,2,FALSE,0.666666666666667,2020,2020-2021
AZ,2021-05-31,inter-ucx,0,0,0,0,0,0,0,0,0,0,0,0,0,0,FALSE,0,2020,2020-2021
AZ,2021-05-31,inter-ui,85,38,12,4,2,2,1,2,0,34,47,227,132,170,FALSE,0.748898678414097,2020,2020-2021
AZ,2021-05-31,intra-total,4255,1529,574,374,278,228,165,91,31,241,1911,9677,6166,7695,FALSE,0.79518445799318,2020,2020-2021
AZ,2021-05-31,intra-ucfe,1,0,1,0,1,0,0,0,2,5,0,10,1,1,FALSE,0.1,2020,2020-2021
AZ,2021-05-31,intra-ucx,3,2,3,3,0,0,0,0,1,7,2,21,5,7,FALSE,0.333333333333333,2020,2020-2021
AZ,2021-05-31,intra-ui,4251,1527,570,371,277,228,165,91,28,229,1909,9646,6160,7687,FALSE,0.796910636533278,2020,2020-2021
AZ,2021-06-30,inter-total,78,29,11,6,1,2,2,2,3,46,35,215,113,142,FALSE,0.66046511627907,2020,2020-2021
AZ,2021-06-30,inter-ucfe,0,0,0,0,0,0,0,0,0,2,0,2,0,0,FALSE,0,2020,2020-2021
AZ,2021-06-30,inter-ucx,0,0,0,0,0,0,0,0,0,0,0,0,0,0,FALSE,0,2020,2020-2021
AZ,2021-06-30,inter-ui,78,29,11,6,1,2,2,2,3,44,35,213,113,142,FALSE,0.666666666666667,2020,2020-2021
AZ,2021-06-30,intra-total,2766,1162,394,230,178,147,154,145,110,643,1350,7279,4116,5278,FALSE,0.725099601593626,2020,2020-2021
AZ,2021-06-30,intra-ucfe,0,0,2,1,1,1,0,0,0,10,0,15,0,0,FALSE,0,2020,2020-2021
AZ,2021-06-30,intra-ucx,0,0,2,1,1,0,1,1,1,6,6,19,6,6,FALSE,0.315789473684211,2020,2020-2021
AZ,2021-06-30,intra-ui,2766,1162,390,228,176,146,153,144,109,627,1344,7245,4110,5272,FALSE,0.727674258109041,2020,2020-2021
AZ,2021-07-31,inter-total,42,20,10,1,4,1,2,3,2,45,38,168,80,100,FALSE,0.595238095238095,2021,2021-2022
AZ,2021-07-31,inter-ucfe,0,0,0,0,0,0,1,1,0,0,2,4,2,2,FALSE,0.5,2021,2021-2022
AZ,2021-07-31,inter-ucx,0,0,0,0,0,0,0,0,0,0,0,0,0,0,FALSE,0,2021,2021-2022
AZ,2021-07-31,inter-ui,42,20,10,1,4,1,1,2,2,45,36,164,78,98,FALSE,0.597560975609756,2021,2021-2022
AZ,2021-07-31,intra-total,2661,881,267,138,82,59,37,49,45,898,1337,6454,3998,4879,FALSE,0.755965292841649,2021,2021-2022
AZ,2021-07-31,intra-ucfe,10,2,1,1,1,0,1,1,0,10,4,31,14,16,FALSE,0.516129032258065,2021,2021-2022
AZ,2021-07-31,intra-ucx,1,3,1,0,0,0,0,0,0,2,1,8,2,5,FALSE,0.625,2021,2021-2022
AZ,2021-07-31,intra-ui,2650,876,265,137,81,59,36,48,45,886,1332,6415,3982,4858,FALSE,0.757287607170694,2021,2021-2022
AZ,2021-08-31,inter-total,36,8,7,4,2,3,0,2,2,59,38,161,74,82,FALSE,0.509316770186335,2021,2021-2022
AZ,2021-08-31,inter-ucfe,0,0,1,0,0,0,0,1,0,0,0,2,0,0,FALSE,0,2021,2021-2022
AZ,2021-08-31,inter-ucx,0,0,1,0,1,0,0,0,0,0,0,2,0,0,FALSE,0,2021,2021-2022
AZ,2021-08-31,inter-ui,36,8,5,4,1,3,0,1,2,59,38,157,74,82,FALSE,0.522292993630573,2021,2021-2022
AZ,2021-08-31,intra-total,1502,865,294,181,88,70,47,36,32,803,1016,4934,2518,3383,FALSE,0.685650587758411,2021,2021-2022
AZ,2021-08-31,intra-ucfe,0,1,1,1,1,0,0,0,2,7,2,15,2,3,FALSE,0.2,2021,2021-2022
AZ,2021-08-31,intra-ucx,0,1,1,2,1,1,0,1,2,4,2,15,2,3,FALSE,0.2,2021,2021-2022
AZ,2021-08-31,intra-ui,1502,863,292,178,86,69,47,35,28,792,1012,4904,2514,3377,FALSE,0.688621533442088,2021,2021-2022
AZ,2021-09-30,inter-total,19,0,0,0,0,0,0,0,0,1,4,24,23,23,FALSE,0.958333333333333,2021,2021-2022
AZ,2021-09-30,inter-ucfe,0,0,0,0,0,0,0,0,0,0,0,0,0,0,FALSE,0,2021,2021-2022
AZ,2021-09-30,inter-ucx,0,0,0,0,0,0,0,0,0,0,0,0,0,0,FALSE,0,2021,2021-2022
AZ,2021-09-30,inter-ui,19,0,0,0,0,0,0,0,0,1,4,24,23,23,FALSE,0.958333333333333,2021,2021-2022
AZ,2021-09-30,intra-total,588,0,0,0,0,0,0,0,0,20,147,755,735,735,FALSE,0.973509933774834,2021,2021-2022
AZ,2021-09-30,intra-ucfe,4,0,0,0,0,0,0,0,0,1,3,8,7,7,FALSE,0.875,2021,2021-2022
AZ,2021-09-30,intra-ucx,0,0,0,0,0,0,0,0,0,0,0,0,0,0,FALSE,0,2021,2021-2022
AZ,2021-09-30,intra-ui,584,0,0,0,0,0,0,0,0,19,144,747,728,728,FALSE,0.974564926372155,2021,2021-2022
AZ,2021-10-31,inter-total,42,7,2,0,1,0,0,0,0,0,21,73,63,70,FALSE,0.958904109589041,2021,2021-2022
AZ,2021-10-31,inter-ucfe,1,0,0,0,0,0,0,0,0,0,0,1,1,1,FALSE,1,2021,2021-2022
AZ,2021-10-31,inter-ucx,0,0,0,0,0,0,0,0,0,0,1,1,1,1,FALSE,1,2021,2021-2022
AZ,2021-10-31,inter-ui,41,7,2,0,1,0,0,0,0,0,20,71,61,68,FALSE,0.957746478873239,2021,2021-2022
AZ,2021-10-31,intra-total,1070,125,52,18,2,0,0,0,0,26,590,1883,1660,1785,FALSE,0.947955390334572,2021,2021-2022
AZ,2021-10-31,intra-ucfe,19,1,1,0,0,0,0,0,0,2,6,29,25,26,FALSE,0.896551724137931,2021,2021-2022
AZ,2021-10-31,intra-ucx,2,1,1,0,0,0,0,0,0,0,1,5,3,4,FALSE,0.8,2021,2021-2022
AZ,2021-10-31,intra-ui,1049,123,50,18,2,0,0,0,0,24,583,1849,1632,1755,FALSE,0.949161709031909,2021,2021-2022
AZ,2021-11-30,inter-total,45,4,4,2,1,0,0,0,0,0,21,77,66,70,FALSE,0.909090909090909,2021,2021-2022
AZ,2021-11-30,inter-ucfe,1,0,1,0,0,0,0,0,0,0,2,4,3,3,FALSE,0.75,2021,2021-2022
AZ,2021-11-30,inter-ucx,0,0,0,0,0,0,0,0,0,0,0,0,0,0,FALSE,0,2021,2021-2022
AZ,2021-11-30,inter-ui,44,4,3,2,1,0,0,0,0,0,19,73,63,67,FALSE,0.917808219178082,2021,2021-2022
AZ,2021-11-30,intra-total,964,121,63,34,24,14,8,9,1,31,609,1878,1573,1694,FALSE,0.902023429179979,2021,2021-2022
AZ,2021-11-30,intra-ucfe,16,0,1,1,0,0,0,0,0,0,11,29,27,27,FALSE,0.931034482758621,2021,2021-2022
AZ,2021-11-30,intra-ucx,2,1,1,1,2,2,1,1,0,0,2,13,4,5,FALSE,0.384615384615385,2021,2021-2022
AZ,2021-11-30,intra-ui,946,120,61,32,22,12,7,8,1,31,596,1836,1542,1662,FALSE,0.905228758169935,2021,2021-2022
AZ,2021-12-31,inter-total,33,4,2,3,3,0,1,0,1,3,21,71,54,58,FALSE,0.816901408450704,2021,2021-2022
AZ,2021-12-31,inter-ucfe,2,0,0,1,1,0,0,0,0,0,1,5,3,3,FALSE,0.6,2021,2021-2022
AZ,2021-12-31,inter-ucx,0,0,0,0,0,0,0,0,0,0,0,0,0,0,FALSE,0,2021,2021-2022
AZ,2021-12-31,inter-ui,31,4,2,2,2,0,1,0,1,3,20,66,51,55,FALSE,0.833333333333333,2021,2021-2022
AZ,2021-12-31,intra-total,871,119,43,18,19,14,9,6,8,57,535,1699,1406,1525,FALSE,0.897586815773985,2021,2021-2022
AZ,2021-12-31,intra-ucfe,12,2,2,0,1,2,0,2,0,2,7,30,19,21,FALSE,0.7,2021,2021-2022
AZ,2021-12-31,intra-ucx,0,0,0,1,1,0,0,0,0,0,0,2,0,0,FALSE,0,2021,2021-2022
AZ,2021-12-31,intra-ui,859,117,41,17,17,12,9,4,8,55,528,1667,1387,1504,FALSE,0.902219556088782,2021,2021-2022
AZ,2022-01-31,inter-total,40,4,4,0,0,3,1,3,0,7,22,84,62,66,FALSE,0.785714285714286,2021,2021-2022
AZ,2022-01-31,inter-ucfe,2,0,0,0,0,0,1,1,0,1,0,5,2,2,FALSE,0.4,2021,2021-2022
AZ,2022-01-31,inter-ucx,0,0,0,0,0,0,0,0,0,0,0,0,0,0,FALSE,0,2021,2021-2022
AZ,2022-01-31,inter-ui,38,4,4,0,0,3,0,2,0,6,22,79,60,64,FALSE,0.810126582278481,2021,2021-2022
AZ,2022-01-31,intra-total,1048,135,47,17,24,14,17,7,8,97,576,1990,1624,1759,FALSE,0.88391959798995,2021,2021-2022
AZ,2022-01-31,intra-ucfe,12,1,0,0,3,1,2,0,0,3,2,24,14,15,FALSE,0.625,2021,2021-2022
AZ,2022-01-31,intra-ucx,0,0,0,0,0,0,0,0,0,1,0,1,0,0,FALSE,0,2021,2021-2022
AZ,2022-01-31,intra-ui,1036,134,47,17,21,13,15,7,8,93,574,1965,1610,1744,FALSE,0.887531806615776,2021,2021-2022
AZ,2022-02-28,inter-total,31,6,2,1,2,1,0,0,0,5,17,65,48,54,FALSE,0.830769230769231,2021,2021-2022
AZ,2022-02-28,inter-ucfe,3,1,0,0,0,1,0,0,0,1,0,6,3,4,FALSE,0.666666666666667,2021,2021-2022
AZ,2022-02-28,inter-ucx,0,0,0,0,0,0,0,0,0,0,0,0,0,0,FALSE,0,2021,2021-2022
AZ,2022-02-28,inter-ui,28,5,2,1,2,0,0,0,0,4,17,59,45,50,FALSE,0.847457627118644,2021,2021-2022
AZ,2022-02-28,intra-total,1038,113,50,33,16,9,10,6,6,106,570,1957,1608,1721,FALSE,0.879407256004088,2021,2021-2022
AZ,2022-02-28,intra-ucfe,6,1,2,1,1,0,0,0,1,1,0,13,6,7,FALSE,0.538461538461538,2021,2021-2022
AZ,2022-02-28,intra-ucx,1,0,0,0,0,0,0,0,0,0,0,1,1,1,FALSE,1,2021,2021-2022
AZ,2022-02-28,intra-ui,1031,112,48,32,15,9,10,6,5,105,570,1943,1601,1713,FALSE,0.881626351003603,2021,2021-2022
AZ,2022-03-31,inter-total,38,6,6,1,0,0,1,0,2,5,22,81,60,66,FALSE,0.814814814814815,2021,2021-2022
AZ,2022-03-31,inter-ucfe,0,0,0,0,0,0,0,0,0,2,1,3,1,1,FALSE,0.333333333333333,2021,2021-2022
AZ,2022-03-31,inter-ucx,0,0,0,0,0,0,0,0,0,0,0,0,0,0,FALSE,0,2021,2021-2022
AZ,2022-03-31,inter-ui,38,6,6,1,0,0,1,0,2,3,21,78,59,65,FALSE,0.833333333333333,2021,2021-2022
AZ,2022-03-31,intra-total,1023,184,76,50,33,22,25,15,13,195,605,2241,1628,1812,FALSE,0.808567603748327,2021,2021-2022
AZ,2022-03-31,intra-ucfe,2,0,1,0,2,1,2,0,0,6,2,16,4,4,FALSE,0.25,2021,2021-2022
AZ,2022-03-31,intra-ucx,2,0,0,0,0,1,0,0,0,2,0,5,2,2,FALSE,0.4,2021,2021-2022
AZ,2022-03-31,intra-ui,1019,184,75,50,31,20,23,15,13,187,603,2220,1622,1806,FALSE,0.813513513513514,2021,2021-2022
AZ,2022-04-30,inter-total,35,10,3,0,1,0,0,1,0,8,26,84,61,71,FALSE,0.845238095238095,2021,2021-2022
AZ,2022-04-30,inter-ucfe,0,0,1,0,0,0,0,0,0,1,0,2,0,0,FALSE,0,2021,2021-2022
AZ,2022-04-30,inter-ucx,0,0,0,0,0,0,0,0,0,0,0,0,0,0,FALSE,0,2021,2021-2022
AZ,2022-04-30,inter-ui,35,10,2,0,1,0,0,1,0,7,26,82,61,71,FALSE,0.865853658536585,2021,2021-2022
AZ,2022-04-30,intra-total,2305,166,66,34,12,16,11,10,13,172,667,3472,2972,3138,FALSE,0.903801843317972,2021,2021-2022
AZ,2022-04-30,intra-ucfe,3,0,0,0,0,1,0,0,1,11,3,19,6,6,FALSE,0.315789473684211,2021,2021-2022
AZ,2022-04-30,intra-ucx,2,0,0,0,0,0,0,0,0,0,1,3,3,3,FALSE,1,2021,2021-2022
AZ,2022-04-30,intra-ui,2300,166,66,34,12,15,11,10,12,161,663,3450,2963,3129,FALSE,0.90695652173913,2021,2021-2022
AZ,2022-05-31,inter-total,51,7,7,1,0,0,0,0,3,10,14,93,65,72,FALSE,0.774193548387097,2021,2021-2022
AZ,2022-05-31,inter-ucfe,0,0,0,0,0,0,0,0,0,2,0,2,0,0,FALSE,0,2021,2021-2022
AZ,2022-05-31,inter-ucx,0,0,0,0,0,0,0,0,0,0,0,0,0,0,FALSE,0,2021,2021-2022
AZ,2022-05-31,inter-ui,51,7,7,1,0,0,0,0,3,8,14,91,65,72,FALSE,0.791208791208791,2021,2021-2022
AZ,2022-05-31,intra-total,2930,275,130,47,23,16,3,11,11,157,667,4270,3597,3872,FALSE,0.906791569086651,2021,2021-2022
AZ,2022-05-31,intra-ucfe,2,0,0,0,1,0,0,0,0,7,2,12,4,4,FALSE,0.333333333333333,2021,2021-2022
AZ,2022-05-31,intra-ucx,1,0,0,0,1,1,0,0,0,7,1,11,2,2,FALSE,0.181818181818182,2021,2021-2022
AZ,2022-05-31,intra-ui,2927,275,130,47,21,15,3,11,11,143,664,4247,3591,3866,FALSE,0.91028961619967,2021,2021-2022
AZ,2022-06-30,inter-total,71,22,8,7,3,3,1,0,1,7,19,142,90,112,FALSE,0.788732394366197,2021,2021-2022
AZ,2022-06-30,inter-ucfe,3,0,0,0,1,0,0,0,0,2,0,6,3,3,FALSE,0.5,2021,2021-2022
AZ,2022-06-30,inter-ucx,0,0,0,0,0,0,0,0,0,0,0,0,0,0,FALSE,0,2021,2021-2022
AZ,2022-06-30,inter-ui,68,22,8,7,2,3,1,0,1,5,19,136,87,109,FALSE,0.801470588235294,2021,2021-2022
AZ,2022-06-30,intra-total,2406,457,257,138,65,39,30,12,19,168,656,4247,3062,3519,FALSE,0.828584883447139,2021,2021-2022
AZ,2022-06-30,intra-ucfe,21,2,3,0,0,0,1,0,0,5,2,34,23,25,FALSE,0.735294117647059,2021,2021-2022
AZ,2022-06-30,intra-ucx,0,0,0,2,0,0,1,0,1,3,1,8,1,1,FALSE,0.125,2021,2021-2022
AZ,2022-06-30,intra-ui,2385,455,254,136,65,39,28,12,18,160,653,4205,3038,3493,FALSE,0.830677764565993,2021,2021-2022
AZ,2022-07-31,inter-total,67,4,8,7,1,4,2,0,0,6,15,114,82,86,FALSE,0.754385964912281,2022,2022-2023
AZ,2022-07-31,inter-ucfe,1,0,1,0,0,0,1,0,0,0,0,3,1,1,FALSE,0.333333333333333,2022,2022-2023
AZ,2022-07-31,inter-ucx,0,0,0,0,0,0,0,0,0,0,0,0,0,0,FALSE,0,2022,2022-2023
AZ,2022-07-31,inter-ui,66,4,7,7,1,4,1,0,0,6,15,111,81,85,FALSE,0.765765765765766,2022,2022-2023
AZ,2022-07-31,intra-total,3279,330,178,86,49,31,21,12,14,133,662,4795,3941,4271,FALSE,0.890719499478624,2022,2022-2023
AZ,2022-07-31,intra-ucfe,5,2,0,0,3,0,1,0,0,5,5,21,10,12,FALSE,0.571428571428571,2022,2022-2023
AZ,2022-07-31,intra-ucx,0,1,0,0,0,0,0,1,1,2,3,8,3,4,FALSE,0.5,2022,2022-2023
AZ,2022-07-31,intra-ui,3274,327,178,86,46,31,20,11,13,126,654,4766,3928,4255,FALSE,0.892782207301721,2022,2022-2023
AZ,2022-08-31,inter-total,66,18,10,7,6,2,1,4,1,3,25,143,91,109,FALSE,0.762237762237762,2022,2022-2023
AZ,2022-08-31,inter-ucfe,0,0,0,0,0,0,0,2,1,1,1,5,1,1,FALSE,0.2,2022,2022-2023
AZ,2022-08-31,inter-ucx,0,0,0,0,0,0,0,0,0,0,0,0,0,0,FALSE,0,2022,2022-2023
AZ,2022-08-31,inter-ui,66,18,10,7,6,2,1,2,0,2,24,138,90,108,FALSE,0.782608695652174,2022,2022-2023
AZ,2022-08-31,intra-total,2157,571,406,240,118,62,33,26,21,170,716,4520,2873,3444,FALSE,0.761946902654867,2022,2022-2023
AZ,2022-08-31,intra-ucfe,4,3,10,14,2,1,3,1,1,13,0,52,4,7,FALSE,0.134615384615385,2022,2022-2023
AZ,2022-08-31,intra-ucx,0,0,0,2,0,0,0,1,1,2,0,6,0,0,FALSE,0,2022,2022-2023
AZ,2022-08-31,intra-ui,2153,568,396,224,116,61,30,24,19,155,716,4462,2869,3437,FALSE,0.770282384580906,2022,2022-2023
AZ,2022-09-30,inter-total,40,11,8,7,2,2,2,1,1,3,27,104,67,78,FALSE,0.75,2022,2022-2023
AZ,2022-09-30,inter-ucfe,0,0,0,1,0,0,0,0,0,0,0,1,0,0,FALSE,0,2022,2022-2023
AZ,2022-09-30,inter-ucx,0,0,0,0,0,0,0,0,0,0,0,0,0,0,FALSE,0,2022,2022-2023
AZ,2022-09-30,inter-ui,40,11,8,6,2,2,2,1,1,3,27,103,67,78,FALSE,0.757281553398058,2022,2022-2023
AZ,2022-09-30,intra-total,1110,456,369,157,95,69,38,23,26,127,490,2960,1600,2056,FALSE,0.694594594594595,2022,2022-2023
AZ,2022-09-30,intra-ucfe,3,0,2,1,1,0,0,2,3,9,0,21,3,3,FALSE,0.142857142857143,2022,2022-2023
AZ,2022-09-30,intra-ucx,2,1,1,1,0,0,0,1,0,0,0,6,2,3,FALSE,0.5,2022,2022-2023
AZ,2022-09-30,intra-ui,1105,455,366,155,94,69,38,20,23,118,490,2933,1595,2050,FALSE,0.698943061711558,2022,2022-2023
AZ,2022-10-31,inter-total,53,8,8,4,3,0,4,1,0,6,25,112,78,86,FALSE,0.767857142857143,2022,2022-2023
AZ,2022-10-31,inter-ucfe,0,0,0,1,0,0,0,0,0,0,0,1,0,0,FALSE,0,2022,2022-2023
AZ,2022-10-31,inter-ucx,1,0,0,0,0,0,0,0,0,0,0,1,1,1,FALSE,1,2022,2022-2023
AZ,2022-10-31,inter-ui,52,8,8,3,3,0,4,1,0,6,25,110,77,85,FALSE,0.772727272727273,2022,2022-2023
AZ,2022-10-31,intra-total,1242,348,314,170,111,60,42,20,15,118,525,2965,1767,2115,FALSE,0.713322091062395,2022,2022-2023
AZ,2022-10-31,intra-ucfe,7,2,1,0,1,1,0,0,0,6,1,19,8,10,FALSE,0.526315789473684,2022,2022-2023
AZ,2022-10-31,intra-ucx,2,0,0,0,0,0,0,0,1,1,0,4,2,2,FALSE,0.5,2022,2022-2023
AZ,2022-10-31,intra-ui,1233,346,313,170,110,59,42,20,14,111,524,2942,1757,2103,FALSE,0.714819850441876,2022,2022-2023
AZ,2022-11-30,inter-total,58,11,15,6,4,5,2,3,1,10,21,136,79,90,FALSE,0.661764705882353,2022,2022-2023
AZ,2022-11-30,inter-ucfe,0,0,0,0,0,0,0,1,0,0,1,2,1,1,FALSE,0.5,2022,2022-2023
AZ,2022-11-30,inter-ucx,0,0,0,0,0,0,0,0,0,0,0,0,0,0,FALSE,0,2022,2022-2023
AZ,2022-11-30,inter-ui,58,11,15,6,4,5,2,2,1,10,20,134,78,89,FALSE,0.664179104477612,2022,2022-2023
AZ,2022-11-30,intra-total,1206,420,392,164,150,54,39,44,53,157,582,3261,1788,2208,FALSE,0.677092916283349,2022,2022-2023
AZ,2022-11-30,intra-ucfe,6,2,1,0,0,0,1,0,0,6,3,19,9,11,FALSE,0.578947368421053,2022,2022-2023
AZ,2022-11-30,intra-ucx,0,0,0,1,0,0,0,0,0,0,0,1,0,0,FALSE,0,2022,2022-2023
AZ,2022-11-30,intra-ui,1200,418,391,163,150,54,38,44,53,151,579,3241,1779,2197,FALSE,0.677877198395557,2022,2022-2023
AZ,2022-12-31,inter-total,49,22,12,8,1,3,2,1,0,7,23,128,72,94,FALSE,0.734375,2022,2022-2023
AZ,2022-12-31,inter-ucfe,0,0,0,0,0,0,0,0,0,0,0,0,0,0,FALSE,0,2022,2022-2023
AZ,2022-12-31,inter-ucx,0,0,1,0,0,0,0,0,0,0,0,1,0,0,FALSE,0,2022,2022-2023
AZ,2022-12-31,inter-ui,49,22,11,8,1,3,2,1,0,7,23,127,72,94,FALSE,0.740157480314961,2022,2022-2023
AZ,2022-12-31,intra-total,1112,580,351,138,102,48,31,16,22,158,696,3254,1808,2388,FALSE,0.733866011063307,2022,2022-2023
AZ,2022-12-31,intra-ucfe,7,1,1,3,1,1,2,0,0,0,4,20,11,12,FALSE,0.6,2022,2022-2023
AZ,2022-12-31,intra-ucx,2,2,1,1,1,2,0,1,1,4,0,15,2,4,FALSE,0.266666666666667,2022,2022-2023
AZ,2022-12-31,intra-ui,1103,577,349,134,100,45,29,15,21,154,692,3219,1795,2372,FALSE,0.736874805840323,2022,2022-2023
AZ,2023-01-31,inter-total,54,15,5,1,1,0,1,1,2,7,24,111,78,93,FALSE,0.837837837837838,2022,2022-2023
AZ,2023-01-31,inter-ucfe,1,0,1,0,0,0,0,1,0,1,0,4,1,1,FALSE,0.25,2022,2022-2023
AZ,2023-01-31,inter-ucx,0,0,0,0,0,0,0,0,0,0,0,0,0,0,FALSE,0,2022,2022-2023
AZ,2023-01-31,inter-ui,53,15,4,1,1,0,1,0,2,6,24,107,77,92,FALSE,0.85981308411215,2022,2022-2023
AZ,2023-01-31,intra-total,1595,580,255,96,50,36,25,10,9,116,807,3579,2402,2982,FALSE,0.833193629505449,2022,2022-2023
AZ,2023-01-31,intra-ucfe,13,3,3,1,1,2,0,1,0,6,3,33,16,19,FALSE,0.575757575757576,2022,2022-2023
AZ,2023-01-31,intra-ucx,1,0,0,0,0,0,0,0,0,0,1,2,2,2,FALSE,1,2022,2022-2023
AZ,2023-01-31,intra-ui,1581,577,252,95,49,34,25,9,9,110,803,3544,2384,2961,FALSE,0.835496613995485,2022,2022-2023
AZ,2023-02-28,inter-total,58,12,13,4,2,1,1,0,0,5,29,125,87,99,FALSE,0.792,2022,2022-2023
AZ,2023-02-28,inter-ucfe,1,0,0,0,1,0,0,0,0,1,1,4,2,2,FALSE,0.5,2022,2022-2023
AZ,2023-02-28,inter-ucx,0,0,0,0,0,0,0,0,0,1,0,1,0,0,FALSE,0,2022,2022-2023
AZ,2023-02-28,inter-ui,57,12,13,4,1,1,1,0,0,3,28,120,85,97,FALSE,0.808333333333333,2022,2022-2023
AZ,2023-02-28,intra-total,1511,474,140,66,36,21,12,5,3,101,868,3237,2379,2853,FALSE,0.881371640407785,2022,2022-2023
AZ,2023-02-28,intra-ucfe,5,0,0,2,1,0,0,0,0,3,1,12,6,6,FALSE,0.5,2022,2022-2023
AZ,2023-02-28,intra-ucx,0,0,0,0,0,0,0,0,0,1,1,2,1,1,FALSE,0.5,2022,2022-2023
AZ,2023-02-28,intra-ui,1506,474,140,64,35,21,12,5,3,97,866,3223,2372,2846,FALSE,0.883028234564071,2022,2022-2023
AZ,2023-03-31,inter-total,46,17,5,0,4,3,1,1,3,6,23,109,69,86,FALSE,0.788990825688074,2022,2022-2023
AZ,2023-03-31,inter-ucfe,0,0,0,0,1,0,0,0,3,0,1,5,1,1,FALSE,0.2,2022,2022-2023
AZ,2023-03-31,inter-ucx,0,0,0,0,0,0,0,0,0,0,0,0,0,0,FALSE,0,2022,2022-2023
AZ,2023-03-31,inter-ui,46,17,5,0,3,3,1,1,0,6,22,104,68,85,FALSE,0.817307692307692,2022,2022-2023
AZ,2023-03-31,intra-total,1340,574,225,108,50,18,22,17,6,102,954,3416,2294,2868,FALSE,0.839578454332553,2022,2022-2023
AZ,2023-03-31,intra-ucfe,2,1,0,1,1,2,0,1,1,9,1,19,3,4,FALSE,0.210526315789474,2022,2022-2023
AZ,2023-03-31,intra-ucx,5,0,0,0,0,0,0,0,0,1,3,9,8,8,FALSE,0.888888888888889,2022,2022-2023
AZ,2023-03-31,intra-ui,1333,573,225,107,49,16,22,16,5,92,950,3388,2283,2856,FALSE,0.84297520661157,2022,2022-2023
AZ,2023-04-30,inter-total,49,19,3,3,5,0,2,1,1,4,23,110,72,91,FALSE,0.827272727272727,2022,2022-2023
AZ,2023-04-30,inter-ucfe,0,0,0,0,0,0,0,0,0,0,0,0,0,0,FALSE,0,2022,2022-2023
AZ,2023-04-30,inter-ucx,0,0,0,0,0,0,0,0,0,0,0,0,0,0,FALSE,0,2022,2022-2023
AZ,2023-04-30,inter-ui,49,19,3,3,5,0,2,1,1,4,23,110,72,91,FALSE,0.827272727272727,2022,2022-2023
AZ,2023-04-30,intra-total,2038,525,171,105,68,46,26,16,8,95,699,3797,2737,3262,FALSE,0.859099288912299,2022,2022-2023
AZ,2023-04-30,intra-ucfe,1,0,0,1,1,0,0,0,0,5,0,8,1,1,FALSE,0.125,2022,2022-2023
AZ,2023-04-30,intra-ucx,1,0,0,0,0,0,0,0,0,0,0,1,1,1,FALSE,1,2022,2022-2023
AZ,2023-04-30,intra-ui,2036,525,171,104,67,46,26,16,8,90,699,3788,2735,3260,FALSE,0.860612460401267,2022,2022-2023
AZ,2023-05-31,inter-total,90,18,6,3,1,1,1,0,1,6,30,157,120,138,FALSE,0.878980891719745,2022,2022-2023
AZ,2023-05-31,inter-ucfe,0,0,0,0,0,0,0,0,0,2,0,2,0,0,FALSE,0,2022,2022-2023
AZ,2023-05-31,inter-ucx,0,0,0,0,0,0,0,0,0,0,0,0,0,0,FALSE,0,2022,2022-2023
AZ,2023-05-31,inter-ui,90,18,6,3,1,1,1,0,1,4,30,155,120,138,FALSE,0.890322580645161,2022,2022-2023
AZ,2023-05-31,intra-total,3936,719,377,141,57,31,21,15,17,144,941,6399,4877,5596,FALSE,0.874511642444132,2022,2022-2023
AZ,2023-05-31,intra-ucfe,0,0,0,0,0,0,0,1,0,2,0,3,0,0,FALSE,0,2022,2022-2023
AZ,2023-05-31,intra-ucx,0,0,2,0,0,0,0,0,0,2,1,5,1,1,FALSE,0.2,2022,2022-2023
AZ,2023-05-31,intra-ui,3936,719,375,141,57,31,21,14,17,140,940,6391,4876,5595,FALSE,0.875449851353466,2022,2022-2023
AZ,2023-06-30,inter-total,74,15,11,11,2,0,3,1,0,8,24,149,98,113,FALSE,0.758389261744966,2022,2022-2023
AZ,2023-06-30,inter-ucfe,1,0,0,0,0,0,0,0,0,2,1,4,2,2,FALSE,0.5,2022,2022-2023
AZ,2023-06-30,inter-ucx,0,0,0,0,0,0,0,0,0,0,0,0,0,0,FALSE,0,2022,2022-2023
AZ,2023-06-30,inter-ui,73,15,11,11,2,0,3,1,0,6,23,145,96,111,FALSE,0.76551724137931,2022,2022-2023
AZ,2023-06-30,intra-total,2777,816,516,228,146,69,36,19,10,159,656,5432,3433,4249,FALSE,0.782216494845361,2022,2022-2023
AZ,2023-06-30,intra-ucfe,14,5,1,1,0,1,1,0,1,7,9,40,23,28,FALSE,0.7,2022,2022-2023
AZ,2023-06-30,intra-ucx,0,0,2,4,0,2,2,1,1,3,0,15,0,0,FALSE,0,2022,2022-2023
AZ,2023-06-30,intra-ui,2763,811,513,223,146,66,33,18,8,149,647,5377,3410,4221,FALSE,0.785010228752092,2022,2022-2023
AZ,2023-07-31,inter-total,74,33,21,2,1,1,1,0,2,5,20,160,94,127,FALSE,0.79375,2023,2023-2024
AZ,2023-07-31,inter-ucfe,1,0,0,0,0,0,0,0,1,0,0,2,1,1,FALSE,0.5,2023,2023-2024
AZ,2023-07-31,inter-ucx,0,0,0,0,0,0,0,0,0,0,0,0,0,0,FALSE,0,2023,2023-2024
AZ,2023-07-31,inter-ui,73,33,21,2,1,1,1,0,1,5,20,158,93,126,FALSE,0.79746835443038,2023,2023-2024
AZ,2023-07-31,intra-total,3625,782,600,197,91,38,26,20,9,141,649,6178,4274,5056,FALSE,0.818387827775979,2023,2023-2024
AZ,2023-07-31,intra-ucfe,30,2,4,3,1,3,0,0,0,5,6,54,36,38,FALSE,0.703703703703704,2023,2023-2024
AZ,2023-07-31,intra-ucx,2,0,1,1,0,0,2,0,1,2,2,11,4,4,FALSE,0.363636363636364,2023,2023-2024
AZ,2023-07-31,intra-ui,3593,780,595,193,90,35,24,20,8,134,641,6113,4234,5014,FALSE,0.820219204973008,2023,2023-2024
AZ,2023-08-31,inter-total,65,35,17,12,3,3,0,1,0,10,14,160,79,114,FALSE,0.7125,2023,2023-2024
AZ,2023-08-31,inter-ucfe,1,0,0,0,1,0,0,0,0,0,0,2,1,1,FALSE,0.5,2023,2023-2024
AZ,2023-08-31,inter-ucx,0,0,0,0,0,0,0,0,0,0,0,0,0,0,FALSE,0,2023,2023-2024
AZ,2023-08-31,inter-ui,64,35,17,12,2,3,0,1,0,10,14,158,78,113,FALSE,0.715189873417722,2023,2023-2024
AZ,2023-08-31,intra-total,2036,1160,466,199,114,63,42,20,15,163,611,4889,2647,3807,FALSE,0.778686848026181,2023,2023-2024
AZ,2023-08-31,intra-ucfe,0,5,4,6,3,3,1,2,2,2,2,30,2,7,FALSE,0.233333333333333,2023,2023-2024
AZ,2023-08-31,intra-ucx,0,0,3,1,2,0,0,0,0,0,1,7,1,1,FALSE,0.142857142857143,2023,2023-2024
AZ,2023-08-31,intra-ui,2036,1155,459,192,109,60,41,18,13,161,608,4852,2644,3799,FALSE,0.782976092333059,2023,2023-2024
AZ,2023-09-30,inter-total,50,10,22,14,4,3,1,1,1,5,16,127,66,76,FALSE,0.598425196850394,2023,2023-2024
AZ,2023-09-30,inter-ucfe,0,0,0,0,1,0,0,0,0,0,0,1,0,0,FALSE,0,2023,2023-2024
AZ,2023-09-30,inter-ucx,0,0,0,0,0,0,0,0,1,0,0,1,0,0,FALSE,0,2023,2023-2024
AZ,2023-09-30,inter-ui,50,10,22,14,3,3,1,1,0,5,16,125,66,76,FALSE,0.608,2023,2023-2024
AZ,2023-09-30,intra-total,1178,391,516,390,120,52,27,18,15,168,323,3198,1501,1892,FALSE,0.59161976235147,2023,2023-2024
AZ,2023-09-30,intra-ucfe,2,0,2,0,0,0,1,0,4,8,0,17,2,2,FALSE,0.117647058823529,2023,2023-2024
AZ,2023-09-30,intra-ucx,3,1,2,1,0,0,0,0,0,0,3,10,6,7,FALSE,0.7,2023,2023-2024
AZ,2023-09-30,intra-ui,1173,390,512,389,120,52,26,18,11,160,320,3171,1493,1883,FALSE,0.593818984547461,2023,2023-2024
AZ,2023-10-31,inter-total,60,5,13,14,4,4,1,0,1,6,13,121,73,78,FALSE,0.644628099173554,2023,2023-2024
AZ,2023-10-31,inter-ucfe,3,0,0,0,0,0,0,0,0,2,0,5,3,3,FALSE,0.6,2023,2023-2024
AZ,2023-10-31,inter-ucx,0,1,0,0,0,0,0,0,0,0,0,1,0,1,FALSE,1,2023,2023-2024
AZ,2023-10-31,inter-ui,57,4,13,14,4,4,1,0,1,4,13,115,70,74,FALSE,0.643478260869565,2023,2023-2024
AZ,2023-10-31,intra-total,1289,237,286,589,365,102,46,24,13,144,357,3452,1646,1883,FALSE,0.545480880648899,2023,2023-2024
AZ,2023-10-31,intra-ucfe,5,0,0,0,0,0,0,0,0,9,1,15,6,6,FALSE,0.4,2023,2023-2024
AZ,2023-10-31,intra-ucx,0,0,0,0,0,0,0,0,0,2,2,4,2,2,FALSE,0.5,2023,2023-2024
AZ,2023-10-31,intra-ui,1284,237,286,589,365,102,46,24,13,133,354,3433,1638,1875,FALSE,0.546169531022429,2023,2023-2024
AZ,2023-11-30,inter-total,53,5,7,5,9,8,1,0,0,12,15,115,68,73,FALSE,0.634782608695652,2023,2023-2024
AZ,2023-11-30,inter-ucfe,0,0,0,0,0,0,0,0,0,0,0,0,0,0,FALSE,0,2023,2023-2024
AZ,2023-11-30,inter-ucx,0,0,0,0,0,0,0,0,0,1,0,1,0,0,FALSE,0,2023,2023-2024
AZ,2023-11-30,inter-ui,53,5,7,5,9,8,1,0,0,11,15,114,68,73,FALSE,0.640350877192982,2023,2023-2024
AZ,2023-11-30,intra-total,1139,235,226,284,476,234,70,40,22,305,361,3392,1500,1735,FALSE,0.511497641509434,2023,2023-2024
AZ,2023-11-30,intra-ucfe,4,0,4,1,0,2,2,0,0,5,2,20,6,6,FALSE,0.3,2023,2023-2024
AZ,2023-11-30,intra-ucx,1,0,0,1,1,0,0,0,0,1,0,4,1,1,FALSE,0.25,2023,2023-2024
AZ,2023-11-30,intra-ui,1134,235,222,282,475,232,68,40,22,299,359,3368,1493,1728,FALSE,0.513064133016627,2023,2023-2024
AZ,2023-12-31,inter-total,67,12,14,8,16,8,3,0,2,7,11,148,78,90,FALSE,0.608108108108108,2023,2023-2024
AZ,2023-12-31,inter-ucfe,1,1,2,0,0,0,0,0,0,0,0,4,1,2,FALSE,0.5,2023,2023-2024
AZ,2023-12-31,inter-ucx,0,0,0,0,0,0,0,0,0,0,0,0,0,0,FALSE,0,2023,2023-2024
AZ,2023-12-31,inter-ui,66,11,12,8,16,8,3,0,2,7,11,144,77,88,FALSE,0.611111111111111,2023,2023-2024
AZ,2023-12-31,intra-total,953,241,242,248,503,372,100,47,24,181,259,3170,1212,1453,FALSE,0.458359621451104,2023,2023-2024
AZ,2023-12-31,intra-ucfe,2,1,2,1,0,0,3,1,0,6,2,18,4,5,FALSE,0.277777777777778,2023,2023-2024
AZ,2023-12-31,intra-ucx,0,1,1,1,0,0,0,0,0,0,1,4,1,2,FALSE,0.5,2023,2023-2024
AZ,2023-12-31,intra-ui,951,239,239,246,503,372,97,46,24,175,256,3148,1207,1446,FALSE,0.459339263024142,2023,2023-2024
AZ,2024-01-31,inter-total,65,6,8,10,10,16,2,1,2,9,16,145,81,87,FALSE,0.6,2023,2023-2024
AZ,2024-01-31,inter-ucfe,0,0,0,0,1,1,0,0,0,0,0,2,0,0,FALSE,0,2023,2023-2024
AZ,2024-01-31,inter-ucx,0,0,0,0,0,0,0,0,0,0,0,0,0,0,FALSE,0,2023,2023-2024
AZ,2024-01-31,inter-ui,65,6,8,10,9,15,2,1,2,9,16,143,81,87,FALSE,0.608391608391608,2023,2023-2024
AZ,2024-01-31,intra-total,1340,209,183,269,545,441,120,65,41,189,282,3684,1622,1831,FALSE,0.497014115092291,2023,2023-2024
AZ,2024-01-31,intra-ucfe,11,2,0,0,2,2,1,2,2,4,4,30,15,17,FALSE,0.566666666666667,2023,2023-2024
AZ,2024-01-31,intra-ucx,0,0,0,0,1,1,0,1,0,1,0,4,0,0,FALSE,0,2023,2023-2024
AZ,2024-01-31,intra-ui,1329,207,183,269,542,438,119,62,39,184,278,3650,1607,1814,FALSE,0.496986301369863,2023,2023-2024
AZ,2024-02-29,inter-total,53,7,11,16,15,13,2,0,2,5,10,134,63,70,FALSE,0.522388059701493,2023,2023-2024
AZ,2024-02-29,inter-ucfe,1,0,0,0,1,0,0,0,0,0,2,4,3,3,FALSE,0.75,2023,2023-2024
AZ,2024-02-29,inter-ucx,0,0,0,0,0,0,0,0,0,0,0,0,0,0,FALSE,0,2023,2023-2024
AZ,2024-02-29,inter-ui,52,7,11,16,14,13,2,0,2,5,8,130,60,67,FALSE,0.515384615384615,2023,2023-2024
AZ,2024-02-29,intra-total,1080,206,224,406,655,268,89,44,28,186,198,3384,1278,1484,FALSE,0.438534278959811,2023,2023-2024
AZ,2024-02-29,intra-ucfe,2,2,2,2,0,1,2,0,0,9,0,20,2,4,FALSE,0.2,2023,2023-2024
AZ,2024-02-29,intra-ucx,1,4,1,1,0,0,0,0,0,1,1,9,2,6,FALSE,0.666666666666667,2023,2023-2024
AZ,2024-02-29,intra-ui,1077,200,221,403,655,267,87,44,28,176,197,3355,1274,1474,FALSE,0.439344262295082,2023,2023-2024
AZ,2024-03-31,inter-total,46,11,5,8,7,8,3,0,0,6,22,116,68,79,FALSE,0.681034482758621,2023,2023-2024
AZ,2024-03-31,inter-ucfe,0,0,0,0,0,0,0,0,0,0,1,1,1,1,FALSE,1,2023,2023-2024
AZ,2024-03-31,inter-ucx,0,1,0,0,0,0,0,0,0,0,0,1,0,1,FALSE,1,2023,2023-2024
AZ,2024-03-31,inter-ui,46,10,5,8,7,8,3,0,0,6,21,114,67,77,FALSE,0.675438596491228,2023,2023-2024
AZ,2024-03-31,intra-total,1120,453,280,235,328,292,129,36,29,198,589,3689,1709,2162,FALSE,0.586066684738412,2023,2023-2024
AZ,2024-03-31,intra-ucfe,4,0,1,1,0,1,1,2,1,3,0,14,4,4,FALSE,0.285714285714286,2023,2023-2024
AZ,2024-03-31,intra-ucx,0,1,1,0,1,1,0,1,0,0,1,6,1,2,FALSE,0.333333333333333,2023,2023-2024
AZ,2024-03-31,intra-ui,1116,452,278,234,327,290,128,33,28,195,588,3669,1704,2156,FALSE,0.587626056146089,2023,2023-2024
AZ,2024-04-30,inter-total,66,18,8,6,7,0,2,2,3,12,24,148,90,108,FALSE,0.72972972972973,2023,2023-2024
AZ,2024-04-30,inter-ucfe,0,0,1,0,0,0,0,0,0,0,1,2,1,1,FALSE,0.5,2023,2023-2024
AZ,2024-04-30,inter-ucx,0,0,0,0,0,0,0,0,0,0,0,0,0,0,FALSE,0,2023,2023-2024
AZ,2024-04-30,inter-ui,66,18,7,6,7,0,2,2,3,12,23,146,89,107,FALSE,0.732876712328767,2023,2023-2024
AZ,2024-04-30,intra-total,2699,667,324,157,95,88,84,86,85,283,571,5139,3270,3937,FALSE,0.766102354543686,2023,2023-2024
AZ,2024-04-30,intra-ucfe,1,2,0,1,0,0,1,1,0,0,1,7,2,4,FALSE,0.571428571428571,2023,2023-2024
AZ,2024-04-30,intra-ucx,4,0,1,0,0,0,0,1,0,0,2,8,6,6,FALSE,0.75,2023,2023-2024
AZ,2024-04-30,intra-ui,2694,665,323,156,95,88,83,84,85,283,568,5124,3262,3927,FALSE,0.766393442622951,2023,2023-2024
AZ,2024-05-31,inter-total,110,16,21,14,5,7,7,2,0,30,14,226,124,140,FALSE,0.619469026548673,2023,2023-2024
AZ,2024-05-31,inter-ucfe,0,0,2,0,2,1,0,0,0,0,0,5,0,0,FALSE,0,2023,2023-2024
AZ,2024-05-31,inter-ucx,0,0,0,0,0,0,0,0,0,0,0,0,0,0,FALSE,0,2023,2023-2024
AZ,2024-05-31,inter-ui,110,16,19,14,3,6,7,2,0,30,14,221,124,140,FALSE,0.633484162895928,2023,2023-2024
AZ,2024-05-31,intra-total,2727,496,853,446,138,104,158,84,49,604,373,6032,3100,3596,FALSE,0.596153846153846,2023,2023-2024
AZ,2024-05-31,intra-ucfe,0,0,1,4,1,0,0,1,0,1,0,8,0,0,FALSE,0,2023,2023-2024
AZ,2024-05-31,intra-ucx,2,2,3,0,1,0,0,0,0,0,0,8,2,4,FALSE,0.5,2023,2023-2024
AZ,2024-05-31,intra-ui,2725,494,849,442,136,104,158,83,49,603,373,6016,3098,3592,FALSE,0.597074468085106,2023,2023-2024
AZ,2024-06-30,inter-total,67,8,24,15,4,5,3,4,0,9,10,149,77,85,FALSE,0.570469798657718,2023,2023-2024
AZ,2024-06-30,inter-ucfe,0,0,0,0,0,0,0,1,0,0,0,1,0,0,FALSE,0,2023,2023-2024
AZ,2024-06-30,inter-ucx,0,0,0,0,0,0,0,0,0,0,0,0,0,0,FALSE,0,2023,2023-2024
AZ,2024-06-30,inter-ui,67,8,24,15,4,5,3,3,0,9,10,148,77,85,FALSE,0.574324324324324,2023,2023-2024
AZ,2024-06-30,intra-total,2549,417,671,632,227,88,50,18,14,136,495,5297,3044,3461,FALSE,0.653388710590901,2023,2023-2024
AZ,2024-06-30,intra-ucfe,14,7,0,4,3,0,0,0,0,3,4,35,18,25,FALSE,0.714285714285714,2023,2023-2024
AZ,2024-06-30,intra-ucx,3,1,0,0,0,1,0,0,0,1,0,6,3,4,FALSE,0.666666666666667,2023,2023-2024
AZ,2024-06-30,intra-ui,2532,409,671,628,224,87,50,18,14,132,491,5256,3023,3432,FALSE,0.65296803652968,2023,2023-2024
AZ,2024-07-31,inter-total,92,9,16,12,6,4,1,1,0,10,24,175,116,125,FALSE,0.714285714285714,2024,2024-2025
AZ,2024-07-31,inter-ucfe,1,0,0,0,0,0,0,0,0,2,0,3,1,1,FALSE,0.333333333333333,2024,2024-2025
AZ,2024-07-31,inter-ucx,0,1,0,0,0,0,0,0,0,0,0,1,0,1,FALSE,1,2024,2024-2025
AZ,2024-07-31,inter-ui,91,8,16,12,6,4,1,1,0,8,24,171,115,123,FALSE,0.719298245614035,2024,2024-2025
AZ,2024-07-31,intra-total,3696,535,898,451,180,120,67,37,31,172,648,6835,4344,4879,FALSE,0.713825896122897,2024,2024-2025
AZ,2024-07-31,intra-ucfe,50,1,4,2,0,1,0,1,0,6,7,72,57,58,FALSE,0.805555555555556,2024,2024-2025
AZ,2024-07-31,intra-ucx,0,5,2,2,0,0,0,0,0,0,4,13,4,9,FALSE,0.692307692307692,2024,2024-2025
AZ,2024-07-31,intra-ui,3646,529,892,447,180,119,67,36,31,166,637,6750,4283,4812,FALSE,0.712888888888889,2024,2024-2025
AZ,2024-08-31,inter-total,84,20,16,11,5,4,1,2,0,10,17,170,101,121,FALSE,0.711764705882353,2024,2024-2025
AZ,2024-08-31,inter-ucfe,1,1,0,0,0,0,0,0,0,0,0,2,1,2,FALSE,1,2024,2024-2025
AZ,2024-08-31,inter-ucx,0,0,0,0,0,0,0,0,0,0,0,0,0,0,FALSE,0,2024,2024-2025
AZ,2024-08-31,inter-ui,83,19,16,11,5,4,1,2,0,10,17,168,100,119,FALSE,0.708333333333333,2024,2024-2025
AZ,2024-08-31,intra-total,1969,522,825,462,190,111,61,21,16,119,607,4903,2576,3098,FALSE,0.631858046094228,2024,2024-2025
AZ,2024-08-31,intra-ucfe,1,2,6,5,2,2,0,0,0,2,4,24,5,7,FALSE,0.291666666666667,2024,2024-2025
AZ,2024-08-31,intra-ucx,4,1,1,0,0,0,0,0,0,1,4,11,8,9,FALSE,0.818181818181818,2024,2024-2025
AZ,2024-08-31,intra-ui,1964,519,818,457,188,109,61,21,16,116,599,4868,2563,3082,FALSE,0.633114215283484,2024,2024-2025
AZ,2024-09-30,inter-total,57,20,8,12,10,6,2,0,2,5,18,140,75,95,FALSE,0.678571428571429,2024,2024-2025
AZ,2024-09-30,inter-ucfe,0,0,0,0,0,0,0,0,0,0,0,0,0,0,FALSE,0,2024,2024-2025
AZ,2024-09-30,inter-ucx,0,0,0,0,0,0,0,0,0,0,0,0,0,0,FALSE,0,2024,2024-2025
AZ,2024-09-30,inter-ui,57,20,8,12,10,6,2,0,2,5,18,140,75,95,FALSE,0.678571428571429,2024,2024-2025
AZ,2024-09-30,intra-total,1430,519,378,586,267,109,42,33,20,160,707,4251,2137,2656,FALSE,0.62479416607857,2024,2024-2025
AZ,2024-09-30,intra-ucfe,2,1,2,1,0,0,0,1,0,1,0,8,2,3,FALSE,0.375,2024,2024-2025
AZ,2024-09-30,intra-ucx,6,0,0,0,0,0,0,0,0,1,2,9,8,8,FALSE,0.888888888888889,2024,2024-2025
AZ,2024-09-30,intra-ui,1422,518,376,585,267,109,42,32,20,158,705,4234,2127,2645,FALSE,0.62470477090222,2024,2024-2025
AZ,2024-10-31,inter-total,49,28,10,11,7,6,1,1,0,5,32,150,81,109,FALSE,0.726666666666667,2024,2024-2025
AZ,2024-10-31,inter-ucfe,2,1,0,0,0,1,0,0,0,0,0,4,2,3,FALSE,0.75,2024,2024-2025
AZ,2024-10-31,inter-ucx,0,0,0,0,0,0,0,0,0,0,0,0,0,0,FALSE,0,2024,2024-2025
AZ,2024-10-31,inter-ui,47,27,10,11,7,5,1,1,0,5,32,146,79,106,FALSE,0.726027397260274,2024,2024-2025
AZ,2024-10-31,intra-total,1358,784,241,236,254,126,39,32,23,105,1076,4274,2434,3218,FALSE,0.752924660739354,2024,2024-2025
AZ,2024-10-31,intra-ucfe,4,3,0,0,0,2,0,1,1,0,1,12,5,8,FALSE,0.666666666666667,2024,2024-2025
AZ,2024-10-31,intra-ucx,4,0,0,2,0,0,0,0,0,0,2,8,6,6,FALSE,0.75,2024,2024-2025
AZ,2024-10-31,intra-ui,1350,781,241,234,254,124,39,31,22,105,1073,4254,2423,3204,FALSE,0.753173483779972,2024,2024-2025
AZ,2024-11-30,inter-total,60,16,6,1,1,0,0,2,0,5,45,136,105,121,FALSE,0.889705882352941,2024,2024-2025
AZ,2024-11-30,inter-ucfe,4,0,0,0,0,0,0,0,0,0,3,7,7,7,FALSE,1,2024,2024-2025
AZ,2024-11-30,inter-ucx,0,0,0,0,0,0,0,0,0,0,0,0,0,0,FALSE,0,2024,2024-2025
AZ,2024-11-30,inter-ui,56,16,6,1,1,0,0,2,0,5,42,129,98,114,FALSE,0.883720930232558,2024,2024-2025
AZ,2024-11-30,intra-total,1394,474,233,90,40,18,13,14,9,95,1154,3534,2548,3022,FALSE,0.855121675155631,2024,2024-2025
AZ,2024-11-30,intra-ucfe,9,4,5,1,1,1,2,1,1,1,2,28,11,15,FALSE,0.535714285714286,2024,2024-2025
AZ,2024-11-30,intra-ucx,5,1,0,0,1,0,0,0,0,0,4,11,9,10,FALSE,0.909090909090909,2024,2024-2025
AZ,2024-11-30,intra-ui,1380,469,228,89,38,17,11,13,8,94,1148,3495,2528,2997,FALSE,0.857510729613734,2024,2024-2025
AZ,2024-12-31,inter-total,108,9,6,1,3,2,0,0,0,7,36,172,144,153,FALSE,0.88953488372093,2024,2024-2025
AZ,2024-12-31,inter-ucfe,1,1,0,0,0,0,0,0,0,0,1,3,2,3,FALSE,1,2024,2024-2025
AZ,2024-12-31,inter-ucx,0,0,0,0,0,0,0,0,0,0,0,0,0,0,FALSE,0,2024,2024-2025
AZ,2024-12-31,inter-ui,107,8,6,1,3,2,0,0,0,7,35,169,142,150,FALSE,0.887573964497041,2024,2024-2025
AZ,2024-12-31,intra-total,1784,294,128,71,29,26,9,9,1,87,1097,3535,2881,3175,FALSE,0.898161244695898,2024,2024-2025
AZ,2024-12-31,intra-ucfe,12,0,0,1,0,1,0,0,0,0,3,17,15,15,FALSE,0.882352941176471,2024,2024-2025
AZ,2024-12-31,intra-ucx,3,1,1,0,0,0,0,0,0,0,1,6,4,5,FALSE,0.833333333333333,2024,2024-2025
AZ,2024-12-31,intra-ui,1769,293,127,70,29,25,9,9,1,87,1093,3512,2862,3155,FALSE,0.898348519362187,2024,2024-2025
CA,2019-01-31,inter-total,2932,245,94,34,35,18,11,8,2,3,563,3945,3495,3740,FALSE,0.948035487959442,2018,2018-2019
CA,2019-01-31,inter-ucfe,44,25,8,1,0,0,0,0,0,0,30,108,74,99,FALSE,0.916666666666667,2018,2018-2019
CA,2019-01-31,inter-ucx,1,1,0,1,1,0,0,0,0,0,0,4,1,2,FALSE,0.5,2018,2018-2019
CA,2019-01-31,inter-ui,2887,219,86,32,34,18,11,8,2,3,533,3833,3420,3639,FALSE,0.949386903208975,2018,2018-2019
CA,2019-01-31,intra-total,47773,11989,5907,2670,1206,683,355,228,166,387,28422,99786,76195,88184,FALSE,0.883731184735334,2018,2018-2019
CA,2019-01-31,intra-ucfe,1335,610,310,16,5,4,2,0,1,2,922,3207,2257,2867,FALSE,0.893981914561896,2018,2018-2019
CA,2019-01-31,intra-ucx,80,26,23,7,4,4,0,3,1,2,70,220,150,176,FALSE,0.8,2018,2018-2019
CA,2019-01-31,intra-ui,46358,11353,5574,2647,1197,675,353,225,164,383,27430,96359,73788,85141,FALSE,0.883581191170519,2018,2018-2019
CA,2019-02-28,inter-total,1413,193,94,33,23,10,4,5,0,9,472,2256,1885,2078,FALSE,0.921099290780142,2018,2018-2019
CA,2019-02-28,inter-ucfe,7,8,6,4,3,0,0,0,0,2,11,41,18,26,FALSE,0.634146341463415,2018,2018-2019
CA,2019-02-28,inter-ucx,2,1,0,0,0,0,0,0,0,0,0,3,2,3,FALSE,1,2018,2018-2019
CA,2019-02-28,inter-ui,1404,184,88,29,20,10,4,5,0,7,461,2212,1865,2049,FALSE,0.926311030741411,2018,2018-2019
CA,2019-02-28,intra-total,35860,9738,4500,1908,968,552,329,227,105,446,23362,77995,59222,68960,FALSE,0.884159240976986,2018,2018-2019
CA,2019-02-28,intra-ucfe,111,70,57,67,40,10,8,0,1,4,106,474,217,287,FALSE,0.605485232067511,2018,2018-2019
CA,2019-02-28,intra-ucx,74,33,12,2,6,3,1,0,0,0,66,197,140,173,FALSE,0.878172588832487,2018,2018-2019
CA,2019-02-28,intra-ui,35675,9635,4431,1839,922,539,320,227,104,442,23190,77324,58865,68500,FALSE,0.885882778956081,2018,2018-2019
CA,2019-03-31,inter-total,301,112,75,25,37,16,9,3,4,9,330,921,631,743,FALSE,0.806731813246471,2018,2018-2019
CA,2019-03-31,inter-ucfe,6,3,2,1,1,0,2,0,1,1,7,24,13,16,FALSE,0.666666666666667,2018,2018-2019
CA,2019-03-31,inter-ucx,0,0,0,0,0,0,0,0,0,0,1,1,1,1,FALSE,1,2018,2018-2019
CA,2019-03-31,inter-ui,295,109,73,24,36,16,7,3,3,8,322,896,617,726,FALSE,0.810267857142857,2018,2018-2019
CA,2019-03-31,intra-total,30776,6813,3694,1734,1105,768,445,250,190,499,18419,64693,49195,56008,FALSE,0.865750544881208,2018,2018-2019
CA,2019-03-31,intra-ucfe,62,26,18,7,11,8,3,6,4,15,53,213,115,141,FALSE,0.661971830985916,2018,2018-2019
CA,2019-03-31,intra-ucx,103,35,15,8,4,5,3,2,0,2,66,243,169,204,FALSE,0.839506172839506,2018,2018-2019
CA,2019-03-31,intra-ui,30611,6752,3661,1719,1090,755,439,242,186,482,18300,64237,48911,55663,FALSE,0.866525522673848,2018,2018-2019
CA,2019-04-30,inter-total,542,159,76,41,18,11,9,5,3,11,426,1301,968,1127,FALSE,0.866256725595696,2018,2018-2019
CA,2019-04-30,inter-ucfe,3,0,1,1,0,0,0,0,0,2,3,10,6,6,FALSE,0.6,2018,2018-2019
CA,2019-04-30,inter-ucx,1,1,0,0,1,0,0,0,0,2,0,5,1,2,FALSE,0.4,2018,2018-2019
CA,2019-04-30,inter-ui,538,158,75,40,17,11,9,5,3,7,423,1286,961,1119,FALSE,0.870139968895801,2018,2018-2019
CA,2019-04-30,intra-total,27544,6686,3195,1496,782,447,318,232,170,524,16680,58074,44224,50910,FALSE,0.8766401487757,2018,2018-2019
CA,2019-04-30,intra-ucfe,63,21,20,6,1,3,2,2,0,4,33,155,96,117,FALSE,0.754838709677419,2018,2018-2019
CA,2019-04-30,intra-ucx,101,30,13,7,2,3,2,2,2,2,60,224,161,191,FALSE,0.852678571428571,2018,2018-2019
CA,2019-04-30,intra-ui,27380,6635,3162,1483,779,441,314,228,168,518,16587,57695,43967,50602,FALSE,0.87706040384782,2018,2018-2019
CA,2019-05-31,inter-total,513,237,102,41,31,26,22,15,6,21,601,1615,1114,1351,FALSE,0.836532507739938,2018,2018-2019
CA,2019-05-31,inter-ucfe,0,1,0,1,0,0,0,0,0,0,2,4,2,3,FALSE,0.75,2018,2018-2019
CA,2019-05-31,inter-ucx,0,1,0,1,1,0,0,0,1,0,0,4,0,1,FALSE,0.25,2018,2018-2019
CA,2019-05-31,inter-ui,513,235,102,39,30,26,22,15,5,21,599,1607,1112,1347,FALSE,0.838207840696951,2018,2018-2019
CA,2019-05-31,intra-total,26975,7137,3400,1429,708,438,338,225,157,540,16441,57788,43416,50553,FALSE,0.874800996746729,2018,2018-2019
CA,2019-05-31,intra-ucfe,60,18,8,5,1,2,1,4,0,7,23,129,83,101,FALSE,0.782945736434109,2018,2018-2019
CA,2019-05-31,intra-ucx,89,35,8,8,8,2,0,1,0,3,73,227,162,197,FALSE,0.86784140969163,2018,2018-2019
CA,2019-05-31,intra-ui,26826,7084,3384,1416,699,434,337,220,157,530,16345,57432,43171,50255,FALSE,0.875034823791614,2018,2018-2019
CA,2019-06-30,inter-total,233,144,72,39,18,18,12,8,6,10,391,951,624,768,FALSE,0.807570977917981,2018,2018-2019
CA,2019-06-30,inter-ucfe,2,1,1,1,0,0,0,0,0,0,0,5,2,3,FALSE,0.6,2018,2018-2019
CA,2019-06-30,inter-ucx,0,2,0,0,0,0,0,0,0,0,2,4,2,4,FALSE,1,2018,2018-2019
CA,2019-06-30,inter-ui,231,141,71,38,18,18,12,8,6,10,389,942,620,761,FALSE,0.807855626326964,2018,2018-2019
CA,2019-06-30,intra-total,27610,5404,2668,1173,644,384,224,167,102,360,14115,52851,41725,47129,FALSE,0.891733363607122,2018,2018-2019
CA,2019-06-30,intra-ucfe,61,20,8,6,2,1,1,1,0,4,41,145,102,122,FALSE,0.841379310344828,2018,2018-2019
CA,2019-06-30,intra-ucx,108,24,8,10,4,2,1,1,0,1,50,209,158,182,FALSE,0.870813397129187,2018,2018-2019
CA,2019-06-30,intra-ui,27441,5360,2652,1157,638,381,222,165,102,355,14024,52497,41465,46825,FALSE,0.891955730803665,2018,2018-2019
CA,2019-07-31,inter-total,351,169,65,45,25,16,9,14,5,23,421,1143,772,941,FALSE,0.823272090988627,2019,2019-2020
CA,2019-07-31,inter-ucfe,1,3,2,0,0,0,0,0,0,1,0,7,1,4,FALSE,0.571428571428571,2019,2019-2020
CA,2019-07-31,inter-ucx,1,2,1,0,0,0,0,0,0,0,2,6,3,5,FALSE,0.833333333333333,2019,2019-2020
CA,2019-07-31,inter-ui,349,164,62,45,25,16,9,14,5,22,419,1130,768,932,FALSE,0.824778761061947,2019,2019-2020
CA,2019-07-31,intra-total,30982,9360,4563,1898,892,462,262,185,125,419,17462,66610,48444,57804,FALSE,0.867797627983786,2019,2019-2020
CA,2019-07-31,intra-ucfe,108,22,10,7,5,0,0,0,0,4,47,203,155,177,FALSE,0.87192118226601,2019,2019-2020
CA,2019-07-31,intra-ucx,97,28,21,11,7,4,5,0,1,1,64,239,161,189,FALSE,0.790794979079498,2019,2019-2020
CA,2019-07-31,intra-ui,30777,9310,4532,1880,880,458,257,185,124,414,17351,66168,48128,57438,FALSE,0.868063112078346,2019,2019-2020
CA,2019-08-31,inter-total,173,186,117,53,33,10,14,8,5,21,376,996,549,735,FALSE,0.737951807228916,2019,2019-2020
CA,2019-08-31,inter-ucfe,1,3,1,0,0,1,0,1,0,1,0,8,1,4,FALSE,0.5,2019,2019-2020
CA,2019-08-31,inter-ucx,3,2,0,0,0,0,0,0,0,0,1,6,4,6,FALSE,1,2019,2019-2020
CA,2019-08-31,inter-ui,169,181,116,53,33,9,14,7,5,20,375,982,544,725,FALSE,0.738289205702648,2019,2019-2020
CA,2019-08-31,intra-total,25030,7925,4375,1971,1079,555,371,219,130,488,16184,58327,41214,49139,FALSE,0.842474325783942,2019,2019-2020
CA,2019-08-31,intra-ucfe,100,32,22,8,4,1,3,0,0,2,64,236,164,196,FALSE,0.830508474576271,2019,2019-2020
CA,2019-08-31,intra-ucx,104,25,15,8,4,1,2,0,1,1,56,217,160,185,FALSE,0.852534562211982,2019,2019-2020
CA,2019-08-31,intra-ui,24826,7868,4338,1955,1071,553,366,219,129,485,16064,57874,40890,48758,FALSE,0.842485399315755,2019,2019-2020
CA,2019-09-30,inter-total,167,125,63,36,26,26,7,2,11,14,259,736,426,551,FALSE,0.748641304347826,2019,2019-2020
CA,2019-09-30,inter-ucfe,0,3,0,0,0,0,0,0,1,0,2,6,2,5,FALSE,0.833333333333333,2019,2019-2020
CA,2019-09-30,inter-ucx,0,0,2,0,0,0,0,0,0,0,2,4,2,2,FALSE,0.5,2019,2019-2020
CA,2019-09-30,inter-ui,167,122,61,36,26,26,7,2,10,14,255,726,422,544,FALSE,0.74931129476584,2019,2019-2020
CA,2019-09-30,intra-total,23125,5619,3097,1319,670,468,283,172,117,359,12930,48159,36055,41674,FALSE,0.865341888328246,2019,2019-2020
CA,2019-09-30,intra-ucfe,108,19,10,4,2,4,1,1,0,2,28,179,136,155,FALSE,0.865921787709497,2019,2019-2020
CA,2019-09-30,intra-ucx,99,30,8,12,7,2,1,2,2,3,56,222,155,185,FALSE,0.833333333333333,2019,2019-2020
CA,2019-09-30,intra-ui,22918,5570,3079,1303,661,462,281,169,115,354,12846,47758,35764,41334,FALSE,0.865488504543741,2019,2019-2020
CA,2019-10-31,inter-total,240,133,58,25,23,16,6,4,9,17,304,835,544,677,FALSE,0.810778443113773,2019,2019-2020
CA,2019-10-31,inter-ucfe,2,0,0,0,2,0,0,0,0,1,5,10,7,7,FALSE,0.7,2019,2019-2020
CA,2019-10-31,inter-ucx,3,1,1,0,0,0,0,0,0,0,1,6,4,5,FALSE,0.833333333333333,2019,2019-2020
CA,2019-10-31,inter-ui,235,132,57,25,21,16,6,4,9,16,298,819,533,665,FALSE,0.811965811965812,2019,2019-2020
CA,2019-10-31,intra-total,26853,5092,2404,989,536,348,212,152,89,420,15219,52314,42072,47164,FALSE,0.90155598883664,2019,2019-2020
CA,2019-10-31,intra-ucfe,99,11,9,8,2,0,0,3,0,5,48,185,147,158,FALSE,0.854054054054054,2019,2019-2020
CA,2019-10-31,intra-ucx,99,40,16,5,6,4,1,2,0,2,64,239,163,203,FALSE,0.849372384937239,2019,2019-2020
CA,2019-10-31,intra-ui,26655,5041,2379,976,528,344,211,147,89,413,15107,51890,41762,46803,FALSE,0.901965696666024,2019,2019-2020
CA,2019-11-30,inter-total,231,133,57,27,25,5,1,8,6,12,298,803,529,662,FALSE,0.824408468244085,2019,2019-2020
CA,2019-11-30,inter-ucfe,6,3,0,0,0,0,0,0,0,1,4,14,10,13,FALSE,0.928571428571429,2019,2019-2020
CA,2019-11-30,inter-ucx,1,1,2,1,0,0,0,0,0,0,0,5,1,2,FALSE,0.4,2019,2019-2020
CA,2019-11-30,inter-ui,224,129,55,26,25,5,1,8,6,11,294,784,518,647,FALSE,0.825255102040816,2019,2019-2020
CA,2019-11-30,intra-total,29092,6229,2573,946,490,287,166,118,72,289,15310,55572,44402,50631,FALSE,0.911088317857914,2019,2019-2020
CA,2019-11-30,intra-ucfe,95,17,6,6,7,1,1,1,1,4,49,188,144,161,FALSE,0.856382978723404,2019,2019-2020
CA,2019-11-30,intra-ucx,65,23,12,4,4,5,3,1,0,5,32,154,97,120,FALSE,0.779220779220779,2019,2019-2020
CA,2019-11-30,intra-ui,28932,6189,2555,936,479,281,162,116,71,280,15229,55230,44161,50350,FALSE,0.911642223429296,2019,2019-2020
CA,2019-12-31,inter-total,165,184,77,46,21,14,13,7,4,15,277,823,442,626,FALSE,0.760631834750911,2019,2019-2020
CA,2019-12-31,inter-ucfe,5,5,5,2,1,0,0,0,1,1,6,26,11,16,FALSE,0.615384615384615,2019,2019-2020
CA,2019-12-31,inter-ucx,0,2,0,0,0,0,0,0,0,0,0,2,0,2,FALSE,1,2019,2019-2020
CA,2019-12-31,inter-ui,160,177,72,44,20,14,13,7,3,14,271,795,431,608,FALSE,0.764779874213837,2019,2019-2020
CA,2019-12-31,intra-total,35504,10280,4821,1888,829,486,286,174,96,331,21506,76201,57010,67290,FALSE,0.883059277437304,2019,2019-2020
CA,2019-12-31,intra-ucfe,112,52,25,6,5,5,3,0,0,3,103,314,215,267,FALSE,0.85031847133758,2019,2019-2020
CA,2019-12-31,intra-ucx,60,32,21,8,5,3,2,1,2,4,41,179,101,133,FALSE,0.743016759776536,2019,2019-2020
CA,2019-12-31,intra-ui,35332,10196,4775,1874,819,478,281,173,94,324,21362,75708,56694,66890,FALSE,0.883526179531886,2019,2019-2020
CA,2020-01-31,inter-total,237,205,105,61,28,31,6,10,8,26,326,1043,563,768,FALSE,0.73633748801534,2019,2019-2020
CA,2020-01-31,inter-ucfe,6,12,2,2,0,0,0,0,0,0,15,37,21,33,FALSE,0.891891891891892,2019,2019-2020
CA,2020-01-31,inter-ucx,0,0,1,0,0,0,0,0,0,0,0,1,0,0,FALSE,0,2019,2019-2020
CA,2020-01-31,inter-ui,231,193,102,59,28,31,6,10,8,26,311,1005,542,735,FALSE,0.73134328358209,2019,2019-2020
CA,2020-01-31,intra-total,42572,12069,5939,2637,1240,755,424,217,164,537,25295,91849,67867,79936,FALSE,0.87029798909079,2019,2019-2020
CA,2020-01-31,intra-ucfe,182,128,29,10,7,5,3,4,1,5,321,695,503,631,FALSE,0.907913669064748,2019,2019-2020
CA,2020-01-31,intra-ucx,47,27,13,7,5,5,1,2,1,1,39,148,86,113,FALSE,0.763513513513514,2019,2019-2020
CA,2020-01-31,intra-ui,42343,11914,5897,2620,1228,745,420,211,162,531,24935,91006,67278,79192,FALSE,0.870184383447245,2019,2019-2020
CA,2020-02-29,inter-total,113,176,102,44,27,16,18,5,6,27,229,763,342,518,FALSE,0.678899082568807,2019,2019-2020
CA,2020-02-29,inter-ucfe,6,5,3,4,2,0,0,0,0,3,4,27,10,15,FALSE,0.555555555555556,2019,2019-2020
CA,2020-02-29,inter-ucx,1,0,0,0,0,0,0,0,0,0,1,2,2,2,FALSE,1,2019,2019-2020
CA,2020-02-29,inter-ui,106,171,99,40,25,16,18,5,6,24,224,734,330,501,FALSE,0.682561307901907,2019,2019-2020
CA,2020-02-29,intra-total,32071,9504,4635,2148,1150,672,420,236,149,500,18673,70158,50744,60248,FALSE,0.858747398728584,2019,2019-2020
CA,2020-02-29,intra-ucfe,68,75,53,19,12,3,1,3,1,4,110,349,178,253,FALSE,0.724928366762178,2019,2019-2020
CA,2020-02-29,intra-ucx,61,19,17,8,4,1,1,0,0,3,36,150,97,116,FALSE,0.773333333333333,2019,2019-2020
CA,2020-02-29,intra-ui,31942,9410,4565,2121,1134,668,418,233,148,493,18527,69659,50469,59879,FALSE,0.859601774357944,2019,2019-2020
CA,2020-03-31,inter-total,261,177,90,62,49,22,25,10,9,91,509,1305,770,947,FALSE,0.725670498084291,2019,2019-2020
CA,2020-03-31,inter-ucfe,3,6,3,0,1,3,0,0,1,1,6,24,9,15,FALSE,0.625,2019,2019-2020
CA,2020-03-31,inter-ucx,1,0,0,0,0,0,0,0,0,1,2,4,3,3,FALSE,0.75,2019,2019-2020
CA,2020-03-31,inter-ui,257,171,87,62,48,19,25,10,8,89,501,1277,758,929,FALSE,0.727486296006265,2019,2019-2020
CA,2020-03-31,intra-total,67628,12246,4572,2054,1221,907,578,389,304,2447,112968,205314,180596,192842,FALSE,0.939254020670777,2019,2019-2020
CA,2020-03-31,intra-ucfe,64,26,14,8,9,10,12,4,2,37,78,264,142,168,FALSE,0.636363636363636,2019,2019-2020
CA,2020-03-31,intra-ucx,63,32,11,6,6,6,2,3,0,10,59,198,122,154,FALSE,0.777777777777778,2019,2019-2020
CA,2020-03-31,intra-ui,67501,12188,4547,2040,1206,891,564,382,302,2400,112831,204852,180332,192520,FALSE,0.939800441294203,2019,2019-2020
CA,2020-04-30,inter-total,152,2096,1289,735,371,113,14,4,11,28,6308,11121,6460,8556,FALSE,0.769355273806312,2019,2019-2020
CA,2020-04-30,inter-ucfe,0,2,2,0,2,1,0,0,0,0,3,10,3,5,FALSE,0.5,2019,2019-2020
CA,2020-04-30,inter-ucx,0,0,2,1,0,0,0,0,0,0,0,3,0,0,FALSE,0,2019,2019-2020
CA,2020-04-30,inter-ui,152,2094,1285,734,369,112,14,4,11,28,6305,11108,6457,8551,FALSE,0.769805545552755,2019,2019-2020
CA,2020-04-30,intra-total,72224,431007,186905,89042,62875,8907,867,458,414,2023,1141759,1996481,1213983,1644990,FALSE,0.823944730753761,2019,2019-2020
CA,2020-04-30,intra-ucfe,10,57,49,43,20,8,6,1,0,4,44,242,54,111,FALSE,0.458677685950413,2019,2019-2020
CA,2020-04-30,intra-ucx,8,118,120,104,50,22,7,1,1,5,82,518,90,208,FALSE,0.401544401544402,2019,2019-2020
CA,2020-04-30,intra-ui,72206,430832,186736,88895,62805,8877,854,456,413,2014,1141633,1995721,1213839,1644671,FALSE,0.824098659081104,2019,2019-2020
CA,2020-05-31,inter-total,171,1069,399,931,1212,626,236,107,53,91,4860,9755,5031,6100,FALSE,0.625320348539211,2019,2019-2020
CA,2020-05-31,inter-ucfe,0,0,0,0,0,0,0,0,0,1,0,1,0,0,FALSE,0,2019,2019-2020
CA,2020-05-31,inter-ucx,0,0,2,0,0,0,0,0,0,0,0,2,0,0,FALSE,0,2019,2019-2020
CA,2020-05-31,inter-ui,171,1069,397,931,1212,626,236,107,53,90,4860,9752,5031,6100,FALSE,0.625512715340443,2019,2019-2020
CA,2020-05-31,intra-total,23852,161407,21106,13352,11822,10666,6384,4668,2758,3943,531200,791158,555052,716459,FALSE,0.905582702822951,2019,2019-2020
CA,2020-05-31,intra-ucfe,2,15,15,21,32,23,8,4,4,16,25,165,27,42,FALSE,0.254545454545455,2019,2019-2020
CA,2020-05-31,intra-ucx,2,70,37,34,34,24,35,17,7,18,140,418,142,212,FALSE,0.507177033492823,2019,2019-2020
CA,2020-05-31,intra-ui,23848,161322,21054,13297,11756,10619,6341,4647,2747,3909,531035,790575,554883,716205,FALSE,0.905929228725927,2019,2019-2020
CA,2020-06-30,inter-total,261,1066,957,888,711,749,549,314,288,716,1764,8263,2025,3091,FALSE,0.374077211666465,2019,2019-2020
CA,2020-06-30,inter-ucfe,0,0,0,0,0,0,0,1,0,1,0,2,0,0,FALSE,0,2019,2019-2020
CA,2020-06-30,inter-ucx,0,0,0,0,0,0,0,0,0,2,2,4,2,2,FALSE,0.5,2019,2019-2020
CA,2020-06-30,inter-ui,261,1066,957,888,711,749,549,313,288,713,1762,8257,2023,3089,FALSE,0.374106818457067,2019,2019-2020
CA,2020-06-30,intra-total,37224,57141,41257,26943,14383,14455,9057,8780,8377,25728,190213,433558,227437,284578,FALSE,0.656378154710558,2019,2019-2020
CA,2020-06-30,intra-ucfe,7,10,8,6,6,11,12,5,5,27,19,116,26,36,FALSE,0.310344827586207,2019,2019-2020
CA,2020-06-30,intra-ucx,4,13,16,17,10,16,17,13,12,83,38,239,42,55,FALSE,0.230125523012552,2019,2019-2020
CA,2020-06-30,intra-ui,37213,57118,41233,26920,14367,14428,9028,8762,8360,25618,190156,433203,227369,284487,FALSE,0.656705978490454,2019,2019-2020
CA,2020-07-31,inter-total,58,844,587,273,166,129,121,104,93,698,2047,5120,2105,2949,FALSE,0.5759765625,2020,2020-2021
CA,2020-07-31,inter-ucfe,0,0,0,0,0,0,0,0,0,3,0,3,0,0,FALSE,0,2020,2020-2021
CA,2020-07-31,inter-ucx,0,0,0,0,0,0,0,1,1,5,0,7,0,0,FALSE,0,2020,2020-2021
CA,2020-07-31,inter-ui,58,844,587,273,166,129,121,103,92,690,2047,5110,2105,2949,FALSE,0.577103718199609,2020,2020-2021
CA,2020-07-31,intra-total,15092,39924,20822,13098,7349,6232,5314,4838,3648,30081,191558,337956,206650,246574,FALSE,0.72960385375611,2020,2020-2021
CA,2020-07-31,intra-ucfe,3,8,10,10,13,10,11,10,10,89,25,199,28,36,FALSE,0.180904522613065,2020,2020-2021
CA,2020-07-31,intra-ucx,1,10,12,19,10,14,17,22,37,172,50,364,51,61,FALSE,0.167582417582418,2020,2020-2021
CA,2020-07-31,intra-ui,15088,39906,20800,13069,7326,6208,5286,4806,3601,29820,191483,337393,206571,246477,FALSE,0.730533828502666,2020,2020-2021
CA,2020-08-31,inter-total,42,431,411,203,129,86,43,51,40,447,366,2249,408,839,FALSE,0.373054690973766,2020,2020-2021
CA,2020-08-31,inter-ucfe,0,0,0,0,0,1,0,2,0,2,1,6,1,1,FALSE,0.166666666666667,2020,2020-2021
CA,2020-08-31,inter-ucx,0,1,0,1,0,0,0,0,0,0,0,2,0,1,FALSE,0.5,2020,2020-2021
CA,2020-08-31,inter-ui,42,430,411,202,129,85,43,49,40,445,365,2241,407,837,FALSE,0.373493975903614,2020,2020-2021
CA,2020-08-31,intra-total,9692,28372,19102,12161,7402,5390,3448,3269,2856,27703,125598,244993,135290,163662,FALSE,0.668027249758156,2020,2020-2021
CA,2020-08-31,intra-ucfe,0,1,1,4,4,6,3,4,5,91,18,137,18,19,FALSE,0.138686131386861,2020,2020-2021
CA,2020-08-31,intra-ucx,1,1,7,3,2,8,11,15,19,142,24,233,25,26,FALSE,0.111587982832618,2020,2020-2021
CA,2020-08-31,intra-ui,9691,28370,19094,12154,7396,5376,3434,3250,2832,27470,125556,244623,135247,163617,FALSE,0.668853705497848,2020,2020-2021
CA,2020-09-30,inter-total,13,62,80,50,59,88,81,63,43,329,82,950,95,157,FALSE,0.165263157894737,2020,2020-2021
CA,2020-09-30,inter-ucfe,0,1,0,0,0,0,1,1,1,6,1,11,1,2,FALSE,0.181818181818182,2020,2020-2021
CA,2020-09-30,inter-ucx,0,0,0,0,0,0,0,0,1,9,0,10,0,0,FALSE,0,2020,2020-2021
CA,2020-09-30,inter-ui,13,61,80,50,59,88,80,62,41,314,81,929,94,155,FALSE,0.166846071044134,2020,2020-2021
CA,2020-09-30,intra-total,5259,20399,10820,8762,4926,3786,3370,2867,2376,23582,75252,161399,80511,100910,FALSE,0.625220726274636,2020,2020-2021
CA,2020-09-30,intra-ucfe,5,6,6,0,3,3,5,7,3,85,23,146,28,34,FALSE,0.232876712328767,2020,2020-2021
CA,2020-09-30,intra-ucx,3,7,9,4,12,13,16,22,19,329,25,459,28,35,FALSE,0.0762527233115468,2020,2020-2021
CA,2020-09-30,intra-ui,5251,20386,10805,8758,4911,3770,3349,2838,2354,23168,75204,160794,80455,100841,FALSE,0.62714404766347,2020,2020-2021
CA,2020-10-31,inter-total,8,26,110,229,141,151,180,230,88,581,49,1793,57,83,FALSE,0.0462911321807027,2020,2020-2021
CA,2020-10-31,inter-ucfe,0,0,0,0,2,0,0,0,0,10,0,12,0,0,FALSE,0,2020,2020-2021
CA,2020-10-31,inter-ucx,0,0,0,0,0,0,0,1,0,7,0,8,0,0,FALSE,0,2020,2020-2021
CA,2020-10-31,inter-ui,8,26,110,229,139,151,180,229,88,564,49,1773,57,83,FALSE,0.0468133107727016,2020,2020-2021
CA,2020-10-31,intra-total,6388,15350,13363,11550,6893,4170,3487,3057,2653,27960,28014,122885,34402,49752,FALSE,0.404866338446515,2020,2020-2021
CA,2020-10-31,intra-ucfe,2,9,5,11,4,5,8,6,5,127,30,212,32,41,FALSE,0.193396226415094,2020,2020-2021
CA,2020-10-31,intra-ucx,4,8,5,9,70,47,60,59,52,438,16,768,20,28,FALSE,0.0364583333333333,2020,2020-2021
CA,2020-10-31,intra-ui,6382,15333,13353,11530,6819,4118,3419,2992,2596,27395,27968,121905,34350,49683,FALSE,0.407555063369017,2020,2020-2021
CA,2020-11-30,inter-total,17,242,241,152,185,159,168,129,40,401,203,1937,220,462,FALSE,0.238513164687661,2020,2020-2021
CA,2020-11-30,inter-ucfe,0,1,0,1,0,2,0,1,0,4,1,10,1,2,FALSE,0.2,2020,2020-2021
CA,2020-11-30,inter-ucx,0,0,0,0,0,0,0,0,0,3,0,3,0,0,FALSE,0,2020,2020-2021
CA,2020-11-30,inter-ui,17,241,241,151,185,157,168,128,40,394,202,1924,219,460,FALSE,0.239085239085239,2020,2020-2021
CA,2020-11-30,intra-total,6508,10012,4923,3296,2221,2556,1933,1430,1106,15503,53708,103196,60216,70228,FALSE,0.680530253110586,2020,2020-2021
CA,2020-11-30,intra-ucfe,16,85,40,27,29,11,10,4,8,95,234,559,250,335,FALSE,0.599284436493739,2020,2020-2021
CA,2020-11-30,intra-ucx,1,57,75,44,18,8,9,8,13,102,59,394,60,117,FALSE,0.296954314720812,2020,2020-2021
CA,2020-11-30,intra-ui,6491,9870,4808,3225,2174,2537,1914,1418,1085,15306,53415,102243,59906,69776,FALSE,0.682452588441262,2020,2020-2021
CA,2020-12-31,inter-total,54,136,52,33,31,12,19,13,13,220,524,1107,578,714,FALSE,0.644986449864499,2020,2020-2021
CA,2020-12-31,inter-ucfe,0,1,2,2,0,1,0,0,1,3,2,12,2,3,FALSE,0.25,2020,2020-2021
CA,2020-12-31,inter-ucx,0,1,1,0,0,0,0,0,1,4,0,7,0,1,FALSE,0.142857142857143,2020,2020-2021
CA,2020-12-31,inter-ui,54,134,49,31,31,11,19,13,11,213,522,1088,576,710,FALSE,0.652573529411765,2020,2020-2021
CA,2020-12-31,intra-total,8523,12168,5078,3113,1718,1085,871,717,606,11607,59695,105181,68218,80386,FALSE,0.764263507667735,2020,2020-2021
CA,2020-12-31,intra-ucfe,30,92,73,52,56,21,29,15,12,65,214,659,244,336,FALSE,0.509863429438543,2020,2020-2021
CA,2020-12-31,intra-ucx,3,79,54,30,19,7,5,6,5,61,43,312,46,125,FALSE,0.400641025641026,2020,2020-2021
CA,2020-12-31,intra-ui,8490,11997,4951,3031,1643,1057,837,696,589,11481,59438,104210,67928,79925,FALSE,0.766960944247193,2020,2020-2021
CA,2021-01-31,inter-total,16,76,67,43,21,19,12,11,2,98,120,485,136,212,FALSE,0.437113402061856,2020,2020-2021
CA,2021-01-31,inter-ucfe,0,0,1,1,1,0,1,1,0,3,4,12,4,4,FALSE,0.333333333333333,2020,2020-2021
CA,2021-01-31,inter-ucx,0,0,0,0,0,0,0,0,0,1,0,1,0,0,FALSE,0,2020,2020-2021
CA,2021-01-31,inter-ui,16,76,66,42,20,19,11,10,2,94,116,472,132,208,FALSE,0.440677966101695,2020,2020-2021
CA,2021-01-31,intra-total,5474,13052,6593,3771,1681,888,603,388,319,4062,47167,83998,52641,65693,FALSE,0.782078144717731,2020,2020-2021
CA,2021-01-31,intra-ucfe,24,103,55,19,22,9,16,7,9,43,163,470,187,290,FALSE,0.617021276595745,2020,2020-2021
CA,2021-01-31,intra-ucx,1,42,37,27,15,5,4,5,1,33,70,240,71,113,FALSE,0.470833333333333,2020,2020-2021
CA,2021-01-31,intra-ui,5449,12907,6501,3725,1644,874,583,376,309,3986,46934,83288,52383,65290,FALSE,0.783906445106138,2020,2020-2021
CA,2021-02-28,inter-total,16,206,310,293,228,117,49,32,22,163,120,1556,136,342,FALSE,0.219794344473008,2020,2020-2021
CA,2021-02-28,inter-ucfe,1,0,2,2,5,2,1,1,1,4,2,21,3,3,FALSE,0.142857142857143,2020,2020-2021
CA,2021-02-28,inter-ucx,0,0,0,0,0,0,0,0,0,1,0,1,0,0,FALSE,0,2020,2020-2021
CA,2021-02-28,inter-ui,15,206,308,291,223,115,48,31,21,158,118,1534,133,339,FALSE,0.220990873533246,2020,2020-2021
CA,2021-02-28,intra-total,1511,16460,17937,12169,13801,4632,1771,866,562,3458,19298,92465,20809,37269,FALSE,0.403060617530958,2020,2020-2021
CA,2021-02-28,intra-ucfe,11,62,81,95,83,73,17,6,9,31,59,527,70,132,FALSE,0.250474383301708,2020,2020-2021
CA,2021-02-28,intra-ucx,0,31,39,29,21,16,4,6,2,30,19,197,19,50,FALSE,0.253807106598985,2020,2020-2021
CA,2021-02-28,intra-ui,1500,16367,17817,12045,13697,4543,1750,854,551,3397,19220,91741,20720,37087,FALSE,0.404257638351446,2020,2020-2021
CA,2021-03-31,inter-total,46,238,128,133,100,102,92,85,65,199,421,1609,467,705,FALSE,0.438160348042262,2020,2020-2021
CA,2021-03-31,inter-ucfe,2,2,0,2,2,1,3,4,0,3,1,20,3,5,FALSE,0.25,2020,2020-2021
CA,2021-03-31,inter-ucx,0,0,0,3,0,0,0,0,0,1,0,4,0,0,FALSE,0,2020,2020-2021
CA,2021-03-31,inter-ui,44,236,128,128,98,101,89,81,65,195,420,1585,464,700,FALSE,0.441640378548896,2020,2020-2021
CA,2021-03-31,intra-total,3957,16433,9975,8858,7117,4357,3082,2419,1776,5026,30894,93894,34851,51284,FALSE,0.546190384902124,2020,2020-2021
CA,2021-03-31,intra-ucfe,9,34,41,54,48,33,27,16,14,57,66,399,75,109,FALSE,0.273182957393484,2020,2020-2021
CA,2021-03-31,intra-ucx,1,10,30,19,16,15,9,1,3,26,23,153,24,34,FALSE,0.222222222222222,2020,2020-2021
CA,2021-03-31,intra-ui,3947,16389,9904,8785,7053,4309,3046,2402,1759,4943,30805,93342,34752,51141,FALSE,0.547888410361895,2020,2020-2021
CA,2021-04-30,inter-total,71,297,174,165,75,35,28,55,37,172,753,1862,824,1121,FALSE,0.602040816326531,2020,2020-2021
CA,2021-04-30,inter-ucfe,0,1,0,0,0,0,0,1,0,6,5,13,5,6,FALSE,0.461538461538462,2020,2020-2021
CA,2021-04-30,inter-ucx,0,1,0,1,0,0,1,0,0,0,0,3,0,1,FALSE,0.333333333333333,2020,2020-2021
CA,2021-04-30,inter-ui,71,295,174,164,75,35,27,54,37,166,748,1846,819,1114,FALSE,0.603466955579632,2020,2020-2021
CA,2021-04-30,intra-total,7408,23032,15152,12562,6179,2832,1884,1694,1479,6029,57938,136189,65346,88378,FALSE,0.648936404555434,2020,2020-2021
CA,2021-04-30,intra-ucfe,5,20,16,13,8,12,13,12,8,58,29,194,34,54,FALSE,0.278350515463918,2020,2020-2021
CA,2021-04-30,intra-ucx,0,15,12,12,30,30,12,3,4,23,23,164,23,38,FALSE,0.231707317073171,2020,2020-2021
CA,2021-04-30,intra-ui,7403,22997,15124,12537,6141,2790,1859,1679,1467,5948,57886,135831,65289,88286,FALSE,0.64996944732793,2020,2020-2021
CA,2021-05-31,inter-total,96,310,302,231,177,178,134,90,55,261,637,2471,733,1043,FALSE,0.422096317280453,2020,2020-2021
CA,2021-05-31,inter-ucfe,0,1,1,0,0,0,1,0,0,2,0,5,0,1,FALSE,0.2,2020,2020-2021
CA,2021-05-31,inter-ucx,0,0,0,0,0,1,0,0,1,1,0,3,0,0,FALSE,0,2020,2020-2021
CA,2021-05-31,inter-ui,96,309,301,231,177,177,133,90,54,258,637,2463,733,1042,FALSE,0.423061307348762,2020,2020-2021
CA,2021-05-31,intra-total,7172,21813,18422,13383,12013,13272,9482,5994,3275,7664,41326,153816,48498,70311,FALSE,0.45711109377438,2020,2020-2021
CA,2021-05-31,intra-ucfe,3,22,17,14,8,12,17,12,11,60,52,228,55,77,FALSE,0.337719298245614,2020,2020-2021
CA,2021-05-31,intra-ucx,1,11,13,19,9,20,15,17,5,34,19,163,20,31,FALSE,0.190184049079755,2020,2020-2021
CA,2021-05-31,intra-ui,7168,21780,18392,13350,11996,13240,9450,5965,3259,7570,41255,153425,48423,70203,FALSE,0.457572103633697,2020,2020-2021
CA,2021-06-30,inter-total,64,162,155,173,126,101,90,116,103,500,479,2069,543,705,FALSE,0.340744320927985,2020,2020-2021
CA,2021-06-30,inter-ucfe,0,0,0,0,0,0,0,0,2,7,0,9,0,0,FALSE,0,2020,2020-2021
CA,2021-06-30,inter-ucx,0,0,0,0,0,0,0,0,0,2,0,2,0,0,FALSE,0,2020,2020-2021
CA,2021-06-30,inter-ui,64,162,155,173,126,101,90,116,101,491,479,2058,543,705,FALSE,0.342565597667639,2020,2020-2021
CA,2021-06-30,intra-total,4118,11814,9472,10564,7851,5402,5663,6021,6281,25243,29508,121937,33626,45440,FALSE,0.372651451159205,2020,2020-2021
CA,2021-06-30,intra-ucfe,7,10,15,20,16,18,24,14,16,81,35,256,42,52,FALSE,0.203125,2020,2020-2021
CA,2021-06-30,intra-ucx,1,10,10,8,5,12,13,14,21,53,18,165,19,29,FALSE,0.175757575757576,2020,2020-2021
CA,2021-06-30,intra-ui,4110,11794,9447,10536,7830,5372,5626,5993,6244,25109,29455,121516,33565,45359,FALSE,0.373275947200369,2020,2020-2021
CA,2021-07-31,inter-total,39,155,134,122,137,71,73,50,64,732,478,2055,517,672,FALSE,0.327007299270073,2021,2021-2022
CA,2021-07-31,inter-ucfe,1,1,0,0,0,0,0,1,0,9,0,12,1,2,FALSE,0.166666666666667,2021,2021-2022
CA,2021-07-31,inter-ucx,0,0,0,0,0,0,0,1,0,2,0,3,0,0,FALSE,0,2021,2021-2022
CA,2021-07-31,inter-ui,38,154,134,122,137,71,73,48,64,721,478,2040,516,670,FALSE,0.32843137254902,2021,2021-2022
CA,2021-07-31,intra-total,2942,9774,7260,7666,8332,4710,3295,3108,2988,35168,23770,109013,26712,36486,FALSE,0.334694027317843,2021,2021-2022
CA,2021-07-31,intra-ucfe,4,30,22,20,19,3,9,17,18,97,37,276,41,71,FALSE,0.257246376811594,2021,2021-2022
CA,2021-07-31,intra-ucx,2,23,26,25,45,36,29,12,13,91,30,332,32,55,FALSE,0.16566265060241,2021,2021-2022
CA,2021-07-31,intra-ui,2936,9721,7212,7621,8268,4671,3257,3079,2957,34980,23703,108405,26639,36360,FALSE,0.335408883354089,2021,2021-2022
CA,2021-08-31,inter-total,26,128,80,106,77,101,48,53,53,796,487,1955,513,641,FALSE,0.327877237851662,2021,2021-2022
CA,2021-08-31,inter-ucfe,0,0,0,0,0,0,1,0,1,6,3,11,3,3,FALSE,0.272727272727273,2021,2021-2022
CA,2021-08-31,inter-ucx,0,0,0,1,0,0,0,0,0,0,0,1,0,0,FALSE,0,2021,2021-2022
CA,2021-08-31,inter-ui,26,128,80,105,77,101,47,53,52,790,484,1943,510,638,FALSE,0.328358208955224,2021,2021-2022
CA,2021-08-31,intra-total,1900,7326,5895,5678,4832,6672,2791,2403,2336,32191,20531,92555,22431,29757,FALSE,0.321506131489385,2021,2021-2022
CA,2021-08-31,intra-ucfe,9,19,20,36,30,21,15,8,10,105,74,347,83,102,FALSE,0.293948126801153,2021,2021-2022
CA,2021-08-31,intra-ucx,3,28,30,11,11,5,4,2,5,53,59,211,62,90,FALSE,0.42654028436019,2021,2021-2022
CA,2021-08-31,intra-ui,1888,7279,5845,5631,4791,6646,2772,2393,2321,32033,20398,91997,22286,29565,FALSE,0.321369175081796,2021,2021-2022
CA,2021-09-30,inter-total,137,130,68,58,48,60,72,41,55,693,269,1631,406,536,FALSE,0.328632740649908,2021,2021-2022
CA,2021-09-30,inter-ucfe,0,0,0,0,0,0,0,0,0,12,2,14,2,2,FALSE,0.142857142857143,2021,2021-2022
CA,2021-09-30,inter-ucx,0,0,0,0,0,0,0,0,0,3,1,4,1,1,FALSE,0.25,2021,2021-2022
CA,2021-09-30,inter-ui,137,130,68,58,48,60,72,41,55,678,266,1613,403,533,FALSE,0.330440173589585,2021,2021-2022
CA,2021-09-30,intra-total,7601,7209,4075,4095,3008,3970,4964,2637,3173,24734,16835,82301,24436,31645,FALSE,0.384503225963233,2021,2021-2022
CA,2021-09-30,intra-ucfe,20,12,17,11,9,3,9,10,12,89,42,234,62,74,FALSE,0.316239316239316,2021,2021-2022
CA,2021-09-30,intra-ucx,16,22,15,9,8,12,5,3,3,45,29,167,45,67,FALSE,0.401197604790419,2021,2021-2022
CA,2021-09-30,intra-ui,7565,7175,4043,4075,2991,3955,4950,2624,3158,24600,16764,81900,24329,31504,FALSE,0.384664224664225,2021,2021-2022
CA,2021-10-31,inter-total,313,109,122,140,81,103,47,33,24,629,158,1759,471,580,FALSE,0.329732802728823,2021,2021-2022
CA,2021-10-31,inter-ucfe,3,0,1,1,2,0,0,0,0,2,1,10,4,4,FALSE,0.4,2021,2021-2022
CA,2021-10-31,inter-ucx,0,0,0,0,0,0,1,0,0,1,1,3,1,1,FALSE,0.333333333333333,2021,2021-2022
CA,2021-10-31,inter-ui,310,109,121,139,79,103,46,33,24,626,156,1746,466,575,FALSE,0.329324169530355,2021,2021-2022
CA,2021-10-31,intra-total,17956,6089,8562,10967,5660,6819,2895,1722,1748,23207,12487,98112,30443,36532,FALSE,0.372349967384214,2021,2021-2022
CA,2021-10-31,intra-ucfe,55,19,16,24,8,10,7,1,6,63,24,233,79,98,FALSE,0.420600858369099,2021,2021-2022
CA,2021-10-31,intra-ucx,60,22,13,3,9,7,5,3,6,46,22,196,82,104,FALSE,0.530612244897959,2021,2021-2022
CA,2021-10-31,intra-ui,17841,6048,8533,10940,5643,6802,2883,1718,1736,23098,12441,97683,30282,36330,FALSE,0.371917324406499,2021,2021-2022
CA,2021-11-30,inter-total,359,59,46,29,14,16,20,22,12,668,130,1375,489,548,FALSE,0.398545454545455,2021,2021-2022
CA,2021-11-30,inter-ucfe,3,0,0,0,0,0,0,0,0,4,1,8,4,4,FALSE,0.5,2021,2021-2022
CA,2021-11-30,inter-ucx,1,0,0,0,0,0,0,0,0,0,1,2,2,2,FALSE,1,2021,2021-2022
CA,2021-11-30,inter-ui,355,59,46,29,14,16,20,22,12,664,128,1365,483,542,FALSE,0.397069597069597,2021,2021-2022
CA,2021-11-30,intra-total,23026,4440,3014,1780,1153,1156,1829,1143,978,16756,10167,65442,33193,37633,FALSE,0.575058830720333,2021,2021-2022
CA,2021-11-30,intra-ucfe,47,12,13,6,3,10,12,4,6,41,31,185,78,90,FALSE,0.486486486486487,2021,2021-2022
CA,2021-11-30,intra-ucx,60,19,5,12,5,2,2,2,3,21,18,149,78,97,FALSE,0.651006711409396,2021,2021-2022
CA,2021-11-30,intra-ui,22919,4409,2996,1762,1145,1144,1815,1137,969,16694,10118,65108,33037,37446,FALSE,0.575136695951342,2021,2021-2022
CA,2021-12-31,inter-total,357,68,32,39,20,29,17,15,12,824,138,1551,495,563,FALSE,0.362991618310767,2021,2021-2022
CA,2021-12-31,inter-ucfe,8,4,1,2,0,0,1,0,0,6,9,31,17,21,FALSE,0.67741935483871,2021,2021-2022
CA,2021-12-31,inter-ucx,0,0,0,0,0,0,0,0,0,0,1,1,1,1,FALSE,1,2021,2021-2022
CA,2021-12-31,inter-ui,349,64,31,37,20,29,16,15,12,818,128,1519,477,541,FALSE,0.356155365371955,2021,2021-2022
CA,2021-12-31,intra-total,26399,4387,2940,1987,1265,1040,792,714,632,17171,10184,67511,36583,40970,FALSE,0.606864066596555,2021,2021-2022
CA,2021-12-31,intra-ucfe,83,28,17,14,9,5,7,3,2,59,43,270,126,154,FALSE,0.57037037037037,2021,2021-2022
CA,2021-12-31,intra-ucx,72,14,7,2,3,1,3,1,1,18,16,138,88,102,FALSE,0.739130434782609,2021,2021-2022
CA,2021-12-31,intra-ui,26244,4345,2916,1971,1253,1034,782,710,629,17094,10125,67103,36369,40714,FALSE,0.606738893939168,2021,2021-2022
CA,2022-01-31,inter-total,467,79,64,41,44,29,33,32,67,872,161,1889,628,707,FALSE,0.37427210164108,2021,2021-2022
CA,2022-01-31,inter-ucfe,11,4,1,1,2,1,1,1,1,8,7,38,18,22,FALSE,0.578947368421053,2021,2021-2022
CA,2022-01-31,inter-ucx,0,0,0,0,0,0,0,0,0,1,0,1,0,0,FALSE,0,2021,2021-2022
CA,2022-01-31,inter-ui,456,75,63,40,42,28,32,31,66,863,154,1850,610,685,FALSE,0.37027027027027,2021,2021-2022
CA,2022-01-31,intra-total,34792,5135,3566,2096,1286,1111,965,875,947,19309,12823,82905,47615,52750,FALSE,0.636270430010253,2021,2021-2022
CA,2022-01-31,intra-ucfe,155,51,19,16,7,8,4,5,6,82,84,437,239,290,FALSE,0.663615560640732,2021,2021-2022
CA,2022-01-31,intra-ucx,40,12,7,4,4,5,3,3,1,30,22,131,62,74,FALSE,0.564885496183206,2021,2021-2022
CA,2022-01-31,intra-ui,34597,5072,3540,2076,1275,1098,958,867,940,19197,12717,82337,47314,52386,FALSE,0.636238871953071,2021,2021-2022
CA,2022-02-28,inter-total,370,134,103,75,41,35,39,25,40,480,184,1526,554,688,FALSE,0.450851900393185,2021,2021-2022
CA,2022-02-28,inter-ucfe,5,4,4,5,1,0,0,0,1,4,2,26,7,11,FALSE,0.423076923076923,2021,2021-2022
CA,2022-02-28,inter-ucx,1,1,0,0,0,0,0,0,0,0,0,2,1,2,FALSE,1,2021,2021-2022
CA,2022-02-28,inter-ui,364,129,99,70,40,35,39,25,39,476,182,1498,546,675,FALSE,0.450600801068091,2021,2021-2022
CA,2022-02-28,intra-total,25202,4891,4144,2852,2035,1654,1386,1309,1037,19778,9384,73672,34586,39477,FALSE,0.535848083396677,2021,2021-2022
CA,2022-02-28,intra-ucfe,83,45,38,26,14,14,11,8,3,77,54,373,137,182,FALSE,0.487935656836461,2021,2021-2022
CA,2022-02-28,intra-ucx,52,9,10,10,3,8,4,4,3,28,18,149,70,79,FALSE,0.530201342281879,2021,2021-2022
CA,2022-02-28,intra-ui,25067,4837,4096,2816,2018,1632,1371,1297,1031,19673,9312,73150,34379,39216,FALSE,0.536103896103896,2021,2021-2022
CA,2022-03-31,inter-total,412,88,82,39,36,37,32,40,57,393,205,1421,617,705,FALSE,0.49612948627727,2021,2021-2022
CA,2022-03-31,inter-ucfe,6,0,3,0,0,2,3,1,2,9,6,32,12,12,FALSE,0.375,2021,2021-2022
CA,2022-03-31,inter-ucx,0,0,0,0,0,0,0,0,0,0,0,0,0,0,FALSE,0,2021,2021-2022
CA,2022-03-31,inter-ui,406,88,79,39,36,35,29,39,55,384,199,1389,605,693,FALSE,0.498920086393089,2021,2021-2022
CA,2022-03-31,intra-total,25077,4828,3876,3068,2573,2293,2056,1743,2533,17997,9797,75841,34874,39702,FALSE,0.523489932885906,2021,2021-2022
CA,2022-03-31,intra-ucfe,53,15,16,14,15,9,13,9,6,78,23,251,76,91,FALSE,0.362549800796813,2021,2021-2022
CA,2022-03-31,intra-ucx,55,15,6,15,10,0,5,4,4,33,25,172,80,95,FALSE,0.552325581395349,2021,2021-2022
CA,2022-03-31,intra-ui,24969,4798,3854,3039,2548,2284,2038,1730,2523,17886,9749,75418,34718,39516,FALSE,0.523959797395847,2021,2021-2022
CA,2022-04-30,inter-total,607,80,59,34,27,32,13,36,44,303,243,1478,850,930,FALSE,0.629228687415426,2021,2021-2022
CA,2022-04-30,inter-ucfe,2,0,0,1,0,2,2,1,1,6,0,15,2,2,FALSE,0.133333333333333,2021,2021-2022
CA,2022-04-30,inter-ucx,0,0,1,0,0,1,0,0,0,1,1,4,1,1,FALSE,0.25,2021,2021-2022
CA,2022-04-30,inter-ui,605,80,58,33,27,29,11,35,43,296,242,1459,847,927,FALSE,0.635366689513365,2021,2021-2022
CA,2022-04-30,intra-total,27904,5037,3404,2474,1966,1723,1410,1294,1216,11716,11283,69427,39187,44224,FALSE,0.636985610785429,2021,2021-2022
CA,2022-04-30,intra-ucfe,51,17,5,6,6,10,4,3,7,62,20,191,71,88,FALSE,0.460732984293194,2021,2021-2022
CA,2022-04-30,intra-ucx,67,13,10,7,8,5,8,3,6,29,33,189,100,113,FALSE,0.597883597883598,2021,2021-2022
CA,2022-04-30,intra-ui,27786,5007,3389,2461,1952,1708,1398,1288,1203,11625,11230,69047,39016,44023,FALSE,0.637580198994888,2021,2021-2022
CA,2022-05-31,inter-total,684,160,106,52,34,25,26,31,6,187,290,1601,974,1134,FALSE,0.708307307932542,2021,2021-2022
CA,2022-05-31,inter-ucfe,1,0,0,0,0,0,0,0,0,5,0,6,1,1,FALSE,0.166666666666667,2021,2021-2022
CA,2022-05-31,inter-ucx,0,0,1,0,0,0,0,0,0,0,0,1,0,0,FALSE,0,2021,2021-2022
CA,2022-05-31,inter-ui,683,160,105,52,34,25,26,31,6,182,290,1594,973,1133,FALSE,0.710790464240903,2021,2021-2022
CA,2022-05-31,intra-total,28984,6162,3984,2654,1740,1280,1144,907,738,7998,12283,67874,41267,47429,FALSE,0.698780092524383,2021,2021-2022
CA,2022-05-31,intra-ucfe,20,14,6,11,6,2,3,7,2,43,19,133,39,53,FALSE,0.398496240601504,2021,2021-2022
CA,2022-05-31,intra-ucx,66,19,15,8,9,2,6,3,2,21,24,175,90,109,FALSE,0.622857142857143,2021,2021-2022
CA,2022-05-31,intra-ui,28898,6129,3963,2635,1725,1276,1135,897,734,7934,12240,67566,41138,47267,FALSE,0.699567829973655,2021,2021-2022
CA,2022-06-30,inter-total,406,145,67,56,36,19,24,13,10,139,214,1129,620,765,FALSE,0.677590788308237,2021,2021-2022
CA,2022-06-30,inter-ucfe,1,0,0,0,0,0,0,2,0,2,1,6,2,2,FALSE,0.333333333333333,2021,2021-2022
CA,2022-06-30,inter-ucx,0,0,0,0,0,0,0,1,0,0,0,1,0,0,FALSE,0,2021,2021-2022
CA,2022-06-30,inter-ui,405,145,67,56,36,19,24,10,10,137,213,1122,618,763,FALSE,0.680035650623886,2021,2021-2022
CA,2022-06-30,intra-total,23916,5833,3433,2127,1287,899,741,594,473,4763,11403,55469,35319,41152,FALSE,0.741891867529611,2021,2021-2022
CA,2022-06-30,intra-ucfe,17,23,5,7,2,4,4,4,4,21,18,109,35,58,FALSE,0.532110091743119,2021,2021-2022
CA,2022-06-30,intra-ucx,28,15,6,6,6,2,5,2,0,10,16,96,44,59,FALSE,0.614583333333333,2021,2021-2022
CA,2022-06-30,intra-ui,23871,5795,3422,2114,1279,893,732,588,469,4732,11369,55264,35240,41035,FALSE,0.742526780544297,2021,2021-2022
CA,2022-07-31,inter-total,468,120,88,63,28,20,18,13,11,84,274,1187,742,862,FALSE,0.72620050547599,2022,2022-2023
CA,2022-07-31,inter-ucfe,1,0,0,0,0,0,0,0,1,1,0,3,1,1,FALSE,0.333333333333333,2022,2022-2023
CA,2022-07-31,inter-ucx,1,0,0,1,0,0,0,0,0,0,1,3,2,2,FALSE,0.666666666666667,2022,2022-2023
CA,2022-07-31,inter-ui,466,120,88,62,28,20,18,13,10,83,273,1181,739,859,FALSE,0.727349703640982,2022,2022-2023
CA,2022-07-31,intra-total,29945,6949,4501,2858,1489,962,664,452,378,4290,13456,65944,43401,50350,FALSE,0.763526628654616,2022,2022-2023
CA,2022-07-31,intra-ucfe,12,10,10,5,4,3,3,3,1,17,11,79,23,33,FALSE,0.417721518987342,2022,2022-2023
CA,2022-07-31,intra-ucx,27,20,9,2,6,2,3,0,1,9,26,105,53,73,FALSE,0.695238095238095,2022,2022-2023
CA,2022-07-31,intra-ui,29906,6919,4482,2851,1479,957,658,449,376,4264,13419,65760,43325,50244,FALSE,0.764051094890511,2022,2022-2023
CA,2022-08-31,inter-total,475,106,102,93,42,43,20,17,9,85,228,1220,703,809,FALSE,0.663114754098361,2022,2022-2023
CA,2022-08-31,inter-ucfe,0,0,2,1,0,1,0,0,0,2,0,6,0,0,FALSE,0,2022,2022-2023
CA,2022-08-31,inter-ucx,1,0,0,0,0,0,0,0,0,2,1,4,2,2,FALSE,0.5,2022,2022-2023
CA,2022-08-31,inter-ui,474,106,100,92,42,42,20,17,9,81,227,1210,701,807,FALSE,0.666942148760331,2022,2022-2023
CA,2022-08-31,intra-total,25801,6572,4859,4066,2219,1831,1295,852,512,4498,11956,64461,37757,44329,FALSE,0.687687128651433,2022,2022-2023
CA,2022-08-31,intra-ucfe,19,14,9,10,7,5,2,5,1,15,16,103,35,49,FALSE,0.475728155339806,2022,2022-2023
CA,2022-08-31,intra-ucx,27,26,18,12,6,4,1,4,2,7,22,129,49,75,FALSE,0.581395348837209,2022,2022-2023
CA,2022-08-31,intra-ui,25755,6532,4832,4044,2206,1822,1292,843,509,4476,11918,64229,37673,44205,FALSE,0.688240514409379,2022,2022-2023
CA,2022-09-30,inter-total,334,85,96,78,41,44,29,11,11,91,153,973,487,572,FALSE,0.587872559095581,2022,2022-2023
CA,2022-09-30,inter-ucfe,1,0,0,0,0,0,0,0,0,3,0,4,1,1,FALSE,0.25,2022,2022-2023
CA,2022-09-30,inter-ucx,0,1,0,0,0,0,0,0,1,0,0,2,0,1,FALSE,0.5,2022,2022-2023
CA,2022-09-30,inter-ui,333,84,96,78,41,44,29,11,10,88,153,967,486,570,FALSE,0.589451913133402,2022,2022-2023
CA,2022-09-30,intra-total,21498,5026,3773,3037,2082,1826,1339,980,799,4086,9287,53733,30785,35811,FALSE,0.666461950756518,2022,2022-2023
CA,2022-09-30,intra-ucfe,12,5,5,4,2,2,7,6,2,13,6,64,18,23,FALSE,0.359375,2022,2022-2023
CA,2022-09-30,intra-ucx,18,23,13,10,6,7,1,0,3,9,20,110,38,61,FALSE,0.554545454545455,2022,2022-2023
CA,2022-09-30,intra-ui,21468,4998,3755,3023,2074,1817,1331,974,794,4064,9261,53559,30729,35727,FALSE,0.667058757631771,2022,2022-2023
CA,2022-10-31,inter-total,413,80,61,112,77,39,29,23,12,81,119,1046,532,612,FALSE,0.58508604206501,2022,2022-2023
CA,2022-10-31,inter-ucfe,3,0,0,0,0,0,0,0,0,2,1,6,4,4,FALSE,0.666666666666667,2022,2022-2023
CA,2022-10-31,inter-ucx,0,0,0,0,0,0,0,0,0,0,0,0,0,0,FALSE,0,2022,2022-2023
CA,2022-10-31,inter-ui,410,80,61,112,77,39,29,23,12,79,118,1040,528,608,FALSE,0.584615384615385,2022,2022-2023
CA,2022-10-31,intra-total,26604,3809,3707,3437,2449,1785,1181,671,541,3261,8425,55870,35029,38838,FALSE,0.695149454089851,2022,2022-2023
CA,2022-10-31,intra-ucfe,5,5,7,8,3,3,2,0,2,16,6,57,11,16,FALSE,0.280701754385965,2022,2022-2023
CA,2022-10-31,intra-ucx,27,15,13,9,4,8,5,1,0,12,17,111,44,59,FALSE,0.531531531531532,2022,2022-2023
CA,2022-10-31,intra-ui,26572,3789,3687,3420,2442,1774,1174,670,539,3233,8402,55702,34974,38763,FALSE,0.695899608631647,2022,2022-2023
CA,2022-11-30,inter-total,481,142,97,83,46,14,8,9,3,67,217,1167,698,840,FALSE,0.719794344473008,2022,2022-2023
CA,2022-11-30,inter-ucfe,4,1,0,1,0,0,1,0,0,2,3,12,7,8,FALSE,0.666666666666667,2022,2022-2023
CA,2022-11-30,inter-ucx,0,1,0,1,0,0,0,0,0,0,0,2,0,1,FALSE,0.5,2022,2022-2023
CA,2022-11-30,inter-ui,477,140,97,81,46,14,7,9,3,65,214,1153,691,831,FALSE,0.720728534258456,2022,2022-2023
CA,2022-11-30,intra-total,28422,6205,6001,4044,2100,1030,591,447,316,1899,11531,62586,39953,46158,FALSE,0.737513181861758,2022,2022-2023
CA,2022-11-30,intra-ucfe,16,7,2,3,3,2,3,1,1,4,14,56,30,37,FALSE,0.660714285714286,2022,2022-2023
CA,2022-11-30,intra-ucx,16,6,14,6,7,2,2,3,0,8,32,96,48,54,FALSE,0.5625,2022,2022-2023
CA,2022-11-30,intra-ui,28390,6192,5985,4035,2090,1026,586,443,315,1887,11485,62434,39875,46067,FALSE,0.737851170836403,2022,2022-2023
CA,2022-12-31,inter-total,555,165,93,47,25,16,9,5,3,48,263,1229,818,983,FALSE,0.799837266069976,2022,2022-2023
CA,2022-12-31,inter-ucfe,1,2,1,0,0,2,0,0,0,0,2,8,3,5,FALSE,0.625,2022,2022-2023
CA,2022-12-31,inter-ucx,1,0,0,0,0,0,0,0,0,1,0,2,1,1,FALSE,0.5,2022,2022-2023
CA,2022-12-31,inter-ui,553,163,92,47,25,14,9,5,3,47,261,1219,814,977,FALSE,0.801476620180476,2022,2022-2023
CA,2022-12-31,intra-total,36139,10101,6293,3186,1623,838,560,336,224,1652,17380,78332,53519,63620,FALSE,0.812184037175101,2022,2022-2023
CA,2022-12-31,intra-ucfe,34,15,10,4,2,0,6,1,1,7,25,105,59,74,FALSE,0.704761904761905,2022,2022-2023
CA,2022-12-31,intra-ucx,25,17,6,1,5,0,3,0,0,8,33,98,58,75,FALSE,0.76530612244898,2022,2022-2023
CA,2022-12-31,intra-ui,36080,10069,6277,3181,1616,838,551,335,223,1637,17322,78129,53402,63471,FALSE,0.812387205775064,2022,2022-2023
CA,2023-01-31,inter-total,805,136,82,45,26,20,9,9,3,48,254,1437,1059,1195,FALSE,0.831593597773139,2022,2022-2023
CA,2023-01-31,inter-ucfe,2,4,3,1,1,2,1,1,0,0,3,18,5,9,FALSE,0.5,2022,2022-2023
CA,2023-01-31,inter-ucx,0,0,1,0,0,0,0,0,0,1,0,2,0,0,FALSE,0,2022,2022-2023
CA,2023-01-31,inter-ui,803,132,78,44,25,18,8,8,3,47,251,1417,1054,1186,FALSE,0.836979534227241,2022,2022-2023
CA,2023-01-31,intra-total,60042,10441,6000,2996,1565,957,608,436,333,1801,20642,105821,80684,91125,FALSE,0.861123973502424,2022,2022-2023
CA,2023-01-31,intra-ucfe,38,32,25,11,8,2,3,0,3,7,38,167,76,108,FALSE,0.646706586826347,2022,2022-2023
CA,2023-01-31,intra-ucx,17,12,7,6,5,3,1,2,1,7,21,82,38,50,FALSE,0.609756097560976,2022,2022-2023
CA,2023-01-31,intra-ui,59987,10397,5968,2979,1552,952,604,434,329,1787,20583,105572,80570,90967,FALSE,0.861658394271208,2022,2022-2023
CA,2023-02-28,inter-total,517,123,76,38,22,17,12,7,11,50,253,1126,770,893,FALSE,0.793072824156306,2022,2022-2023
CA,2023-02-28,inter-ucfe,3,2,4,2,0,1,2,0,1,2,2,19,5,7,FALSE,0.368421052631579,2022,2022-2023
CA,2023-02-28,inter-ucx,0,1,0,0,0,0,0,0,0,1,0,2,0,1,FALSE,0.5,2022,2022-2023
CA,2023-02-28,inter-ui,514,120,72,36,22,16,10,7,10,47,251,1105,765,885,FALSE,0.800904977375566,2022,2022-2023
CA,2023-02-28,intra-total,38370,10333,5453,2514,1399,883,603,374,274,1783,21711,83697,60081,70414,FALSE,0.841296581717385,2022,2022-2023
CA,2023-02-28,intra-ucfe,27,36,40,26,18,7,5,4,1,13,30,207,57,93,FALSE,0.449275362318841,2022,2022-2023
CA,2023-02-28,intra-ucx,18,24,13,1,4,1,5,2,1,6,39,114,57,81,FALSE,0.710526315789474,2022,2022-2023
CA,2023-02-28,intra-ui,38325,10273,5400,2487,1377,875,593,368,272,1764,21642,83376,59967,70240,FALSE,0.842448666282863,2022,2022-2023
CA,2023-03-31,inter-total,441,119,73,37,29,17,8,4,7,40,225,1000,666,785,FALSE,0.785,2022,2022-2023
CA,2023-03-31,inter-ucfe,4,0,0,1,0,0,0,0,0,3,0,8,4,4,FALSE,0.5,2022,2022-2023
CA,2023-03-31,inter-ucx,0,0,1,0,0,0,0,0,0,0,0,1,0,0,FALSE,0,2022,2022-2023
CA,2023-03-31,inter-ui,437,119,72,36,29,17,8,4,7,37,225,991,662,781,FALSE,0.788092835519677,2022,2022-2023
CA,2023-03-31,intra-total,34414,9064,5039,2555,1385,955,678,507,351,2214,19597,76759,54011,63075,FALSE,0.821727745280684,2022,2022-2023
CA,2023-03-31,intra-ucfe,23,12,17,12,8,3,5,4,5,8,18,115,41,53,FALSE,0.460869565217391,2022,2022-2023
CA,2023-03-31,intra-ucx,26,15,8,10,4,2,4,1,0,8,19,97,45,60,FALSE,0.618556701030928,2022,2022-2023
CA,2023-03-31,intra-ui,34365,9037,5014,2533,1373,950,669,502,346,2198,19560,76547,53925,62962,FALSE,0.82252733614642,2022,2022-2023
CA,2023-04-30,inter-total,504,142,98,44,23,8,14,7,6,39,283,1168,787,929,FALSE,0.795376712328767,2022,2022-2023
CA,2023-04-30,inter-ucfe,0,0,1,0,1,1,0,0,0,2,0,5,0,0,FALSE,0,2022,2022-2023
CA,2023-04-30,inter-ucx,1,0,0,0,0,0,0,0,0,0,0,1,1,1,FALSE,1,2022,2022-2023
CA,2023-04-30,inter-ui,503,142,97,44,22,7,14,7,6,37,283,1162,786,928,FALSE,0.798623063683305,2022,2022-2023
CA,2023-04-30,intra-total,35812,10422,6074,2951,1507,852,643,422,312,2278,17155,78428,52967,63389,FALSE,0.808244504513694,2022,2022-2023
CA,2023-04-30,intra-ucfe,13,17,9,10,5,2,1,0,1,11,17,86,30,47,FALSE,0.546511627906977,2022,2022-2023
CA,2023-04-30,intra-ucx,18,13,13,3,3,2,2,0,3,3,22,82,40,53,FALSE,0.646341463414634,2022,2022-2023
CA,2023-04-30,intra-ui,35781,10392,6052,2938,1499,848,640,422,308,2264,17116,78260,52897,63289,FALSE,0.808701763352926,2022,2022-2023
CA,2023-05-31,inter-total,601,152,108,39,20,13,9,6,3,35,330,1316,931,1083,FALSE,0.822948328267477,2022,2022-2023
CA,2023-05-31,inter-ucfe,0,0,0,1,0,0,1,0,0,3,1,6,1,1,FALSE,0.166666666666667,2022,2022-2023
CA,2023-05-31,inter-ucx,0,0,0,1,0,0,0,0,0,0,0,1,0,0,FALSE,0,2022,2022-2023
CA,2023-05-31,inter-ui,601,152,108,37,20,13,8,6,3,32,329,1309,930,1082,FALSE,0.826585179526356,2022,2022-2023
CA,2023-05-31,intra-total,33219,8169,4418,2053,1056,672,436,288,236,1830,17681,70058,50900,59069,FALSE,0.843144251905564,2022,2022-2023
CA,2023-05-31,intra-ucfe,15,21,10,6,6,5,1,0,0,9,12,85,27,48,FALSE,0.564705882352941,2022,2022-2023
CA,2023-05-31,intra-ucx,31,16,6,4,2,4,2,2,1,7,27,102,58,74,FALSE,0.725490196078431,2022,2022-2023
CA,2023-05-31,intra-ui,33173,8132,4402,2043,1048,663,433,286,235,1814,17642,69871,50815,58947,FALSE,0.843654735154785,2022,2022-2023
CA,2023-06-30,inter-total,627,128,92,39,21,14,21,14,7,42,319,1324,946,1074,FALSE,0.811178247734139,2022,2022-2023
CA,2023-06-30,inter-ucfe,0,0,0,0,1,0,0,0,0,4,1,6,1,1,FALSE,0.166666666666667,2022,2022-2023
CA,2023-06-30,inter-ucx,0,1,0,0,0,0,0,0,0,0,0,1,0,1,FALSE,1,2022,2022-2023
CA,2023-06-30,inter-ui,627,127,92,39,20,14,21,14,7,38,318,1317,945,1072,FALSE,0.813971146545178,2022,2022-2023
CA,2023-06-30,intra-total,36487,8188,4609,2183,1098,693,415,320,239,1819,20374,76425,56861,65049,FALSE,0.851148184494603,2022,2022-2023
CA,2023-06-30,intra-ucfe,24,10,9,4,3,1,1,1,0,9,16,78,40,50,FALSE,0.641025641025641,2022,2022-2023
CA,2023-06-30,intra-ucx,33,5,8,5,4,10,1,1,0,7,23,97,56,61,FALSE,0.628865979381443,2022,2022-2023
CA,2023-06-30,intra-ui,36430,8173,4592,2174,1091,682,413,318,239,1803,20335,76250,56765,64938,FALSE,0.851645901639344,2022,2022-2023
CA,2023-07-31,inter-total,729,120,75,35,24,16,11,9,10,42,298,1369,1027,1147,FALSE,0.837837837837838,2023,2023-2024
CA,2023-07-31,inter-ucfe,1,0,0,0,0,0,0,0,0,0,0,1,1,1,FALSE,1,2023,2023-2024
CA,2023-07-31,inter-ucx,0,0,0,0,1,0,0,0,0,0,0,1,0,0,FALSE,0,2023,2023-2024
CA,2023-07-31,inter-ui,728,120,75,35,23,16,11,9,10,42,298,1367,1026,1146,FALSE,0.838332114118508,2023,2023-2024
CA,2023-07-31,intra-total,42645,7897,5049,2193,1013,573,379,283,203,1486,20864,82585,63509,71406,FALSE,0.864636435187988,2023,2023-2024
CA,2023-07-31,intra-ucfe,13,8,8,3,5,3,6,4,1,12,21,84,34,42,FALSE,0.5,2023,2023-2024
CA,2023-07-31,intra-ucx,26,17,9,2,3,5,7,0,2,4,28,103,54,71,FALSE,0.689320388349515,2023,2023-2024
CA,2023-07-31,intra-ui,42606,7872,5032,2188,1005,565,366,279,200,1470,20815,82398,63421,71293,FALSE,0.865227311342508,2023,2023-2024
CA,2023-08-31,inter-total,478,146,67,41,21,21,11,9,6,33,313,1146,791,937,FALSE,0.817626527050611,2023,2023-2024
CA,2023-08-31,inter-ucfe,0,2,0,0,0,0,0,0,0,0,0,2,0,2,FALSE,1,2023,2023-2024
CA,2023-08-31,inter-ucx,1,2,0,0,0,0,0,0,1,0,0,4,1,3,FALSE,0.75,2023,2023-2024
CA,2023-08-31,inter-ui,477,142,67,41,21,21,11,9,5,33,313,1140,790,932,FALSE,0.817543859649123,2023,2023-2024
CA,2023-08-31,intra-total,32859,8426,4733,2306,1187,743,468,330,219,1567,20579,73417,53438,61864,FALSE,0.842638625931324,2023,2023-2024
CA,2023-08-31,intra-ucfe,10,7,7,8,2,3,2,3,1,8,16,67,26,33,FALSE,0.492537313432836,2023,2023-2024
CA,2023-08-31,intra-ucx,55,17,4,3,8,1,3,1,2,4,22,120,77,94,FALSE,0.783333333333333,2023,2023-2024
CA,2023-08-31,intra-ui,32794,8402,4722,2295,1177,739,463,326,216,1555,20541,73230,53335,61737,FALSE,0.843056124539123,2023,2023-2024
CA,2023-09-30,inter-total,444,91,65,24,15,14,9,6,4,27,265,964,709,800,FALSE,0.829875518672199,2023,2023-2024
CA,2023-09-30,inter-ucfe,0,0,0,0,0,1,0,0,0,0,0,1,0,0,FALSE,0,2023,2023-2024
CA,2023-09-30,inter-ucx,0,0,0,0,0,0,0,0,0,2,0,2,0,0,FALSE,0,2023,2023-2024
CA,2023-09-30,inter-ui,444,91,65,24,15,13,9,6,4,25,265,961,709,800,FALSE,0.832466181061394,2023,2023-2024
CA,2023-09-30,intra-total,27261,6251,3561,1580,801,508,334,260,170,1381,15955,58062,43216,49467,FALSE,0.851968585305363,2023,2023-2024
CA,2023-09-30,intra-ucfe,15,7,4,7,3,2,1,2,0,4,8,53,23,30,FALSE,0.566037735849057,2023,2023-2024
CA,2023-09-30,intra-ucx,54,13,7,5,3,2,1,1,1,9,29,125,83,96,FALSE,0.768,2023,2023-2024
CA,2023-09-30,intra-ui,27192,6231,3550,1568,795,504,332,257,169,1368,15918,57884,43110,49341,FALSE,0.852411719991708,2023,2023-2024
CA,2023-10-31,inter-total,616,116,48,25,14,8,10,8,11,31,319,1206,935,1051,FALSE,0.871475953565506,2023,2023-2024
CA,2023-10-31,inter-ucfe,2,1,0,1,0,0,0,0,0,0,3,7,5,6,FALSE,0.857142857142857,2023,2023-2024
CA,2023-10-31,inter-ucx,3,1,0,0,0,0,0,0,0,0,3,7,6,7,FALSE,1,2023,2023-2024
CA,2023-10-31,inter-ui,611,114,48,24,14,8,10,8,11,31,313,1192,924,1038,FALSE,0.870805369127517,2023,2023-2024
CA,2023-10-31,intra-total,34999,5863,3076,1313,657,422,246,235,166,1396,18884,67257,53883,59746,FALSE,0.888323891936899,2023,2023-2024
CA,2023-10-31,intra-ucfe,20,15,6,5,1,1,1,2,0,10,15,76,35,50,FALSE,0.657894736842105,2023,2023-2024
CA,2023-10-31,intra-ucx,111,27,16,4,10,2,0,2,0,7,53,232,164,191,FALSE,0.823275862068966,2023,2023-2024
CA,2023-10-31,intra-ui,34868,5821,3054,1304,646,419,245,231,166,1379,18816,66949,53684,59505,FALSE,0.888810885898221,2023,2023-2024
CA,2023-11-30,inter-total,675,93,48,15,7,5,2,4,3,35,287,1174,962,1055,FALSE,0.898637137989778,2023,2023-2024
CA,2023-11-30,inter-ucfe,4,3,0,1,0,0,0,0,0,3,5,16,9,12,FALSE,0.75,2023,2023-2024
CA,2023-11-30,inter-ucx,1,0,1,0,0,1,0,0,0,0,0,3,1,1,FALSE,0.333333333333333,2023,2023-2024
CA,2023-11-30,inter-ui,670,90,47,14,7,4,2,4,3,32,282,1155,952,1042,FALSE,0.902164502164502,2023,2023-2024
CA,2023-11-30,intra-total,37954,5952,2928,1321,602,349,215,148,117,1158,18269,69013,56223,62175,FALSE,0.900917218495066,2023,2023-2024
CA,2023-11-30,intra-ucfe,32,20,8,5,5,0,2,0,4,8,31,115,63,83,FALSE,0.721739130434783,2023,2023-2024
CA,2023-11-30,intra-ucx,108,16,11,3,4,2,5,0,2,5,33,189,141,157,FALSE,0.830687830687831,2023,2023-2024
CA,2023-11-30,intra-ui,37814,5916,2909,1313,593,347,208,148,111,1145,18205,68709,56019,61935,FALSE,0.901410295594464,2023,2023-2024
CA,2023-12-31,inter-total,741,97,47,25,7,6,4,4,2,27,273,1233,1014,1111,FALSE,0.901054339010543,2023,2023-2024
CA,2023-12-31,inter-ucfe,13,1,0,1,0,0,0,0,0,0,6,21,19,20,FALSE,0.952380952380952,2023,2023-2024
CA,2023-12-31,inter-ucx,1,0,0,1,0,0,0,0,0,2,1,5,2,2,FALSE,0.4,2023,2023-2024
CA,2023-12-31,inter-ui,727,96,47,23,7,6,4,4,2,25,266,1207,993,1089,FALSE,0.902236951118476,2023,2023-2024
CA,2023-12-31,intra-total,42279,6716,3310,1497,700,388,267,159,125,1046,18796,75283,61075,67791,FALSE,0.900482180571975,2023,2023-2024
CA,2023-12-31,intra-ucfe,62,20,13,6,3,3,1,0,1,9,50,168,112,132,FALSE,0.785714285714286,2023,2023-2024
CA,2023-12-31,intra-ucx,101,12,10,4,6,2,2,4,1,6,40,188,141,153,FALSE,0.813829787234043,2023,2023-2024
CA,2023-12-31,intra-ui,42116,6684,3287,1487,691,383,264,155,123,1031,18706,74927,60822,67506,FALSE,0.900956931413242,2023,2023-2024
CA,2024-01-31,inter-total,762,133,73,32,13,13,5,4,3,20,333,1391,1095,1228,FALSE,0.882818116462976,2023,2023-2024
CA,2024-01-31,inter-ucfe,9,8,1,2,1,0,0,0,0,4,12,37,21,29,FALSE,0.783783783783784,2023,2023-2024
CA,2024-01-31,inter-ucx,2,3,0,0,0,0,0,0,0,0,0,5,2,5,FALSE,1,2023,2023-2024
CA,2024-01-31,inter-ui,751,122,72,30,12,13,5,4,3,16,321,1349,1072,1194,FALSE,0.885100074128985,2023,2023-2024
CA,2024-01-31,intra-total,53770,10199,4813,2190,1132,670,371,281,153,1310,21700,96589,75470,85669,FALSE,0.886943647827392,2023,2023-2024
CA,2024-01-31,intra-ucfe,73,48,19,11,3,3,3,0,1,11,74,246,147,195,FALSE,0.792682926829268,2023,2023-2024
CA,2024-01-31,intra-ucx,81,18,9,4,3,2,1,0,1,7,42,168,123,141,FALSE,0.839285714285714,2023,2023-2024
CA,2024-01-31,intra-ui,53616,10133,4785,2175,1126,665,367,281,151,1292,21584,96175,75200,85333,FALSE,0.887268001039771,2023,2023-2024
CA,2024-02-29,inter-total,595,114,66,38,16,12,4,8,1,33,295,1182,890,1004,FALSE,0.849407783417936,2023,2023-2024
CA,2024-02-29,inter-ucfe,3,5,0,1,1,1,1,0,0,1,1,14,4,9,FALSE,0.642857142857143,2023,2023-2024
CA,2024-02-29,inter-ucx,1,0,0,0,0,0,0,0,0,0,0,1,1,1,FALSE,1,2023,2023-2024
CA,2024-02-29,inter-ui,591,109,66,37,15,11,3,8,1,32,294,1167,885,994,FALSE,0.851756640959726,2023,2023-2024
CA,2024-02-29,intra-total,41760,9319,4397,2117,1084,633,448,344,205,1373,21699,83379,63459,72778,FALSE,0.872857673994651,2023,2023-2024
CA,2024-02-29,intra-ucfe,52,38,18,9,7,3,0,2,1,6,41,177,93,131,FALSE,0.740112994350282,2023,2023-2024
CA,2024-02-29,intra-ucx,89,21,10,5,4,2,0,1,0,7,37,176,126,147,FALSE,0.835227272727273,2023,2023-2024
CA,2024-02-29,intra-ui,41619,9260,4369,2103,1073,628,448,341,204,1360,21621,83026,63240,72500,FALSE,0.873220436971551,2023,2023-2024
CA,2024-03-31,inter-total,566,110,63,21,19,14,12,11,4,39,308,1167,874,984,FALSE,0.84318766066838,2023,2023-2024
CA,2024-03-31,inter-ucfe,1,3,0,1,0,1,1,0,0,3,1,11,2,5,FALSE,0.454545454545455,2023,2023-2024
CA,2024-03-31,inter-ucx,3,0,1,0,0,0,0,0,0,0,0,4,3,3,FALSE,0.75,2023,2023-2024
CA,2024-03-31,inter-ui,562,107,62,20,19,13,11,11,4,36,307,1152,869,976,FALSE,0.847222222222222,2023,2023-2024
CA,2024-03-31,intra-total,38744,7944,4369,2334,1271,870,610,432,293,1543,20926,79336,59670,67614,FALSE,0.852248663910457,2023,2023-2024
CA,2024-03-31,intra-ucfe,28,20,8,5,4,5,5,3,2,9,25,114,53,73,FALSE,0.640350877192982,2023,2023-2024
CA,2024-03-31,intra-ucx,122,25,12,10,7,2,2,1,1,4,63,249,185,210,FALSE,0.843373493975904,2023,2023-2024
CA,2024-03-31,intra-ui,38594,7899,4349,2319,1260,863,603,428,290,1530,20838,78973,59432,67331,FALSE,0.852582528205842,2023,2023-2024
CA,2024-04-30,inter-total,684,74,41,24,18,8,4,6,7,36,289,1191,973,1047,FALSE,0.879093198992443,2023,2023-2024
CA,2024-04-30,inter-ucfe,1,0,1,0,0,0,0,0,1,2,1,6,2,2,FALSE,0.333333333333333,2023,2023-2024
CA,2024-04-30,inter-ucx,4,0,0,0,0,0,0,0,0,0,0,4,4,4,FALSE,1,2023,2023-2024
CA,2024-04-30,inter-ui,679,74,40,24,18,8,4,6,6,34,288,1181,967,1041,FALSE,0.881456392887383,2023,2023-2024
CA,2024-04-30,intra-total,37289,6062,2900,1496,784,514,352,246,198,1404,18421,69666,55710,61772,FALSE,0.886687910889099,2023,2023-2024
CA,2024-04-30,intra-ucfe,21,13,7,6,3,5,0,0,1,5,32,93,53,66,FALSE,0.709677419354839,2023,2023-2024
CA,2024-04-30,intra-ucx,106,20,14,3,4,0,1,1,1,2,54,206,160,180,FALSE,0.87378640776699,2023,2023-2024
CA,2024-04-30,intra-ui,37162,6029,2879,1487,777,509,351,245,196,1397,18335,69367,55497,61526,FALSE,0.88696354174175,2023,2023-2024
CA,2024-05-31,inter-total,665,158,73,34,14,8,10,2,4,17,386,1371,1051,1209,FALSE,0.88183807439825,2023,2023-2024
CA,2024-05-31,inter-ucfe,2,1,1,2,0,0,1,0,0,0,0,7,2,3,FALSE,0.428571428571429,2023,2023-2024
CA,2024-05-31,inter-ucx,1,1,1,0,0,0,1,0,0,1,3,8,4,5,FALSE,0.625,2023,2023-2024
CA,2024-05-31,inter-ui,662,156,71,32,14,8,8,2,4,16,383,1356,1045,1201,FALSE,0.885693215339233,2023,2023-2024
CA,2024-05-31,intra-total,32178,7304,3459,1587,714,425,280,236,153,1246,20247,67829,52425,59729,FALSE,0.880582051924693,2023,2023-2024
CA,2024-05-31,intra-ucfe,34,26,12,7,3,6,2,1,1,5,18,115,52,78,FALSE,0.678260869565217,2023,2023-2024
CA,2024-05-31,intra-ucx,110,24,19,8,4,3,0,2,1,7,54,232,164,188,FALSE,0.810344827586207,2023,2023-2024
CA,2024-05-31,intra-ui,32034,7254,3428,1572,707,416,278,233,151,1234,20175,67482,52209,59463,FALSE,0.881168311549747,2023,2023-2024
CA,2024-06-30,inter-total,603,111,70,34,16,13,9,4,5,24,278,1167,881,992,FALSE,0.850042844901457,2023,2023-2024
CA,2024-06-30,inter-ucfe,0,1,0,0,0,0,0,0,1,3,0,5,0,1,FALSE,0.2,2023,2023-2024
CA,2024-06-30,inter-ucx,2,0,0,0,0,0,0,0,0,0,0,2,2,2,FALSE,1,2023,2023-2024
CA,2024-06-30,inter-ui,601,110,70,34,16,13,9,4,4,21,278,1160,879,989,FALSE,0.852586206896552,2023,2023-2024
CA,2024-06-30,intra-total,35925,7612,4044,1873,868,537,327,198,128,1131,20662,73305,56587,64199,FALSE,0.875779278357547,2023,2023-2024
CA,2024-06-30,intra-ucfe,25,18,12,8,7,3,2,2,1,5,20,103,45,63,FALSE,0.611650485436893,2023,2023-2024
CA,2024-06-30,intra-ucx,113,20,10,7,1,0,1,1,4,4,52,213,165,185,FALSE,0.868544600938967,2023,2023-2024
CA,2024-06-30,intra-ui,35787,7574,4022,1858,860,534,324,195,123,1122,20590,72989,56377,63951,FALSE,0.876173121977284,2023,2023-2024
CA,2024-07-31,inter-total,659,124,61,32,21,7,10,6,4,47,384,1355,1043,1167,FALSE,0.861254612546125,2024,2024-2025
CA,2024-07-31,inter-ucfe,0,1,0,1,0,1,0,0,0,0,0,3,0,1,FALSE,0.333333333333333,2024,2024-2025
CA,2024-07-31,inter-ucx,4,0,0,0,0,0,0,0,0,0,0,4,4,4,FALSE,1,2024,2024-2025
CA,2024-07-31,inter-ui,655,123,61,31,21,6,10,6,4,47,384,1348,1039,1162,FALSE,0.862017804154303,2024,2024-2025
CA,2024-07-31,intra-total,41195,8923,4961,2347,1125,606,354,244,188,1355,23927,85225,65122,74045,FALSE,0.868817835142271,2024,2024-2025
CA,2024-07-31,intra-ucfe,25,12,10,9,7,4,1,1,3,11,31,114,56,68,FALSE,0.596491228070175,2024,2024-2025
CA,2024-07-31,intra-ucx,109,23,12,7,6,3,1,1,1,4,68,235,177,200,FALSE,0.851063829787234,2024,2024-2025
CA,2024-07-31,intra-ui,41061,8888,4939,2331,1112,599,352,242,184,1340,23828,84876,64889,73777,FALSE,0.869232763089684,2024,2024-2025
CA,2024-08-31,inter-total,580,102,53,23,12,8,6,5,0,29,339,1157,919,1021,FALSE,0.882454624027658,2024,2024-2025
CA,2024-08-31,inter-ucfe,1,0,0,0,0,0,0,0,0,0,2,3,3,3,FALSE,1,2024,2024-2025
CA,2024-08-31,inter-ucx,4,0,1,0,0,0,0,1,0,1,1,8,5,5,FALSE,0.625,2024,2024-2025
CA,2024-08-31,inter-ui,575,102,52,23,12,8,6,4,0,28,336,1146,911,1013,FALSE,0.883944153577662,2024,2024-2025
CA,2024-08-31,intra-total,35521,6629,3437,1496,762,487,323,216,160,1241,19714,69986,55235,61864,FALSE,0.883948218215072,2024,2024-2025
CA,2024-08-31,intra-ucfe,27,13,11,6,7,3,3,1,1,7,31,110,58,71,FALSE,0.645454545454546,2024,2024-2025
CA,2024-08-31,intra-ucx,112,26,15,7,4,1,2,0,0,8,55,230,167,193,FALSE,0.839130434782609,2024,2024-2025
CA,2024-08-31,intra-ui,35382,6590,3411,1483,751,483,318,215,159,1226,19628,69646,55010,61600,FALSE,0.884472905838095,2024,2024-2025
CA,2024-09-30,inter-total,537,84,46,25,11,10,6,5,1,30,307,1062,844,928,FALSE,0.873822975517891,2024,2024-2025
CA,2024-09-30,inter-ucfe,2,1,1,0,3,1,0,0,0,0,0,8,2,3,FALSE,0.375,2024,2024-2025
CA,2024-09-30,inter-ucx,1,1,0,0,0,0,0,0,0,1,0,3,1,2,FALSE,0.666666666666667,2024,2024-2025
CA,2024-09-30,inter-ui,534,82,45,25,8,9,6,5,1,29,307,1051,841,923,FALSE,0.878211227402474,2024,2024-2025
CA,2024-09-30,intra-total,31261,6160,3181,1527,692,418,257,168,124,1124,17907,62819,49168,55328,FALSE,0.880752638532928,2024,2024-2025
CA,2024-09-30,intra-ucfe,17,12,4,11,5,4,0,1,0,2,16,72,33,45,FALSE,0.625,2024,2024-2025
CA,2024-09-30,intra-ucx,138,25,9,5,1,1,2,1,1,7,40,230,178,203,FALSE,0.882608695652174,2024,2024-2025
CA,2024-09-30,intra-ui,31106,6123,3168,1511,686,413,255,166,123,1115,17851,62517,48957,55080,FALSE,0.88104035702289,2024,2024-2025
CA,2024-10-31,inter-total,477,73,44,17,8,9,5,7,1,36,320,997,797,870,FALSE,0.872617853560682,2024,2024-2025
CA,2024-10-31,inter-ucfe,0,2,3,0,0,1,0,0,0,0,3,9,3,5,FALSE,0.555555555555556,2024,2024-2025
CA,2024-10-31,inter-ucx,3,1,0,0,0,0,0,0,0,0,1,5,4,5,FALSE,1,2024,2024-2025
CA,2024-10-31,inter-ui,474,70,41,17,8,8,5,7,1,36,316,983,790,860,FALSE,0.874872838250254,2024,2024-2025
CA,2024-10-31,intra-total,31539,5885,2882,1358,644,376,237,168,126,1066,18089,62370,49628,55513,FALSE,0.890059323392657,2024,2024-2025
CA,2024-10-31,intra-ucfe,14,9,10,6,0,4,3,0,1,11,16,74,30,39,FALSE,0.527027027027027,2024,2024-2025
CA,2024-10-31,intra-ucx,117,22,12,9,5,1,2,0,0,5,48,221,165,187,FALSE,0.846153846153846,2024,2024-2025
CA,2024-10-31,intra-ui,31408,5854,2860,1343,639,371,232,168,125,1050,18025,62075,49433,55287,FALSE,0.890648409182441,2024,2024-2025
CA,2024-11-30,inter-total,549,96,50,14,9,4,2,1,2,19,274,1020,823,919,FALSE,0.900980392156863,2024,2024-2025
CA,2024-11-30,inter-ucfe,13,4,0,0,0,0,0,0,0,0,4,21,17,21,FALSE,1,2024,2024-2025
CA,2024-11-30,inter-ucx,3,0,0,0,0,0,0,0,0,0,1,4,4,4,FALSE,1,2024,2024-2025
CA,2024-11-30,inter-ui,533,92,50,14,9,4,2,1,2,19,269,995,802,894,FALSE,0.898492462311558,2024,2024-2025
CA,2024-11-30,intra-total,34054,6350,3234,1387,574,339,182,127,85,821,17321,64474,51375,57725,FALSE,0.895322145360921,2024,2024-2025
CA,2024-11-30,intra-ucfe,40,18,7,5,3,2,1,1,0,6,24,107,64,82,FALSE,0.766355140186916,2024,2024-2025
CA,2024-11-30,intra-ucx,109,29,9,6,2,3,1,0,0,2,52,213,161,190,FALSE,0.892018779342723,2024,2024-2025
CA,2024-11-30,intra-ui,33905,6303,3218,1376,569,334,180,126,85,813,17245,64154,51150,57453,FALSE,0.895548212114599,2024,2024-2025
CA,2024-12-31,inter-total,659,115,69,29,15,5,5,5,4,22,330,1258,989,1104,FALSE,0.87758346581876,2024,2024-2025
CA,2024-12-31,inter-ucfe,12,3,1,2,1,0,0,0,0,1,11,31,23,26,FALSE,0.838709677419355,2024,2024-2025
CA,2024-12-31,inter-ucx,3,0,0,0,0,0,1,0,0,0,1,5,4,4,FALSE,0.8,2024,2024-2025
CA,2024-12-31,inter-ui,644,112,68,27,14,5,4,5,4,21,318,1222,962,1074,FALSE,0.878887070376432,2024,2024-2025
CA,2024-12-31,intra-total,44449,8589,4250,2069,875,521,326,207,142,1054,21914,84396,66363,74952,FALSE,0.888098962036116,2024,2024-2025
CA,2024-12-31,intra-ucfe,83,40,15,4,5,6,2,3,0,5,84,247,167,207,FALSE,0.838056680161943,2024,2024-2025
CA,2024-12-31,intra-ucx,101,23,12,5,3,2,0,0,0,4,52,202,153,176,FALSE,0.871287128712871,2024,2024-2025
CA,2024-12-31,intra-ui,44265,8526,4223,2060,867,513,324,204,142,1045,21778,83947,66043,74569,FALSE,0.888286657057429,2024,2024-2025
CO,2019-01-31,inter-total,252,19,6,6,5,3,0,3,2,8,119,423,371,390,FALSE,0.921985815602837,2018,2018-2019
CO,2019-01-31,inter-ucfe,14,1,1,0,1,0,0,0,0,1,17,35,31,32,FALSE,0.914285714285714,2018,2018-2019
CO,2019-01-31,inter-ucx,0,0,0,0,0,0,0,0,0,0,0,0,0,0,FALSE,0,2018,2018-2019
CO,2019-01-31,inter-ui,238,18,5,6,4,3,0,3,2,7,102,388,340,358,FALSE,0.922680412371134,2018,2018-2019
CO,2019-01-31,intra-total,4730,305,52,27,21,25,22,12,6,33,1911,7144,6641,6946,FALSE,0.972284434490481,2018,2018-2019
CO,2019-01-31,intra-ucfe,455,4,2,1,0,1,1,0,0,1,153,618,608,612,FALSE,0.990291262135922,2018,2018-2019
CO,2019-01-31,intra-ucx,11,0,2,1,0,0,0,0,0,1,7,22,18,18,FALSE,0.818181818181818,2018,2018-2019
CO,2019-01-31,intra-ui,4264,301,48,25,21,24,21,12,6,31,1751,6504,6015,6316,FALSE,0.971094710947109,2018,2018-2019
CO,2019-02-28,inter-total,150,40,7,3,6,0,1,1,1,2,90,301,240,280,FALSE,0.930232558139535,2018,2018-2019
CO,2019-02-28,inter-ucfe,7,6,4,0,0,0,0,0,0,0,10,27,17,23,FALSE,0.851851851851852,2018,2018-2019
CO,2019-02-28,inter-ucx,1,0,0,0,0,0,0,0,0,0,0,1,1,1,FALSE,1,2018,2018-2019
CO,2019-02-28,inter-ui,142,34,3,3,6,0,1,1,1,2,80,273,222,256,FALSE,0.937728937728938,2018,2018-2019
CO,2019-02-28,intra-total,2721,294,65,38,27,19,18,6,4,20,1703,4915,4424,4718,FALSE,0.959918616480163,2018,2018-2019
CO,2019-02-28,intra-ucfe,24,13,5,6,1,0,0,0,0,2,24,75,48,61,FALSE,0.813333333333333,2018,2018-2019
CO,2019-02-28,intra-ucx,28,2,0,0,0,0,0,0,0,0,7,37,35,37,FALSE,1,2018,2018-2019
CO,2019-02-28,intra-ui,2669,279,60,32,26,19,18,6,4,18,1672,4803,4341,4620,FALSE,0.961898813241724,2018,2018-2019
CO,2019-03-31,inter-total,130,14,4,3,6,3,1,1,1,1,76,240,206,220,FALSE,0.916666666666667,2018,2018-2019
CO,2019-03-31,inter-ucfe,2,2,0,0,0,0,0,0,0,0,3,7,5,7,FALSE,1,2018,2018-2019
CO,2019-03-31,inter-ucx,0,0,0,0,0,0,0,0,0,0,0,0,0,0,FALSE,0,2018,2018-2019
CO,2019-03-31,inter-ui,128,12,4,3,6,3,1,1,1,1,73,233,201,213,FALSE,0.914163090128755,2018,2018-2019
CO,2019-03-31,intra-total,2067,204,46,32,32,28,10,4,11,22,1484,3940,3551,3755,FALSE,0.953045685279188,2018,2018-2019
CO,2019-03-31,intra-ucfe,10,3,1,2,1,0,0,1,1,0,7,26,17,20,FALSE,0.769230769230769,2018,2018-2019
CO,2019-03-31,intra-ucx,15,2,1,1,0,0,0,0,0,0,3,22,18,20,FALSE,0.909090909090909,2018,2018-2019
CO,2019-03-31,intra-ui,2042,199,44,29,31,28,10,3,10,22,1474,3892,3516,3715,FALSE,0.954522096608428,2018,2018-2019
CO,2019-04-30,inter-total,161,11,3,2,3,1,1,1,2,5,68,258,229,240,FALSE,0.930232558139535,2018,2018-2019
CO,2019-04-30,inter-ucfe,1,0,0,0,0,0,0,0,0,1,2,4,3,3,FALSE,0.75,2018,2018-2019
CO,2019-04-30,inter-ucx,0,0,0,0,0,0,0,0,0,0,0,0,0,0,FALSE,0,2018,2018-2019
CO,2019-04-30,inter-ui,160,11,3,2,3,1,1,1,2,4,66,254,226,237,FALSE,0.933070866141732,2018,2018-2019
CO,2019-04-30,intra-total,2012,134,33,30,34,27,10,12,7,32,1125,3456,3137,3271,FALSE,0.946469907407407,2018,2018-2019
CO,2019-04-30,intra-ucfe,6,3,2,0,1,3,0,0,0,2,9,26,15,18,FALSE,0.692307692307692,2018,2018-2019
CO,2019-04-30,intra-ucx,16,2,0,0,0,0,0,0,0,0,8,26,24,26,FALSE,1,2018,2018-2019
CO,2019-04-30,intra-ui,1990,129,31,30,33,24,10,12,7,30,1108,3404,3098,3227,FALSE,0.948002350176263,2018,2018-2019
CO,2019-05-31,inter-total,157,16,4,7,1,3,1,1,1,0,76,267,233,249,FALSE,0.932584269662921,2018,2018-2019
CO,2019-05-31,inter-ucfe,2,1,0,1,0,0,0,0,0,0,1,5,3,4,FALSE,0.8,2018,2018-2019
CO,2019-05-31,inter-ucx,0,0,0,0,0,0,0,0,0,0,0,0,0,0,FALSE,0,2018,2018-2019
CO,2019-05-31,inter-ui,155,15,4,6,1,3,1,1,1,0,75,262,230,245,FALSE,0.935114503816794,2018,2018-2019
CO,2019-05-31,intra-total,2053,167,49,34,15,9,16,12,7,21,1416,3799,3469,3636,FALSE,0.95709397209792,2018,2018-2019
CO,2019-05-31,intra-ucfe,6,0,1,1,1,0,0,0,0,0,9,18,15,15,FALSE,0.833333333333333,2018,2018-2019
CO,2019-05-31,intra-ucx,26,1,1,0,0,0,0,0,0,0,6,34,32,33,FALSE,0.970588235294118,2018,2018-2019
CO,2019-05-31,intra-ui,2021,166,47,33,14,9,16,12,7,21,1401,3747,3422,3588,FALSE,0.957566052842274,2018,2018-2019
CO,2019-06-30,inter-total,118,12,4,1,1,1,1,2,0,2,58,200,176,188,FALSE,0.94,2018,2018-2019
CO,2019-06-30,inter-ucfe,1,0,0,0,0,0,0,0,0,0,1,2,2,2,FALSE,1,2018,2018-2019
CO,2019-06-30,inter-ucx,0,0,0,0,0,0,0,0,0,0,0,0,0,0,FALSE,0,2018,2018-2019
CO,2019-06-30,inter-ui,117,12,4,1,1,1,1,2,0,2,57,198,174,186,FALSE,0.939393939393939,2018,2018-2019
CO,2019-06-30,intra-total,2156,127,39,26,27,23,4,3,3,21,1209,3638,3365,3492,FALSE,0.959868059373282,2018,2018-2019
CO,2019-06-30,intra-ucfe,1,1,0,0,0,0,0,0,0,0,7,9,8,9,FALSE,1,2018,2018-2019
CO,2019-06-30,intra-ucx,13,0,0,0,1,0,0,0,0,0,3,17,16,16,FALSE,0.941176470588235,2018,2018-2019
CO,2019-06-30,intra-ui,2142,126,39,26,26,23,4,3,3,21,1199,3612,3341,3467,FALSE,0.959856035437431,2018,2018-2019
CO,2019-07-31,inter-total,162,13,6,1,6,1,1,1,0,5,68,264,230,243,FALSE,0.920454545454545,2019,2019-2020
CO,2019-07-31,inter-ucfe,0,2,1,0,0,0,1,0,0,0,1,5,1,3,FALSE,0.6,2019,2019-2020
CO,2019-07-31,inter-ucx,0,0,0,0,0,0,0,0,0,0,0,0,0,0,FALSE,0,2019,2019-2020
CO,2019-07-31,inter-ui,162,11,5,1,6,1,0,1,0,5,67,259,229,240,FALSE,0.926640926640927,2019,2019-2020
CO,2019-07-31,intra-total,1889,148,33,25,28,15,20,13,6,17,1206,3400,3095,3243,FALSE,0.953823529411765,2019,2019-2020
CO,2019-07-31,intra-ucfe,7,4,0,0,0,0,0,0,0,0,3,14,10,14,FALSE,1,2019,2019-2020
CO,2019-07-31,intra-ucx,25,0,0,0,0,0,0,0,0,0,4,29,29,29,FALSE,1,2019,2019-2020
CO,2019-07-31,intra-ui,1857,144,33,25,28,15,20,13,6,17,1199,3357,3056,3200,FALSE,0.953232052427763,2019,2019-2020
CO,2019-08-31,inter-total,135,11,9,3,2,2,1,0,0,4,81,248,216,227,FALSE,0.915322580645161,2019,2019-2020
CO,2019-08-31,inter-ucfe,3,0,1,0,0,0,0,0,0,0,3,7,6,6,FALSE,0.857142857142857,2019,2019-2020
CO,2019-08-31,inter-ucx,0,0,0,0,0,0,0,0,0,0,1,1,1,1,FALSE,1,2019,2019-2020
CO,2019-08-31,inter-ui,132,11,8,3,2,2,1,0,0,4,77,240,209,220,FALSE,0.916666666666667,2019,2019-2020
CO,2019-08-31,intra-total,1634,156,41,44,27,12,14,9,2,24,1190,3153,2824,2980,FALSE,0.945131620678719,2019,2019-2020
CO,2019-08-31,intra-ucfe,6,2,1,1,0,0,0,0,0,1,5,16,11,13,FALSE,0.8125,2019,2019-2020
CO,2019-08-31,intra-ucx,8,1,0,0,1,0,0,0,0,0,8,18,16,17,FALSE,0.944444444444444,2019,2019-2020
CO,2019-08-31,intra-ui,1620,153,40,43,26,12,14,9,2,23,1177,3119,2797,2950,FALSE,0.945815966655979,2019,2019-2020
CO,2019-09-30,inter-total,122,15,3,1,3,3,0,1,1,0,75,224,197,212,FALSE,0.946428571428571,2019,2019-2020
CO,2019-09-30,inter-ucfe,1,0,0,0,0,0,0,0,0,0,2,3,3,3,FALSE,1,2019,2019-2020
CO,2019-09-30,inter-ucx,0,0,0,0,0,0,0,0,0,0,0,0,0,0,FALSE,0,2019,2019-2020
CO,2019-09-30,inter-ui,121,15,3,1,3,3,0,1,1,0,73,221,194,209,FALSE,0.945701357466063,2019,2019-2020
CO,2019-09-30,intra-total,1384,160,32,24,22,22,9,6,5,12,1034,2710,2418,2578,FALSE,0.951291512915129,2019,2019-2020
CO,2019-09-30,intra-ucfe,3,1,0,1,0,1,0,0,0,1,7,14,10,11,FALSE,0.785714285714286,2019,2019-2020
CO,2019-09-30,intra-ucx,15,2,0,0,0,0,0,0,0,0,5,22,20,22,FALSE,1,2019,2019-2020
CO,2019-09-30,intra-ui,1366,157,32,23,22,21,9,6,5,11,1022,2674,2388,2545,FALSE,0.951757666417352,2019,2019-2020
CO,2019-10-31,inter-total,190,17,9,3,2,1,1,0,0,2,78,303,268,285,FALSE,0.940594059405941,2019,2019-2020
CO,2019-10-31,inter-ucfe,3,0,0,0,0,0,0,0,0,0,1,4,4,4,FALSE,1,2019,2019-2020
CO,2019-10-31,inter-ucx,0,0,0,0,0,0,0,0,0,0,0,0,0,0,FALSE,0,2019,2019-2020
CO,2019-10-31,inter-ui,187,17,9,3,2,1,1,0,0,2,77,299,264,281,FALSE,0.939799331103679,2019,2019-2020
CO,2019-10-31,intra-total,1833,145,39,25,12,16,12,11,4,14,1179,3290,3012,3157,FALSE,0.959574468085106,2019,2019-2020
CO,2019-10-31,intra-ucfe,12,0,1,1,0,0,0,0,0,0,4,18,16,16,FALSE,0.888888888888889,2019,2019-2020
CO,2019-10-31,intra-ucx,16,0,0,1,0,0,0,0,0,0,9,26,25,25,FALSE,0.961538461538461,2019,2019-2020
CO,2019-10-31,intra-ui,1805,145,38,23,12,16,12,11,4,14,1166,3246,2971,3116,FALSE,0.959950708564387,2019,2019-2020
CO,2019-11-30,inter-total,214,18,8,3,3,1,1,1,0,1,99,349,313,331,FALSE,0.948424068767908,2019,2019-2020
CO,2019-11-30,inter-ucfe,5,0,1,0,0,0,0,0,0,0,12,18,17,17,FALSE,0.944444444444444,2019,2019-2020
CO,2019-11-30,inter-ucx,1,0,0,0,0,0,0,0,0,0,1,2,2,2,FALSE,1,2019,2019-2020
CO,2019-11-30,inter-ui,208,18,7,3,3,1,1,1,0,1,86,329,294,312,FALSE,0.948328267477204,2019,2019-2020
CO,2019-11-30,intra-total,2056,192,35,27,24,22,10,6,8,19,1515,3914,3571,3763,FALSE,0.961420541645376,2019,2019-2020
CO,2019-11-30,intra-ucfe,19,2,0,0,0,0,1,0,0,0,29,51,48,50,FALSE,0.980392156862745,2019,2019-2020
CO,2019-11-30,intra-ucx,7,0,0,0,1,0,0,0,0,0,2,10,9,9,FALSE,0.9,2019,2019-2020
CO,2019-11-30,intra-ui,2030,190,35,27,23,22,9,6,8,19,1484,3853,3514,3704,FALSE,0.96132883467428,2019,2019-2020
CO,2019-12-31,inter-total,222,50,7,3,4,2,5,0,0,1,105,399,327,377,FALSE,0.944862155388471,2019,2019-2020
CO,2019-12-31,inter-ucfe,4,2,1,0,0,0,0,0,0,0,6,13,10,12,FALSE,0.923076923076923,2019,2019-2020
CO,2019-12-31,inter-ucx,0,0,0,0,0,0,0,0,0,0,0,0,0,0,FALSE,0,2019,2019-2020
CO,2019-12-31,inter-ui,218,48,6,3,4,2,5,0,0,1,99,386,317,365,FALSE,0.94559585492228,2019,2019-2020
CO,2019-12-31,intra-total,2815,331,66,25,31,26,14,10,8,24,1557,4907,4372,4703,FALSE,0.958426737314041,2019,2019-2020
CO,2019-12-31,intra-ucfe,29,9,2,0,1,1,1,0,0,0,42,85,71,80,FALSE,0.941176470588235,2019,2019-2020
CO,2019-12-31,intra-ucx,20,1,1,0,0,2,0,0,0,0,10,34,30,31,FALSE,0.911764705882353,2019,2019-2020
CO,2019-12-31,intra-ui,2766,321,63,25,30,23,13,10,8,24,1505,4788,4271,4592,FALSE,0.95906432748538,2019,2019-2020
CO,2020-01-31,inter-total,279,25,12,4,4,3,2,3,1,3,113,449,392,417,FALSE,0.928730512249443,2019,2019-2020
CO,2020-01-31,inter-ucfe,14,2,1,0,1,1,1,0,0,0,11,31,25,27,FALSE,0.870967741935484,2019,2019-2020
CO,2020-01-31,inter-ucx,0,0,0,0,0,0,0,0,0,0,0,0,0,0,FALSE,0,2019,2019-2020
CO,2020-01-31,inter-ui,265,23,11,4,3,2,1,3,1,3,102,418,367,390,FALSE,0.933014354066986,2019,2019-2020
CO,2020-01-31,intra-total,3797,347,64,32,12,36,19,15,8,21,1885,6236,5682,6029,FALSE,0.966805644644003,2019,2019-2020
CO,2020-01-31,intra-ucfe,51,4,1,0,0,1,1,0,0,0,22,80,73,77,FALSE,0.9625,2019,2019-2020
CO,2020-01-31,intra-ucx,10,1,1,0,0,0,0,0,0,0,3,15,13,14,FALSE,0.933333333333333,2019,2019-2020
CO,2020-01-31,intra-ui,3736,342,62,32,12,35,18,15,8,21,1860,6141,5596,5938,FALSE,0.966943494544862,2019,2019-2020
CO,2020-02-29,inter-total,160,22,9,5,4,2,2,1,1,3,118,327,278,300,FALSE,0.91743119266055,2019,2019-2020
CO,2020-02-29,inter-ucfe,4,3,2,1,0,0,0,0,0,0,11,21,15,18,FALSE,0.857142857142857,2019,2019-2020
CO,2020-02-29,inter-ucx,0,0,0,0,0,0,0,0,0,0,0,0,0,0,FALSE,0,2019,2019-2020
CO,2020-02-29,inter-ui,156,19,7,4,4,2,2,1,1,3,107,306,263,282,FALSE,0.92156862745098,2019,2019-2020
CO,2020-02-29,intra-total,2522,357,58,38,27,12,10,14,10,29,1917,4994,4439,4796,FALSE,0.960352422907489,2019,2019-2020
CO,2020-02-29,intra-ucfe,27,7,0,0,1,0,0,0,0,0,26,61,53,60,FALSE,0.983606557377049,2019,2019-2020
CO,2020-02-29,intra-ucx,10,1,0,0,0,0,0,0,0,0,5,16,15,16,FALSE,1,2019,2019-2020
CO,2020-02-29,intra-ui,2485,349,58,38,26,12,10,14,10,29,1886,4917,4371,4720,FALSE,0.959934919666463,2019,2019-2020
CO,2020-03-31,inter-total,160,22,5,2,1,1,1,0,0,0,273,465,433,455,FALSE,0.978494623655914,2019,2019-2020
CO,2020-03-31,inter-ucfe,3,0,1,0,0,0,0,0,0,0,1,5,4,4,FALSE,0.8,2019,2019-2020
CO,2020-03-31,inter-ucx,0,0,0,0,0,0,0,0,0,0,0,0,0,0,FALSE,0,2019,2019-2020
CO,2020-03-31,inter-ui,157,22,4,2,1,1,1,0,0,0,272,460,429,451,FALSE,0.980434782608696,2019,2019-2020
CO,2020-03-31,intra-total,2597,397,72,31,19,34,15,9,12,33,17973,21192,20570,20967,FALSE,0.989382785956965,2019,2019-2020
CO,2020-03-31,intra-ucfe,10,1,1,2,2,0,1,0,0,0,12,29,22,23,FALSE,0.793103448275862,2019,2019-2020
CO,2020-03-31,intra-ucx,17,0,1,0,0,0,0,0,0,0,11,29,28,28,FALSE,0.96551724137931,2019,2019-2020
CO,2020-03-31,intra-ui,2570,396,70,29,17,34,14,9,12,33,17950,21134,20520,20916,FALSE,0.989684867985237,2019,2019-2020
CO,2020-04-30,inter-total,93,554,268,24,12,5,1,1,0,2,2863,3823,2956,3510,FALSE,0.918127125294271,2019,2019-2020
CO,2020-04-30,inter-ucfe,0,1,2,0,0,0,0,0,0,0,0,3,0,1,FALSE,0.333333333333333,2019,2019-2020
CO,2020-04-30,inter-ucx,0,0,0,0,0,0,0,0,0,0,0,0,0,0,FALSE,0,2019,2019-2020
CO,2020-04-30,inter-ui,93,553,266,24,12,5,1,1,0,2,2863,3820,2956,3509,FALSE,0.918586387434555,2019,2019-2020
CO,2020-04-30,intra-total,5100,40237,8708,605,282,40,24,14,8,27,146926,201971,152026,192263,FALSE,0.95193369345104,2019,2019-2020
CO,2020-04-30,intra-ucfe,0,8,7,6,2,1,0,0,0,0,30,54,30,38,FALSE,0.703703703703704,2019,2019-2020
CO,2020-04-30,intra-ucx,4,16,12,5,3,0,0,0,0,0,56,96,60,76,FALSE,0.791666666666667,2019,2019-2020
CO,2020-04-30,intra-ui,5096,40213,8689,594,277,39,24,14,8,27,146840,201821,151936,192149,FALSE,0.952076344879869,2019,2019-2020
CO,2020-05-31,inter-total,69,220,50,42,35,46,31,29,8,5,2294,2829,2363,2583,FALSE,0.91304347826087,2019,2019-2020
CO,2020-05-31,inter-ucfe,0,1,1,0,0,3,0,0,0,0,3,8,3,4,FALSE,0.5,2019,2019-2020
CO,2020-05-31,inter-ucx,0,0,0,0,0,0,0,0,0,0,0,0,0,0,FALSE,0,2019,2019-2020
CO,2020-05-31,inter-ui,69,219,49,42,35,43,31,29,8,5,2291,2821,2360,2579,FALSE,0.914214817440624,2019,2019-2020
CO,2020-05-31,intra-total,2145,8554,1911,812,860,1015,565,394,165,59,71280,87760,73425,81979,FALSE,0.934127164995442,2019,2019-2020
CO,2020-05-31,intra-ucfe,1,20,4,2,2,2,0,1,2,0,30,64,31,51,FALSE,0.796875,2019,2019-2020
CO,2020-05-31,intra-ucx,2,17,9,1,2,2,1,0,1,0,60,95,62,79,FALSE,0.831578947368421,2019,2019-2020
CO,2020-05-31,intra-ui,2142,8517,1898,809,856,1011,564,393,162,59,71190,87601,73332,81849,FALSE,0.934338649102179,2019,2019-2020
CO,2020-06-30,inter-total,26,165,28,18,17,25,24,31,32,99,1169,1634,1195,1360,FALSE,0.832313341493268,2019,2019-2020
CO,2020-06-30,inter-ucfe,0,0,1,0,2,0,0,0,0,1,1,5,1,1,FALSE,0.2,2019,2019-2020
CO,2020-06-30,inter-ucx,0,0,0,0,0,0,0,0,0,0,0,0,0,0,FALSE,0,2019,2019-2020
CO,2020-06-30,inter-ui,26,165,27,18,15,25,24,31,32,98,1168,1629,1194,1359,FALSE,0.834254143646409,2019,2019-2020
CO,2020-06-30,intra-total,1135,3910,699,323,393,799,555,476,549,1591,30853,41283,31988,35898,FALSE,0.869558898335877,2019,2019-2020
CO,2020-06-30,intra-ucfe,0,9,1,1,0,3,3,4,3,4,16,44,16,25,FALSE,0.568181818181818,2019,2019-2020
CO,2020-06-30,intra-ucx,0,17,7,1,2,0,2,0,0,1,55,85,55,72,FALSE,0.847058823529412,2019,2019-2020
CO,2020-06-30,intra-ui,1135,3884,691,321,391,796,550,472,546,1586,30782,41154,31917,35801,FALSE,0.869927589055742,2019,2019-2020
CO,2020-07-31,inter-total,24,108,14,11,7,12,8,7,11,161,823,1186,847,955,FALSE,0.805227655986509,2020,2020-2021
CO,2020-07-31,inter-ucfe,0,1,0,0,1,0,0,0,0,1,2,5,2,3,FALSE,0.6,2020,2020-2021
CO,2020-07-31,inter-ucx,0,0,0,0,0,0,0,0,0,0,0,0,0,0,FALSE,0,2020,2020-2021
CO,2020-07-31,inter-ui,24,107,14,11,6,12,8,7,11,160,821,1181,845,952,FALSE,0.806096528365792,2020,2020-2021
CO,2020-07-31,intra-total,868,2374,465,185,224,162,186,221,172,2258,19544,26659,20412,22786,FALSE,0.854720732210511,2020,2020-2021
CO,2020-07-31,intra-ucfe,0,7,4,2,1,2,1,0,3,5,13,38,13,20,FALSE,0.526315789473684,2020,2020-2021
CO,2020-07-31,intra-ucx,2,12,5,1,1,1,1,0,1,4,55,83,57,69,FALSE,0.831325301204819,2020,2020-2021
CO,2020-07-31,intra-ui,866,2355,456,182,222,159,184,221,168,2249,19476,26538,20342,22697,FALSE,0.855264149521441,2020,2020-2021
CO,2020-08-31,inter-total,28,81,23,5,10,9,6,11,12,513,676,1374,704,785,FALSE,0.571324599708879,2020,2020-2021
CO,2020-08-31,inter-ucfe,0,0,0,0,1,1,0,0,0,0,2,4,2,2,FALSE,0.5,2020,2020-2021
CO,2020-08-31,inter-ucx,0,0,0,0,0,0,0,0,0,1,0,1,0,0,FALSE,0,2020,2020-2021
CO,2020-08-31,inter-ui,28,81,23,5,9,8,6,11,12,512,674,1369,702,783,FALSE,0.571950328707086,2020,2020-2021
CO,2020-08-31,intra-total,492,1712,396,227,177,177,155,111,109,2373,14306,20235,14798,16510,FALSE,0.815913021991599,2020,2020-2021
CO,2020-08-31,intra-ucfe,0,7,0,3,2,0,2,0,2,10,20,46,20,27,FALSE,0.586956521739131,2020,2020-2021
CO,2020-08-31,intra-ucx,0,10,2,3,1,2,1,0,1,6,60,86,60,70,FALSE,0.813953488372093,2020,2020-2021
CO,2020-08-31,intra-ui,492,1695,394,221,174,175,152,111,106,2357,14226,20103,14718,16413,FALSE,0.816445306670646,2020,2020-2021
CO,2020-09-30,inter-total,20,52,12,6,6,6,11,6,11,480,445,1055,465,517,FALSE,0.490047393364929,2020,2020-2021
CO,2020-09-30,inter-ucfe,0,0,0,0,0,0,0,0,0,4,2,6,2,2,FALSE,0.333333333333333,2020,2020-2021
CO,2020-09-30,inter-ucx,0,0,0,0,0,0,0,0,0,1,1,2,1,1,FALSE,0.5,2020,2020-2021
CO,2020-09-30,inter-ui,20,52,12,6,6,6,11,6,11,475,442,1047,462,514,FALSE,0.490926456542502,2020,2020-2021
CO,2020-09-30,intra-total,380,1246,171,108,69,96,115,121,93,1847,9413,13659,9793,11039,FALSE,0.808185079434805,2020,2020-2021
CO,2020-09-30,intra-ucfe,1,8,2,1,1,2,2,2,1,5,13,38,14,22,FALSE,0.578947368421053,2020,2020-2021
CO,2020-09-30,intra-ucx,1,8,2,1,0,0,2,2,0,7,29,52,30,38,FALSE,0.730769230769231,2020,2020-2021
CO,2020-09-30,intra-ui,378,1230,167,106,68,94,111,117,92,1835,9371,13569,9749,10979,FALSE,0.809123737932051,2020,2020-2021
CO,2020-10-31,inter-total,14,85,14,3,9,3,9,6,8,595,587,1333,601,686,FALSE,0.514628657164291,2020,2020-2021
CO,2020-10-31,inter-ucfe,1,2,3,0,0,0,0,1,0,1,2,10,3,5,FALSE,0.5,2020,2020-2021
CO,2020-10-31,inter-ucx,0,0,0,0,0,0,0,0,0,1,0,1,0,0,FALSE,0,2020,2020-2021
CO,2020-10-31,inter-ui,13,83,11,3,9,3,9,5,8,593,585,1322,598,681,FALSE,0.515128593040847,2020,2020-2021
CO,2020-10-31,intra-total,351,1015,140,67,57,47,66,54,77,1629,9106,12609,9457,10472,FALSE,0.830517884051075,2020,2020-2021
CO,2020-10-31,intra-ucfe,0,6,1,0,3,0,1,1,1,15,14,42,14,20,FALSE,0.476190476190476,2020,2020-2021
CO,2020-10-31,intra-ucx,1,14,2,1,1,1,1,0,0,4,26,51,27,41,FALSE,0.803921568627451,2020,2020-2021
CO,2020-10-31,intra-ui,350,995,137,66,53,46,64,53,76,1610,9066,12516,9416,10411,FALSE,0.831815276446149,2020,2020-2021
CO,2020-11-30,inter-total,32,67,18,11,5,2,5,3,4,112,823,1082,855,922,FALSE,0.852125693160813,2020,2020-2021
CO,2020-11-30,inter-ucfe,0,4,2,1,0,1,0,0,0,0,3,11,3,7,FALSE,0.636363636363636,2020,2020-2021
CO,2020-11-30,inter-ucx,0,0,0,0,0,0,0,0,0,0,0,0,0,0,FALSE,0,2020,2020-2021
CO,2020-11-30,inter-ui,32,63,16,10,5,1,5,3,4,112,820,1071,852,915,FALSE,0.854341736694678,2020,2020-2021
CO,2020-11-30,intra-total,415,1274,240,58,54,43,38,38,27,752,12163,15102,12578,13852,FALSE,0.917229506025692,2020,2020-2021
CO,2020-11-30,intra-ucfe,0,22,10,4,2,3,1,1,2,7,25,77,25,47,FALSE,0.61038961038961,2020,2020-2021
CO,2020-11-30,intra-ucx,0,1,2,0,0,1,1,0,0,2,25,32,25,26,FALSE,0.8125,2020,2020-2021
CO,2020-11-30,intra-ui,415,1251,228,54,52,39,36,37,25,743,12113,14993,12528,13779,FALSE,0.919028880144067,2020,2020-2021
CO,2020-12-31,inter-total,56,249,43,5,4,7,7,6,2,127,1882,2388,1938,2187,FALSE,0.915829145728643,2020,2020-2021
CO,2020-12-31,inter-ucfe,1,4,3,2,0,1,0,0,0,3,2,16,3,7,FALSE,0.4375,2020,2020-2021
CO,2020-12-31,inter-ucx,0,0,0,0,0,0,0,0,0,0,0,0,0,0,FALSE,0,2020,2020-2021
CO,2020-12-31,inter-ui,55,245,40,3,4,6,7,6,2,124,1880,2372,1935,2180,FALSE,0.919055649241147,2020,2020-2021
CO,2020-12-31,intra-total,1423,2852,368,116,87,56,68,64,54,908,26965,32961,28388,31240,FALSE,0.947786778313765,2020,2020-2021
CO,2020-12-31,intra-ucfe,1,25,12,11,14,8,7,1,0,13,46,138,47,72,FALSE,0.521739130434783,2020,2020-2021
CO,2020-12-31,intra-ucx,0,9,20,6,4,0,0,0,0,1,11,51,11,20,FALSE,0.392156862745098,2020,2020-2021
CO,2020-12-31,intra-ui,1422,2818,336,99,69,48,61,63,54,894,26908,32772,28330,31148,FALSE,0.950445502258025,2020,2020-2021
CO,2021-01-31,inter-total,452,150,10,3,4,5,4,1,2,42,1238,1911,1690,1840,FALSE,0.962846677132391,2020,2020-2021
CO,2021-01-31,inter-ucfe,2,1,1,0,0,1,0,0,0,0,5,10,7,8,FALSE,0.8,2020,2020-2021
CO,2021-01-31,inter-ucx,0,0,0,0,0,0,0,0,0,0,0,0,0,0,FALSE,0,2020,2020-2021
CO,2021-01-31,inter-ui,450,149,9,3,4,4,4,1,2,42,1233,1901,1683,1832,FALSE,0.963703314045239,2020,2020-2021
CO,2021-01-31,intra-total,6654,1731,193,59,52,32,24,11,6,240,13059,22061,19713,21444,FALSE,0.972032092833507,2020,2020-2021
CO,2021-01-31,intra-ucfe,25,5,1,0,0,1,2,0,0,5,11,50,36,41,FALSE,0.82,2020,2020-2021
CO,2021-01-31,intra-ucx,8,2,1,0,0,1,1,1,0,2,7,23,15,17,FALSE,0.739130434782609,2020,2020-2021
CO,2021-01-31,intra-ui,6621,1724,191,59,52,30,21,10,6,233,13041,21988,19662,21386,FALSE,0.972621429870839,2020,2020-2021
CO,2021-02-28,inter-total,395,44,33,32,32,3,8,1,1,25,91,665,486,530,FALSE,0.796992481203008,2020,2020-2021
CO,2021-02-28,inter-ucfe,0,0,0,0,0,0,1,0,0,1,0,2,0,0,FALSE,0,2020,2020-2021
CO,2021-02-28,inter-ucx,0,0,0,0,0,0,0,0,0,0,0,0,0,0,FALSE,0,2020,2020-2021
CO,2021-02-28,inter-ui,395,44,33,32,32,3,7,1,1,24,91,663,486,530,FALSE,0.799396681749623,2020,2020-2021
CO,2021-02-28,intra-total,12638,846,368,300,147,70,123,8,15,173,2307,16995,14945,15791,FALSE,0.929155634010003,2020,2020-2021
CO,2021-02-28,intra-ucfe,6,0,3,3,0,2,5,0,0,1,0,20,6,6,FALSE,0.3,2020,2020-2021
CO,2021-02-28,intra-ucx,4,2,0,0,0,0,0,0,0,1,1,8,5,7,FALSE,0.875,2020,2020-2021
CO,2021-02-28,intra-ui,12628,844,365,297,147,68,118,8,15,171,2306,16967,14934,15778,FALSE,0.92992279130076,2020,2020-2021
CO,2021-03-31,inter-total,861,45,33,32,32,21,11,9,5,47,121,1217,982,1027,FALSE,0.843878389482334,2020,2020-2021
CO,2021-03-31,inter-ucfe,2,1,0,0,0,0,1,0,0,2,0,6,2,3,FALSE,0.5,2020,2020-2021
CO,2021-03-31,inter-ucx,1,0,0,0,0,0,0,0,0,0,0,1,1,1,FALSE,1,2020,2020-2021
CO,2021-03-31,inter-ui,858,44,33,32,32,21,10,9,5,45,121,1210,979,1023,FALSE,0.845454545454546,2020,2020-2021
CO,2021-03-31,intra-total,51957,847,653,499,240,191,142,128,89,337,5048,60131,57005,57852,FALSE,0.962099416274467,2020,2020-2021
CO,2021-03-31,intra-ucfe,6,1,3,3,0,3,5,5,2,5,1,34,7,8,FALSE,0.235294117647059,2020,2020-2021
CO,2021-03-31,intra-ucx,6,2,0,0,1,0,1,2,0,1,2,15,8,10,FALSE,0.666666666666667,2020,2020-2021
CO,2021-03-31,intra-ui,51945,844,650,496,239,188,136,121,87,331,5045,60082,56990,57834,FALSE,0.962584467893878,2020,2020-2021
CO,2021-04-30,inter-total,491,57,35,26,15,9,14,7,5,57,125,841,616,673,FALSE,0.800237812128419,2020,2020-2021
CO,2021-04-30,inter-ucfe,1,0,0,0,0,0,0,0,0,0,0,1,1,1,FALSE,1,2020,2020-2021
CO,2021-04-30,inter-ucx,0,0,0,0,0,0,0,0,0,1,0,1,0,0,FALSE,0,2020,2020-2021
CO,2021-04-30,inter-ui,490,57,35,26,15,9,14,7,5,56,125,839,615,672,FALSE,0.800953516090584,2020,2020-2021
CO,2021-04-30,intra-total,9320,769,441,279,204,162,117,85,86,604,2142,14209,11462,12231,FALSE,0.86079245548596,2020,2020-2021
CO,2021-04-30,intra-ucfe,3,1,1,0,1,1,0,0,0,19,2,28,5,6,FALSE,0.214285714285714,2020,2020-2021
CO,2021-04-30,intra-ucx,11,1,2,1,0,0,0,0,0,3,6,24,17,18,FALSE,0.75,2020,2020-2021
CO,2021-04-30,intra-ui,9306,767,438,278,203,161,117,85,86,582,2134,14157,11440,12207,FALSE,0.862258953168044,2020,2020-2021
CO,2021-05-31,inter-total,386,32,36,23,22,18,13,7,7,103,96,743,482,514,FALSE,0.691790040376851,2020,2020-2021
CO,2021-05-31,inter-ucfe,0,0,0,0,1,0,0,0,0,4,0,5,0,0,FALSE,0,2020,2020-2021
CO,2021-05-31,inter-ucx,0,0,0,0,0,0,0,0,0,1,0,1,0,0,FALSE,0,2020,2020-2021
CO,2021-05-31,inter-ui,386,32,36,23,21,18,13,7,7,98,96,737,482,514,FALSE,0.697421981004071,2020,2020-2021
CO,2021-05-31,intra-total,7724,700,424,350,313,260,215,142,140,1147,1703,13118,9427,10127,FALSE,0.771992681811252,2020,2020-2021
CO,2021-05-31,intra-ucfe,11,1,1,0,1,2,0,2,1,20,2,41,13,14,FALSE,0.341463414634146,2020,2020-2021
CO,2021-05-31,intra-ucx,8,3,0,2,1,0,2,0,1,11,3,31,11,14,FALSE,0.451612903225806,2020,2020-2021
CO,2021-05-31,intra-ui,7705,696,423,348,311,258,213,140,138,1116,1698,13046,9403,10099,FALSE,0.774107005978844,2020,2020-2021
CO,2021-06-30,inter-total,296,56,25,7,8,8,6,5,11,84,75,581,371,427,FALSE,0.734939759036145,2020,2020-2021
CO,2021-06-30,inter-ucfe,1,2,0,0,0,0,0,0,0,1,0,4,1,3,FALSE,0.75,2020,2020-2021
CO,2021-06-30,inter-ucx,1,0,0,0,0,0,0,0,0,0,0,1,1,1,FALSE,1,2020,2020-2021
CO,2021-06-30,inter-ui,294,54,25,7,8,8,6,5,11,83,75,576,369,423,FALSE,0.734375,2020,2020-2021
CO,2021-06-30,intra-total,5940,891,386,176,120,113,130,144,128,851,1567,10446,7507,8398,FALSE,0.803944093432893,2020,2020-2021
CO,2021-06-30,intra-ucfe,9,1,1,1,1,0,0,1,2,24,1,41,10,11,FALSE,0.268292682926829,2020,2020-2021
CO,2021-06-30,intra-ucx,11,2,1,0,1,0,3,0,0,8,8,34,19,21,FALSE,0.617647058823529,2020,2020-2021
CO,2021-06-30,intra-ui,5920,888,384,175,118,113,127,143,126,819,1558,10371,7478,8366,FALSE,0.806672452029698,2020,2020-2021
CO,2021-07-31,inter-total,208,49,14,13,12,13,10,11,10,142,83,565,291,340,FALSE,0.601769911504425,2021,2021-2022
CO,2021-07-31,inter-ucfe,0,0,0,0,0,0,0,1,1,4,1,7,1,1,FALSE,0.142857142857143,2021,2021-2022
CO,2021-07-31,inter-ucx,1,1,0,0,0,0,0,0,0,1,1,4,2,3,FALSE,0.75,2021,2021-2022
CO,2021-07-31,inter-ui,207,48,14,13,12,13,10,10,9,137,81,554,288,336,FALSE,0.606498194945848,2021,2021-2022
CO,2021-07-31,intra-total,4514,978,332,316,221,190,161,159,132,2224,1342,10569,5856,6834,FALSE,0.646608004541584,2021,2021-2022
CO,2021-07-31,intra-ucfe,11,7,2,1,0,2,1,1,3,52,5,85,16,23,FALSE,0.270588235294118,2021,2021-2022
CO,2021-07-31,intra-ucx,8,6,2,3,0,1,1,0,0,7,9,37,17,23,FALSE,0.621621621621622,2021,2021-2022
CO,2021-07-31,intra-ui,4495,965,328,312,221,187,159,158,129,2165,1328,10447,5823,6788,FALSE,0.649755910787786,2021,2021-2022
CO,2021-08-31,inter-total,97,42,34,23,9,11,7,14,9,74,48,368,145,187,FALSE,0.508152173913044,2021,2021-2022
CO,2021-08-31,inter-ucfe,1,0,0,1,0,0,0,1,0,2,1,6,2,2,FALSE,0.333333333333333,2021,2021-2022
CO,2021-08-31,inter-ucx,0,0,0,1,0,0,0,0,0,0,0,1,0,0,FALSE,0,2021,2021-2022
CO,2021-08-31,inter-ui,96,42,34,21,9,11,7,13,9,72,47,361,143,185,FALSE,0.512465373961219,2021,2021-2022
CO,2021-08-31,intra-total,1995,703,542,318,193,170,125,117,89,1080,888,6220,2883,3586,FALSE,0.576527331189711,2021,2021-2022
CO,2021-08-31,intra-ucfe,0,4,4,3,3,2,0,0,0,20,3,39,3,7,FALSE,0.17948717948718,2021,2021-2022
CO,2021-08-31,intra-ucx,18,5,2,1,0,3,1,0,1,8,5,44,23,28,FALSE,0.636363636363636,2021,2021-2022
CO,2021-08-31,intra-ui,1977,694,536,314,190,165,124,117,88,1052,880,6137,2857,3551,FALSE,0.578621476291348,2021,2021-2022
CO,2021-09-30,inter-total,116,39,16,15,11,15,9,6,9,57,48,341,164,203,FALSE,0.595307917888563,2021,2021-2022
CO,2021-09-30,inter-ucfe,0,0,1,0,0,0,1,0,0,5,0,7,0,0,FALSE,0,2021,2021-2022
CO,2021-09-30,inter-ucx,1,0,0,0,0,0,0,0,0,1,0,2,1,1,FALSE,0.5,2021,2021-2022
CO,2021-09-30,inter-ui,115,39,15,15,11,15,8,6,9,51,48,332,163,202,FALSE,0.608433734939759,2021,2021-2022
CO,2021-09-30,intra-total,3626,652,314,253,192,143,146,101,74,677,979,7157,4605,5257,FALSE,0.734525639234316,2021,2021-2022
CO,2021-09-30,intra-ucfe,3,2,2,1,0,0,0,2,0,54,3,67,6,8,FALSE,0.119402985074627,2021,2021-2022
CO,2021-09-30,intra-ucx,3,7,2,1,1,1,1,0,0,2,3,21,6,13,FALSE,0.619047619047619,2021,2021-2022
CO,2021-09-30,intra-ui,3620,643,310,251,191,142,145,99,74,621,973,7069,4593,5236,FALSE,0.740698825859386,2021,2021-2022
CO,2021-10-31,inter-total,60,11,15,13,20,13,14,16,7,88,16,273,76,87,FALSE,0.318681318681319,2021,2021-2022
CO,2021-10-31,inter-ucfe,2,0,0,0,0,0,1,0,0,4,0,7,2,2,FALSE,0.285714285714286,2021,2021-2022
CO,2021-10-31,inter-ucx,0,1,0,0,0,0,0,0,0,3,0,4,0,1,FALSE,0.25,2021,2021-2022
CO,2021-10-31,inter-ui,58,10,15,13,20,13,13,16,7,81,16,262,74,84,FALSE,0.320610687022901,2021,2021-2022
CO,2021-10-31,intra-total,730,222,188,253,297,263,230,193,141,872,198,3587,928,1150,FALSE,0.320602174519097,2021,2021-2022
CO,2021-10-31,intra-ucfe,7,2,2,1,0,1,0,0,1,53,0,67,7,9,FALSE,0.134328358208955,2021,2021-2022
CO,2021-10-31,intra-ucx,9,1,0,0,0,1,0,1,1,8,3,24,12,13,FALSE,0.541666666666667,2021,2021-2022
CO,2021-10-31,intra-ui,714,219,186,252,297,261,230,192,139,811,195,3496,909,1128,FALSE,0.322654462242563,2021,2021-2022
CO,2021-11-30,inter-total,73,8,9,9,14,14,12,12,17,84,17,269,90,98,FALSE,0.364312267657993,2021,2021-2022
CO,2021-11-30,inter-ucfe,13,0,1,1,0,0,0,0,0,3,2,20,15,15,FALSE,0.75,2021,2021-2022
CO,2021-11-30,inter-ucx,0,0,0,0,0,0,0,0,0,1,0,1,0,0,FALSE,0,2021,2021-2022
CO,2021-11-30,inter-ui,60,8,8,8,14,14,12,12,17,80,15,248,75,83,FALSE,0.334677419354839,2021,2021-2022
CO,2021-11-30,intra-total,801,184,92,124,211,267,201,192,154,989,224,3439,1025,1209,FALSE,0.351555684792091,2021,2021-2022
CO,2021-11-30,intra-ucfe,19,7,1,4,0,0,0,1,0,27,7,66,26,33,FALSE,0.5,2021,2021-2022
CO,2021-11-30,intra-ucx,11,2,0,2,2,2,1,1,0,15,4,40,15,17,FALSE,0.425,2021,2021-2022
CO,2021-11-30,intra-ui,771,175,91,118,209,265,200,190,154,947,213,3333,984,1159,FALSE,0.347734773477348,2021,2021-2022
CO,2021-12-31,inter-total,74,11,10,10,12,14,20,19,11,135,20,336,94,105,FALSE,0.3125,2021,2021-2022
CO,2021-12-31,inter-ucfe,8,1,1,2,1,0,0,1,0,4,3,21,11,12,FALSE,0.571428571428571,2021,2021-2022
CO,2021-12-31,inter-ucx,0,0,0,0,0,0,0,0,0,0,0,0,0,0,FALSE,0,2021,2021-2022
CO,2021-12-31,inter-ui,66,10,9,8,11,14,20,18,11,131,17,315,83,93,FALSE,0.295238095238095,2021,2021-2022
CO,2021-12-31,intra-total,873,190,91,82,143,295,367,349,221,2001,255,4867,1128,1318,FALSE,0.270803369632217,2021,2021-2022
CO,2021-12-31,intra-ucfe,23,3,3,1,0,3,0,3,0,14,17,67,40,43,FALSE,0.641791044776119,2021,2021-2022
CO,2021-12-31,intra-ucx,7,3,1,1,0,1,2,1,2,20,2,40,9,12,FALSE,0.3,2021,2021-2022
CO,2021-12-31,intra-ui,843,184,87,80,143,291,365,345,219,1967,236,4760,1079,1263,FALSE,0.265336134453782,2021,2021-2022
CO,2022-01-31,inter-total,99,5,7,10,5,6,13,16,23,156,22,362,121,126,FALSE,0.348066298342541,2021,2021-2022
CO,2022-01-31,inter-ucfe,9,1,1,1,2,0,1,0,2,1,3,21,12,13,FALSE,0.619047619047619,2021,2021-2022
CO,2022-01-31,inter-ucx,0,0,0,0,0,0,0,0,0,0,1,1,1,1,FALSE,1,2021,2021-2022
CO,2022-01-31,inter-ui,90,4,6,9,3,6,12,16,21,155,18,340,108,112,FALSE,0.329411764705882,2021,2021-2022
CO,2022-01-31,intra-total,1542,153,98,81,79,104,178,275,335,2059,353,5257,1895,2048,FALSE,0.389575803690318,2021,2021-2022
CO,2022-01-31,intra-ucfe,22,1,2,3,2,1,1,2,0,20,4,58,26,27,FALSE,0.46551724137931,2021,2021-2022
CO,2022-01-31,intra-ucx,5,2,3,1,0,2,2,0,3,28,4,50,9,11,FALSE,0.22,2021,2021-2022
CO,2022-01-31,intra-ui,1515,150,93,77,77,101,175,273,332,2011,345,5149,1860,2010,FALSE,0.390367061565353,2021,2021-2022
CO,2022-02-28,inter-total,50,18,10,15,5,10,6,9,15,109,22,269,72,90,FALSE,0.33457249070632,2021,2021-2022
CO,2022-02-28,inter-ucfe,2,2,0,3,1,1,0,0,0,3,3,15,5,7,FALSE,0.466666666666667,2021,2021-2022
CO,2022-02-28,inter-ucx,0,0,0,0,0,0,0,0,0,0,0,0,0,0,FALSE,0,2021,2021-2022
CO,2022-02-28,inter-ui,48,16,10,12,4,9,6,9,15,106,19,254,67,83,FALSE,0.326771653543307,2021,2021-2022
CO,2022-02-28,intra-total,794,228,162,124,89,82,75,128,213,1858,258,4011,1052,1280,FALSE,0.319122413363251,2021,2021-2022
CO,2022-02-28,intra-ucfe,8,1,3,1,2,2,1,1,2,18,10,49,18,19,FALSE,0.387755102040816,2021,2021-2022
CO,2022-02-28,intra-ucx,1,10,3,2,0,0,3,1,2,24,5,51,6,16,FALSE,0.313725490196078,2021,2021-2022
CO,2022-02-28,intra-ui,785,217,156,121,87,80,71,126,209,1816,243,3911,1028,1245,FALSE,0.318332907184863,2021,2021-2022
CO,2022-03-31,inter-total,39,11,10,4,5,14,6,12,12,193,19,325,58,69,FALSE,0.212307692307692,2021,2021-2022
CO,2022-03-31,inter-ucfe,2,2,1,0,0,0,1,2,1,13,0,22,2,4,FALSE,0.181818181818182,2021,2021-2022
CO,2022-03-31,inter-ucx,0,0,0,0,0,0,0,0,0,1,0,1,0,0,FALSE,0,2021,2021-2022
CO,2022-03-31,inter-ui,37,9,9,4,5,14,5,10,11,179,19,302,56,65,FALSE,0.21523178807947,2021,2021-2022
CO,2022-03-31,intra-total,533,152,101,99,100,115,166,155,241,2958,204,4824,737,889,FALSE,0.184286898839138,2021,2021-2022
CO,2022-03-31,intra-ucfe,2,0,3,3,1,4,2,4,3,46,8,76,10,10,FALSE,0.131578947368421,2021,2021-2022
CO,2022-03-31,intra-ucx,7,4,3,3,3,1,3,0,2,19,3,48,10,14,FALSE,0.291666666666667,2021,2021-2022
CO,2022-03-31,intra-ui,524,148,95,93,96,110,161,151,236,2893,193,4700,717,865,FALSE,0.184042553191489,2021,2021-2022
CO,2022-04-30,inter-total,50,9,9,10,6,8,10,8,8,204,27,349,77,86,FALSE,0.246418338108883,2021,2021-2022
CO,2022-04-30,inter-ucfe,1,0,0,1,0,0,1,0,1,3,0,7,1,1,FALSE,0.142857142857143,2021,2021-2022
CO,2022-04-30,inter-ucx,0,0,0,1,0,0,0,0,0,0,0,1,0,0,FALSE,0,2021,2021-2022
CO,2022-04-30,inter-ui,49,9,9,8,6,8,9,8,7,201,27,341,76,85,FALSE,0.249266862170088,2021,2021-2022
CO,2022-04-30,intra-total,738,167,157,142,143,126,136,134,109,3469,237,5558,975,1142,FALSE,0.205469593378913,2021,2021-2022
CO,2022-04-30,intra-ucfe,3,1,1,0,1,0,2,0,2,31,1,42,4,5,FALSE,0.119047619047619,2021,2021-2022
CO,2022-04-30,intra-ucx,11,1,2,3,1,1,1,1,1,14,3,39,14,15,FALSE,0.384615384615385,2021,2021-2022
CO,2022-04-30,intra-ui,724,165,154,139,141,125,133,133,106,3424,233,5477,957,1122,FALSE,0.204856673361329,2021,2021-2022
CO,2022-05-31,inter-total,94,13,4,4,2,7,4,4,1,186,10,329,104,117,FALSE,0.355623100303951,2021,2021-2022
CO,2022-05-31,inter-ucfe,0,0,0,0,0,0,0,0,0,5,0,5,0,0,FALSE,0,2021,2021-2022
CO,2022-05-31,inter-ucx,2,0,1,0,0,0,0,0,0,2,0,5,2,2,FALSE,0.4,2021,2021-2022
CO,2022-05-31,inter-ui,92,13,3,4,2,7,4,4,1,179,10,319,102,115,FALSE,0.360501567398119,2021,2021-2022
CO,2022-05-31,intra-total,1029,162,125,88,102,75,80,64,83,2754,170,4732,1199,1361,FALSE,0.287616229923922,2021,2021-2022
CO,2022-05-31,intra-ucfe,2,1,1,0,0,2,1,0,1,16,3,27,5,6,FALSE,0.222222222222222,2021,2021-2022
CO,2022-05-31,intra-ucx,14,3,3,0,0,0,1,2,1,11,1,36,15,18,FALSE,0.5,2021,2021-2022
CO,2022-05-31,intra-ui,1013,158,121,88,102,73,78,62,81,2727,166,4669,1179,1337,FALSE,0.286356821589205,2021,2021-2022
CO,2022-06-30,inter-total,85,8,7,4,3,8,3,1,7,127,13,266,98,106,FALSE,0.398496240601504,2021,2021-2022
CO,2022-06-30,inter-ucfe,0,0,0,0,0,0,0,0,0,1,0,1,0,0,FALSE,0,2021,2021-2022
CO,2022-06-30,inter-ucx,0,0,0,0,0,0,0,0,0,2,0,2,0,0,FALSE,0,2021,2021-2022
CO,2022-06-30,inter-ui,85,8,7,4,3,8,3,1,7,124,13,263,98,106,FALSE,0.403041825095057,2021,2021-2022
CO,2022-06-30,intra-total,1167,121,105,97,75,77,73,66,50,2522,208,4561,1375,1496,FALSE,0.327998245998685,2021,2021-2022
CO,2022-06-30,intra-ucfe,8,2,0,0,1,0,0,0,1,19,3,34,11,13,FALSE,0.382352941176471,2021,2021-2022
CO,2022-06-30,intra-ucx,14,2,3,1,0,0,0,0,0,3,2,25,16,18,FALSE,0.72,2021,2021-2022
CO,2022-06-30,intra-ui,1145,117,102,96,74,77,73,66,49,2500,203,4502,1348,1465,FALSE,0.325410928476233,2021,2021-2022
CO,2022-07-31,inter-total,94,5,8,4,4,4,3,2,3,149,17,293,111,116,FALSE,0.395904436860068,2022,2022-2023
CO,2022-07-31,inter-ucfe,1,0,0,0,0,0,0,0,0,2,1,4,2,2,FALSE,0.5,2022,2022-2023
CO,2022-07-31,inter-ucx,0,0,0,0,0,0,0,0,0,0,1,1,1,1,FALSE,1,2022,2022-2023
CO,2022-07-31,inter-ui,93,5,8,4,4,4,3,2,3,147,15,288,108,113,FALSE,0.392361111111111,2022,2022-2023
CO,2022-07-31,intra-total,1032,116,106,116,93,98,101,82,86,2609,226,4665,1258,1374,FALSE,0.294533762057878,2022,2022-2023
CO,2022-07-31,intra-ucfe,3,0,1,0,2,0,0,0,0,6,1,13,4,4,FALSE,0.307692307692308,2022,2022-2023
CO,2022-07-31,intra-ucx,12,4,0,2,1,2,0,1,0,11,8,41,20,24,FALSE,0.585365853658537,2022,2022-2023
CO,2022-07-31,intra-ui,1017,112,105,114,90,96,101,81,86,2592,217,4611,1234,1346,FALSE,0.29191064844936,2022,2022-2023
CO,2022-08-31,inter-total,89,6,7,10,9,7,3,4,3,151,14,303,103,109,FALSE,0.35973597359736,2022,2022-2023
CO,2022-08-31,inter-ucfe,0,1,0,0,0,0,0,1,0,0,0,2,0,1,FALSE,0.5,2022,2022-2023
CO,2022-08-31,inter-ucx,0,0,0,0,0,0,0,0,0,2,0,2,0,0,FALSE,0,2022,2022-2023
CO,2022-08-31,inter-ui,89,5,7,10,9,7,3,3,3,149,14,299,103,108,FALSE,0.361204013377926,2022,2022-2023
CO,2022-08-31,intra-total,1198,156,108,140,160,107,90,80,85,2937,245,5306,1443,1599,FALSE,0.301356954391255,2022,2022-2023
CO,2022-08-31,intra-ucfe,2,0,0,0,0,0,0,0,0,10,0,12,2,2,FALSE,0.166666666666667,2022,2022-2023
CO,2022-08-31,intra-ucx,13,4,1,1,3,2,0,1,0,8,0,33,13,17,FALSE,0.515151515151515,2022,2022-2023
CO,2022-08-31,intra-ui,1183,152,107,139,157,105,90,79,85,2919,245,5261,1428,1580,FALSE,0.300323132484319,2022,2022-2023
CO,2022-09-30,inter-total,66,2,8,9,6,4,3,10,2,157,12,279,78,80,FALSE,0.28673835125448,2022,2022-2023
CO,2022-09-30,inter-ucfe,1,0,2,0,0,0,0,0,0,4,0,7,1,1,FALSE,0.142857142857143,2022,2022-2023
CO,2022-09-30,inter-ucx,0,0,0,0,0,0,0,0,0,2,0,2,0,0,FALSE,0,2022,2022-2023
CO,2022-09-30,inter-ui,65,2,6,9,6,4,3,10,2,151,12,270,77,79,FALSE,0.292592592592593,2022,2022-2023
CO,2022-09-30,intra-total,898,151,131,161,202,149,109,114,122,2843,279,5159,1177,1328,FALSE,0.257414227563481,2022,2022-2023
CO,2022-09-30,intra-ucfe,1,1,0,0,0,0,1,0,0,10,1,14,2,3,FALSE,0.214285714285714,2022,2022-2023
CO,2022-09-30,intra-ucx,15,2,2,2,1,1,1,0,0,3,1,28,16,18,FALSE,0.642857142857143,2022,2022-2023
CO,2022-09-30,intra-ui,882,148,129,159,201,148,107,114,122,2830,277,5117,1159,1307,FALSE,0.255423099472347,2022,2022-2023
CO,2022-10-31,inter-total,92,6,12,3,2,5,3,4,3,174,11,315,103,109,FALSE,0.346031746031746,2022,2022-2023
CO,2022-10-31,inter-ucfe,3,1,0,0,0,0,0,0,0,2,1,7,4,5,FALSE,0.714285714285714,2022,2022-2023
CO,2022-10-31,inter-ucx,1,0,0,0,0,0,0,0,0,0,0,1,1,1,FALSE,1,2022,2022-2023
CO,2022-10-31,inter-ui,88,5,12,3,2,5,3,4,3,172,10,307,98,103,FALSE,0.335504885993485,2022,2022-2023
CO,2022-10-31,intra-total,1143,91,105,181,161,103,82,87,93,2927,249,5222,1392,1483,FALSE,0.283990808119494,2022,2022-2023
CO,2022-10-31,intra-ucfe,11,0,0,0,1,0,0,0,0,15,1,28,12,12,FALSE,0.428571428571429,2022,2022-2023
CO,2022-10-31,intra-ucx,13,0,0,0,1,1,0,0,0,4,2,21,15,15,FALSE,0.714285714285714,2022,2022-2023
CO,2022-10-31,intra-ui,1119,91,105,181,159,102,82,87,93,2908,246,5173,1365,1456,FALSE,0.281461434370771,2022,2022-2023
CO,2022-11-30,inter-total,122,13,6,12,6,4,3,4,4,127,11,312,133,146,FALSE,0.467948717948718,2022,2022-2023
CO,2022-11-30,inter-ucfe,14,1,1,0,0,0,0,0,0,1,1,18,15,16,FALSE,0.888888888888889,2022,2022-2023
CO,2022-11-30,inter-ucx,0,0,0,0,0,0,0,0,0,1,0,1,0,0,FALSE,0,2022,2022-2023
CO,2022-11-30,inter-ui,108,12,5,12,6,4,3,4,4,125,10,293,118,130,FALSE,0.443686006825939,2022,2022-2023
CO,2022-11-30,intra-total,1480,125,172,241,180,109,84,86,80,2587,251,5395,1731,1856,FALSE,0.344022242817424,2022,2022-2023
CO,2022-11-30,intra-ucfe,33,2,0,0,0,2,1,1,0,19,5,63,38,40,FALSE,0.634920634920635,2022,2022-2023
CO,2022-11-30,intra-ucx,18,1,3,2,1,0,0,1,4,7,3,40,21,22,FALSE,0.55,2022,2022-2023
CO,2022-11-30,intra-ui,1429,122,169,239,179,107,83,84,76,2561,243,5292,1672,1794,FALSE,0.339002267573696,2022,2022-2023
CO,2022-12-31,inter-total,135,17,16,14,8,6,4,6,5,168,17,396,152,169,FALSE,0.426767676767677,2022,2022-2023
CO,2022-12-31,inter-ucfe,11,1,0,0,0,0,0,0,0,2,1,15,12,13,FALSE,0.866666666666667,2022,2022-2023
CO,2022-12-31,inter-ucx,0,0,0,1,0,0,0,0,0,0,0,1,0,0,FALSE,0,2022,2022-2023
CO,2022-12-31,inter-ui,124,16,16,13,8,6,4,6,5,166,16,380,140,156,FALSE,0.410526315789474,2022,2022-2023
CO,2022-12-31,intra-total,1674,251,317,210,204,148,132,136,131,2819,302,6324,1976,2227,FALSE,0.352150537634409,2022,2022-2023
CO,2022-12-31,intra-ucfe,38,4,3,0,0,1,1,0,0,10,8,65,46,50,FALSE,0.769230769230769,2022,2022-2023
CO,2022-12-31,intra-ucx,9,2,2,1,2,0,0,2,0,2,3,23,12,14,FALSE,0.608695652173913,2022,2022-2023
CO,2022-12-31,intra-ui,1627,245,312,209,202,147,131,134,131,2807,291,6236,1918,2163,FALSE,0.34685695958948,2022,2022-2023
CO,2023-01-31,inter-total,183,8,18,9,7,5,11,9,6,133,25,414,208,216,FALSE,0.521739130434783,2022,2022-2023
CO,2023-01-31,inter-ucfe,4,0,1,0,0,0,0,1,1,1,0,8,4,4,FALSE,0.5,2022,2022-2023
CO,2023-01-31,inter-ucx,0,0,0,0,0,0,0,0,0,1,0,1,0,0,FALSE,0,2022,2022-2023
CO,2023-01-31,inter-ui,179,8,17,9,7,5,11,8,5,131,25,405,204,212,FALSE,0.523456790123457,2022,2022-2023
CO,2023-01-31,intra-total,3082,178,275,147,131,153,138,120,207,2683,308,7422,3390,3568,FALSE,0.480732956076529,2022,2022-2023
CO,2023-01-31,intra-ucfe,34,2,0,0,0,1,1,0,0,10,8,56,42,44,FALSE,0.785714285714286,2022,2022-2023
CO,2023-01-31,intra-ucx,22,2,2,1,1,0,0,0,1,5,1,35,23,25,FALSE,0.714285714285714,2022,2022-2023
CO,2023-01-31,intra-ui,3026,174,273,146,130,152,137,120,206,2668,299,7331,3325,3499,FALSE,0.477288228072569,2022,2022-2023
CO,2023-02-28,inter-total,150,27,12,20,42,41,37,34,25,180,35,603,185,212,FALSE,0.351575456053068,2022,2022-2023
CO,2023-02-28,inter-ucfe,7,1,1,1,1,1,0,0,0,4,0,16,7,8,FALSE,0.5,2022,2022-2023
CO,2023-02-28,inter-ucx,0,0,0,0,0,0,0,0,0,0,0,0,0,0,FALSE,0,2022,2022-2023
CO,2023-02-28,inter-ui,143,26,11,19,41,40,37,34,25,176,35,587,178,204,FALSE,0.347529812606474,2022,2022-2023
CO,2023-02-28,intra-total,3320,709,517,643,1004,859,797,962,740,3173,1015,13739,4335,5044,FALSE,0.367130067690516,2022,2022-2023
CO,2023-02-28,intra-ucfe,21,3,3,3,2,0,1,1,3,13,5,55,26,29,FALSE,0.527272727272727,2022,2022-2023
CO,2023-02-28,intra-ucx,21,0,1,1,2,0,1,3,1,7,4,41,25,25,FALSE,0.609756097560976,2022,2022-2023
CO,2023-02-28,intra-ui,3278,706,513,639,1000,859,795,958,736,3153,1006,13643,4284,4990,FALSE,0.365755332404896,2022,2022-2023
CO,2023-03-31,inter-total,117,39,40,30,18,15,7,11,3,43,37,360,154,193,FALSE,0.536111111111111,2022,2022-2023
CO,2023-03-31,inter-ucfe,2,0,1,0,0,0,0,0,0,2,0,5,2,2,FALSE,0.4,2022,2022-2023
CO,2023-03-31,inter-ucx,1,0,0,0,0,0,0,0,0,0,1,2,2,2,FALSE,1,2022,2022-2023
CO,2023-03-31,inter-ui,114,39,39,30,18,15,7,11,3,41,36,353,150,189,FALSE,0.535410764872521,2022,2022-2023
CO,2023-03-31,intra-total,3147,938,1101,772,427,332,182,95,71,527,1349,8941,4496,5434,FALSE,0.607761995302539,2022,2022-2023
CO,2023-03-31,intra-ucfe,5,2,3,3,0,3,1,2,1,10,2,32,7,9,FALSE,0.28125,2022,2022-2023
CO,2023-03-31,intra-ucx,10,0,2,1,0,1,0,0,0,4,2,20,12,12,FALSE,0.6,2022,2022-2023
CO,2023-03-31,intra-ui,3132,936,1096,768,427,328,181,93,70,513,1345,8889,4477,5413,FALSE,0.608954888063899,2022,2022-2023
CO,2023-04-30,inter-total,67,7,6,2,6,2,6,0,4,86,14,200,81,88,FALSE,0.44,2022,2022-2023
CO,2023-04-30,inter-ucfe,2,0,0,0,0,0,0,0,0,10,0,12,2,2,FALSE,0.166666666666667,2022,2022-2023
CO,2023-04-30,inter-ucx,0,0,0,0,0,0,0,0,0,0,0,0,0,0,FALSE,0,2022,2022-2023
CO,2023-04-30,inter-ui,65,7,6,2,6,2,6,0,4,76,14,188,79,86,FALSE,0.457446808510638,2022,2022-2023
CO,2023-04-30,intra-total,3437,185,139,97,80,61,51,55,46,589,759,5499,4196,4381,FALSE,0.796690307328605,2022,2022-2023
CO,2023-04-30,intra-ucfe,4,1,1,0,2,0,0,2,0,13,2,25,6,7,FALSE,0.28,2022,2022-2023
CO,2023-04-30,intra-ucx,6,1,1,0,1,0,0,0,0,3,3,15,9,10,FALSE,0.666666666666667,2022,2022-2023
CO,2023-04-30,intra-ui,3427,183,137,97,77,61,51,53,46,573,754,5459,4181,4364,FALSE,0.79941381205349,2022,2022-2023
CO,2023-05-31,inter-total,72,19,15,18,18,16,16,10,2,29,23,238,95,114,FALSE,0.478991596638655,2022,2022-2023
CO,2023-05-31,inter-ucfe,0,0,0,0,0,0,0,0,0,0,0,0,0,0,FALSE,0,2022,2022-2023
CO,2023-05-31,inter-ucx,1,0,0,0,0,0,0,0,0,1,0,2,1,1,FALSE,0.5,2022,2022-2023
CO,2023-05-31,inter-ui,71,19,15,18,18,16,16,10,2,28,23,236,94,113,FALSE,0.478813559322034,2022,2022-2023
CO,2023-05-31,intra-total,3210,187,120,86,66,66,55,54,41,389,642,4916,3852,4039,FALSE,0.82160292921074,2022,2022-2023
CO,2023-05-31,intra-ucfe,2,3,0,0,1,0,0,0,0,7,1,14,3,6,FALSE,0.428571428571429,2022,2022-2023
CO,2023-05-31,intra-ucx,13,2,1,0,2,0,1,0,0,12,2,33,15,17,FALSE,0.515151515151515,2022,2022-2023
CO,2023-05-31,intra-ui,3195,182,119,86,63,66,54,54,41,370,639,4869,3834,4016,FALSE,0.824810022591908,2022,2022-2023
CO,2023-06-30,inter-total,47,7,15,8,3,7,5,2,4,27,13,138,60,67,FALSE,0.485507246376812,2022,2022-2023
CO,2023-06-30,inter-ucfe,0,0,0,0,0,0,0,0,0,1,2,3,2,2,FALSE,0.666666666666667,2022,2022-2023
CO,2023-06-30,inter-ucx,0,0,0,0,0,0,0,0,0,1,0,1,0,0,FALSE,0,2022,2022-2023
CO,2023-06-30,inter-ui,47,7,15,8,3,7,5,2,4,25,11,134,58,65,FALSE,0.485074626865672,2022,2022-2023
CO,2023-06-30,intra-total,3400,268,234,157,105,78,66,59,36,402,920,5725,4320,4588,FALSE,0.801397379912664,2022,2022-2023
CO,2023-06-30,intra-ucfe,0,1,1,1,0,0,0,0,0,3,2,8,2,3,FALSE,0.375,2022,2022-2023
CO,2023-06-30,intra-ucx,11,0,1,0,1,2,2,0,0,13,3,33,14,14,FALSE,0.424242424242424,2022,2022-2023
CO,2023-06-30,intra-ui,3389,267,232,156,104,76,64,59,36,386,915,5684,4304,4571,FALSE,0.804187192118227,2022,2022-2023
CO,2023-07-31,inter-total,54,23,11,10,11,13,14,16,17,68,23,260,77,100,FALSE,0.384615384615385,2023,2023-2024
CO,2023-07-31,inter-ucfe,0,0,0,0,0,0,0,0,0,1,0,1,0,0,FALSE,0,2023,2023-2024
CO,2023-07-31,inter-ucx,0,0,0,0,0,0,0,0,0,0,0,0,0,0,FALSE,0,2023,2023-2024
CO,2023-07-31,inter-ui,54,23,11,10,11,13,14,16,17,67,23,259,77,100,FALSE,0.386100386100386,2023,2023-2024
CO,2023-07-31,intra-total,1534,490,243,152,88,66,79,120,189,872,781,4614,2315,2805,FALSE,0.607932379713914,2023,2023-2024
CO,2023-07-31,intra-ucfe,2,0,0,0,0,0,0,1,0,3,1,7,3,3,FALSE,0.428571428571429,2023,2023-2024
CO,2023-07-31,intra-ucx,9,2,1,2,3,1,1,1,1,1,1,23,10,12,FALSE,0.521739130434783,2023,2023-2024
CO,2023-07-31,intra-ui,1523,488,242,150,85,65,78,118,188,868,779,4584,2302,2790,FALSE,0.608638743455497,2023,2023-2024
CO,2023-08-31,inter-total,71,42,23,12,12,16,7,18,13,84,22,320,93,135,FALSE,0.421875,2023,2023-2024
CO,2023-08-31,inter-ucfe,0,0,0,0,0,0,0,0,0,1,0,1,0,0,FALSE,0,2023,2023-2024
CO,2023-08-31,inter-ucx,0,0,0,0,0,0,0,0,0,1,0,1,0,0,FALSE,0,2023,2023-2024
CO,2023-08-31,inter-ui,71,42,23,12,12,16,7,18,13,82,22,318,93,135,FALSE,0.424528301886792,2023,2023-2024
CO,2023-08-31,intra-total,1661,969,588,244,176,131,102,120,106,1043,596,5736,2257,3226,FALSE,0.562412831241283,2023,2023-2024
CO,2023-08-31,intra-ucfe,1,1,1,0,0,0,1,1,3,3,2,13,3,4,FALSE,0.307692307692308,2023,2023-2024
CO,2023-08-31,intra-ucx,6,1,1,4,0,0,0,1,0,1,3,17,9,10,FALSE,0.588235294117647,2023,2023-2024
CO,2023-08-31,intra-ui,1654,967,586,240,176,131,101,118,103,1039,591,5706,2245,3212,FALSE,0.56291622853137,2023,2023-2024
CO,2023-09-30,inter-total,63,11,49,45,25,14,8,6,4,67,22,314,85,96,FALSE,0.305732484076433,2023,2023-2024
CO,2023-09-30,inter-ucfe,0,0,1,0,0,0,0,1,0,1,0,3,0,0,FALSE,0,2023,2023-2024
CO,2023-09-30,inter-ucx,0,0,0,0,0,0,0,0,0,0,0,0,0,0,FALSE,0,2023,2023-2024
CO,2023-09-30,inter-ui,63,11,48,45,25,14,8,5,4,66,22,311,85,96,FALSE,0.308681672025724,2023,2023-2024
CO,2023-09-30,intra-total,1303,250,988,835,339,225,218,189,132,1017,314,5810,1617,1867,FALSE,0.321342512908778,2023,2023-2024
CO,2023-09-30,intra-ucfe,2,1,0,0,1,0,1,1,1,3,1,11,3,4,FALSE,0.363636363636364,2023,2023-2024
CO,2023-09-30,intra-ucx,22,2,1,2,1,0,5,1,3,3,3,43,25,27,FALSE,0.627906976744186,2023,2023-2024
CO,2023-09-30,intra-ui,1279,247,987,833,337,225,212,187,128,1011,310,5756,1589,1836,FALSE,0.318971507991661,2023,2023-2024
CO,2023-10-31,inter-total,88,6,11,24,27,16,6,5,5,76,14,278,102,108,FALSE,0.388489208633094,2023,2023-2024
CO,2023-10-31,inter-ucfe,2,0,0,0,0,0,0,0,2,0,0,4,2,2,FALSE,0.5,2023,2023-2024
CO,2023-10-31,inter-ucx,0,0,0,0,0,0,0,0,0,0,0,0,0,0,FALSE,0,2023,2023-2024
CO,2023-10-31,inter-ui,86,6,11,24,27,16,6,5,3,76,14,274,100,106,FALSE,0.386861313868613,2023,2023-2024
CO,2023-10-31,intra-total,1937,270,231,801,856,244,138,129,115,1108,385,6214,2322,2592,FALSE,0.417122626327647,2023,2023-2024
CO,2023-10-31,intra-ucfe,2,0,0,0,0,1,0,0,1,3,3,10,5,5,FALSE,0.5,2023,2023-2024
CO,2023-10-31,intra-ucx,15,3,1,0,2,1,0,0,0,6,5,33,20,23,FALSE,0.696969696969697,2023,2023-2024
CO,2023-10-31,intra-ui,1920,267,230,801,854,242,138,129,114,1099,377,6171,2297,2564,FALSE,0.415491816561335,2023,2023-2024
CO,2023-11-30,inter-total,71,9,8,41,34,22,11,10,5,52,21,284,92,101,FALSE,0.355633802816901,2023,2023-2024
CO,2023-11-30,inter-ucfe,1,2,0,0,0,0,0,0,0,0,2,5,3,5,FALSE,1,2023,2023-2024
CO,2023-11-30,inter-ucx,0,0,0,0,0,0,0,0,0,0,0,0,0,0,FALSE,0,2023,2023-2024
CO,2023-11-30,inter-ui,70,7,8,41,34,22,11,10,5,52,19,279,89,96,FALSE,0.344086021505376,2023,2023-2024
CO,2023-11-30,intra-total,1771,257,298,821,899,409,140,101,67,700,485,5948,2256,2513,FALSE,0.422494956287828,2023,2023-2024
CO,2023-11-30,intra-ucfe,17,4,1,0,0,0,2,0,0,1,5,30,22,26,FALSE,0.866666666666667,2023,2023-2024
CO,2023-11-30,intra-ucx,11,2,0,0,3,1,1,0,1,2,1,22,12,14,FALSE,0.636363636363636,2023,2023-2024
CO,2023-11-30,intra-ui,1743,251,297,821,896,408,137,101,66,697,479,5896,2222,2473,FALSE,0.419436906377205,2023,2023-2024
CO,2023-12-31,inter-total,105,21,27,58,27,25,8,7,9,41,26,354,131,152,FALSE,0.429378531073446,2023,2023-2024
CO,2023-12-31,inter-ucfe,3,1,3,1,1,0,0,1,0,1,1,12,4,5,FALSE,0.416666666666667,2023,2023-2024
CO,2023-12-31,inter-ucx,0,0,0,0,0,0,0,0,0,0,0,0,0,0,FALSE,0,2023,2023-2024
CO,2023-12-31,inter-ui,102,20,24,57,26,25,8,6,9,40,25,342,127,147,FALSE,0.429824561403509,2023,2023-2024
CO,2023-12-31,intra-total,1949,369,411,1141,981,434,219,104,90,637,704,7039,2653,3022,FALSE,0.429322346924279,2023,2023-2024
CO,2023-12-31,intra-ucfe,17,4,4,9,3,0,1,2,0,3,7,50,24,28,FALSE,0.56,2023,2023-2024
CO,2023-12-31,intra-ucx,7,3,1,3,2,0,1,0,0,3,9,29,16,19,FALSE,0.655172413793103,2023,2023-2024
CO,2023-12-31,intra-ui,1925,362,406,1129,976,434,217,102,90,631,688,6960,2613,2975,FALSE,0.427442528735632,2023,2023-2024
CO,2024-01-31,inter-total,135,24,23,57,41,21,13,8,9,42,33,406,168,192,FALSE,0.472906403940887,2023,2023-2024
CO,2024-01-31,inter-ucfe,5,2,0,1,0,1,2,0,1,0,1,13,6,8,FALSE,0.615384615384615,2023,2023-2024
CO,2024-01-31,inter-ucx,0,0,0,0,0,0,0,0,0,0,0,0,0,0,FALSE,0,2023,2023-2024
CO,2024-01-31,inter-ui,130,22,23,56,41,20,11,8,8,42,32,393,162,184,FALSE,0.468193384223919,2023,2023-2024
CO,2024-01-31,intra-total,3072,563,462,1363,1249,539,244,162,117,739,685,9195,3757,4320,FALSE,0.469820554649266,2023,2023-2024
CO,2024-01-31,intra-ucfe,34,3,3,4,3,3,1,2,0,1,5,59,39,42,FALSE,0.711864406779661,2023,2023-2024
CO,2024-01-31,intra-ucx,14,6,3,2,2,2,2,0,0,5,2,38,16,22,FALSE,0.578947368421053,2023,2023-2024
CO,2024-01-31,intra-ui,3024,554,456,1357,1244,534,241,160,117,733,678,9098,3702,4256,FALSE,0.467795119806551,2023,2023-2024
CO,2024-02-29,inter-total,93,22,53,49,31,15,9,5,4,39,25,345,118,140,FALSE,0.405797101449275,2023,2023-2024
CO,2024-02-29,inter-ucfe,1,2,0,0,0,0,0,0,0,0,2,5,3,5,FALSE,1,2023,2023-2024
CO,2024-02-29,inter-ucx,0,0,0,0,0,0,0,0,0,0,0,0,0,0,FALSE,0,2023,2023-2024
CO,2024-02-29,inter-ui,92,20,53,49,31,15,9,5,4,39,23,340,115,135,FALSE,0.397058823529412,2023,2023-2024
CO,2024-02-29,intra-total,2186,522,1436,1262,725,324,158,135,131,850,624,8353,2810,3332,FALSE,0.398898599305639,2023,2023-2024
CO,2024-02-29,intra-ucfe,4,5,5,6,1,1,3,2,0,7,3,37,7,12,FALSE,0.324324324324324,2023,2023-2024
CO,2024-02-29,intra-ucx,10,1,0,0,2,1,0,1,0,5,3,23,13,14,FALSE,0.608695652173913,2023,2023-2024
CO,2024-02-29,intra-ui,2172,516,1431,1256,722,322,155,132,131,838,618,8293,2790,3306,FALSE,0.39864946340287,2023,2023-2024
CO,2024-03-31,inter-total,70,7,42,37,27,10,5,4,5,41,12,260,82,89,FALSE,0.342307692307692,2023,2023-2024
CO,2024-03-31,inter-ucfe,1,0,0,1,0,1,0,0,0,0,0,3,1,1,FALSE,0.333333333333333,2023,2023-2024
CO,2024-03-31,inter-ucx,0,0,0,0,0,0,0,0,0,0,0,0,0,0,FALSE,0,2023,2023-2024
CO,2024-03-31,inter-ui,69,7,42,36,27,9,5,4,5,41,12,257,81,88,FALSE,0.342412451361868,2023,2023-2024
CO,2024-03-31,intra-total,1554,260,1129,1470,661,255,164,133,157,942,284,7009,1838,2098,FALSE,0.29932943358539,2023,2023-2024
CO,2024-03-31,intra-ucfe,7,1,4,1,1,3,2,2,1,8,3,33,10,11,FALSE,0.333333333333333,2023,2023-2024
CO,2024-03-31,intra-ucx,22,4,4,4,2,1,2,0,2,6,1,48,23,27,FALSE,0.5625,2023,2023-2024
CO,2024-03-31,intra-ui,1525,255,1121,1465,658,251,160,131,154,928,280,6928,1805,2060,FALSE,0.297344110854503,2023,2023-2024
CO,2024-04-30,inter-total,75,4,13,47,36,13,9,2,6,38,10,253,85,89,FALSE,0.351778656126482,2023,2023-2024
CO,2024-04-30,inter-ucfe,1,0,0,0,0,1,0,0,1,0,0,3,1,1,FALSE,0.333333333333333,2023,2023-2024
CO,2024-04-30,inter-ucx,0,0,0,0,0,0,0,0,0,0,0,0,0,0,FALSE,0,2023,2023-2024
CO,2024-04-30,inter-ui,74,4,13,47,36,12,9,2,5,38,10,250,84,88,FALSE,0.352,2023,2023-2024
CO,2024-04-30,intra-total,1781,281,375,1227,963,361,150,123,108,1017,299,6685,2080,2361,FALSE,0.353178758414361,2023,2023-2024
CO,2024-04-30,intra-ucfe,6,2,1,3,0,0,1,1,1,5,0,20,6,8,FALSE,0.4,2023,2023-2024
CO,2024-04-30,intra-ucx,16,2,2,0,1,0,1,1,0,2,5,30,21,23,FALSE,0.766666666666667,2023,2023-2024
CO,2024-04-30,intra-ui,1759,277,372,1224,962,361,148,121,107,1010,294,6635,2053,2330,FALSE,0.351168048229088,2023,2023-2024
CO,2024-05-31,inter-total,106,31,25,43,21,11,4,3,5,45,22,316,128,159,FALSE,0.503164556962025,2023,2023-2024
CO,2024-05-31,inter-ucfe,0,0,0,0,0,0,0,0,0,0,1,1,1,1,FALSE,1,2023,2023-2024
CO,2024-05-31,inter-ucx,0,0,0,0,0,0,0,0,0,0,0,0,0,0,FALSE,0,2023,2023-2024
CO,2024-05-31,inter-ui,106,31,25,43,21,11,4,3,5,45,21,315,127,158,FALSE,0.501587301587302,2023,2023-2024
CO,2024-05-31,intra-total,2438,751,891,1175,638,252,128,99,89,798,740,7999,3178,3929,FALSE,0.491186398299788,2023,2023-2024
CO,2024-05-31,intra-ucfe,2,0,1,0,0,0,0,0,1,4,1,9,3,3,FALSE,0.333333333333333,2023,2023-2024
CO,2024-05-31,intra-ucx,27,2,3,2,0,1,0,0,0,2,2,39,29,31,FALSE,0.794871794871795,2023,2023-2024
CO,2024-05-31,intra-ui,2409,749,887,1173,638,251,128,99,88,792,737,7951,3146,3895,FALSE,0.489875487360081,2023,2023-2024
CO,2024-06-30,inter-total,106,22,13,26,15,14,3,6,3,31,27,266,133,155,FALSE,0.582706766917293,2023,2023-2024
CO,2024-06-30,inter-ucfe,1,0,0,0,0,1,0,0,0,1,0,3,1,1,FALSE,0.333333333333333,2023,2023-2024
CO,2024-06-30,inter-ucx,0,0,0,0,0,0,0,0,0,0,0,0,0,0,FALSE,0,2023,2023-2024
CO,2024-06-30,inter-ui,105,22,13,26,15,13,3,6,3,30,27,263,132,154,FALSE,0.585551330798479,2023,2023-2024
CO,2024-06-30,intra-total,2972,412,430,803,592,309,162,110,82,712,597,7181,3569,3981,FALSE,0.554379612867289,2023,2023-2024
CO,2024-06-30,intra-ucfe,0,1,0,0,1,1,3,0,0,9,1,16,1,2,FALSE,0.125,2023,2023-2024
CO,2024-06-30,intra-ucx,15,1,3,0,1,0,1,0,0,2,4,27,19,20,FALSE,0.740740740740741,2023,2023-2024
CO,2024-06-30,intra-ui,2957,410,427,803,590,308,158,110,82,701,592,7138,3549,3959,FALSE,0.55463715326422,2023,2023-2024
CO,2024-07-31,inter-total,109,33,19,40,12,12,7,5,3,40,20,300,129,162,FALSE,0.54,2024,2024-2025
CO,2024-07-31,inter-ucfe,0,0,0,0,2,0,0,0,0,1,0,3,0,0,FALSE,0,2024,2024-2025
CO,2024-07-31,inter-ucx,0,0,1,0,0,0,0,0,0,0,0,1,0,0,FALSE,0,2024,2024-2025
CO,2024-07-31,inter-ui,109,33,18,40,10,12,7,5,3,39,20,296,129,162,FALSE,0.547297297297297,2024,2024-2025
CO,2024-07-31,intra-total,2954,435,732,778,477,236,143,97,80,547,584,7063,3538,3973,FALSE,0.562508848931049,2024,2024-2025
CO,2024-07-31,intra-ucfe,2,0,1,2,2,1,0,2,0,5,1,16,3,3,FALSE,0.1875,2024,2024-2025
CO,2024-07-31,intra-ucx,18,3,3,2,1,1,0,0,1,2,8,39,26,29,FALSE,0.743589743589744,2024,2024-2025
CO,2024-07-31,intra-ui,2934,432,728,774,474,234,143,95,79,540,575,7008,3509,3941,FALSE,0.562357305936073,2024,2024-2025
CO,2024-08-31,inter-total,101,49,33,19,15,6,6,3,2,49,50,333,151,200,FALSE,0.600600600600601,2024,2024-2025
CO,2024-08-31,inter-ucfe,0,0,0,0,0,2,0,0,0,2,0,4,0,0,FALSE,0,2024,2024-2025
CO,2024-08-31,inter-ucx,0,0,0,0,0,0,0,0,0,0,0,0,0,0,FALSE,0,2024,2024-2025
CO,2024-08-31,inter-ui,101,49,33,19,15,4,6,3,2,47,50,329,151,200,FALSE,0.60790273556231,2024,2024-2025
CO,2024-08-31,intra-total,3157,1031,714,377,199,127,81,71,50,771,1080,7658,4237,5268,FALSE,0.687908069992165,2024,2024-2025
CO,2024-08-31,intra-ucfe,3,3,0,0,2,0,1,1,0,6,1,17,4,7,FALSE,0.411764705882353,2024,2024-2025
CO,2024-08-31,intra-ucx,24,3,1,1,3,2,0,0,0,3,5,42,29,32,FALSE,0.761904761904762,2024,2024-2025
CO,2024-08-31,intra-ui,3130,1025,713,376,194,125,80,70,50,762,1074,7599,4204,5229,FALSE,0.688116857481248,2024,2024-2025
CO,2024-09-30,inter-total,112,32,17,8,2,9,4,2,3,18,46,253,158,190,FALSE,0.75098814229249,2024,2024-2025
CO,2024-09-30,inter-ucfe,2,0,0,0,0,0,0,0,0,0,0,2,2,2,FALSE,1,2024,2024-2025
CO,2024-09-30,inter-ucx,0,0,0,0,0,0,0,0,0,0,0,0,0,0,FALSE,0,2024,2024-2025
CO,2024-09-30,inter-ui,110,32,17,8,2,9,4,2,3,18,46,251,156,188,FALSE,0.749003984063745,2024,2024-2025
CO,2024-09-30,intra-total,3029,727,324,173,87,48,46,35,26,489,901,5885,3930,4657,FALSE,0.791333899745115,2024,2024-2025
CO,2024-09-30,intra-ucfe,4,1,3,0,0,1,1,0,0,6,1,17,5,6,FALSE,0.352941176470588,2024,2024-2025
CO,2024-09-30,intra-ucx,17,1,0,1,0,0,0,0,0,0,6,25,23,24,FALSE,0.96,2024,2024-2025
CO,2024-09-30,intra-ui,3008,725,321,172,87,47,45,35,26,483,894,5843,3902,4627,FALSE,0.791887728906384,2024,2024-2025
CO,2024-10-31,inter-total,160,24,13,14,8,6,3,1,4,25,69,327,229,253,FALSE,0.773700305810398,2024,2024-2025
CO,2024-10-31,inter-ucfe,1,0,0,0,0,0,0,0,0,1,0,2,1,1,FALSE,0.5,2024,2024-2025
CO,2024-10-31,inter-ucx,0,0,0,0,0,0,0,0,0,0,0,0,0,0,FALSE,0,2024,2024-2025
CO,2024-10-31,inter-ui,159,24,13,14,8,6,3,1,4,24,69,325,228,252,FALSE,0.775384615384615,2024,2024-2025
CO,2024-10-31,intra-total,3283,824,425,196,103,83,62,59,43,318,1392,6788,4675,5499,FALSE,0.810106069534473,2024,2024-2025
CO,2024-10-31,intra-ucfe,9,1,0,1,0,1,1,0,0,1,3,17,12,13,FALSE,0.764705882352941,2024,2024-2025
CO,2024-10-31,intra-ucx,23,5,0,0,0,0,1,0,0,4,9,42,32,37,FALSE,0.880952380952381,2024,2024-2025
CO,2024-10-31,intra-ui,3251,818,425,195,103,82,60,59,43,313,1380,6729,4631,5449,FALSE,0.809778570367068,2024,2024-2025
CO,2024-11-30,inter-total,177,39,15,14,3,3,1,3,2,26,61,344,238,277,FALSE,0.805232558139535,2024,2024-2025
CO,2024-11-30,inter-ucfe,6,0,1,0,0,0,0,0,0,1,2,10,8,8,FALSE,0.8,2024,2024-2025
CO,2024-11-30,inter-ucx,0,0,0,0,0,0,0,0,0,0,0,0,0,0,FALSE,0,2024,2024-2025
CO,2024-11-30,inter-ui,171,39,14,14,3,3,1,3,2,25,59,334,230,269,FALSE,0.805389221556886,2024,2024-2025
CO,2024-11-30,intra-total,3532,720,274,123,51,35,16,31,27,284,1263,6356,4795,5515,FALSE,0.867684078036501,2024,2024-2025
CO,2024-11-30,intra-ucfe,19,0,3,2,1,0,1,1,0,0,3,30,22,22,FALSE,0.733333333333333,2024,2024-2025
CO,2024-11-30,intra-ucx,19,0,2,1,0,0,0,0,0,3,4,29,23,23,FALSE,0.793103448275862,2024,2024-2025
CO,2024-11-30,intra-ui,3494,720,269,120,50,35,15,30,27,281,1256,6297,4750,5470,FALSE,0.86866761950135,2024,2024-2025
CT,2019-01-31,inter-total,281,74,32,18,4,7,2,1,0,8,203,630,484,558,TRUE,0.768253968253968,2018,2018-2019
CT,2019-01-31,inter-ucfe,1,1,3,3,0,0,0,0,0,0,0,8,1,2,TRUE,0.125,2018,2018-2019
CT,2019-01-31,inter-ucx,0,0,0,0,0,0,0,0,0,0,0,0,0,0,TRUE,0,2018,2018-2019
CT,2019-01-31,inter-ui,280,73,29,15,4,7,2,1,0,8,203,622,483,556,TRUE,0.776527331189711,2018,2018-2019
CT,2019-01-31,intra-total,9643,1849,826,375,106,33,23,13,15,127,5117,18127,14760,16609,TRUE,0.814254978760964,2018,2018-2019
CT,2019-01-31,intra-ucfe,9,34,28,4,0,0,0,0,0,0,31,106,40,74,TRUE,0.377358490566038,2018,2018-2019
CT,2019-01-31,intra-ucx,2,1,2,1,0,1,0,0,0,0,10,17,12,13,TRUE,0.705882352941177,2018,2018-2019
CT,2019-01-31,intra-ui,9632,1814,796,370,106,32,23,13,15,127,5076,18004,14708,16522,TRUE,0.816929571206399,2018,2018-2019
CT,2019-02-28,inter-total,112,43,38,15,12,4,2,3,0,8,95,332,207,250,TRUE,0.623493975903615,2018,2018-2019
CT,2019-02-28,inter-ucfe,0,0,0,0,0,0,0,0,0,0,0,0,0,0,TRUE,0,2018,2018-2019
CT,2019-02-28,inter-ucx,0,0,0,0,0,0,0,0,0,0,0,0,0,0,TRUE,0,2018,2018-2019
CT,2019-02-28,inter-ui,112,43,38,15,12,4,2,3,0,8,95,332,207,250,TRUE,0.623493975903615,2018,2018-2019
CT,2019-02-28,intra-total,3657,812,677,458,226,124,55,42,17,147,2027,8242,5684,6496,TRUE,0.689638437272507,2018,2018-2019
CT,2019-02-28,intra-ucfe,3,3,3,1,3,1,1,0,0,0,3,18,6,9,TRUE,0.333333333333333,2018,2018-2019
CT,2019-02-28,intra-ucx,5,1,2,0,0,0,0,0,0,1,6,15,11,12,TRUE,0.733333333333333,2018,2018-2019
CT,2019-02-28,intra-ui,3649,808,672,457,223,123,54,42,17,146,2018,8209,5667,6475,TRUE,0.690339870873432,2018,2018-2019
CT,2019-03-31,inter-total,89,32,32,12,4,3,1,0,1,1,77,252,166,198,TRUE,0.658730158730159,2018,2018-2019
CT,2019-03-31,inter-ucfe,0,0,0,0,0,0,0,0,0,0,0,0,0,0,TRUE,0,2018,2018-2019
CT,2019-03-31,inter-ucx,0,0,0,0,0,0,0,0,0,0,0,0,0,0,TRUE,0,2018,2018-2019
CT,2019-03-31,inter-ui,89,32,32,12,4,3,1,0,1,1,77,252,166,198,TRUE,0.658730158730159,2018,2018-2019
CT,2019-03-31,intra-total,2568,821,683,363,139,71,50,32,40,246,1794,6807,4362,5183,TRUE,0.640810929925077,2018,2018-2019
CT,2019-03-31,intra-ucfe,1,3,2,1,0,0,1,1,0,0,1,10,2,5,TRUE,0.2,2018,2018-2019
CT,2019-03-31,intra-ucx,5,2,2,0,0,0,0,0,0,0,4,13,9,11,TRUE,0.692307692307692,2018,2018-2019
CT,2019-03-31,intra-ui,2562,816,679,362,139,71,49,31,40,246,1789,6784,4351,5167,TRUE,0.641362028301887,2018,2018-2019
CT,2019-04-30,inter-total,89,37,19,8,4,1,2,2,1,3,59,225,148,185,TRUE,0.657777777777778,2018,2018-2019
CT,2019-04-30,inter-ucfe,0,0,0,0,0,0,0,0,0,0,0,0,0,0,TRUE,0,2018,2018-2019
CT,2019-04-30,inter-ucx,0,0,0,0,0,0,0,0,0,0,0,0,0,0,TRUE,0,2018,2018-2019
CT,2019-04-30,inter-ui,89,37,19,8,4,1,2,2,1,3,59,225,148,185,TRUE,0.657777777777778,2018,2018-2019
CT,2019-04-30,intra-total,3112,812,508,188,84,40,31,12,16,149,1573,6525,4685,5497,TRUE,0.718007662835249,2018,2018-2019
CT,2019-04-30,intra-ucfe,1,2,1,0,0,0,0,0,0,2,6,12,7,9,TRUE,0.583333333333333,2018,2018-2019
CT,2019-04-30,intra-ucx,3,0,0,1,0,0,0,0,0,0,0,4,3,3,TRUE,0.75,2018,2018-2019
CT,2019-04-30,intra-ui,3108,810,507,187,84,40,31,12,16,147,1567,6509,4675,5485,TRUE,0.718236288216316,2018,2018-2019
CT,2019-05-31,inter-total,115,43,16,11,3,3,4,1,1,9,96,302,211,254,TRUE,0.698675496688742,2018,2018-2019
CT,2019-05-31,inter-ucfe,0,1,0,0,0,0,0,0,0,0,0,1,0,1,TRUE,0,2018,2018-2019
CT,2019-05-31,inter-ucx,0,0,0,0,0,0,0,0,0,0,0,0,0,0,TRUE,0,2018,2018-2019
CT,2019-05-31,inter-ui,115,42,16,11,3,3,4,1,1,9,96,301,211,253,TRUE,0.700996677740864,2018,2018-2019
CT,2019-05-31,intra-total,2467,945,532,185,94,33,16,19,9,75,1765,6140,4232,5177,TRUE,0.689250814332248,2018,2018-2019
CT,2019-05-31,intra-ucfe,2,1,0,1,0,0,0,0,0,0,3,7,5,6,TRUE,0.714285714285714,2018,2018-2019
CT,2019-05-31,intra-ucx,6,0,0,0,0,0,0,0,0,0,4,10,10,10,TRUE,1,2018,2018-2019
CT,2019-05-31,intra-ui,2459,944,532,184,94,33,16,19,9,75,1758,6123,4217,5161,TRUE,0.688714682345256,2018,2018-2019
CT,2019-06-30,inter-total,111,34,17,8,2,3,2,1,2,4,89,273,200,234,TRUE,0.732600732600733,2018,2018-2019
CT,2019-06-30,inter-ucfe,0,0,0,0,0,0,0,0,0,0,0,0,0,0,TRUE,0,2018,2018-2019
CT,2019-06-30,inter-ucx,0,0,0,0,0,0,0,0,0,0,0,0,0,0,TRUE,0,2018,2018-2019
CT,2019-06-30,inter-ui,111,34,17,8,2,3,2,1,2,4,89,273,200,234,TRUE,0.732600732600733,2018,2018-2019
CT,2019-06-30,intra-total,3101,743,448,194,69,46,15,21,16,112,1541,6306,4642,5385,TRUE,0.736124326038693,2018,2018-2019
CT,2019-06-30,intra-ucfe,2,3,0,0,1,0,0,0,0,0,1,7,3,6,TRUE,0.428571428571429,2018,2018-2019
CT,2019-06-30,intra-ucx,5,1,1,2,0,0,0,1,0,0,3,13,8,9,TRUE,0.615384615384615,2018,2018-2019
CT,2019-06-30,intra-ui,3094,739,447,192,68,46,15,20,16,112,1537,6286,4631,5370,TRUE,0.736716512885778,2018,2018-2019
CT,2019-07-31,inter-total,124,56,19,10,6,2,1,0,3,2,109,332,233,289,TRUE,0.701807228915663,2019,2019-2020
CT,2019-07-31,inter-ucfe,0,0,0,1,0,0,0,0,0,0,0,1,0,0,TRUE,0,2019,2019-2020
CT,2019-07-31,inter-ucx,0,0,0,0,0,0,0,0,0,0,0,0,0,0,TRUE,0,2019,2019-2020
CT,2019-07-31,inter-ui,124,56,19,9,6,2,1,0,3,2,109,331,233,289,TRUE,0.70392749244713,2019,2019-2020
CT,2019-07-31,intra-total,5528,961,713,303,113,30,17,13,9,130,2334,10151,7862,8823,TRUE,0.774504974879322,2019,2019-2020
CT,2019-07-31,intra-ucfe,1,0,1,1,0,0,0,1,0,0,3,7,4,4,TRUE,0.571428571428571,2019,2019-2020
CT,2019-07-31,intra-ucx,9,3,0,0,0,0,1,0,0,0,7,20,16,19,TRUE,0.8,2019,2019-2020
CT,2019-07-31,intra-ui,5518,958,712,302,113,30,16,12,9,130,2324,10124,7842,8800,TRUE,0.774595021730541,2019,2019-2020
CT,2019-08-31,inter-total,99,35,29,17,6,3,0,1,0,8,89,287,188,223,TRUE,0.655052264808362,2019,2019-2020
CT,2019-08-31,inter-ucfe,0,0,1,0,0,0,0,0,0,1,0,2,0,0,TRUE,0,2019,2019-2020
CT,2019-08-31,inter-ucx,0,0,0,0,0,0,0,0,0,0,0,0,0,0,TRUE,0,2019,2019-2020
CT,2019-08-31,inter-ui,99,35,28,17,6,3,0,1,0,7,89,285,188,223,TRUE,0.659649122807018,2019,2019-2020
CT,2019-08-31,intra-total,3138,659,642,401,169,89,38,19,6,104,1588,6853,4726,5385,TRUE,0.689624981759813,2019,2019-2020
CT,2019-08-31,intra-ucfe,1,1,1,3,1,0,0,0,0,0,3,10,4,5,TRUE,0.4,2019,2019-2020
CT,2019-08-31,intra-ucx,6,1,1,0,0,0,0,0,0,0,5,13,11,12,TRUE,0.846153846153846,2019,2019-2020
CT,2019-08-31,intra-ui,3131,657,640,398,168,89,38,19,6,104,1580,6830,4711,5368,TRUE,0.689751098096633,2019,2019-2020
CT,2019-09-30,inter-total,64,26,24,13,9,2,0,2,1,4,72,217,136,162,TRUE,0.626728110599078,2019,2019-2020
CT,2019-09-30,inter-ucfe,0,0,0,0,0,0,0,0,0,0,0,0,0,0,TRUE,0,2019,2019-2020
CT,2019-09-30,inter-ucx,0,0,0,0,0,0,0,0,0,0,0,0,0,0,TRUE,0,2019,2019-2020
CT,2019-09-30,inter-ui,64,26,24,13,9,2,0,2,1,4,72,217,136,162,TRUE,0.626728110599078,2019,2019-2020
CT,2019-09-30,intra-total,1931,703,569,332,143,58,25,15,11,118,1407,5312,3338,4041,TRUE,0.628388554216867,2019,2019-2020
CT,2019-09-30,intra-ucfe,5,1,1,0,3,0,1,0,0,0,2,13,7,8,TRUE,0.538461538461538,2019,2019-2020
CT,2019-09-30,intra-ucx,3,1,1,0,1,0,0,0,0,0,2,8,5,6,TRUE,0.625,2019,2019-2020
CT,2019-09-30,intra-ui,1923,701,567,332,139,58,24,15,11,118,1403,5291,3326,4027,TRUE,0.628614628614629,2019,2019-2020
CT,2019-10-31,inter-total,93,43,17,10,1,3,0,1,0,8,76,252,169,212,TRUE,0.670634920634921,2019,2019-2020
CT,2019-10-31,inter-ucfe,0,0,0,0,0,0,0,0,0,0,0,0,0,0,TRUE,0,2019,2019-2020
CT,2019-10-31,inter-ucx,0,0,0,0,0,0,0,0,0,0,1,1,1,1,TRUE,1,2019,2019-2020
CT,2019-10-31,inter-ui,93,43,17,10,1,3,0,1,0,8,75,251,168,211,TRUE,0.669322709163347,2019,2019-2020
CT,2019-10-31,intra-total,2288,830,470,214,102,32,16,25,7,106,1768,5858,4056,4886,TRUE,0.692386480027313,2019,2019-2020
CT,2019-10-31,intra-ucfe,0,5,0,0,2,0,0,0,0,0,4,11,4,9,TRUE,0.363636363636364,2019,2019-2020
CT,2019-10-31,intra-ucx,6,1,0,0,1,1,0,0,0,1,5,15,11,12,TRUE,0.733333333333333,2019,2019-2020
CT,2019-10-31,intra-ui,2282,824,470,214,99,31,16,25,7,105,1759,5832,4041,4865,TRUE,0.692901234567901,2019,2019-2020
CT,2019-11-30,inter-total,153,35,16,4,2,0,3,2,0,7,98,320,251,286,TRUE,0.784375,2019,2019-2020
CT,2019-11-30,inter-ucfe,0,0,0,0,0,0,0,0,0,0,0,0,0,0,TRUE,0,2019,2019-2020
CT,2019-11-30,inter-ucx,1,0,0,0,0,0,0,0,0,0,0,1,1,1,TRUE,1,2019,2019-2020
CT,2019-11-30,inter-ui,152,35,16,4,2,0,3,2,0,7,98,319,250,285,TRUE,0.783699059561129,2019,2019-2020
CT,2019-11-30,intra-total,2742,738,316,153,60,27,17,18,11,113,1794,5989,4536,5274,TRUE,0.757388545667056,2019,2019-2020
CT,2019-11-30,intra-ucfe,3,1,0,1,0,0,0,0,0,1,0,6,3,4,TRUE,0.5,2019,2019-2020
CT,2019-11-30,intra-ucx,4,1,1,1,0,0,0,0,0,0,4,11,8,9,TRUE,0.727272727272727,2019,2019-2020
CT,2019-11-30,intra-ui,2735,736,315,151,60,27,17,18,11,112,1790,5972,4525,5261,TRUE,0.757702612190221,2019,2019-2020
CT,2019-12-31,inter-total,215,45,12,8,7,1,1,1,2,6,140,438,355,400,TRUE,0.810502283105023,2019,2019-2020
CT,2019-12-31,inter-ucfe,0,0,0,0,0,0,0,0,0,0,0,0,0,0,TRUE,0,2019,2019-2020
CT,2019-12-31,inter-ucx,0,0,0,0,0,0,0,0,0,0,0,0,0,0,TRUE,0,2019,2019-2020
CT,2019-12-31,inter-ui,215,45,12,8,7,1,1,1,2,6,140,438,355,400,TRUE,0.810502283105023,2019,2019-2020
CT,2019-12-31,intra-total,7457,884,369,132,53,25,22,9,6,85,2708,11750,10165,11049,TRUE,0.865106382978724,2019,2019-2020
CT,2019-12-31,intra-ucfe,0,1,1,1,2,0,0,0,0,0,2,7,2,3,TRUE,0.285714285714286,2019,2019-2020
CT,2019-12-31,intra-ucx,0,6,0,1,1,1,0,0,0,0,9,18,9,15,TRUE,0.5,2019,2019-2020
CT,2019-12-31,intra-ui,7457,877,368,130,50,24,22,9,6,85,2697,11725,10154,11031,TRUE,0.866012793176972,2019,2019-2020
CT,2020-01-31,inter-total,250,74,14,8,5,5,1,1,0,5,179,542,429,503,TRUE,0.791512915129151,2019,2019-2020
CT,2020-01-31,inter-ucfe,0,0,1,0,0,0,0,0,0,0,1,2,1,1,TRUE,0.5,2019,2019-2020
CT,2020-01-31,inter-ucx,0,0,0,0,0,0,0,0,0,0,0,0,0,0,TRUE,0,2019,2019-2020
CT,2020-01-31,inter-ui,250,74,13,8,5,5,1,1,0,5,178,540,428,502,TRUE,0.792592592592593,2019,2019-2020
CT,2020-01-31,intra-total,8593,1601,742,375,92,42,18,21,14,120,4935,16553,13528,15129,TRUE,0.817253670029602,2019,2019-2020
CT,2020-01-31,intra-ucfe,2,6,2,1,1,0,0,0,0,0,2,14,4,10,TRUE,0.285714285714286,2019,2019-2020
CT,2020-01-31,intra-ucx,2,2,2,0,0,0,1,0,0,0,4,11,6,8,TRUE,0.545454545454545,2019,2019-2020
CT,2020-01-31,intra-ui,8589,1593,738,374,91,42,17,21,14,120,4929,16528,13518,15111,TRUE,0.817884801548887,2019,2019-2020
CT,2020-02-29,inter-total,103,47,34,13,9,3,6,1,0,12,87,315,190,237,TRUE,0.603174603174603,2019,2019-2020
CT,2020-02-29,inter-ucfe,0,0,0,0,0,0,0,0,0,0,0,0,0,0,TRUE,0,2019,2019-2020
CT,2020-02-29,inter-ucx,0,0,0,0,0,0,0,0,0,0,0,0,0,0,TRUE,0,2019,2019-2020
CT,2020-02-29,inter-ui,103,47,34,13,9,3,6,1,0,12,87,315,190,237,TRUE,0.603174603174603,2019,2019-2020
CT,2020-02-29,intra-total,3624,895,678,416,200,110,46,30,24,130,1916,8069,5540,6435,TRUE,0.686578262486058,2019,2019-2020
CT,2020-02-29,intra-ucfe,1,0,1,0,2,1,0,0,0,0,1,6,2,2,TRUE,0.333333333333333,2019,2019-2020
CT,2020-02-29,intra-ucx,4,3,3,1,0,0,0,0,0,0,2,13,6,9,TRUE,0.461538461538462,2019,2019-2020
CT,2020-02-29,intra-ui,3619,892,674,415,198,109,46,30,24,130,1913,8050,5532,6424,TRUE,0.687204968944099,2019,2019-2020
CT,2020-03-31,inter-total,175,55,25,5,4,1,2,1,1,4,193,466,368,423,TRUE,0.789699570815451,2019,2019-2020
CT,2020-03-31,inter-ucfe,0,0,0,0,0,0,0,0,0,0,0,0,0,0,TRUE,0,2019,2019-2020
CT,2020-03-31,inter-ucx,0,0,0,0,0,0,0,0,0,0,0,0,0,0,TRUE,0,2019,2019-2020
CT,2020-03-31,inter-ui,175,55,25,5,4,1,2,1,1,4,193,466,368,423,TRUE,0.789699570815451,2019,2019-2020
CT,2020-03-31,intra-total,16899,999,561,266,103,65,36,32,24,137,9544,28666,26443,27442,TRUE,0.922451684922905,2019,2019-2020
CT,2020-03-31,intra-ucfe,3,4,2,0,0,0,0,0,0,0,3,12,6,10,TRUE,0.5,2019,2019-2020
CT,2020-03-31,intra-ucx,9,0,0,1,0,0,0,0,0,0,6,16,15,15,TRUE,0.9375,2019,2019-2020
CT,2020-03-31,intra-ui,16887,995,559,265,103,65,36,32,24,137,9535,28638,26422,27417,TRUE,0.922620294713318,2019,2019-2020
CT,2020-04-30,inter-total,125,705,316,134,29,0,3,0,0,3,502,1817,627,1332,TRUE,0.345074298293891,2019,2019-2020
CT,2020-04-30,inter-ucfe,0,0,0,0,0,0,0,0,0,0,0,0,0,0,TRUE,0,2019,2019-2020
CT,2020-04-30,inter-ucx,0,0,0,0,0,0,0,0,0,0,0,0,0,0,TRUE,0,2019,2019-2020
CT,2020-04-30,inter-ui,125,705,316,134,29,0,3,0,0,3,502,1817,627,1332,TRUE,0.345074298293891,2019,2019-2020
CT,2020-04-30,intra-total,51621,46980,13850,4318,1081,50,26,13,12,131,61530,179612,113151,160131,TRUE,0.629974611941296,2019,2019-2020
CT,2020-04-30,intra-ucfe,1,2,5,3,2,0,0,0,0,2,2,17,3,5,TRUE,0.176470588235294,2019,2019-2020
CT,2020-04-30,intra-ucx,2,2,9,5,0,0,0,0,0,0,0,18,2,4,TRUE,0.111111111111111,2019,2019-2020
CT,2020-04-30,intra-ui,51618,46976,13836,4310,1079,50,26,13,12,129,61528,179577,113146,160122,TRUE,0.630069552336881,2019,2019-2020
CT,2020-05-31,inter-total,74,389,277,175,136,150,145,47,5,5,267,1670,341,730,TRUE,0.204191616766467,2019,2019-2020
CT,2020-05-31,inter-ucfe,0,0,0,0,0,0,0,0,0,0,0,0,0,0,TRUE,0,2019,2019-2020
CT,2020-05-31,inter-ucx,0,0,0,0,0,0,0,0,0,0,0,0,0,0,TRUE,0,2019,2019-2020
CT,2020-05-31,inter-ui,74,389,277,175,136,150,145,47,5,5,267,1670,341,730,TRUE,0.204191616766467,2019,2019-2020
CT,2020-05-31,intra-total,25164,9822,7016,4328,3461,3198,2372,1055,230,147,8141,64934,33305,43127,TRUE,0.512905411648751,2019,2019-2020
CT,2020-05-31,intra-ucfe,0,1,6,17,11,7,1,3,0,0,1,47,1,2,TRUE,0.0212765957446809,2019,2019-2020
CT,2020-05-31,intra-ucx,1,3,5,13,12,4,4,0,0,0,0,42,1,4,TRUE,0.0238095238095238,2019,2019-2020
CT,2020-05-31,intra-ui,25163,9818,7005,4298,3438,3187,2367,1052,230,147,8140,64845,33303,43121,TRUE,0.513578533425862,2019,2019-2020
CT,2020-06-30,inter-total,82,244,92,117,180,320,393,174,70,77,268,2017,350,594,TRUE,0.173525037183937,2019,2019-2020
CT,2020-06-30,inter-ucfe,0,1,0,0,0,0,0,0,0,0,0,1,0,1,TRUE,0,2019,2019-2020
CT,2020-06-30,inter-ucx,0,0,0,0,0,0,0,0,0,0,0,0,0,0,TRUE,0,2019,2019-2020
CT,2020-06-30,inter-ui,82,243,92,117,180,320,393,174,70,77,268,2016,350,593,TRUE,0.173611111111111,2019,2019-2020
CT,2020-06-30,intra-total,9625,7349,2432,1833,2285,2611,2757,1665,1060,1582,7972,41171,17597,24946,TRUE,0.427412499089165,2019,2019-2020
CT,2020-06-30,intra-ucfe,2,6,18,18,11,5,5,2,3,9,3,82,5,11,TRUE,0.0609756097560976,2019,2019-2020
CT,2020-06-30,intra-ucx,2,9,15,8,4,6,0,3,0,3,2,52,4,13,TRUE,0.0769230769230769,2019,2019-2020
CT,2020-06-30,intra-ui,9621,7334,2399,1807,2270,2600,2752,1660,1057,1570,7967,41037,17588,24922,TRUE,0.428588834466457,2019,2019-2020
CT,2020-07-31,inter-total,88,246,101,50,49,35,40,22,13,132,260,1036,348,594,TRUE,0.335907335907336,2020,2020-2021
CT,2020-07-31,inter-ucfe,0,0,0,0,0,0,0,0,0,0,0,0,0,0,TRUE,0,2020,2020-2021
CT,2020-07-31,inter-ucx,0,0,0,1,0,0,0,0,0,0,0,1,0,0,TRUE,0,2020,2020-2021
CT,2020-07-31,inter-ui,88,246,101,49,49,35,40,22,13,132,260,1035,348,594,TRUE,0.336231884057971,2020,2020-2021
CT,2020-07-31,intra-total,4496,7501,2393,866,846,660,572,491,374,2442,8689,29330,13185,20686,TRUE,0.449539720422775,2020,2020-2021
CT,2020-07-31,intra-ucfe,1,5,10,6,1,3,2,2,1,12,7,50,8,13,TRUE,0.16,2020,2020-2021
CT,2020-07-31,intra-ucx,1,7,14,6,2,0,0,2,0,3,1,36,2,9,TRUE,0.0555555555555556,2020,2020-2021
CT,2020-07-31,intra-ui,4494,7489,2369,854,843,657,570,487,373,2427,8681,29244,13175,20664,TRUE,0.450519764738066,2020,2020-2021
CT,2020-08-31,inter-total,107,125,58,34,74,25,13,9,11,84,246,786,353,478,TRUE,0.44910941475827,2020,2020-2021
CT,2020-08-31,inter-ucfe,0,0,0,0,0,0,0,0,0,1,0,1,0,0,TRUE,0,2020,2020-2021
CT,2020-08-31,inter-ucx,0,0,1,0,0,0,0,0,0,0,0,1,0,0,TRUE,0,2020,2020-2021
CT,2020-08-31,inter-ui,107,125,57,34,74,25,13,9,11,83,246,784,353,478,TRUE,0.450255102040816,2020,2020-2021
CT,2020-08-31,intra-total,3544,2936,1411,651,2626,587,386,272,195,1448,5352,19408,8896,11832,TRUE,0.458367683429514,2020,2020-2021
CT,2020-08-31,intra-ucfe,5,5,6,1,4,3,2,0,0,11,6,43,11,16,TRUE,0.255813953488372,2020,2020-2021
CT,2020-08-31,intra-ucx,2,1,7,1,1,0,1,0,0,4,4,21,6,7,TRUE,0.285714285714286,2020,2020-2021
CT,2020-08-31,intra-ui,3537,2930,1398,649,2621,584,383,272,195,1433,5342,19344,8879,11809,TRUE,0.459005376344086,2020,2020-2021
CT,2020-09-30,inter-total,90,15,11,20,9,13,10,13,9,32,163,385,253,268,TRUE,0.657142857142857,2020,2020-2021
CT,2020-09-30,inter-ucfe,1,0,0,0,0,0,0,0,0,0,0,1,1,1,TRUE,1,2020,2020-2021
CT,2020-09-30,inter-ucx,0,0,0,0,0,0,0,0,0,0,0,0,0,0,TRUE,0,2020,2020-2021
CT,2020-09-30,inter-ui,89,15,11,20,9,13,10,13,9,32,163,384,252,267,TRUE,0.65625,2020,2020-2021
CT,2020-09-30,intra-total,2904,444,306,263,199,233,242,211,204,1042,3303,9351,6207,6651,TRUE,0.663779274943856,2020,2020-2021
CT,2020-09-30,intra-ucfe,3,2,0,0,1,0,1,2,2,9,5,25,8,10,TRUE,0.32,2020,2020-2021
CT,2020-09-30,intra-ucx,3,1,1,1,1,2,0,2,0,4,8,23,11,12,TRUE,0.478260869565217,2020,2020-2021
CT,2020-09-30,intra-ui,2898,441,305,262,197,231,241,207,202,1029,3290,9303,6188,6629,TRUE,0.665161775771257,2020,2020-2021
CT,2020-10-31,inter-total,118,19,12,2,6,4,5,2,9,34,99,310,217,236,TRUE,0.7,2020,2020-2021
CT,2020-10-31,inter-ucfe,0,0,0,0,0,0,0,0,0,0,0,0,0,0,TRUE,0,2020,2020-2021
CT,2020-10-31,inter-ucx,0,0,0,0,0,0,0,0,0,0,0,0,0,0,TRUE,0,2020,2020-2021
CT,2020-10-31,inter-ui,118,19,12,2,6,4,5,2,9,34,99,310,217,236,TRUE,0.7,2020,2020-2021
CT,2020-10-31,intra-total,3062,529,331,229,160,141,120,98,120,1005,1968,7763,5030,5559,TRUE,0.647945381939972,2020,2020-2021
CT,2020-10-31,intra-ucfe,5,9,2,2,0,0,1,0,0,7,9,35,14,23,TRUE,0.4,2020,2020-2021
CT,2020-10-31,intra-ucx,3,4,1,0,1,0,0,0,0,5,2,16,5,9,TRUE,0.3125,2020,2020-2021
CT,2020-10-31,intra-ui,3054,516,328,227,159,141,119,98,120,993,1957,7712,5011,5527,TRUE,0.649766597510373,2020,2020-2021
CT,2020-11-30,inter-total,156,34,16,12,5,6,2,3,3,27,103,367,259,293,TRUE,0.705722070844687,2020,2020-2021
CT,2020-11-30,inter-ucfe,0,0,1,0,0,0,0,0,0,1,0,2,0,0,TRUE,0,2020,2020-2021
CT,2020-11-30,inter-ucx,0,0,0,0,0,0,0,0,0,0,0,0,0,0,TRUE,0,2020,2020-2021
CT,2020-11-30,inter-ui,156,34,15,12,5,6,2,3,3,26,103,365,259,293,TRUE,0.70958904109589,2020,2020-2021
CT,2020-11-30,intra-total,2937,544,371,221,163,127,94,73,105,723,1979,7337,4916,5460,TRUE,0.67002862205261,2020,2020-2021
CT,2020-11-30,intra-ucfe,25,11,8,4,3,0,2,1,0,5,23,82,48,59,TRUE,0.585365853658537,2020,2020-2021
CT,2020-11-30,intra-ucx,5,3,2,1,0,0,1,2,0,0,2,16,7,10,TRUE,0.4375,2020,2020-2021
CT,2020-11-30,intra-ui,2907,530,361,216,160,127,91,70,105,718,1954,7239,4861,5391,TRUE,0.671501588617212,2020,2020-2021
CT,2020-12-31,inter-total,277,36,17,17,4,10,6,3,2,15,160,547,437,473,TRUE,0.79890310786106,2020,2020-2021
CT,2020-12-31,inter-ucfe,0,0,0,0,0,0,2,0,0,0,1,3,1,1,TRUE,0.333333333333333,2020,2020-2021
CT,2020-12-31,inter-ucx,0,0,0,0,0,0,0,0,0,0,0,0,0,0,TRUE,0,2020,2020-2021
CT,2020-12-31,inter-ui,277,36,17,17,4,10,4,3,2,15,159,544,436,472,TRUE,0.801470588235294,2020,2020-2021
CT,2020-12-31,intra-total,6713,715,449,301,190,136,83,53,54,426,3262,12382,9975,10690,TRUE,0.805604910353739,2020,2020-2021
CT,2020-12-31,intra-ucfe,6,13,4,5,2,2,1,2,1,3,21,60,27,40,TRUE,0.45,2020,2020-2021
CT,2020-12-31,intra-ucx,4,3,0,1,1,0,0,0,0,1,0,10,4,7,TRUE,0.4,2020,2020-2021
CT,2020-12-31,intra-ui,6703,699,445,295,187,134,82,51,53,422,3241,12312,9944,10643,TRUE,0.807667316439246,2020,2020-2021
CT,2021-01-31,inter-total,266,96,30,21,11,7,2,1,2,11,233,680,499,595,TRUE,0.733823529411765,2020,2020-2021
CT,2021-01-31,inter-ucfe,0,0,1,0,1,0,0,0,0,0,0,2,0,0,TRUE,0,2020,2020-2021
CT,2021-01-31,inter-ucx,0,0,0,0,0,0,0,0,0,0,0,0,0,0,TRUE,0,2020,2020-2021
CT,2021-01-31,inter-ui,266,96,29,21,10,7,2,1,2,11,233,678,499,595,TRUE,0.735988200589971,2020,2020-2021
CT,2021-01-31,intra-total,6129,1939,767,477,236,108,68,48,29,269,6021,16091,12150,14089,TRUE,0.755080479771301,2020,2020-2021
CT,2021-01-31,intra-ucfe,7,9,7,2,0,1,0,2,1,1,12,42,19,28,TRUE,0.452380952380952,2020,2020-2021
CT,2021-01-31,intra-ucx,3,3,1,1,1,0,1,0,0,2,6,18,9,12,TRUE,0.5,2020,2020-2021
CT,2021-01-31,intra-ui,6119,1927,759,474,235,107,67,46,28,266,6003,16031,12122,14049,TRUE,0.756159940116025,2020,2020-2021
CT,2021-02-28,inter-total,177,39,39,31,16,10,6,4,2,10,140,474,317,356,TRUE,0.668776371308017,2020,2020-2021
CT,2021-02-28,inter-ucfe,0,0,0,0,0,0,0,0,0,0,0,0,0,0,TRUE,0,2020,2020-2021
CT,2021-02-28,inter-ucx,0,0,0,0,0,0,0,0,0,0,0,0,0,0,TRUE,0,2020,2020-2021
CT,2021-02-28,inter-ui,177,39,39,31,16,10,6,4,2,10,140,474,317,356,TRUE,0.668776371308017,2020,2020-2021
CT,2021-02-28,intra-total,4195,937,807,585,449,254,121,98,45,314,3203,11008,7398,8335,TRUE,0.672056686046512,2020,2020-2021
CT,2021-02-28,intra-ucfe,6,5,9,5,4,3,4,3,3,5,4,51,10,15,TRUE,0.196078431372549,2020,2020-2021
CT,2021-02-28,intra-ucx,3,3,1,0,0,0,0,1,0,1,5,14,8,11,TRUE,0.571428571428571,2020,2020-2021
CT,2021-02-28,intra-ui,4186,929,797,580,445,251,117,94,42,308,3194,10943,7380,8309,TRUE,0.674403728410856,2020,2020-2021
CT,2021-03-31,inter-total,226,31,18,15,15,12,9,9,3,19,113,470,339,370,TRUE,0.721276595744681,2020,2020-2021
CT,2021-03-31,inter-ucfe,0,0,0,0,0,0,0,0,0,0,0,0,0,0,TRUE,0,2020,2020-2021
CT,2021-03-31,inter-ucx,0,0,0,0,0,0,0,0,0,0,0,0,0,0,TRUE,0,2020,2020-2021
CT,2021-03-31,inter-ui,226,31,18,15,15,12,9,9,3,19,113,470,339,370,TRUE,0.721276595744681,2020,2020-2021
CT,2021-03-31,intra-total,6229,597,477,407,367,293,194,116,90,446,2743,11959,8972,9569,TRUE,0.750229952337152,2020,2020-2021
CT,2021-03-31,intra-ucfe,8,5,2,6,0,8,4,2,1,5,9,50,17,22,TRUE,0.34,2020,2020-2021
CT,2021-03-31,intra-ucx,5,2,1,1,1,1,0,0,0,2,4,17,9,11,TRUE,0.529411764705882,2020,2020-2021
CT,2021-03-31,intra-ui,6216,590,474,400,366,284,190,114,89,439,2730,11892,8946,9536,TRUE,0.752270433905146,2020,2020-2021
CT,2021-04-30,inter-total,377,63,46,21,25,4,7,2,2,14,192,753,569,632,TRUE,0.755644090305445,2020,2020-2021
CT,2021-04-30,inter-ucfe,0,0,0,0,0,0,0,0,1,0,0,1,0,0,TRUE,0,2020,2020-2021
CT,2021-04-30,inter-ucx,0,0,0,0,0,0,0,0,0,0,0,0,0,0,TRUE,0,2020,2020-2021
CT,2021-04-30,inter-ui,377,63,46,21,25,4,7,2,1,14,192,752,569,632,TRUE,0.756648936170213,2020,2020-2021
CT,2021-04-30,intra-total,7953,1682,988,607,449,258,161,91,56,333,4601,17179,12554,14236,TRUE,0.730775947377612,2020,2020-2021
CT,2021-04-30,intra-ucfe,4,7,9,3,2,1,1,1,2,6,4,40,8,15,TRUE,0.2,2020,2020-2021
CT,2021-04-30,intra-ucx,2,2,0,1,0,1,0,0,0,0,4,10,6,8,TRUE,0.6,2020,2020-2021
CT,2021-04-30,intra-ui,7947,1673,979,603,447,256,160,90,54,327,4593,17129,12540,14213,TRUE,0.732091774184132,2020,2020-2021
CT,2021-05-31,inter-total,250,48,33,29,28,30,12,6,2,24,134,596,384,432,TRUE,0.644295302013423,2020,2020-2021
CT,2021-05-31,inter-ucfe,0,0,0,0,0,0,0,0,0,0,2,2,2,2,TRUE,1,2020,2020-2021
CT,2021-05-31,inter-ucx,0,0,0,0,0,0,0,0,0,0,0,0,0,0,TRUE,0,2020,2020-2021
CT,2021-05-31,inter-ui,250,48,33,29,28,30,12,6,2,24,132,594,382,430,TRUE,0.643097643097643,2020,2020-2021
CT,2021-05-31,intra-total,4060,775,537,444,556,522,349,171,91,292,2382,10179,6442,7217,TRUE,0.63287159838884,2020,2020-2021
CT,2021-05-31,intra-ucfe,9,4,6,5,1,3,4,0,1,6,7,46,16,20,TRUE,0.347826086956522,2020,2020-2021
CT,2021-05-31,intra-ucx,5,2,3,0,0,0,0,1,0,0,4,15,9,11,TRUE,0.6,2020,2020-2021
CT,2021-05-31,intra-ui,4046,769,528,439,555,519,345,170,90,286,2371,10118,6417,7186,TRUE,0.634216248270409,2020,2020-2021
CT,2021-06-30,inter-total,278,39,26,15,8,14,13,10,8,22,160,593,438,477,TRUE,0.738617200674536,2020,2020-2021
CT,2021-06-30,inter-ucfe,0,1,0,0,0,0,0,0,0,0,0,1,0,1,TRUE,0,2020,2020-2021
CT,2021-06-30,inter-ucx,1,0,0,0,0,0,0,0,0,0,0,1,1,1,TRUE,1,2020,2020-2021
CT,2021-06-30,inter-ui,277,38,26,15,8,14,13,10,8,22,160,591,437,475,TRUE,0.739424703891709,2020,2020-2021
CT,2021-06-30,intra-total,4922,661,358,257,152,190,238,166,156,480,2069,9649,6991,7652,TRUE,0.724531039485957,2020,2020-2021
CT,2021-06-30,intra-ucfe,7,1,4,3,2,1,2,0,0,4,8,32,15,16,TRUE,0.46875,2020,2020-2021
CT,2021-06-30,intra-ucx,4,0,1,1,1,0,1,0,0,0,5,13,9,9,TRUE,0.692307692307692,2020,2020-2021
CT,2021-06-30,intra-ui,4911,660,353,253,149,189,235,166,156,476,2056,9604,6967,7627,TRUE,0.72542690545606,2020,2020-2021
CT,2021-07-31,inter-total,199,33,14,9,8,5,3,5,7,28,86,397,285,318,TRUE,0.717884130982368,2021,2021-2022
CT,2021-07-31,inter-ucfe,0,0,0,0,0,0,0,0,0,0,0,0,0,0,TRUE,0,2021,2021-2022
CT,2021-07-31,inter-ucx,0,0,0,0,0,0,0,0,0,0,0,0,0,0,TRUE,0,2021,2021-2022
CT,2021-07-31,inter-ui,199,33,14,9,8,5,3,5,7,28,86,397,285,318,TRUE,0.717884130982368,2021,2021-2022
CT,2021-07-31,intra-total,3992,477,269,141,131,79,69,120,147,479,1745,7649,5737,6214,TRUE,0.750032684010982,2021,2021-2022
CT,2021-07-31,intra-ucfe,1,1,0,1,1,1,0,0,0,1,1,7,2,3,TRUE,0.285714285714286,2021,2021-2022
CT,2021-07-31,intra-ucx,4,1,2,0,1,0,0,0,0,0,3,11,7,8,TRUE,0.636363636363636,2021,2021-2022
CT,2021-07-31,intra-ui,3987,475,267,140,129,78,69,120,147,478,1741,7631,5728,6203,TRUE,0.750622461014284,2021,2021-2022
CT,2021-08-31,inter-total,173,21,15,16,5,9,10,12,6,28,78,373,251,272,TRUE,0.672922252010724,2021,2021-2022
CT,2021-08-31,inter-ucfe,0,0,0,0,0,0,0,0,0,1,0,1,0,0,TRUE,0,2021,2021-2022
CT,2021-08-31,inter-ucx,0,0,0,0,0,0,0,0,0,0,0,0,0,0,TRUE,0,2021,2021-2022
CT,2021-08-31,inter-ui,173,21,15,16,5,9,10,12,6,27,78,372,251,272,TRUE,0.674731182795699,2021,2021-2022
CT,2021-08-31,intra-total,2998,351,258,205,109,96,199,252,209,496,1176,6349,4174,4525,TRUE,0.657426366356907,2021,2021-2022
CT,2021-08-31,intra-ucfe,5,0,2,1,1,0,1,1,0,2,1,14,6,6,TRUE,0.428571428571429,2021,2021-2022
CT,2021-08-31,intra-ucx,6,2,1,1,0,0,0,0,0,0,2,12,8,10,TRUE,0.666666666666667,2021,2021-2022
CT,2021-08-31,intra-ui,2987,349,255,203,108,96,198,251,209,494,1173,6323,4160,4509,TRUE,0.65791554641784,2021,2021-2022
CT,2021-09-30,inter-total,228,24,8,5,3,2,4,7,9,22,70,382,298,322,TRUE,0.780104712041885,2021,2021-2022
CT,2021-09-30,inter-ucfe,0,0,0,0,0,0,0,0,0,0,0,0,0,0,TRUE,0,2021,2021-2022
CT,2021-09-30,inter-ucx,0,0,0,0,0,0,0,0,0,0,0,0,0,0,TRUE,0,2021,2021-2022
CT,2021-09-30,inter-ui,228,24,8,5,3,2,4,7,9,22,70,382,298,322,TRUE,0.780104712041885,2021,2021-2022
CT,2021-09-30,intra-total,4790,419,160,104,75,74,71,168,215,665,1189,7930,5979,6398,TRUE,0.753972257250946,2021,2021-2022
CT,2021-09-30,intra-ucfe,12,1,2,2,0,0,0,0,0,6,4,27,16,17,TRUE,0.592592592592593,2021,2021-2022
CT,2021-09-30,intra-ucx,4,0,2,0,0,1,0,0,1,0,2,10,6,6,TRUE,0.6,2021,2021-2022
CT,2021-09-30,intra-ui,4774,418,156,102,75,73,71,168,214,659,1183,7893,5957,6375,TRUE,0.754719371595084,2021,2021-2022
CT,2021-10-31,inter-total,69,13,16,6,2,2,0,3,2,15,36,164,105,118,TRUE,0.640243902439024,2021,2021-2022
CT,2021-10-31,inter-ucfe,0,0,0,0,0,0,0,0,0,0,0,0,0,0,TRUE,0,2021,2021-2022
CT,2021-10-31,inter-ucx,0,0,0,0,0,0,0,0,0,0,0,0,0,0,TRUE,0,2021,2021-2022
CT,2021-10-31,inter-ui,69,13,16,6,2,2,0,3,2,15,36,164,105,118,TRUE,0.640243902439024,2021,2021-2022
CT,2021-10-31,intra-total,1715,311,269,128,82,59,48,110,183,484,818,4207,2533,2844,TRUE,0.602091751842168,2021,2021-2022
CT,2021-10-31,intra-ucfe,1,3,1,1,0,0,0,0,1,2,1,10,2,5,TRUE,0.2,2021,2021-2022
CT,2021-10-31,intra-ucx,4,2,0,1,1,1,0,0,0,0,2,11,6,8,TRUE,0.545454545454545,2021,2021-2022
CT,2021-10-31,intra-ui,1710,306,268,126,81,58,48,110,182,482,815,4186,2525,2831,TRUE,0.603201146679408,2021,2021-2022
CT,2021-11-30,inter-total,103,14,8,6,8,0,2,6,6,10,78,241,181,195,TRUE,0.75103734439834,2021,2021-2022
CT,2021-11-30,inter-ucfe,0,0,0,0,0,0,0,0,0,0,0,0,0,0,TRUE,0,2021,2021-2022
CT,2021-11-30,inter-ucx,0,0,0,0,0,0,0,0,0,0,0,0,0,0,TRUE,0,2021,2021-2022
CT,2021-11-30,inter-ui,103,14,8,6,8,0,2,6,6,10,78,241,181,195,TRUE,0.75103734439834,2021,2021-2022
CT,2021-11-30,intra-total,1994,287,183,122,72,74,101,125,186,403,1139,4686,3133,3420,TRUE,0.668587281263338,2021,2021-2022
CT,2021-11-30,intra-ucfe,5,1,1,0,1,1,1,1,0,2,7,20,12,13,TRUE,0.6,2021,2021-2022
CT,2021-11-30,intra-ucx,4,3,0,0,0,0,1,0,0,1,2,11,6,9,TRUE,0.545454545454545,2021,2021-2022
CT,2021-11-30,intra-ui,1985,283,182,122,71,73,99,124,186,400,1130,4655,3115,3398,TRUE,0.669172932330827,2021,2021-2022
CT,2021-12-31,inter-total,131,15,11,7,6,4,7,4,3,6,94,288,225,240,TRUE,0.78125,2021,2021-2022
CT,2021-12-31,inter-ucfe,0,0,0,0,0,0,0,0,0,0,0,0,0,0,TRUE,0,2021,2021-2022
CT,2021-12-31,inter-ucx,0,0,0,0,0,0,0,0,0,1,0,1,0,0,TRUE,0,2021,2021-2022
CT,2021-12-31,inter-ui,131,15,11,7,6,4,7,4,3,5,94,287,225,240,TRUE,0.78397212543554,2021,2021-2022
CT,2021-12-31,intra-total,4884,414,243,169,163,171,149,94,52,238,1481,8058,6365,6779,TRUE,0.789898237776123,2021,2021-2022
CT,2021-12-31,intra-ucfe,1,1,0,0,0,1,0,0,0,1,3,7,4,5,TRUE,0.571428571428571,2021,2021-2022
CT,2021-12-31,intra-ucx,2,3,1,0,1,0,0,0,0,1,4,12,6,9,TRUE,0.5,2021,2021-2022
CT,2021-12-31,intra-ui,4881,410,242,169,162,170,149,94,52,236,1474,8039,6355,6765,TRUE,0.79052120910561,2021,2021-2022
CT,2022-01-31,inter-total,194,30,9,11,5,0,3,2,0,5,96,355,290,320,TRUE,0.816901408450704,2021,2021-2022
CT,2022-01-31,inter-ucfe,0,0,0,0,0,0,0,0,0,0,0,0,0,0,TRUE,0,2021,2021-2022
CT,2022-01-31,inter-ucx,0,0,0,0,0,0,0,0,0,0,0,0,0,0,TRUE,0,2021,2021-2022
CT,2022-01-31,inter-ui,194,30,9,11,5,0,3,2,0,5,96,355,290,320,TRUE,0.816901408450704,2021,2021-2022
CT,2022-01-31,intra-total,8378,836,411,289,125,75,43,27,22,155,3099,13460,11477,12313,TRUE,0.852674591381872,2021,2021-2022
CT,2022-01-31,intra-ucfe,2,5,1,1,0,0,0,0,0,2,2,13,4,9,TRUE,0.307692307692308,2021,2021-2022
CT,2022-01-31,intra-ucx,6,5,2,1,0,0,0,0,0,0,1,15,7,12,TRUE,0.466666666666667,2021,2021-2022
CT,2022-01-31,intra-ui,8370,826,408,287,125,75,43,27,22,153,3096,13432,11466,12292,TRUE,0.853633114949375,2021,2021-2022
CT,2022-02-28,inter-total,87,23,18,11,6,4,3,0,2,0,68,222,155,178,TRUE,0.698198198198198,2021,2021-2022
CT,2022-02-28,inter-ucfe,0,0,0,0,0,0,0,0,0,0,0,0,0,0,TRUE,0,2021,2021-2022
CT,2022-02-28,inter-ucx,0,0,0,0,0,0,0,0,0,0,0,0,0,0,TRUE,0,2021,2021-2022
CT,2022-02-28,inter-ui,87,23,18,11,6,4,3,0,2,0,68,222,155,178,TRUE,0.698198198198198,2021,2021-2022
CT,2022-02-28,intra-total,2881,525,466,360,178,104,61,26,22,140,1778,6541,4659,5184,TRUE,0.712276410334811,2021,2021-2022
CT,2022-02-28,intra-ucfe,3,3,1,1,2,1,1,0,0,2,1,15,4,7,TRUE,0.266666666666667,2021,2021-2022
CT,2022-02-28,intra-ucx,4,3,0,1,1,1,0,0,0,0,2,12,6,9,TRUE,0.5,2021,2021-2022
CT,2022-02-28,intra-ui,2874,519,465,358,175,102,60,26,22,138,1775,6514,4649,5168,TRUE,0.713693583051888,2021,2021-2022
CT,2022-03-31,inter-total,69,20,11,6,5,0,4,3,0,3,43,164,112,132,TRUE,0.682926829268293,2021,2021-2022
CT,2022-03-31,inter-ucfe,0,0,1,0,1,0,0,0,0,0,0,2,0,0,TRUE,0,2021,2021-2022
CT,2022-03-31,inter-ucx,0,0,0,0,0,0,0,0,0,0,0,0,0,0,TRUE,0,2021,2021-2022
CT,2022-03-31,inter-ui,69,20,10,6,4,0,4,3,0,3,43,162,112,132,TRUE,0.691358024691358,2021,2021-2022
CT,2022-03-31,intra-total,2209,519,393,223,110,79,66,66,54,196,1452,5367,3661,4180,TRUE,0.682131544624558,2021,2021-2022
CT,2022-03-31,intra-ucfe,5,1,1,1,0,1,0,1,1,2,1,14,6,7,TRUE,0.428571428571429,2021,2021-2022
CT,2022-03-31,intra-ucx,1,3,0,0,1,0,0,0,0,0,7,12,8,11,TRUE,0.666666666666667,2021,2021-2022
CT,2022-03-31,intra-ui,2203,515,392,222,109,78,66,65,53,194,1444,5341,3647,4162,TRUE,0.682830930537353,2021,2021-2022
CT,2022-04-30,inter-total,66,9,6,3,4,2,3,0,1,10,29,133,95,104,TRUE,0.714285714285714,2021,2021-2022
CT,2022-04-30,inter-ucfe,0,0,0,0,0,0,0,0,0,0,0,0,0,0,TRUE,0,2021,2021-2022
CT,2022-04-30,inter-ucx,0,0,0,0,0,0,0,0,0,0,0,0,0,0,TRUE,0,2021,2021-2022
CT,2022-04-30,inter-ui,66,9,6,3,4,2,3,0,1,10,29,133,95,104,TRUE,0.714285714285714,2021,2021-2022
CT,2022-04-30,intra-total,2571,480,272,107,61,30,18,18,19,166,1270,5012,3841,4321,TRUE,0.766360734237829,2021,2021-2022
CT,2022-04-30,intra-ucfe,5,1,0,0,1,0,0,1,1,0,2,11,7,8,TRUE,0.636363636363636,2021,2021-2022
CT,2022-04-30,intra-ucx,4,6,0,0,0,0,0,0,0,0,6,16,10,16,TRUE,0.625,2021,2021-2022
CT,2022-04-30,intra-ui,2562,473,272,107,60,30,18,17,18,166,1262,4985,3824,4297,TRUE,0.767101303911735,2021,2021-2022
CT,2022-05-31,inter-total,72,14,14,8,2,1,3,0,0,3,43,160,115,129,TRUE,0.71875,2021,2021-2022
CT,2022-05-31,inter-ucfe,1,0,0,0,0,0,0,0,0,0,0,1,1,1,TRUE,1,2021,2021-2022
CT,2022-05-31,inter-ucx,0,0,0,0,0,0,0,0,0,0,0,0,0,0,TRUE,0,2021,2021-2022
CT,2022-05-31,inter-ui,71,14,14,8,2,1,3,0,0,3,43,159,114,128,TRUE,0.716981132075472,2021,2021-2022
CT,2022-05-31,intra-total,1782,427,340,196,71,46,29,23,17,110,1150,4191,2932,3359,TRUE,0.699594368885708,2021,2021-2022
CT,2022-05-31,intra-ucfe,5,1,2,1,2,0,2,1,0,1,3,18,8,9,TRUE,0.444444444444444,2021,2021-2022
CT,2022-05-31,intra-ucx,3,0,1,0,1,0,0,0,0,0,5,10,8,8,TRUE,0.8,2021,2021-2022
CT,2022-05-31,intra-ui,1774,426,337,195,68,46,27,22,17,109,1142,4163,2916,3342,TRUE,0.700456401633438,2021,2021-2022
CT,2022-06-30,inter-total,67,20,13,8,4,3,2,1,0,3,81,202,148,168,TRUE,0.732673267326733,2021,2021-2022
CT,2022-06-30,inter-ucfe,0,0,0,0,0,0,0,0,0,0,1,1,1,1,TRUE,1,2021,2021-2022
CT,2022-06-30,inter-ucx,0,0,0,0,0,0,0,0,0,0,0,0,0,0,TRUE,0,2021,2021-2022
CT,2022-06-30,inter-ui,67,20,13,8,4,3,2,1,0,3,80,201,147,167,TRUE,0.73134328358209,2021,2021-2022
CT,2022-06-30,intra-total,2310,410,335,199,85,59,30,19,14,98,1265,4824,3575,3985,TRUE,0.741086235489221,2021,2021-2022
CT,2022-06-30,intra-ucfe,1,1,1,1,0,1,0,0,0,1,3,9,4,5,TRUE,0.444444444444444,2021,2021-2022
CT,2022-06-30,intra-ucx,5,1,0,0,1,0,1,0,0,1,2,11,7,8,TRUE,0.636363636363636,2021,2021-2022
CT,2022-06-30,intra-ui,2304,408,334,198,84,58,29,19,14,96,1260,4804,3564,3972,TRUE,0.74188176519567,2021,2021-2022
CT,2022-07-31,inter-total,11,27,9,7,2,3,2,2,2,5,60,130,71,98,TRUE,0.546153846153846,2022,2022-2023
CT,2022-07-31,inter-ucfe,0,1,0,0,0,0,0,0,0,0,0,1,0,1,TRUE,0,2022,2022-2023
CT,2022-07-31,inter-ucx,0,0,0,0,0,0,0,0,0,0,0,0,0,0,TRUE,0,2022,2022-2023
CT,2022-07-31,inter-ui,11,26,9,7,2,3,2,2,2,5,60,129,71,97,TRUE,0.550387596899225,2022,2022-2023
CT,2022-07-31,intra-total,736,1207,667,317,175,80,50,14,13,129,2816,6204,3552,4759,TRUE,0.572533849129594,2022,2022-2023
CT,2022-07-31,intra-ucfe,0,1,0,1,0,0,0,1,0,3,1,7,1,2,TRUE,0.142857142857143,2022,2022-2023
CT,2022-07-31,intra-ucx,0,0,1,0,0,0,0,0,0,0,0,1,0,0,TRUE,0,2022,2022-2023
CT,2022-07-31,intra-ui,736,1206,666,316,175,80,50,13,13,126,2815,6196,3551,4757,TRUE,0.573111684958037,2022,2022-2023
CT,2022-08-31,inter-total,11,30,7,14,3,8,3,1,1,10,65,153,76,106,TRUE,0.496732026143791,2022,2022-2023
CT,2022-08-31,inter-ucfe,0,0,0,0,0,0,0,0,0,0,0,0,0,0,TRUE,0,2022,2022-2023
CT,2022-08-31,inter-ucx,0,0,0,0,0,0,0,0,0,0,0,0,0,0,TRUE,0,2022,2022-2023
CT,2022-08-31,inter-ui,11,30,7,14,3,8,3,1,1,10,65,153,76,106,TRUE,0.496732026143791,2022,2022-2023
CT,2022-08-31,intra-total,788,797,671,604,421,254,150,68,41,133,1559,5486,2347,3144,TRUE,0.427816259569814,2022,2022-2023
CT,2022-08-31,intra-ucfe,0,1,0,0,0,0,0,0,0,2,0,3,0,1,TRUE,0,2022,2022-2023
CT,2022-08-31,intra-ucx,1,1,0,0,1,0,0,0,1,1,1,6,2,3,TRUE,0.333333333333333,2022,2022-2023
CT,2022-08-31,intra-ui,787,795,671,604,420,254,150,68,40,130,1558,5477,2345,3140,TRUE,0.428154098959284,2022,2022-2023
CT,2022-09-30,inter-total,6,14,8,5,3,3,4,11,6,15,18,93,24,38,TRUE,0.258064516129032,2022,2022-2023
CT,2022-09-30,inter-ucfe,0,0,0,0,0,0,0,0,0,1,0,1,0,0,TRUE,0,2022,2022-2023
CT,2022-09-30,inter-ucx,0,0,0,0,0,0,0,0,0,0,0,0,0,0,TRUE,0,2022,2022-2023
CT,2022-09-30,inter-ui,6,14,8,5,3,3,4,11,6,14,18,92,24,38,TRUE,0.260869565217391,2022,2022-2023
CT,2022-09-30,intra-total,281,474,262,280,285,303,201,175,148,369,870,3648,1151,1625,TRUE,0.315515350877193,2022,2022-2023
CT,2022-09-30,intra-ucfe,0,1,1,1,1,1,0,0,2,2,1,10,1,2,TRUE,0.1,2022,2022-2023
CT,2022-09-30,intra-ucx,0,2,1,1,1,2,1,1,0,1,1,11,1,3,TRUE,0.0909090909090909,2022,2022-2023
CT,2022-09-30,intra-ui,281,471,260,278,283,300,200,174,146,366,868,3627,1149,1620,TRUE,0.316790736145575,2022,2022-2023
CT,2022-10-31,inter-total,10,12,7,8,5,2,7,6,3,21,20,101,30,42,TRUE,0.297029702970297,2022,2022-2023
CT,2022-10-31,inter-ucfe,0,0,0,0,0,0,0,0,0,1,0,1,0,0,TRUE,0,2022,2022-2023
CT,2022-10-31,inter-ucx,0,0,0,0,0,0,0,0,0,0,0,0,0,0,TRUE,0,2022,2022-2023
CT,2022-10-31,inter-ui,10,12,7,8,5,2,7,6,3,20,20,100,30,42,TRUE,0.3,2022,2022-2023
CT,2022-10-31,intra-total,273,409,231,201,186,207,162,133,102,385,725,3014,998,1407,TRUE,0.331121433311214,2022,2022-2023
CT,2022-10-31,intra-ucfe,0,0,1,0,0,1,2,0,0,7,0,11,0,0,TRUE,0,2022,2022-2023
CT,2022-10-31,intra-ucx,0,3,0,2,0,1,0,1,0,1,1,9,1,4,TRUE,0.111111111111111,2022,2022-2023
CT,2022-10-31,intra-ui,273,406,230,199,186,205,160,132,102,377,724,2994,997,1403,TRUE,0.332999331997328,2022,2022-2023
CT,2022-11-30,inter-total,17,17,9,6,5,11,2,5,0,17,46,135,63,80,TRUE,0.466666666666667,2022,2022-2023
CT,2022-11-30,inter-ucfe,0,0,0,0,0,0,0,0,0,0,0,0,0,0,TRUE,0,2022,2022-2023
CT,2022-11-30,inter-ucx,0,0,0,0,0,0,0,0,0,0,0,0,0,0,TRUE,0,2022,2022-2023
CT,2022-11-30,inter-ui,17,17,9,6,5,11,2,5,0,17,46,135,63,80,TRUE,0.466666666666667,2022,2022-2023
CT,2022-11-30,intra-total,502,512,292,271,250,191,169,123,111,424,1077,3922,1579,2091,TRUE,0.402600713921469,2022,2022-2023
CT,2022-11-30,intra-ucfe,0,1,0,0,0,2,0,1,0,3,0,7,0,1,TRUE,0,2022,2022-2023
CT,2022-11-30,intra-ucx,2,0,0,0,0,0,0,0,0,3,1,6,3,3,TRUE,0.5,2022,2022-2023
CT,2022-11-30,intra-ui,500,511,292,271,250,189,169,122,111,418,1076,3909,1576,2087,TRUE,0.403172166794577,2022,2022-2023
CT,2022-12-31,inter-total,17,20,21,14,11,7,8,4,2,16,42,162,59,79,TRUE,0.364197530864198,2022,2022-2023
CT,2022-12-31,inter-ucfe,0,0,0,0,0,0,0,0,0,0,0,0,0,0,TRUE,0,2022,2022-2023
CT,2022-12-31,inter-ucx,0,0,0,0,0,0,0,0,0,1,0,1,0,0,TRUE,0,2022,2022-2023
CT,2022-12-31,inter-ui,17,20,21,14,11,7,8,4,2,15,42,161,59,79,TRUE,0.366459627329193,2022,2022-2023
CT,2022-12-31,intra-total,984,848,406,312,331,265,218,144,122,475,2029,6134,3013,3861,TRUE,0.491196609064232,2022,2022-2023
CT,2022-12-31,intra-ucfe,0,0,0,0,0,0,0,0,0,0,0,0,0,0,TRUE,0,2022,2022-2023
CT,2022-12-31,intra-ucx,1,1,0,1,0,1,1,0,0,1,0,6,1,2,TRUE,0.166666666666667,2022,2022-2023
CT,2022-12-31,intra-ui,983,847,406,311,331,264,217,144,122,474,2029,6128,3012,3859,TRUE,0.491514360313316,2022,2022-2023
CT,2023-01-31,inter-total,31,34,21,13,21,14,7,7,2,15,52,217,83,117,TRUE,0.382488479262673,2022,2022-2023
CT,2023-01-31,inter-ucfe,0,0,0,0,0,0,0,0,0,0,0,0,0,0,TRUE,0,2022,2022-2023
CT,2023-01-31,inter-ucx,0,0,0,0,0,0,0,0,0,0,0,0,0,0,TRUE,0,2022,2022-2023
CT,2023-01-31,inter-ui,31,34,21,13,21,14,7,7,2,15,52,217,83,117,TRUE,0.382488479262673,2022,2022-2023
CT,2023-01-31,intra-total,1785,2152,1038,596,395,278,194,136,90,447,4440,11551,6225,8377,TRUE,0.538914379707385,2022,2022-2023
CT,2023-01-31,intra-ucfe,0,0,0,0,1,0,0,0,0,2,0,3,0,0,TRUE,0,2022,2022-2023
CT,2023-01-31,intra-ucx,0,0,0,0,1,1,0,0,0,0,3,5,3,3,TRUE,0.6,2022,2022-2023
CT,2023-01-31,intra-ui,1785,2152,1038,596,393,277,194,136,90,445,4437,11543,6222,8374,TRUE,0.539027982326951,2022,2022-2023
CT,2023-02-28,inter-total,11,34,8,17,11,11,10,10,7,21,56,196,67,101,TRUE,0.341836734693878,2022,2022-2023
CT,2023-02-28,inter-ucfe,0,0,0,0,0,0,0,0,0,0,0,0,0,0,TRUE,0,2022,2022-2023
CT,2023-02-28,inter-ucx,0,0,0,0,0,0,0,0,0,0,0,0,0,0,TRUE,0,2022,2022-2023
CT,2023-02-28,inter-ui,11,34,8,17,11,11,10,10,7,21,56,196,67,101,TRUE,0.341836734693878,2022,2022-2023
CT,2023-02-28,intra-total,676,1264,767,869,583,414,294,172,114,434,2050,7637,2726,3990,TRUE,0.356946444939112,2022,2022-2023
CT,2023-02-28,intra-ucfe,0,0,1,2,0,0,0,0,0,1,0,4,0,0,TRUE,0,2022,2022-2023
CT,2023-02-28,intra-ucx,1,1,0,0,0,1,0,0,0,0,2,5,3,4,TRUE,0.6,2022,2022-2023
CT,2023-02-28,intra-ui,675,1263,766,867,583,413,294,172,114,433,2048,7628,2723,3986,TRUE,0.3569743051914,2022,2022-2023
CT,2023-03-31,inter-total,13,26,15,8,10,11,5,5,3,35,37,168,50,76,TRUE,0.297619047619048,2022,2022-2023
CT,2023-03-31,inter-ucfe,0,0,0,0,0,0,0,0,0,0,0,0,0,0,TRUE,0,2022,2022-2023
CT,2023-03-31,inter-ucx,0,0,0,0,0,0,0,0,0,1,0,1,0,0,TRUE,0,2022,2022-2023
CT,2023-03-31,inter-ui,13,26,15,8,10,11,5,5,3,34,37,167,50,76,TRUE,0.29940119760479,2022,2022-2023
CT,2023-03-31,intra-total,551,1127,645,485,399,289,229,231,162,655,1775,6548,2326,3453,TRUE,0.355222968845449,2022,2022-2023
CT,2023-03-31,intra-ucfe,0,0,0,1,1,0,1,0,0,1,0,4,0,0,TRUE,0,2022,2022-2023
CT,2023-03-31,intra-ucx,2,3,2,0,2,0,0,1,0,2,0,12,2,5,TRUE,0.166666666666667,2022,2022-2023
CT,2023-03-31,intra-ui,549,1124,643,484,396,289,228,230,162,652,1775,6532,2324,3448,TRUE,0.355786895284752,2022,2022-2023
CT,2023-04-30,inter-total,4,26,12,6,5,0,1,5,3,18,34,114,38,64,TRUE,0.333333333333333,2022,2022-2023
CT,2023-04-30,inter-ucfe,0,0,0,0,0,0,0,0,0,0,0,0,0,0,TRUE,0,2022,2022-2023
CT,2023-04-30,inter-ucx,0,0,0,0,0,0,0,0,0,0,0,0,0,0,TRUE,0,2022,2022-2023
CT,2023-04-30,inter-ui,4,26,12,6,5,0,1,5,3,18,34,114,38,64,TRUE,0.333333333333333,2022,2022-2023
CT,2023-04-30,intra-total,669,890,389,233,150,126,91,68,61,418,1722,4817,2391,3281,TRUE,0.496367033423293,2022,2022-2023
CT,2023-04-30,intra-ucfe,0,0,1,0,1,0,0,0,0,1,0,3,0,0,TRUE,0,2022,2022-2023
CT,2023-04-30,intra-ucx,0,1,0,0,0,2,0,0,0,0,0,3,0,1,TRUE,0,2022,2022-2023
CT,2023-04-30,intra-ui,669,889,388,233,149,124,91,68,61,417,1722,4811,2391,3280,TRUE,0.496986073581376,2022,2022-2023
CT,2023-05-31,inter-total,12,20,10,13,11,2,1,2,4,14,36,125,48,68,TRUE,0.384,2022,2022-2023
CT,2023-05-31,inter-ucfe,0,0,0,0,0,0,0,0,0,0,0,0,0,0,TRUE,0,2022,2022-2023
CT,2023-05-31,inter-ucx,0,0,0,0,0,0,0,0,0,0,0,0,0,0,TRUE,0,2022,2022-2023
CT,2023-05-31,inter-ui,12,20,10,13,11,2,1,2,4,14,36,125,48,68,TRUE,0.384,2022,2022-2023
CT,2023-05-31,intra-total,636,1037,446,279,168,97,61,47,32,288,1758,4849,2394,3431,TRUE,0.493710043307899,2022,2022-2023
CT,2023-05-31,intra-ucfe,0,0,0,0,0,0,0,0,0,1,0,1,0,0,TRUE,0,2022,2022-2023
CT,2023-05-31,intra-ucx,0,0,1,0,0,0,0,0,0,3,2,6,2,2,TRUE,0.333333333333333,2022,2022-2023
CT,2023-05-31,intra-ui,636,1037,445,279,168,97,61,47,32,284,1756,4842,2392,3429,TRUE,0.494010739363899,2022,2022-2023
CT,2023-06-30,inter-total,9,25,16,7,7,4,2,0,2,19,33,124,42,67,TRUE,0.338709677419355,2022,2022-2023
CT,2023-06-30,inter-ucfe,0,0,0,0,0,0,0,0,0,0,0,0,0,0,TRUE,0,2022,2022-2023
CT,2023-06-30,inter-ucx,0,0,0,0,0,0,0,0,0,0,0,0,0,0,TRUE,0,2022,2022-2023
CT,2023-06-30,inter-ui,9,25,16,7,7,4,2,0,2,19,33,124,42,67,TRUE,0.338709677419355,2022,2022-2023
CT,2023-06-30,intra-total,1366,907,426,251,160,109,83,76,48,533,1695,5654,3061,3968,TRUE,0.541386628935267,2022,2022-2023
CT,2023-06-30,intra-ucfe,0,1,0,1,1,1,0,1,0,1,1,7,1,2,TRUE,0.142857142857143,2022,2022-2023
CT,2023-06-30,intra-ucx,0,1,1,0,0,0,0,0,0,0,1,3,1,2,TRUE,0.333333333333333,2022,2022-2023
CT,2023-06-30,intra-ui,1366,905,425,250,159,108,83,75,48,532,1693,5644,3059,3964,TRUE,0.541991495393338,2022,2022-2023
CT,2023-07-31,inter-total,15,27,13,9,10,6,5,5,4,5,34,133,49,76,TRUE,0.368421052631579,2023,2023-2024
CT,2023-07-31,inter-ucfe,0,0,0,0,0,0,0,0,0,0,0,0,0,0,TRUE,0,2023,2023-2024
CT,2023-07-31,inter-ucx,0,0,0,0,0,0,0,0,0,0,1,1,1,1,TRUE,1,2023,2023-2024
CT,2023-07-31,inter-ui,15,27,13,9,10,6,5,5,4,5,33,132,48,75,TRUE,0.363636363636364,2023,2023-2024
CT,2023-07-31,intra-total,1489,1610,738,370,174,113,77,46,47,499,2691,7854,4180,5790,TRUE,0.532212885154062,2023,2023-2024
CT,2023-07-31,intra-ucfe,0,1,1,0,2,1,0,0,0,2,0,7,0,1,TRUE,0,2023,2023-2024
CT,2023-07-31,intra-ucx,0,2,0,0,1,0,0,0,0,0,0,3,0,2,TRUE,0,2023,2023-2024
CT,2023-07-31,intra-ui,1489,1607,737,370,171,112,77,46,47,497,2691,7844,4180,5787,TRUE,0.532891381947986,2023,2023-2024
CT,2023-08-31,inter-total,4,29,21,21,5,7,7,2,0,20,43,159,47,76,TRUE,0.29559748427673,2023,2023-2024
CT,2023-08-31,inter-ucfe,0,0,0,0,0,0,0,0,0,0,0,0,0,0,TRUE,0,2023,2023-2024
CT,2023-08-31,inter-ucx,0,0,0,0,0,0,0,0,0,0,0,0,0,0,TRUE,0,2023,2023-2024
CT,2023-08-31,inter-ui,4,29,21,21,5,7,7,2,0,20,43,159,47,76,TRUE,0.29559748427673,2023,2023-2024
CT,2023-08-31,intra-total,1100,1216,638,476,339,203,139,77,48,323,1969,6528,3069,4285,TRUE,0.470128676470588,2023,2023-2024
CT,2023-08-31,intra-ucfe,0,1,0,0,1,2,2,0,0,2,0,8,0,1,TRUE,0,2023,2023-2024
CT,2023-08-31,intra-ucx,0,0,1,1,1,1,1,0,1,0,2,8,2,2,TRUE,0.25,2023,2023-2024
CT,2023-08-31,intra-ui,1100,1215,637,475,337,200,136,77,47,321,1967,6512,3067,4282,TRUE,0.470976658476659,2023,2023-2024
CT,2023-09-30,inter-total,7,21,13,14,9,3,6,4,1,10,24,112,31,52,TRUE,0.276785714285714,2023,2023-2024
CT,2023-09-30,inter-ucfe,0,0,0,0,0,0,0,0,0,0,0,0,0,0,TRUE,0,2023,2023-2024
CT,2023-09-30,inter-ucx,0,0,0,0,0,0,0,0,0,0,0,0,0,0,TRUE,0,2023,2023-2024
CT,2023-09-30,inter-ui,7,21,13,14,9,3,6,4,1,10,24,112,31,52,TRUE,0.276785714285714,2023,2023-2024
CT,2023-09-30,intra-total,391,878,446,272,158,134,80,64,55,236,1357,4071,1748,2626,TRUE,0.429378531073446,2023,2023-2024
CT,2023-09-30,intra-ucfe,0,0,0,0,0,2,1,1,0,0,0,4,0,0,TRUE,0,2023,2023-2024
CT,2023-09-30,intra-ucx,3,1,0,0,0,0,0,0,0,2,1,7,4,5,TRUE,0.571428571428571,2023,2023-2024
CT,2023-09-30,intra-ui,388,877,446,272,158,132,79,63,55,234,1356,4060,1744,2621,TRUE,0.429556650246305,2023,2023-2024
CT,2023-10-31,inter-total,4,31,10,6,4,3,3,4,2,14,42,123,46,77,TRUE,0.373983739837398,2023,2023-2024
CT,2023-10-31,inter-ucfe,0,0,0,1,0,0,0,0,0,0,0,1,0,0,TRUE,0,2023,2023-2024
CT,2023-10-31,inter-ucx,0,0,0,0,0,0,0,0,0,0,0,0,0,0,TRUE,0,2023,2023-2024
CT,2023-10-31,inter-ui,4,31,10,5,4,3,3,4,2,14,42,122,46,77,TRUE,0.377049180327869,2023,2023-2024
CT,2023-10-31,intra-total,399,1058,431,195,148,103,73,55,38,223,1545,4268,1944,3002,TRUE,0.455482661668229,2023,2023-2024
CT,2023-10-31,intra-ucfe,0,1,3,0,0,1,0,0,0,0,0,5,0,1,TRUE,0,2023,2023-2024
CT,2023-10-31,intra-ucx,3,3,0,0,3,0,0,0,0,0,1,10,4,7,TRUE,0.4,2023,2023-2024
CT,2023-10-31,intra-ui,396,1054,428,195,145,102,73,55,38,223,1544,4253,1940,2994,TRUE,0.456148600987538,2023,2023-2024
CT,2023-11-30,inter-total,23,28,16,4,7,4,5,0,2,12,65,166,88,116,TRUE,0.530120481927711,2023,2023-2024
CT,2023-11-30,inter-ucfe,0,0,0,0,0,0,0,0,0,0,0,0,0,0,TRUE,0,2023,2023-2024
CT,2023-11-30,inter-ucx,0,0,0,0,0,0,0,0,0,0,0,0,0,0,TRUE,0,2023,2023-2024
CT,2023-11-30,inter-ui,23,28,16,4,7,4,5,0,2,12,65,166,88,116,TRUE,0.530120481927711,2023,2023-2024
CT,2023-11-30,intra-total,515,1022,430,216,155,87,65,40,28,193,1755,4506,2270,3292,TRUE,0.503772747447847,2023,2023-2024
CT,2023-11-30,intra-ucfe,0,0,0,0,1,0,1,0,0,1,0,3,0,0,TRUE,0,2023,2023-2024
CT,2023-11-30,intra-ucx,0,1,1,0,0,1,0,0,0,1,2,6,2,3,TRUE,0.333333333333333,2023,2023-2024
CT,2023-11-30,intra-ui,515,1021,429,216,154,86,64,40,28,191,1753,4497,2268,3289,TRUE,0.504336224149433,2023,2023-2024
CT,2023-12-31,inter-total,20,32,27,19,7,7,2,2,1,18,40,175,60,92,TRUE,0.342857142857143,2023,2023-2024
CT,2023-12-31,inter-ucfe,0,0,0,0,0,0,0,0,0,0,0,0,0,0,TRUE,0,2023,2023-2024
CT,2023-12-31,inter-ucx,0,0,0,0,0,0,0,0,0,0,0,0,0,0,TRUE,0,2023,2023-2024
CT,2023-12-31,inter-ui,20,32,27,19,7,7,2,2,1,18,40,175,60,92,TRUE,0.342857142857143,2023,2023-2024
CT,2023-12-31,intra-total,961,1149,466,278,177,103,65,41,40,213,2205,5698,3166,4315,TRUE,0.555633555633556,2023,2023-2024
CT,2023-12-31,intra-ucfe,1,0,0,1,0,0,0,0,0,1,0,3,1,1,TRUE,0.333333333333333,2023,2023-2024
CT,2023-12-31,intra-ucx,0,0,0,0,0,0,0,1,0,1,0,2,0,0,TRUE,0,2023,2023-2024
CT,2023-12-31,intra-ui,960,1149,466,277,177,103,65,40,40,211,2205,5693,3165,4314,TRUE,0.555945898471808,2023,2023-2024
CT,2024-01-31,inter-total,33,37,21,14,12,7,8,5,3,15,65,220,98,135,TRUE,0.445454545454545,2023,2023-2024
CT,2024-01-31,inter-ucfe,0,0,0,0,0,0,0,0,0,0,0,0,0,0,TRUE,0,2023,2023-2024
CT,2024-01-31,inter-ucx,0,0,0,0,0,0,0,0,0,0,0,0,0,0,TRUE,0,2023,2023-2024
CT,2024-01-31,inter-ui,33,37,21,14,12,7,8,5,3,15,65,220,98,135,TRUE,0.445454545454545,2023,2023-2024
CT,2024-01-31,intra-total,2122,2326,1066,590,305,170,117,72,49,273,5067,12157,7189,9515,TRUE,0.591346549313153,2023,2023-2024
CT,2024-01-31,intra-ucfe,0,1,1,0,1,0,0,1,0,2,1,7,1,2,TRUE,0.142857142857143,2023,2023-2024
CT,2024-01-31,intra-ucx,2,0,1,0,0,0,0,0,0,0,1,4,3,3,TRUE,0.75,2023,2023-2024
CT,2024-01-31,intra-ui,2120,2325,1064,590,304,170,117,71,49,271,5065,12146,7185,9510,TRUE,0.591552774575992,2023,2023-2024
CT,2024-02-29,inter-total,17,26,32,16,12,14,7,6,4,20,26,180,43,69,TRUE,0.238888888888889,2023,2023-2024
CT,2024-02-29,inter-ucfe,0,0,0,0,0,1,0,0,0,0,0,1,0,0,TRUE,0,2023,2023-2024
CT,2024-02-29,inter-ucx,0,0,0,0,0,0,0,0,0,0,0,0,0,0,TRUE,0,2023,2023-2024
CT,2024-02-29,inter-ui,17,26,32,16,12,13,7,6,4,20,26,179,43,69,TRUE,0.240223463687151,2023,2023-2024
CT,2024-02-29,intra-total,836,1389,841,663,586,329,212,152,52,301,2131,7492,2967,4356,TRUE,0.396022423918847,2023,2023-2024
CT,2024-02-29,intra-ucfe,0,1,0,1,1,0,1,0,0,2,0,6,0,1,TRUE,0,2023,2023-2024
CT,2024-02-29,intra-ucx,0,1,0,0,2,0,0,0,0,0,1,4,1,2,TRUE,0.25,2023,2023-2024
CT,2024-02-29,intra-ui,836,1387,841,662,583,329,211,152,52,299,2130,7482,2966,4353,TRUE,0.39641807003475,2023,2023-2024
CT,2024-03-31,inter-total,12,19,11,14,13,6,5,5,3,18,31,137,43,62,TRUE,0.313868613138686,2023,2023-2024
CT,2024-03-31,inter-ucfe,0,0,0,0,0,0,0,0,0,0,0,0,0,0,TRUE,0,2023,2023-2024
CT,2024-03-31,inter-ucx,0,0,0,0,0,0,0,0,0,0,0,0,0,0,TRUE,0,2023,2023-2024
CT,2024-03-31,inter-ui,12,19,11,14,13,6,5,5,3,18,31,137,43,62,TRUE,0.313868613138686,2023,2023-2024
CT,2024-03-31,intra-total,560,1040,621,368,238,183,172,132,118,393,1627,5452,2187,3227,TRUE,0.401137197358767,2023,2023-2024
CT,2024-03-31,intra-ucfe,0,0,0,0,0,0,0,1,0,1,0,2,0,0,TRUE,0,2023,2023-2024
CT,2024-03-31,intra-ucx,3,0,0,0,1,0,0,0,0,1,0,5,3,3,TRUE,0.6,2023,2023-2024
CT,2024-03-31,intra-ui,557,1040,621,368,237,183,172,131,118,391,1627,5445,2184,3224,TRUE,0.401101928374656,2023,2023-2024
CT,2024-04-30,inter-total,11,26,12,8,11,7,1,1,4,14,25,120,36,62,TRUE,0.3,2023,2023-2024
CT,2024-04-30,inter-ucfe,0,0,0,0,0,0,0,0,0,0,0,0,0,0,TRUE,0,2023,2023-2024
CT,2024-04-30,inter-ucx,0,0,0,0,0,0,0,0,0,0,0,0,0,0,TRUE,0,2023,2023-2024
CT,2024-04-30,inter-ui,11,26,12,8,11,7,1,1,4,14,25,120,36,62,TRUE,0.3,2023,2023-2024
CT,2024-04-30,intra-total,782,1077,446,279,163,117,83,68,39,359,1889,5302,2671,3748,TRUE,0.50377216144851,2023,2023-2024
CT,2024-04-30,intra-ucfe,0,2,1,0,1,0,1,0,0,1,0,6,0,2,TRUE,0,2023,2023-2024
CT,2024-04-30,intra-ucx,2,1,0,0,0,0,0,0,0,1,0,4,2,3,TRUE,0.5,2023,2023-2024
CT,2024-04-30,intra-ui,780,1074,445,279,162,117,82,68,39,357,1889,5292,2669,3743,TRUE,0.504346182917612,2023,2023-2024
CT,2024-05-31,inter-total,20,16,15,7,1,5,3,0,1,15,46,129,66,82,TRUE,0.511627906976744,2023,2023-2024
CT,2024-05-31,inter-ucfe,0,0,0,0,0,0,0,0,0,1,0,1,0,0,TRUE,0,2023,2023-2024
CT,2024-05-31,inter-ucx,0,0,0,0,0,0,0,0,0,0,0,0,0,0,TRUE,0,2023,2023-2024
CT,2024-05-31,inter-ui,20,16,15,7,1,5,3,0,1,14,46,128,66,82,TRUE,0.515625,2023,2023-2024
CT,2024-05-31,intra-total,736,1016,456,252,144,106,51,38,27,287,1840,4953,2576,3592,TRUE,0.520088835049465,2023,2023-2024
CT,2024-05-31,intra-ucfe,0,1,1,1,0,1,0,0,0,1,1,6,1,2,TRUE,0.166666666666667,2023,2023-2024
CT,2024-05-31,intra-ucx,0,0,0,1,0,0,0,0,0,1,0,2,0,0,TRUE,0,2023,2023-2024
CT,2024-05-31,intra-ui,736,1015,455,250,144,105,51,38,27,285,1839,4945,2575,3590,TRUE,0.520728008088979,2023,2023-2024
CT,2024-06-30,inter-total,16,27,20,5,5,1,4,2,0,7,48,135,64,91,TRUE,0.474074074074074,2023,2023-2024
CT,2024-06-30,inter-ucfe,0,0,0,0,0,0,0,0,0,0,0,0,0,0,TRUE,0,2023,2023-2024
CT,2024-06-30,inter-ucx,0,0,0,0,0,0,0,0,0,0,0,0,0,0,TRUE,0,2023,2023-2024
CT,2024-06-30,inter-ui,16,27,20,5,5,1,4,2,0,7,48,135,64,91,TRUE,0.474074074074074,2023,2023-2024
CT,2024-06-30,intra-total,1312,903,370,193,108,77,69,46,35,217,1558,4888,2870,3773,TRUE,0.587152209492635,2023,2023-2024
CT,2024-06-30,intra-ucfe,0,2,0,0,1,1,0,0,0,0,0,4,0,2,TRUE,0,2023,2023-2024
CT,2024-06-30,intra-ucx,0,0,0,0,0,1,1,0,0,1,0,3,0,0,TRUE,0,2023,2023-2024
CT,2024-06-30,intra-ui,1312,901,370,193,107,75,68,46,35,216,1558,4881,2870,3771,TRUE,0.5879942634706,2023,2023-2024
CT,2024-07-31,inter-total,10,26,18,12,9,6,4,1,2,14,51,153,61,87,TRUE,0.398692810457516,2024,2024-2025
CT,2024-07-31,inter-ucfe,0,0,0,0,0,0,0,0,0,0,0,0,0,0,TRUE,0,2024,2024-2025
CT,2024-07-31,inter-ucx,0,0,0,0,0,0,0,0,0,0,0,0,0,0,TRUE,0,2024,2024-2025
CT,2024-07-31,inter-ui,10,26,18,12,9,6,4,1,2,14,51,153,61,87,TRUE,0.398692810457516,2024,2024-2025
CT,2024-07-31,intra-total,1850,1506,792,472,204,107,59,45,35,250,2921,8241,4771,6277,TRUE,0.578934595316102,2024,2024-2025
CT,2024-07-31,intra-ucfe,0,0,0,1,0,1,1,0,0,3,0,6,0,0,TRUE,0,2024,2024-2025
CT,2024-07-31,intra-ucx,1,1,0,0,1,1,0,0,1,1,0,6,1,2,TRUE,0.166666666666667,2024,2024-2025
CT,2024-07-31,intra-ui,1849,1505,792,471,203,105,58,45,34,246,2921,8229,4770,6275,TRUE,0.579657309515129,2024,2024-2025
CT,2024-08-31,inter-total,29,39,17,18,11,7,6,3,3,12,71,216,100,139,TRUE,0.462962962962963,2024,2024-2025
CT,2024-08-31,inter-ucfe,0,0,0,0,0,0,0,0,0,0,0,0,0,0,TRUE,0,2024,2024-2025
CT,2024-08-31,inter-ucx,0,0,0,0,0,0,0,0,0,0,0,0,0,0,TRUE,0,2024,2024-2025
CT,2024-08-31,inter-ui,29,39,17,18,11,7,6,3,3,12,71,216,100,139,TRUE,0.462962962962963,2024,2024-2025
CT,2024-08-31,intra-total,1118,1034,676,432,342,209,128,70,54,212,1737,6012,2855,3889,TRUE,0.474883566200932,2024,2024-2025
CT,2024-08-31,intra-ucfe,0,0,0,0,1,2,0,0,0,2,0,5,0,0,TRUE,0,2024,2024-2025
CT,2024-08-31,intra-ucx,0,0,0,1,1,0,0,0,0,0,0,2,0,0,TRUE,0,2024,2024-2025
CT,2024-08-31,intra-ui,1118,1034,676,431,340,207,128,70,54,210,1737,6005,2855,3889,TRUE,0.475437135720233,2024,2024-2025
CT,2024-09-30,inter-total,21,35,16,11,8,7,4,2,0,9,60,173,81,116,TRUE,0.468208092485549,2024,2024-2025
CT,2024-09-30,inter-ucfe,0,0,0,0,0,0,0,0,0,0,0,0,0,0,TRUE,0,2024,2024-2025
CT,2024-09-30,inter-ucx,0,0,0,0,0,0,0,0,0,0,0,0,0,0,TRUE,0,2024,2024-2025
CT,2024-09-30,inter-ui,21,35,16,11,8,7,4,2,0,9,60,173,81,116,TRUE,0.468208092485549,2024,2024-2025
CT,2024-09-30,intra-total,408,895,490,324,186,119,78,63,59,191,1193,4006,1601,2496,TRUE,0.399650524213679,2024,2024-2025
CT,2024-09-30,intra-ucfe,0,0,0,0,1,0,0,0,1,0,1,3,1,1,TRUE,0.333333333333333,2024,2024-2025
CT,2024-09-30,intra-ucx,0,1,0,0,0,1,1,1,0,0,0,4,0,1,TRUE,0,2024,2024-2025
CT,2024-09-30,intra-ui,408,894,490,324,185,118,77,62,58,191,1192,3999,1600,2494,TRUE,0.400100025006252,2024,2024-2025
CT,2024-10-31,inter-total,62,46,21,11,15,4,3,6,3,13,100,284,162,208,TRUE,0.570422535211268,2024,2024-2025
CT,2024-10-31,inter-ucfe,0,0,0,0,0,0,0,0,0,0,0,0,0,0,TRUE,0,2024,2024-2025
CT,2024-10-31,inter-ucx,0,0,0,0,0,0,0,0,0,0,0,0,0,0,TRUE,0,2024,2024-2025
CT,2024-10-31,inter-ui,62,46,21,11,15,4,3,6,3,13,100,284,162,208,TRUE,0.570422535211268,2024,2024-2025
CT,2024-10-31,intra-total,522,883,391,203,133,74,56,37,44,198,1640,4181,2162,3045,TRUE,0.517101171968429,2024,2024-2025
CT,2024-10-31,intra-ucfe,0,1,2,1,1,0,0,0,0,1,1,7,1,2,TRUE,0.142857142857143,2024,2024-2025
CT,2024-10-31,intra-ucx,2,2,2,0,0,0,0,0,0,0,1,7,3,5,TRUE,0.428571428571429,2024,2024-2025
CT,2024-10-31,intra-ui,520,880,387,202,132,74,56,37,44,197,1638,4167,2158,3038,TRUE,0.517878569714423,2024,2024-2025
CT,2024-11-30,inter-total,78,57,21,12,8,7,1,2,2,19,115,322,193,250,TRUE,0.599378881987578,2024,2024-2025
CT,2024-11-30,inter-ucfe,0,1,0,0,0,0,0,0,0,0,0,1,0,1,TRUE,0,2024,2024-2025
CT,2024-11-30,inter-ucx,0,0,0,0,0,0,0,0,0,0,0,0,0,0,TRUE,0,2024,2024-2025
CT,2024-11-30,inter-ui,78,56,21,12,8,7,1,2,2,19,115,321,193,249,TRUE,0.601246105919003,2024,2024-2025
CT,2024-11-30,intra-total,586,870,324,136,76,56,42,32,23,158,1555,3858,2141,3011,TRUE,0.554950751684811,2024,2024-2025
CT,2024-11-30,intra-ucfe,0,3,0,1,0,0,0,0,0,1,1,6,1,4,TRUE,0.166666666666667,2024,2024-2025
CT,2024-11-30,intra-ucx,0,1,0,0,0,0,0,0,0,0,1,2,1,2,TRUE,0.5,2024,2024-2025
CT,2024-11-30,intra-ui,586,866,324,135,76,56,42,32,23,157,1553,3850,2139,3005,TRUE,0.555584415584416,2024,2024-2025
CT,2024-12-31,inter-total,90,52,29,25,10,9,7,3,3,14,159,401,249,301,TRUE,0.620947630922693,2024,2024-2025
CT,2024-12-31,inter-ucfe,0,0,0,0,0,0,0,0,0,0,0,0,0,0,TRUE,0,2024,2024-2025
CT,2024-12-31,inter-ucx,0,0,0,0,0,0,0,0,0,1,0,1,0,0,TRUE,0,2024,2024-2025
CT,2024-12-31,inter-ui,90,52,29,25,10,9,7,3,3,13,159,400,249,301,TRUE,0.6225,2024,2024-2025
CT,2024-12-31,intra-total,1671,1176,446,237,117,69,40,36,23,178,2709,6702,4380,5556,TRUE,0.653536257833483,2024,2024-2025
CT,2024-12-31,intra-ucfe,0,1,1,3,0,1,0,0,0,1,0,7,0,1,TRUE,0,2024,2024-2025
CT,2024-12-31,intra-ucx,0,1,1,0,0,0,0,0,0,1,1,4,1,2,TRUE,0.25,2024,2024-2025
CT,2024-12-31,intra-ui,1671,1174,444,234,117,68,40,36,23,176,2708,6691,4379,5553,TRUE,0.654461216559558,2024,2024-2025
DC,2019-01-31,inter-total,498,48,17,5,3,2,4,3,0,2,292,874,790,838,FALSE,0.958810068649886,2018,2018-2019
DC,2019-01-31,inter-ucfe,212,25,4,0,0,0,1,0,0,0,200,442,412,437,FALSE,0.98868778280543,2018,2018-2019
DC,2019-01-31,inter-ucx,0,0,0,0,0,0,0,0,0,0,0,0,0,0,FALSE,0,2018,2018-2019
DC,2019-01-31,inter-ui,286,23,13,5,3,2,3,3,0,2,92,432,378,401,FALSE,0.928240740740741,2018,2018-2019
DC,2019-01-31,intra-total,2853,215,28,14,5,7,2,5,0,7,1524,4660,4377,4592,FALSE,0.985407725321888,2018,2018-2019
DC,2019-01-31,intra-ucfe,967,106,6,1,1,0,0,0,0,0,875,1956,1842,1948,FALSE,0.995910020449898,2018,2018-2019
DC,2019-01-31,intra-ucx,1,0,0,0,0,0,0,0,0,0,0,1,1,1,FALSE,1,2018,2018-2019
DC,2019-01-31,intra-ui,1885,109,22,13,4,7,2,5,0,7,649,2703,2534,2643,FALSE,0.977802441731409,2018,2018-2019
DC,2019-02-28,inter-total,173,35,18,9,14,2,3,1,2,2,88,347,261,296,FALSE,0.853025936599424,2018,2018-2019
DC,2019-02-28,inter-ucfe,11,2,7,4,7,2,0,0,1,0,8,42,19,21,FALSE,0.5,2018,2018-2019
DC,2019-02-28,inter-ucx,0,0,0,0,0,0,0,0,0,0,0,0,0,0,FALSE,0,2018,2018-2019
DC,2019-02-28,inter-ui,162,33,11,5,7,0,3,1,1,2,80,305,242,275,FALSE,0.901639344262295,2018,2018-2019
DC,2019-02-28,intra-total,640,173,79,72,55,19,5,7,1,5,522,1578,1162,1335,FALSE,0.846007604562738,2018,2018-2019
DC,2019-02-28,intra-ucfe,19,19,26,27,31,5,2,2,0,0,37,168,56,75,FALSE,0.446428571428571,2018,2018-2019
DC,2019-02-28,intra-ucx,0,0,0,0,0,0,0,0,0,0,0,0,0,0,FALSE,0,2018,2018-2019
DC,2019-02-28,intra-ui,621,154,53,45,24,14,3,5,1,5,485,1410,1106,1260,FALSE,0.893617021276596,2018,2018-2019
DC,2019-03-31,inter-total,137,11,7,4,10,6,1,6,3,5,42,232,179,190,FALSE,0.818965517241379,2018,2018-2019
DC,2019-03-31,inter-ucfe,9,2,1,0,1,1,0,0,1,0,6,21,15,17,FALSE,0.80952380952381,2018,2018-2019
DC,2019-03-31,inter-ucx,0,0,0,0,0,0,0,0,0,0,0,0,0,0,FALSE,0,2018,2018-2019
DC,2019-03-31,inter-ui,128,9,6,4,9,5,1,6,2,5,36,211,164,173,FALSE,0.819905213270142,2018,2018-2019
DC,2019-03-31,intra-total,542,33,21,18,21,15,12,7,3,7,370,1049,912,945,FALSE,0.900857959961868,2018,2018-2019
DC,2019-03-31,intra-ucfe,29,5,1,2,4,6,6,3,1,1,17,75,46,51,FALSE,0.68,2018,2018-2019
DC,2019-03-31,intra-ucx,3,0,0,0,0,0,0,0,0,0,1,4,4,4,FALSE,1,2018,2018-2019
DC,2019-03-31,intra-ui,510,28,20,16,17,9,6,4,2,6,352,970,862,890,FALSE,0.917525773195876,2018,2018-2019
DC,2019-04-30,inter-total,166,7,3,1,3,2,3,3,0,5,64,257,230,237,FALSE,0.922178988326848,2018,2018-2019
DC,2019-04-30,inter-ucfe,13,0,0,0,0,0,0,0,0,0,6,19,19,19,FALSE,1,2018,2018-2019
DC,2019-04-30,inter-ucx,0,0,0,0,0,0,0,0,0,0,1,1,1,1,FALSE,1,2018,2018-2019
DC,2019-04-30,inter-ui,153,7,3,1,3,2,3,3,0,5,57,237,210,217,FALSE,0.915611814345992,2018,2018-2019
DC,2019-04-30,intra-total,694,19,7,6,8,4,8,7,5,10,364,1132,1058,1077,FALSE,0.951413427561837,2018,2018-2019
DC,2019-04-30,intra-ucfe,23,2,1,0,0,1,1,2,0,0,15,45,38,40,FALSE,0.888888888888889,2018,2018-2019
DC,2019-04-30,intra-ucx,1,0,0,0,0,0,0,0,0,0,0,1,1,1,FALSE,1,2018,2018-2019
DC,2019-04-30,intra-ui,670,17,6,6,8,3,7,5,5,10,349,1086,1019,1036,FALSE,0.953959484346225,2018,2018-2019
DC,2019-05-31,inter-total,144,7,1,3,4,5,0,2,0,7,60,233,204,211,FALSE,0.905579399141631,2018,2018-2019
DC,2019-05-31,inter-ucfe,4,1,0,1,0,0,0,2,0,1,5,14,9,10,FALSE,0.714285714285714,2018,2018-2019
DC,2019-05-31,inter-ucx,0,0,0,0,0,0,0,0,0,0,0,0,0,0,FALSE,0,2018,2018-2019
DC,2019-05-31,inter-ui,140,6,1,2,4,5,0,0,0,6,55,219,195,201,FALSE,0.917808219178082,2018,2018-2019
DC,2019-05-31,intra-total,686,17,6,8,3,7,6,7,4,8,357,1109,1043,1060,FALSE,0.955816050495942,2018,2018-2019
DC,2019-05-31,intra-ucfe,21,1,2,0,1,0,1,2,0,2,14,44,35,36,FALSE,0.818181818181818,2018,2018-2019
DC,2019-05-31,intra-ucx,0,0,0,0,0,0,0,0,0,0,0,0,0,0,FALSE,0,2018,2018-2019
DC,2019-05-31,intra-ui,665,16,4,8,2,7,5,5,4,6,343,1065,1008,1024,FALSE,0.96150234741784,2018,2018-2019
DC,2019-06-30,inter-total,143,6,3,2,2,3,0,1,0,9,69,238,212,218,FALSE,0.915966386554622,2018,2018-2019
DC,2019-06-30,inter-ucfe,6,1,0,0,0,0,0,0,0,1,4,12,10,11,FALSE,0.916666666666667,2018,2018-2019
DC,2019-06-30,inter-ucx,0,0,0,0,0,0,0,0,0,0,0,0,0,0,FALSE,0,2018,2018-2019
DC,2019-06-30,inter-ui,137,5,3,2,2,3,0,1,0,8,65,226,202,207,FALSE,0.915929203539823,2018,2018-2019
DC,2019-06-30,intra-total,803,13,5,5,6,2,5,5,7,6,303,1160,1106,1119,FALSE,0.964655172413793,2018,2018-2019
DC,2019-06-30,intra-ucfe,18,1,0,0,1,0,0,1,0,0,11,32,29,30,FALSE,0.9375,2018,2018-2019
DC,2019-06-30,intra-ucx,0,0,0,0,0,0,0,0,0,0,0,0,0,0,FALSE,0,2018,2018-2019
DC,2019-06-30,intra-ui,785,12,5,5,5,2,5,4,7,6,292,1128,1077,1089,FALSE,0.965425531914894,2018,2018-2019
DC,2019-07-31,inter-total,193,4,2,3,1,2,2,1,2,4,50,264,243,247,FALSE,0.935606060606061,2019,2019-2020
DC,2019-07-31,inter-ucfe,6,0,0,0,0,0,0,0,0,1,5,12,11,11,FALSE,0.916666666666667,2019,2019-2020
DC,2019-07-31,inter-ucx,0,0,0,0,0,0,0,0,0,0,0,0,0,0,FALSE,0,2019,2019-2020
DC,2019-07-31,inter-ui,187,4,2,3,1,2,2,1,2,3,45,252,232,236,FALSE,0.936507936507937,2019,2019-2020
DC,2019-07-31,intra-total,1407,19,6,5,2,9,4,2,3,2,419,1878,1826,1845,FALSE,0.982428115015975,2019,2019-2020
DC,2019-07-31,intra-ucfe,8,0,0,1,0,1,0,0,0,0,18,28,26,26,FALSE,0.928571428571429,2019,2019-2020
DC,2019-07-31,intra-ucx,1,0,0,0,0,0,0,0,0,0,0,1,1,1,FALSE,1,2019,2019-2020
DC,2019-07-31,intra-ui,1398,19,6,4,2,8,4,2,3,2,401,1849,1799,1818,FALSE,0.983234180638183,2019,2019-2020
DC,2019-08-31,inter-total,138,5,5,2,4,3,2,3,0,6,53,221,191,196,FALSE,0.886877828054299,2019,2019-2020
DC,2019-08-31,inter-ucfe,3,3,2,0,0,0,1,0,0,0,5,14,8,11,FALSE,0.785714285714286,2019,2019-2020
DC,2019-08-31,inter-ucx,0,0,0,0,0,0,0,0,0,0,0,0,0,0,FALSE,0,2019,2019-2020
DC,2019-08-31,inter-ui,135,2,3,2,4,3,1,3,0,6,48,207,183,185,FALSE,0.893719806763285,2019,2019-2020
DC,2019-08-31,intra-total,953,21,8,9,10,8,9,5,4,4,392,1423,1345,1366,FALSE,0.959943780744905,2019,2019-2020
DC,2019-08-31,intra-ucfe,13,0,2,1,1,1,2,0,0,1,18,39,31,31,FALSE,0.794871794871795,2019,2019-2020
DC,2019-08-31,intra-ucx,1,0,0,0,0,0,0,0,0,0,0,1,1,1,FALSE,1,2019,2019-2020
DC,2019-08-31,intra-ui,939,21,6,8,9,7,7,5,4,3,374,1383,1313,1334,FALSE,0.964569775849602,2019,2019-2020
DC,2019-09-30,inter-total,137,3,4,2,4,4,3,4,1,3,44,209,181,184,FALSE,0.880382775119617,2019,2019-2020
DC,2019-09-30,inter-ucfe,7,0,0,0,0,1,0,0,0,0,2,10,9,9,FALSE,0.9,2019,2019-2020
DC,2019-09-30,inter-ucx,1,0,0,0,0,0,0,0,0,0,0,1,1,1,FALSE,1,2019,2019-2020
DC,2019-09-30,inter-ui,129,3,4,2,4,3,3,4,1,3,42,198,171,174,FALSE,0.878787878787879,2019,2019-2020
DC,2019-09-30,intra-total,605,19,4,3,5,11,8,2,3,8,339,1007,944,963,FALSE,0.95630585898709,2019,2019-2020
DC,2019-09-30,intra-ucfe,16,2,0,0,0,1,0,0,0,1,13,33,29,31,FALSE,0.939393939393939,2019,2019-2020
DC,2019-09-30,intra-ucx,1,0,0,0,0,0,0,0,0,0,1,2,2,2,FALSE,1,2019,2019-2020
DC,2019-09-30,intra-ui,588,17,4,3,5,10,8,2,3,7,325,972,913,930,FALSE,0.95679012345679,2019,2019-2020
DC,2019-10-31,inter-total,142,8,2,3,2,2,2,2,0,7,41,211,183,191,FALSE,0.90521327014218,2019,2019-2020
DC,2019-10-31,inter-ucfe,5,0,0,1,0,0,0,0,0,1,6,13,11,11,FALSE,0.846153846153846,2019,2019-2020
DC,2019-10-31,inter-ucx,0,0,0,0,0,0,0,0,0,0,0,0,0,0,FALSE,0,2019,2019-2020
DC,2019-10-31,inter-ui,137,8,2,2,2,2,2,2,0,6,35,198,172,180,FALSE,0.909090909090909,2019,2019-2020
DC,2019-10-31,intra-total,788,17,4,0,5,7,9,1,4,5,403,1243,1191,1208,FALSE,0.97184231697506,2019,2019-2020
DC,2019-10-31,intra-ucfe,14,4,0,0,0,1,1,0,0,0,21,41,35,39,FALSE,0.951219512195122,2019,2019-2020
DC,2019-10-31,intra-ucx,2,0,0,0,0,0,0,0,0,0,1,3,3,3,FALSE,1,2019,2019-2020
DC,2019-10-31,intra-ui,772,13,4,0,5,6,8,1,4,5,381,1199,1153,1166,FALSE,0.972477064220184,2019,2019-2020
DC,2019-11-30,inter-total,91,2,1,2,2,1,2,0,1,5,39,146,130,132,FALSE,0.904109589041096,2019,2019-2020
DC,2019-11-30,inter-ucfe,6,1,0,0,0,0,0,0,0,0,2,9,8,9,FALSE,1,2019,2019-2020
DC,2019-11-30,inter-ucx,0,0,0,0,0,0,0,0,0,0,0,0,0,0,FALSE,0,2019,2019-2020
DC,2019-11-30,inter-ui,85,1,1,2,2,1,2,0,1,5,37,137,122,123,FALSE,0.897810218978102,2019,2019-2020
DC,2019-11-30,intra-total,739,19,6,7,9,4,4,0,1,7,416,1212,1155,1174,FALSE,0.968646864686469,2019,2019-2020
DC,2019-11-30,intra-ucfe,11,2,0,0,0,0,0,0,0,2,10,25,21,23,FALSE,0.92,2019,2019-2020
DC,2019-11-30,intra-ucx,0,0,0,0,0,0,0,0,0,0,0,0,0,0,FALSE,0,2019,2019-2020
DC,2019-11-30,intra-ui,728,17,6,7,9,4,4,0,1,5,406,1187,1134,1151,FALSE,0.969671440606571,2019,2019-2020
DC,2019-12-31,inter-total,89,3,1,4,1,0,1,1,0,2,41,143,130,133,FALSE,0.93006993006993,2019,2019-2020
DC,2019-12-31,inter-ucfe,5,0,0,0,0,0,0,0,0,1,0,6,5,5,FALSE,0.833333333333333,2019,2019-2020
DC,2019-12-31,inter-ucx,0,0,0,0,0,0,0,0,0,0,0,0,0,0,FALSE,0,2019,2019-2020
DC,2019-12-31,inter-ui,84,3,1,4,1,0,1,1,0,1,41,137,125,128,FALSE,0.934306569343066,2019,2019-2020
DC,2019-12-31,intra-total,978,27,5,11,5,8,1,3,1,8,461,1508,1439,1466,FALSE,0.972148541114058,2019,2019-2020
DC,2019-12-31,intra-ucfe,14,3,0,0,0,0,0,0,0,0,8,25,22,25,FALSE,1,2019,2019-2020
DC,2019-12-31,intra-ucx,2,0,0,0,0,0,0,0,0,0,0,2,2,2,FALSE,1,2019,2019-2020
DC,2019-12-31,intra-ui,962,24,5,11,5,8,1,3,1,8,453,1481,1415,1439,FALSE,0.971640783254558,2019,2019-2020
DC,2020-01-31,inter-total,74,5,3,1,0,2,1,1,0,5,27,119,101,106,FALSE,0.890756302521008,2019,2019-2020
DC,2020-01-31,inter-ucfe,0,0,0,0,0,0,0,0,0,0,2,2,2,2,FALSE,1,2019,2019-2020
DC,2020-01-31,inter-ucx,0,0,0,0,0,0,0,0,0,0,0,0,0,0,FALSE,0,2019,2019-2020
DC,2020-01-31,inter-ui,74,5,3,1,0,2,1,1,0,5,25,117,99,104,FALSE,0.888888888888889,2019,2019-2020
DC,2020-01-31,intra-total,950,39,10,6,8,10,12,4,6,7,419,1471,1369,1408,FALSE,0.957171991842284,2019,2019-2020
DC,2020-01-31,intra-ucfe,14,1,2,1,0,1,0,0,0,0,11,30,25,26,FALSE,0.866666666666667,2019,2019-2020
DC,2020-01-31,intra-ucx,1,0,0,0,0,0,0,0,0,0,0,1,1,1,FALSE,1,2019,2019-2020
DC,2020-01-31,intra-ui,935,38,8,5,8,9,12,4,6,7,408,1440,1343,1381,FALSE,0.959027777777778,2019,2019-2020
DC,2020-02-29,inter-total,58,5,0,1,0,2,0,1,0,0,47,114,105,110,FALSE,0.964912280701754,2019,2019-2020
DC,2020-02-29,inter-ucfe,1,0,0,0,0,0,0,1,0,0,3,5,4,4,FALSE,0.8,2019,2019-2020
DC,2020-02-29,inter-ucx,0,0,0,0,0,0,0,0,0,0,0,0,0,0,FALSE,0,2019,2019-2020
DC,2020-02-29,inter-ui,57,5,0,1,0,2,0,0,0,0,44,109,101,106,FALSE,0.972477064220184,2019,2019-2020
DC,2020-02-29,intra-total,746,27,4,7,7,10,12,4,7,8,462,1294,1208,1235,FALSE,0.954404945904173,2019,2019-2020
DC,2020-02-29,intra-ucfe,17,0,0,0,0,1,0,0,1,0,15,34,32,32,FALSE,0.941176470588235,2019,2019-2020
DC,2020-02-29,intra-ucx,0,0,0,0,0,0,0,0,0,0,0,0,0,0,FALSE,0,2019,2019-2020
DC,2020-02-29,intra-ui,729,27,4,7,7,9,12,4,6,8,447,1260,1176,1203,FALSE,0.954761904761905,2019,2019-2020
DC,2020-03-31,inter-total,170,1,1,1,0,0,2,1,0,1,38,215,208,209,FALSE,0.972093023255814,2019,2019-2020
DC,2020-03-31,inter-ucfe,1,1,0,0,0,0,0,0,0,0,1,3,2,3,FALSE,1,2019,2019-2020
DC,2020-03-31,inter-ucx,0,0,0,0,0,0,0,0,0,0,0,0,0,0,FALSE,0,2019,2019-2020
DC,2020-03-31,inter-ui,169,0,1,1,0,0,2,1,0,1,37,212,206,206,FALSE,0.971698113207547,2019,2019-2020
DC,2020-03-31,intra-total,2375,31,8,6,4,19,5,5,4,3,475,2935,2850,2881,FALSE,0.98160136286201,2019,2019-2020
DC,2020-03-31,intra-ucfe,13,0,0,0,0,0,0,0,2,0,10,25,23,23,FALSE,0.92,2019,2019-2020
DC,2020-03-31,intra-ucx,2,0,0,0,0,0,0,0,0,0,0,2,2,2,FALSE,1,2019,2019-2020
DC,2020-03-31,intra-ui,2360,31,8,6,4,19,5,5,2,3,465,2908,2825,2856,FALSE,0.982118294360385,2019,2019-2020
DC,2020-04-30,inter-total,1320,728,472,93,14,2,0,0,0,0,980,3609,2300,3028,FALSE,0.839013577168191,2019,2019-2020
DC,2020-04-30,inter-ucfe,8,5,2,1,0,1,0,0,0,0,10,27,18,23,FALSE,0.851851851851852,2019,2019-2020
DC,2020-04-30,inter-ucx,0,0,0,0,0,0,0,0,0,0,0,0,0,0,FALSE,0,2019,2019-2020
DC,2020-04-30,inter-ui,1312,723,470,92,14,1,0,0,0,0,970,3582,2282,3005,FALSE,0.83891680625349,2019,2019-2020
DC,2020-04-30,intra-total,13101,7368,5355,1010,120,8,7,2,0,11,10002,36984,23103,30471,FALSE,0.823896820246593,2019,2019-2020
DC,2020-04-30,intra-ucfe,72,42,23,4,3,1,0,0,0,0,67,212,139,181,FALSE,0.85377358490566,2019,2019-2020
DC,2020-04-30,intra-ucx,0,1,0,0,0,0,0,0,0,0,0,1,0,1,FALSE,1,2019,2019-2020
DC,2020-04-30,intra-ui,13029,7325,5332,1006,117,7,7,2,0,11,9935,36771,22964,30289,FALSE,0.823719779173806,2019,2019-2020
DC,2020-05-31,inter-total,347,184,179,123,71,48,28,10,0,2,243,1235,590,774,FALSE,0.626720647773279,2019,2019-2020
DC,2020-05-31,inter-ucfe,3,8,8,6,2,1,6,0,0,0,2,36,5,13,FALSE,0.361111111111111,2019,2019-2020
DC,2020-05-31,inter-ucx,0,0,0,0,0,0,0,0,0,0,0,0,0,0,FALSE,0,2019,2019-2020
DC,2020-05-31,inter-ui,344,176,171,117,69,47,22,10,0,2,241,1199,585,761,FALSE,0.634695579649708,2019,2019-2020
DC,2020-05-31,intra-total,4041,1932,1562,1118,670,411,202,119,31,17,2466,12569,6507,8439,FALSE,0.671413795846925,2019,2019-2020
DC,2020-05-31,intra-ucfe,16,70,38,29,32,11,12,4,1,2,20,235,36,106,FALSE,0.451063829787234,2019,2019-2020
DC,2020-05-31,intra-ucx,2,0,1,0,1,0,0,0,0,0,1,5,3,3,FALSE,0.6,2019,2019-2020
DC,2020-05-31,intra-ui,4023,1862,1523,1089,637,400,190,115,30,15,2445,12329,6468,8330,FALSE,0.675642793413902,2019,2019-2020
DC,2020-06-30,inter-total,168,61,38,65,60,35,41,32,16,23,98,637,266,327,FALSE,0.513343799058085,2019,2019-2020
DC,2020-06-30,inter-ucfe,1,3,0,1,3,1,4,4,1,1,1,20,2,5,FALSE,0.25,2019,2019-2020
DC,2020-06-30,inter-ucx,0,0,0,0,0,0,0,0,0,0,0,0,0,0,FALSE,0,2019,2019-2020
DC,2020-06-30,inter-ui,167,58,38,64,57,34,37,28,15,22,97,617,264,322,FALSE,0.521880064829822,2019,2019-2020
DC,2020-06-30,intra-total,2523,569,507,580,587,459,337,215,139,219,1170,7305,3693,4262,FALSE,0.583436002737851,2019,2019-2020
DC,2020-06-30,intra-ucfe,14,10,18,9,6,9,11,5,4,11,3,100,17,27,FALSE,0.27,2019,2019-2020
DC,2020-06-30,intra-ucx,0,0,0,0,0,0,0,0,0,0,0,0,0,0,FALSE,0,2019,2019-2020
DC,2020-06-30,intra-ui,2509,559,489,571,581,450,326,210,135,208,1167,7205,3676,4235,FALSE,0.587786259541985,2019,2019-2020
DC,2020-07-31,inter-total,121,36,29,25,18,35,24,36,22,79,67,492,188,224,FALSE,0.455284552845528,2020,2020-2021
DC,2020-07-31,inter-ucfe,3,3,2,0,2,0,1,1,0,1,1,14,4,7,FALSE,0.5,2020,2020-2021
DC,2020-07-31,inter-ucx,0,0,0,0,0,1,0,0,0,0,0,1,0,0,FALSE,0,2020,2020-2021
DC,2020-07-31,inter-ui,118,33,27,25,16,34,23,35,22,78,66,477,184,217,FALSE,0.454926624737946,2020,2020-2021
DC,2020-07-31,intra-total,1762,442,291,257,213,215,259,256,254,630,831,5410,2593,3035,FALSE,0.560998151571165,2020,2020-2021
DC,2020-07-31,intra-ucfe,6,31,10,2,1,4,6,0,2,15,4,81,10,41,FALSE,0.506172839506173,2020,2020-2021
DC,2020-07-31,intra-ucx,0,0,0,0,0,0,0,0,0,0,0,0,0,0,FALSE,0,2020,2020-2021
DC,2020-07-31,intra-ui,1756,411,281,255,212,211,253,256,252,615,827,5329,2583,2994,FALSE,0.561831488084068,2020,2020-2021
DC,2020-08-31,inter-total,59,31,19,19,105,27,22,17,15,98,28,440,87,118,FALSE,0.268181818181818,2020,2020-2021
DC,2020-08-31,inter-ucfe,0,2,2,3,3,0,1,0,0,5,1,17,1,3,FALSE,0.176470588235294,2020,2020-2021
DC,2020-08-31,inter-ucx,0,0,0,0,0,0,0,0,0,0,0,0,0,0,FALSE,0,2020,2020-2021
DC,2020-08-31,inter-ui,59,29,17,16,102,27,21,17,15,93,27,423,86,115,FALSE,0.271867612293144,2020,2020-2021
DC,2020-08-31,intra-total,919,254,164,226,201,197,149,148,131,873,440,3702,1359,1613,FALSE,0.435710426796326,2020,2020-2021
DC,2020-08-31,intra-ucfe,7,7,9,11,5,7,1,2,4,7,8,68,15,22,FALSE,0.323529411764706,2020,2020-2021
DC,2020-08-31,intra-ucx,0,0,0,0,0,0,0,0,0,0,0,0,0,0,FALSE,0,2020,2020-2021
DC,2020-08-31,intra-ui,912,247,155,215,196,190,148,146,127,866,432,3634,1344,1591,FALSE,0.437809576224546,2020,2020-2021
DC,2020-09-30,inter-total,54,13,11,9,8,9,14,18,8,156,30,330,84,97,FALSE,0.293939393939394,2020,2020-2021
DC,2020-09-30,inter-ucfe,2,0,0,3,0,0,1,0,0,7,0,13,2,2,FALSE,0.153846153846154,2020,2020-2021
DC,2020-09-30,inter-ucx,0,0,0,0,0,0,0,0,0,0,0,0,0,0,FALSE,0,2020,2020-2021
DC,2020-09-30,inter-ui,52,13,11,6,8,9,13,18,8,149,30,317,82,95,FALSE,0.299684542586751,2020,2020-2021
DC,2020-09-30,intra-total,750,199,115,75,108,107,134,99,114,1321,303,3325,1053,1252,FALSE,0.376541353383459,2020,2020-2021
DC,2020-09-30,intra-ucfe,5,1,1,5,6,6,3,6,5,28,3,69,8,9,FALSE,0.130434782608696,2020,2020-2021
DC,2020-09-30,intra-ucx,1,0,1,0,0,0,0,0,1,1,0,4,1,1,FALSE,0.25,2020,2020-2021
DC,2020-09-30,intra-ui,744,198,113,70,102,101,131,93,108,1292,300,3252,1044,1242,FALSE,0.381918819188192,2020,2020-2021
DC,2020-10-31,inter-total,65,17,8,5,11,8,9,4,4,82,33,246,98,115,FALSE,0.467479674796748,2020,2020-2021
DC,2020-10-31,inter-ucfe,1,0,0,0,0,0,1,2,0,4,1,9,2,2,FALSE,0.222222222222222,2020,2020-2021
DC,2020-10-31,inter-ucx,0,0,0,0,0,0,0,0,0,0,0,0,0,0,FALSE,0,2020,2020-2021
DC,2020-10-31,inter-ui,64,17,8,5,11,8,8,2,4,78,32,237,96,113,FALSE,0.476793248945148,2020,2020-2021
DC,2020-10-31,intra-total,694,193,112,96,91,78,67,67,59,1032,318,2807,1012,1205,FALSE,0.429283933024581,2020,2020-2021
DC,2020-10-31,intra-ucfe,6,3,0,4,3,3,1,3,1,22,7,53,13,16,FALSE,0.30188679245283,2020,2020-2021
DC,2020-10-31,intra-ucx,1,0,0,0,1,0,0,0,0,2,0,4,1,1,FALSE,0.25,2020,2020-2021
DC,2020-10-31,intra-ui,687,190,112,92,87,75,66,64,58,1008,311,2750,998,1188,FALSE,0.432,2020,2020-2021
DC,2020-11-30,inter-total,32,12,6,8,4,4,1,3,3,66,33,172,65,77,FALSE,0.447674418604651,2020,2020-2021
DC,2020-11-30,inter-ucfe,0,0,1,0,0,0,0,0,0,1,1,3,1,1,FALSE,0.333333333333333,2020,2020-2021
DC,2020-11-30,inter-ucx,0,0,0,0,0,0,0,0,0,0,0,0,0,0,FALSE,0,2020,2020-2021
DC,2020-11-30,inter-ui,32,12,5,8,4,4,1,3,3,65,32,169,64,76,FALSE,0.449704142011834,2020,2020-2021
DC,2020-11-30,intra-total,479,160,98,71,66,42,50,40,38,763,237,2044,716,876,FALSE,0.428571428571429,2020,2020-2021
DC,2020-11-30,intra-ucfe,6,4,2,5,3,1,7,1,1,7,6,43,12,16,FALSE,0.372093023255814,2020,2020-2021
DC,2020-11-30,intra-ucx,1,0,0,0,0,0,0,0,0,0,0,1,1,1,FALSE,1,2020,2020-2021
DC,2020-11-30,intra-ui,472,156,96,66,63,41,43,39,37,756,231,2000,703,859,FALSE,0.4295,2020,2020-2021
DC,2020-12-31,inter-total,48,17,6,4,9,3,7,4,5,62,33,198,81,98,FALSE,0.494949494949495,2020,2020-2021
DC,2020-12-31,inter-ucfe,0,0,0,0,0,1,0,0,1,1,0,3,0,0,FALSE,0,2020,2020-2021
DC,2020-12-31,inter-ucx,0,0,0,0,0,0,0,0,0,0,0,0,0,0,FALSE,0,2020,2020-2021
DC,2020-12-31,inter-ui,48,17,6,4,9,2,7,4,4,61,33,195,81,98,FALSE,0.502564102564103,2020,2020-2021
DC,2020-12-31,intra-total,634,152,86,64,72,54,51,33,41,577,219,1983,853,1005,FALSE,0.506807866868381,2020,2020-2021
DC,2020-12-31,intra-ucfe,4,2,3,10,5,6,1,0,4,16,2,53,6,8,FALSE,0.150943396226415,2020,2020-2021
DC,2020-12-31,intra-ucx,1,0,0,0,0,0,0,0,0,0,0,1,1,1,FALSE,1,2020,2020-2021
DC,2020-12-31,intra-ui,629,150,83,54,67,48,50,33,37,561,217,1929,846,996,FALSE,0.516329704510109,2020,2020-2021
DC,2021-01-31,inter-total,52,14,12,6,5,6,3,2,0,87,24,211,76,90,FALSE,0.42654028436019,2020,2020-2021
DC,2021-01-31,inter-ucfe,0,0,1,2,0,1,0,0,0,0,0,4,0,0,FALSE,0,2020,2020-2021
DC,2021-01-31,inter-ucx,0,0,0,0,0,0,0,0,0,0,0,0,0,0,FALSE,0,2020,2020-2021
DC,2021-01-31,inter-ui,52,14,11,4,5,5,3,2,0,87,24,207,76,90,FALSE,0.434782608695652,2020,2020-2021
DC,2021-01-31,intra-total,615,163,96,71,51,45,33,14,25,754,289,2156,904,1067,FALSE,0.494897959183674,2020,2020-2021
DC,2021-01-31,intra-ucfe,4,3,6,2,2,6,1,0,1,11,2,38,6,9,FALSE,0.236842105263158,2020,2020-2021
DC,2021-01-31,intra-ucx,1,1,0,0,1,1,0,0,0,0,0,4,1,2,FALSE,0.5,2020,2020-2021
DC,2021-01-31,intra-ui,610,159,90,69,48,38,32,14,24,743,287,2114,897,1056,FALSE,0.499526963103122,2020,2020-2021
DC,2021-02-28,inter-total,42,10,17,16,4,5,7,7,5,112,27,252,69,79,FALSE,0.313492063492064,2020,2020-2021
DC,2021-02-28,inter-ucfe,2,3,12,10,1,0,1,1,0,5,4,39,6,9,FALSE,0.230769230769231,2020,2020-2021
DC,2021-02-28,inter-ucx,0,0,0,0,0,0,0,0,0,0,0,0,0,0,FALSE,0,2020,2020-2021
DC,2021-02-28,inter-ui,40,7,5,6,3,5,6,6,5,107,23,213,63,70,FALSE,0.328638497652582,2020,2020-2021
DC,2021-02-28,intra-total,497,134,157,112,65,54,55,57,46,1056,224,2457,721,855,FALSE,0.347985347985348,2020,2020-2021
DC,2021-02-28,intra-ucfe,10,12,71,54,9,6,2,1,2,27,23,217,33,45,FALSE,0.207373271889401,2020,2020-2021
DC,2021-02-28,intra-ucx,0,0,0,0,0,0,0,0,0,1,1,2,1,1,FALSE,0.5,2020,2020-2021
DC,2021-02-28,intra-ui,487,122,86,58,56,48,53,56,44,1028,200,2238,687,809,FALSE,0.361483467381591,2020,2020-2021
DC,2021-03-31,inter-total,48,21,11,22,20,9,10,15,3,104,28,291,76,97,FALSE,0.333333333333333,2020,2020-2021
DC,2021-03-31,inter-ucfe,1,7,8,20,13,5,5,1,1,2,4,67,5,12,FALSE,0.17910447761194,2020,2020-2021
DC,2021-03-31,inter-ucx,0,0,0,0,0,0,0,0,0,0,0,0,0,0,FALSE,0,2020,2020-2021
DC,2021-03-31,inter-ui,47,14,3,2,7,4,5,14,2,102,24,224,71,85,FALSE,0.379464285714286,2020,2020-2021
DC,2021-03-31,intra-total,804,163,116,166,132,95,67,67,49,864,250,2773,1054,1217,FALSE,0.4388748647674,2020,2020-2021
DC,2021-03-31,intra-ucfe,8,37,42,108,91,43,18,11,2,17,15,392,23,60,FALSE,0.153061224489796,2020,2020-2021
DC,2021-03-31,intra-ucx,0,0,0,0,0,0,1,0,0,0,0,1,0,0,FALSE,0,2020,2020-2021
DC,2021-03-31,intra-ui,796,126,74,58,41,52,48,56,47,847,235,2380,1031,1157,FALSE,0.486134453781513,2020,2020-2021
DC,2021-04-30,inter-total,70,15,9,12,10,8,5,6,3,59,17,214,87,102,FALSE,0.476635514018692,2020,2020-2021
DC,2021-04-30,inter-ucfe,3,1,2,3,3,4,2,0,1,10,3,32,6,7,FALSE,0.21875,2020,2020-2021
DC,2021-04-30,inter-ucx,0,0,0,0,0,0,0,0,0,0,0,0,0,0,FALSE,0,2020,2020-2021
DC,2021-04-30,inter-ui,67,14,7,9,7,4,3,6,2,49,14,182,81,95,FALSE,0.521978021978022,2020,2020-2021
DC,2021-04-30,intra-total,1972,251,121,95,64,38,61,37,46,639,399,3723,2371,2622,FALSE,0.704270749395649,2020,2020-2021
DC,2021-04-30,intra-ucfe,11,15,7,13,11,9,16,6,12,45,18,163,29,44,FALSE,0.269938650306748,2020,2020-2021
DC,2021-04-30,intra-ucx,0,0,0,0,0,0,0,0,0,0,0,0,0,0,FALSE,0,2020,2020-2021
DC,2021-04-30,intra-ui,1961,236,114,82,53,29,45,31,34,594,381,3560,2342,2578,FALSE,0.724157303370787,2020,2020-2021
DC,2021-05-31,inter-total,74,19,10,9,10,9,9,6,9,53,21,229,95,114,FALSE,0.497816593886463,2020,2020-2021
DC,2021-05-31,inter-ucfe,0,2,0,1,0,2,0,2,3,6,2,18,2,4,FALSE,0.222222222222222,2020,2020-2021
DC,2021-05-31,inter-ucx,0,0,0,0,0,0,0,0,0,0,0,0,0,0,FALSE,0,2020,2020-2021
DC,2021-05-31,inter-ui,74,17,10,8,10,7,9,4,6,47,19,211,93,110,FALSE,0.52132701421801,2020,2020-2021
DC,2021-05-31,intra-total,1040,248,180,149,137,118,89,88,64,418,322,2853,1362,1610,FALSE,0.564318261479145,2020,2020-2021
DC,2021-05-31,intra-ucfe,16,13,6,3,2,4,4,5,6,41,6,106,22,35,FALSE,0.330188679245283,2020,2020-2021
DC,2021-05-31,intra-ucx,1,0,0,0,1,0,0,0,0,0,0,2,1,1,FALSE,0.5,2020,2020-2021
DC,2021-05-31,intra-ui,1023,235,174,146,134,114,85,83,58,377,316,2745,1339,1574,FALSE,0.573406193078324,2020,2020-2021
DC,2021-06-30,inter-total,102,12,11,4,7,2,5,4,4,31,35,217,137,149,FALSE,0.686635944700461,2020,2020-2021
DC,2021-06-30,inter-ucfe,0,0,1,1,1,0,0,0,0,2,6,11,6,6,FALSE,0.545454545454545,2020,2020-2021
DC,2021-06-30,inter-ucx,0,0,0,0,0,0,0,0,0,0,0,0,0,0,FALSE,0,2020,2020-2021
DC,2021-06-30,inter-ui,102,12,10,3,6,2,5,4,4,29,29,206,131,143,FALSE,0.694174757281553,2020,2020-2021
DC,2021-06-30,intra-total,1082,292,126,81,58,51,66,54,55,377,336,2578,1418,1710,FALSE,0.663304887509697,2020,2020-2021
DC,2021-06-30,intra-ucfe,11,6,2,5,1,2,2,0,1,30,5,65,16,22,FALSE,0.338461538461539,2020,2020-2021
DC,2021-06-30,intra-ucx,0,0,0,0,0,0,0,0,0,0,0,0,0,0,FALSE,0,2020,2020-2021
DC,2021-06-30,intra-ui,1071,286,124,76,57,49,64,54,54,347,331,2513,1402,1688,FALSE,0.671707122960605,2020,2020-2021
DC,2021-07-31,inter-total,101,8,12,3,1,4,3,1,2,20,23,178,124,132,FALSE,0.741573033707865,2021,2021-2022
DC,2021-07-31,inter-ucfe,3,0,1,0,0,0,0,0,0,4,1,9,4,4,FALSE,0.444444444444444,2021,2021-2022
DC,2021-07-31,inter-ucx,0,0,0,0,0,0,0,0,0,0,0,0,0,0,FALSE,0,2021,2021-2022
DC,2021-07-31,inter-ui,98,8,11,3,1,4,3,1,2,16,22,169,120,128,FALSE,0.757396449704142,2021,2021-2022
DC,2021-07-31,intra-total,757,172,112,54,36,44,28,32,24,463,236,1958,993,1165,FALSE,0.594994892747702,2021,2021-2022
DC,2021-07-31,intra-ucfe,7,0,3,0,1,2,2,3,0,17,5,40,12,12,FALSE,0.3,2021,2021-2022
DC,2021-07-31,intra-ucx,0,1,0,0,1,0,0,0,0,0,1,3,1,2,FALSE,0.666666666666667,2021,2021-2022
DC,2021-07-31,intra-ui,750,171,109,54,34,42,26,29,24,446,230,1915,980,1151,FALSE,0.601044386422977,2021,2021-2022
DC,2021-08-31,inter-total,164,10,7,3,3,9,4,4,1,24,20,249,184,194,FALSE,0.779116465863454,2021,2021-2022
DC,2021-08-31,inter-ucfe,1,2,0,0,1,0,1,0,0,3,0,8,1,3,FALSE,0.375,2021,2021-2022
DC,2021-08-31,inter-ucx,0,0,0,0,0,0,0,0,0,0,0,0,0,0,FALSE,0,2021,2021-2022
DC,2021-08-31,inter-ui,163,8,7,3,2,9,3,4,1,21,20,241,183,191,FALSE,0.79253112033195,2021,2021-2022
DC,2021-08-31,intra-total,599,559,141,110,93,108,59,34,25,293,297,2318,896,1455,FALSE,0.627696289905091,2021,2021-2022
DC,2021-08-31,intra-ucfe,3,2,1,3,2,0,2,1,1,20,0,35,3,5,FALSE,0.142857142857143,2021,2021-2022
DC,2021-08-31,intra-ucx,0,0,0,0,0,0,0,0,0,0,0,0,0,0,FALSE,0,2021,2021-2022
DC,2021-08-31,intra-ui,596,557,140,107,91,108,57,33,24,273,297,2283,893,1450,FALSE,0.635129215943934,2021,2021-2022
DC,2021-09-30,inter-total,64,12,5,4,5,3,3,4,1,32,19,152,83,95,FALSE,0.625,2021,2021-2022
DC,2021-09-30,inter-ucfe,0,0,0,0,1,0,1,0,0,2,0,4,0,0,FALSE,0,2021,2021-2022
DC,2021-09-30,inter-ucx,0,0,0,0,0,0,0,0,0,0,0,0,0,0,FALSE,0,2021,2021-2022
DC,2021-09-30,inter-ui,64,12,5,4,4,3,2,4,1,30,19,148,83,95,FALSE,0.641891891891892,2021,2021-2022
DC,2021-09-30,intra-total,301,48,50,38,43,35,33,27,14,257,89,935,390,438,FALSE,0.468449197860963,2021,2021-2022
DC,2021-09-30,intra-ucfe,5,0,0,0,1,0,2,1,0,11,1,21,6,6,FALSE,0.285714285714286,2021,2021-2022
DC,2021-09-30,intra-ucx,0,0,0,0,0,0,0,0,0,0,0,0,0,0,FALSE,0,2021,2021-2022
DC,2021-09-30,intra-ui,296,48,50,38,42,35,31,26,14,246,88,914,384,432,FALSE,0.472647702407002,2021,2021-2022
DC,2021-10-31,inter-total,55,7,1,2,1,0,2,5,2,27,23,125,78,85,FALSE,0.68,2021,2021-2022
DC,2021-10-31,inter-ucfe,1,0,0,0,0,0,0,2,1,5,0,9,1,1,FALSE,0.111111111111111,2021,2021-2022
DC,2021-10-31,inter-ucx,0,0,0,0,0,0,0,0,0,0,0,0,0,0,FALSE,0,2021,2021-2022
DC,2021-10-31,inter-ui,54,7,1,2,1,0,2,3,1,22,23,116,77,84,FALSE,0.724137931034483,2021,2021-2022
DC,2021-10-31,intra-total,642,311,115,44,84,199,115,23,17,217,1155,2922,1797,2108,FALSE,0.721423682409309,2021,2021-2022
DC,2021-10-31,intra-ucfe,5,0,2,0,1,1,0,0,0,8,0,17,5,5,FALSE,0.294117647058824,2021,2021-2022
DC,2021-10-31,intra-ucx,0,0,0,0,0,0,1,0,0,0,0,1,0,0,FALSE,0,2021,2021-2022
DC,2021-10-31,intra-ui,637,311,113,44,83,198,114,23,17,209,1155,2904,1792,2103,FALSE,0.724173553719008,2021,2021-2022
DC,2021-11-30,inter-total,38,3,2,3,0,1,1,1,1,17,4,71,42,45,FALSE,0.633802816901409,2021,2021-2022
DC,2021-11-30,inter-ucfe,0,0,0,0,0,0,0,0,0,2,1,3,1,1,FALSE,0.333333333333333,2021,2021-2022
DC,2021-11-30,inter-ucx,0,0,0,0,0,0,0,0,0,0,0,0,0,0,FALSE,0,2021,2021-2022
DC,2021-11-30,inter-ui,38,3,2,3,0,1,1,1,1,15,3,68,41,44,FALSE,0.647058823529412,2021,2021-2022
DC,2021-11-30,intra-total,1428,35,30,37,23,33,25,21,11,221,161,2025,1589,1624,FALSE,0.801975308641975,2021,2021-2022
DC,2021-11-30,intra-ucfe,2,1,0,0,1,1,0,0,0,8,0,13,2,3,FALSE,0.230769230769231,2021,2021-2022
DC,2021-11-30,intra-ucx,0,0,0,0,0,0,0,0,0,0,0,0,0,0,FALSE,0,2021,2021-2022
DC,2021-11-30,intra-ui,1426,34,30,37,22,32,25,21,11,213,161,2012,1587,1621,FALSE,0.805666003976143,2021,2021-2022
DC,2021-12-31,inter-total,11,2,3,2,0,0,2,1,2,20,5,48,16,18,FALSE,0.375,2021,2021-2022
DC,2021-12-31,inter-ucfe,1,0,0,0,0,0,0,0,0,5,0,6,1,1,FALSE,0.166666666666667,2021,2021-2022
DC,2021-12-31,inter-ucx,0,0,0,0,0,0,0,0,0,0,0,0,0,0,FALSE,0,2021,2021-2022
DC,2021-12-31,inter-ui,10,2,3,2,0,0,2,1,2,15,5,42,15,17,FALSE,0.404761904761905,2021,2021-2022
DC,2021-12-31,intra-total,404,22,22,15,14,18,13,12,17,243,67,847,471,493,FALSE,0.582054309327037,2021,2021-2022
DC,2021-12-31,intra-ucfe,2,0,1,2,0,0,0,1,1,11,0,18,2,2,FALSE,0.111111111111111,2021,2021-2022
DC,2021-12-31,intra-ucx,0,0,0,0,1,0,0,0,0,0,0,1,0,0,FALSE,0,2021,2021-2022
DC,2021-12-31,intra-ui,402,22,21,13,13,18,13,11,16,232,67,828,469,491,FALSE,0.592995169082126,2021,2021-2022
DC,2022-01-31,inter-total,6,1,1,1,2,1,0,1,2,28,7,50,13,14,FALSE,0.28,2021,2021-2022
DC,2022-01-31,inter-ucfe,0,0,0,0,0,0,0,0,1,0,0,1,0,0,FALSE,0,2021,2021-2022
DC,2022-01-31,inter-ucx,0,0,0,0,0,0,0,0,0,0,0,0,0,0,FALSE,0,2021,2021-2022
DC,2022-01-31,inter-ui,6,1,1,1,2,1,0,1,1,28,7,49,13,14,FALSE,0.285714285714286,2021,2021-2022
DC,2022-01-31,intra-total,524,14,15,5,14,12,8,11,7,249,124,983,648,662,FALSE,0.673448626653103,2021,2021-2022
DC,2022-01-31,intra-ucfe,0,0,0,0,1,0,0,1,1,11,0,14,0,0,FALSE,0,2021,2021-2022
DC,2022-01-31,intra-ucx,0,0,0,0,0,0,0,0,0,0,0,0,0,0,FALSE,0,2021,2021-2022
DC,2022-01-31,intra-ui,524,14,15,5,13,12,8,10,6,238,124,969,648,662,FALSE,0.683178534571723,2021,2021-2022
DC,2022-02-28,inter-total,10,1,1,1,1,0,2,3,1,31,2,53,12,13,FALSE,0.245283018867925,2021,2021-2022
DC,2022-02-28,inter-ucfe,0,0,0,0,0,0,1,0,0,5,0,6,0,0,FALSE,0,2021,2021-2022
DC,2022-02-28,inter-ucx,0,0,0,0,0,0,0,0,0,0,0,0,0,0,FALSE,0,2021,2021-2022
DC,2022-02-28,inter-ui,10,1,1,1,1,0,1,3,1,26,2,47,12,13,FALSE,0.276595744680851,2021,2021-2022
DC,2022-02-28,intra-total,126,23,19,7,13,3,5,8,13,243,60,520,186,209,FALSE,0.401923076923077,2021,2021-2022
DC,2022-02-28,intra-ucfe,1,2,0,0,0,0,0,1,1,14,0,19,1,3,FALSE,0.157894736842105,2021,2021-2022
DC,2022-02-28,intra-ucx,0,0,0,0,0,0,0,0,0,0,0,0,0,0,FALSE,0,2021,2021-2022
DC,2022-02-28,intra-ui,125,21,19,7,13,3,5,7,12,229,60,501,185,206,FALSE,0.411177644710579,2021,2021-2022
DC,2022-03-31,inter-total,22,16,0,3,0,0,0,0,0,24,44,109,66,82,FALSE,0.752293577981651,2021,2021-2022
DC,2022-03-31,inter-ucfe,0,1,0,0,0,0,0,0,0,3,0,4,0,1,FALSE,0.25,2021,2021-2022
DC,2022-03-31,inter-ucx,0,0,0,0,0,0,0,0,0,0,0,0,0,0,FALSE,0,2021,2021-2022
DC,2022-03-31,inter-ui,22,15,0,3,0,0,0,0,0,21,44,105,66,81,FALSE,0.771428571428571,2021,2021-2022
DC,2022-03-31,intra-total,349,78,23,18,11,20,19,8,9,267,408,1210,757,835,FALSE,0.690082644628099,2021,2021-2022
DC,2022-03-31,intra-ucfe,2,1,0,0,1,0,1,0,2,14,0,21,2,3,FALSE,0.142857142857143,2021,2021-2022
DC,2022-03-31,intra-ucx,0,0,0,0,0,0,0,0,0,0,0,0,0,0,FALSE,0,2021,2021-2022
DC,2022-03-31,intra-ui,347,77,23,18,10,20,18,8,7,253,408,1189,755,832,FALSE,0.699747687132044,2021,2021-2022
DC,2022-04-30,inter-total,13,2,3,2,0,0,0,1,1,22,2,46,15,17,FALSE,0.369565217391304,2021,2021-2022
DC,2022-04-30,inter-ucfe,0,0,0,0,0,0,0,0,0,3,0,3,0,0,FALSE,0,2021,2021-2022
DC,2022-04-30,inter-ucx,0,0,0,0,0,0,0,0,0,0,0,0,0,0,FALSE,0,2021,2021-2022
DC,2022-04-30,inter-ui,13,2,3,2,0,0,0,1,1,19,2,43,15,17,FALSE,0.395348837209302,2021,2021-2022
DC,2022-04-30,intra-total,150,79,10,18,14,9,11,11,15,171,80,568,230,309,FALSE,0.544014084507042,2021,2021-2022
DC,2022-04-30,intra-ucfe,1,0,2,0,2,2,1,0,2,5,0,15,1,1,FALSE,0.0666666666666667,2021,2021-2022
DC,2022-04-30,intra-ucx,0,0,0,0,0,0,0,0,0,0,0,0,0,0,FALSE,0,2021,2021-2022
DC,2022-04-30,intra-ui,149,79,8,18,12,7,10,11,13,166,80,553,229,308,FALSE,0.556962025316456,2021,2021-2022
DC,2022-05-31,inter-total,5,0,2,1,1,0,2,1,0,16,7,35,12,12,FALSE,0.342857142857143,2021,2021-2022
DC,2022-05-31,inter-ucfe,0,0,0,0,0,0,1,1,0,2,1,5,1,1,FALSE,0.2,2021,2021-2022
DC,2022-05-31,inter-ucx,0,0,0,0,0,0,0,0,0,0,0,0,0,0,FALSE,0,2021,2021-2022
DC,2022-05-31,inter-ui,5,0,2,1,1,0,1,0,0,14,6,30,11,11,FALSE,0.366666666666667,2021,2021-2022
DC,2022-05-31,intra-total,145,49,29,27,20,19,13,15,8,171,78,574,223,272,FALSE,0.473867595818815,2021,2021-2022
DC,2022-05-31,intra-ucfe,0,0,0,0,1,1,0,0,0,7,0,9,0,0,FALSE,0,2021,2021-2022
DC,2022-05-31,intra-ucx,0,0,0,0,0,0,0,0,0,1,0,1,0,0,FALSE,0,2021,2021-2022
DC,2022-05-31,intra-ui,145,49,29,27,19,18,13,15,8,163,78,564,223,272,FALSE,0.482269503546099,2021,2021-2022
DC,2022-06-30,inter-total,13,1,4,2,1,5,2,2,0,30,3,63,16,17,FALSE,0.26984126984127,2021,2021-2022
DC,2022-06-30,inter-ucfe,0,0,0,0,0,1,0,0,0,4,0,5,0,0,FALSE,0,2021,2021-2022
DC,2022-06-30,inter-ucx,0,0,0,0,0,0,0,0,0,0,0,0,0,0,FALSE,0,2021,2021-2022
DC,2022-06-30,inter-ui,13,1,4,2,1,4,2,2,0,26,3,58,16,17,FALSE,0.293103448275862,2021,2021-2022
DC,2022-06-30,intra-total,175,79,46,29,31,25,20,20,20,237,61,743,236,315,FALSE,0.423956931359354,2021,2021-2022
DC,2022-06-30,intra-ucfe,2,1,1,0,2,1,0,1,0,14,1,23,3,4,FALSE,0.173913043478261,2021,2021-2022
DC,2022-06-30,intra-ucx,0,0,0,0,0,1,0,0,0,0,0,1,0,0,FALSE,0,2021,2021-2022
DC,2022-06-30,intra-ui,173,78,45,29,29,23,20,19,20,223,60,719,233,311,FALSE,0.432545201668985,2021,2021-2022
DC,2022-07-31,inter-total,7,1,2,2,1,0,1,1,1,16,6,38,13,14,FALSE,0.368421052631579,2022,2022-2023
DC,2022-07-31,inter-ucfe,1,0,1,0,0,0,0,0,1,4,0,7,1,1,FALSE,0.142857142857143,2022,2022-2023
DC,2022-07-31,inter-ucx,0,0,0,0,0,0,0,0,0,0,0,0,0,0,FALSE,0,2022,2022-2023
DC,2022-07-31,inter-ui,6,1,1,2,1,0,1,1,0,12,6,31,12,13,FALSE,0.419354838709677,2022,2022-2023
DC,2022-07-31,intra-total,296,49,38,22,19,13,11,25,9,178,118,778,414,463,FALSE,0.595115681233933,2022,2022-2023
DC,2022-07-31,intra-ucfe,1,3,3,1,1,2,0,2,0,8,5,26,6,9,FALSE,0.346153846153846,2022,2022-2023
DC,2022-07-31,intra-ucx,0,0,0,0,0,0,0,0,0,1,0,1,0,0,FALSE,0,2022,2022-2023
DC,2022-07-31,intra-ui,295,46,35,21,18,11,11,23,9,169,113,751,408,454,FALSE,0.604527296937417,2022,2022-2023
DC,2022-08-31,inter-total,13,0,1,1,0,1,0,0,0,28,6,50,19,19,FALSE,0.38,2022,2022-2023
DC,2022-08-31,inter-ucfe,0,0,0,0,0,0,0,0,0,2,0,2,0,0,FALSE,0,2022,2022-2023
DC,2022-08-31,inter-ucx,0,0,0,0,0,0,0,0,0,0,0,0,0,0,FALSE,0,2022,2022-2023
DC,2022-08-31,inter-ui,13,0,1,1,0,1,0,0,0,26,6,48,19,19,FALSE,0.395833333333333,2022,2022-2023
DC,2022-08-31,intra-total,382,106,69,45,36,27,29,11,13,232,156,1106,538,644,FALSE,0.582278481012658,2022,2022-2023
DC,2022-08-31,intra-ucfe,2,1,0,2,1,0,2,0,0,18,1,27,3,4,FALSE,0.148148148148148,2022,2022-2023
DC,2022-08-31,intra-ucx,0,0,0,0,0,0,0,0,0,0,1,1,1,1,FALSE,1,2022,2022-2023
DC,2022-08-31,intra-ui,380,105,69,43,35,27,27,11,13,214,154,1078,534,639,FALSE,0.592764378478664,2022,2022-2023
DC,2022-09-30,inter-total,8,2,2,2,1,2,0,0,1,12,2,32,10,12,FALSE,0.375,2022,2022-2023
DC,2022-09-30,inter-ucfe,0,0,0,0,0,0,0,0,0,1,0,1,0,0,FALSE,0,2022,2022-2023
DC,2022-09-30,inter-ucx,0,0,0,0,0,0,0,0,0,0,0,0,0,0,FALSE,0,2022,2022-2023
DC,2022-09-30,inter-ui,8,2,2,2,1,2,0,0,1,11,2,31,10,12,FALSE,0.387096774193548,2022,2022-2023
DC,2022-09-30,intra-total,171,28,24,18,19,25,29,22,13,209,89,647,260,288,FALSE,0.445131375579598,2022,2022-2023
DC,2022-09-30,intra-ucfe,3,0,1,0,0,1,1,0,2,8,1,17,4,4,FALSE,0.235294117647059,2022,2022-2023
DC,2022-09-30,intra-ucx,0,0,0,0,0,1,0,0,0,2,0,3,0,0,FALSE,0,2022,2022-2023
DC,2022-09-30,intra-ui,168,28,23,18,19,23,28,22,11,199,88,627,256,284,FALSE,0.452950558213716,2022,2022-2023
DC,2022-10-31,inter-total,6,0,2,5,1,1,0,0,0,18,4,37,10,10,FALSE,0.27027027027027,2022,2022-2023
DC,2022-10-31,inter-ucfe,0,0,0,1,0,0,0,0,0,0,0,1,0,0,FALSE,0,2022,2022-2023
DC,2022-10-31,inter-ucx,0,0,0,0,0,0,0,0,0,0,0,0,0,0,FALSE,0,2022,2022-2023
DC,2022-10-31,inter-ui,6,0,2,4,1,1,0,0,0,18,4,36,10,10,FALSE,0.277777777777778,2022,2022-2023
DC,2022-10-31,intra-total,51,30,33,25,27,19,15,8,8,205,49,470,100,130,FALSE,0.276595744680851,2022,2022-2023
DC,2022-10-31,intra-ucfe,0,1,1,3,0,3,0,0,1,9,1,19,1,2,FALSE,0.105263157894737,2022,2022-2023
DC,2022-10-31,intra-ucx,0,0,0,0,0,0,0,0,0,0,0,0,0,0,FALSE,0,2022,2022-2023
DC,2022-10-31,intra-ui,51,29,32,22,27,16,15,8,7,196,48,451,99,128,FALSE,0.283813747228381,2022,2022-2023
DC,2022-11-30,inter-total,8,1,3,0,1,1,1,0,1,19,1,36,9,10,FALSE,0.277777777777778,2022,2022-2023
DC,2022-11-30,inter-ucfe,0,0,0,0,0,0,0,0,0,2,0,2,0,0,FALSE,0,2022,2022-2023
DC,2022-11-30,inter-ucx,0,0,0,0,0,0,0,0,0,0,0,0,0,0,FALSE,0,2022,2022-2023
DC,2022-11-30,inter-ui,8,1,3,0,1,1,1,0,1,17,1,34,9,10,FALSE,0.294117647058824,2022,2022-2023
DC,2022-11-30,intra-total,188,35,13,15,18,17,9,8,8,176,51,538,239,274,FALSE,0.509293680297398,2022,2022-2023
DC,2022-11-30,intra-ucfe,1,0,0,1,0,3,1,1,1,13,0,21,1,1,FALSE,0.0476190476190476,2022,2022-2023
DC,2022-11-30,intra-ucx,0,0,0,0,0,0,0,0,0,0,0,0,0,0,FALSE,0,2022,2022-2023
DC,2022-11-30,intra-ui,187,35,13,14,18,14,8,7,7,163,51,517,238,273,FALSE,0.528046421663443,2022,2022-2023
DC,2022-12-31,inter-total,11,4,2,5,1,0,1,1,2,8,7,42,18,22,FALSE,0.523809523809524,2022,2022-2023
DC,2022-12-31,inter-ucfe,1,0,0,0,0,0,0,0,0,1,2,4,3,3,FALSE,0.75,2022,2022-2023
DC,2022-12-31,inter-ucx,0,0,0,0,0,0,0,0,0,0,0,0,0,0,FALSE,0,2022,2022-2023
DC,2022-12-31,inter-ui,10,4,2,5,1,0,1,1,2,7,5,38,15,19,FALSE,0.5,2022,2022-2023
DC,2022-12-31,intra-total,297,25,21,24,13,18,16,22,27,197,62,722,359,384,FALSE,0.53185595567867,2022,2022-2023
DC,2022-12-31,intra-ucfe,0,0,0,1,0,1,0,1,4,14,3,24,3,3,FALSE,0.125,2022,2022-2023
DC,2022-12-31,intra-ucx,0,0,0,0,0,0,0,1,1,0,0,2,0,0,FALSE,0,2022,2022-2023
DC,2022-12-31,intra-ui,297,25,21,23,13,17,16,20,22,183,59,696,356,381,FALSE,0.547413793103448,2022,2022-2023
DC,2023-01-31,inter-total,16,7,7,5,2,6,1,1,0,7,7,59,23,30,FALSE,0.508474576271186,2022,2022-2023
DC,2023-01-31,inter-ucfe,0,0,0,1,1,1,0,0,0,1,0,4,0,0,FALSE,0,2022,2022-2023
DC,2023-01-31,inter-ucx,0,0,0,1,0,0,0,0,0,0,0,1,0,0,FALSE,0,2022,2022-2023
DC,2023-01-31,inter-ui,16,7,7,3,1,5,1,1,0,6,7,54,23,30,FALSE,0.555555555555556,2022,2022-2023
DC,2023-01-31,intra-total,465,58,34,31,25,29,14,14,10,233,140,1053,605,663,FALSE,0.62962962962963,2022,2022-2023
DC,2023-01-31,intra-ucfe,1,3,1,0,0,4,0,0,0,9,8,26,9,12,FALSE,0.461538461538462,2022,2022-2023
DC,2023-01-31,intra-ucx,0,0,0,0,0,0,0,0,0,1,0,1,0,0,FALSE,0,2022,2022-2023
DC,2023-01-31,intra-ui,464,55,33,31,25,25,14,14,10,223,132,1026,596,651,FALSE,0.634502923976608,2022,2022-2023
DC,2023-02-28,inter-total,17,12,4,5,1,7,4,1,0,9,17,77,34,46,FALSE,0.597402597402597,2022,2022-2023
DC,2023-02-28,inter-ucfe,0,0,0,1,0,1,0,0,0,2,0,4,0,0,FALSE,0,2022,2022-2023
DC,2023-02-28,inter-ucx,0,0,0,0,0,0,0,0,0,0,0,0,0,0,FALSE,0,2022,2022-2023
DC,2023-02-28,inter-ui,17,12,4,4,1,6,4,1,0,7,17,73,34,46,FALSE,0.63013698630137,2022,2022-2023
DC,2023-02-28,intra-total,349,87,68,62,43,39,26,23,23,211,151,1082,500,587,FALSE,0.542513863216266,2022,2022-2023
DC,2023-02-28,intra-ucfe,8,1,3,7,6,0,0,0,0,8,9,42,17,18,FALSE,0.428571428571429,2022,2022-2023
DC,2023-02-28,intra-ucx,0,0,0,0,0,0,0,0,0,1,0,1,0,0,FALSE,0,2022,2022-2023
DC,2023-02-28,intra-ui,341,86,65,55,37,39,26,23,23,202,142,1039,483,569,FALSE,0.547641963426372,2022,2022-2023
DC,2023-03-31,inter-total,9,11,8,3,2,7,2,4,1,20,14,81,23,34,FALSE,0.419753086419753,2022,2022-2023
DC,2023-03-31,inter-ucfe,0,0,0,0,0,0,0,0,0,4,0,4,0,0,FALSE,0,2022,2022-2023
DC,2023-03-31,inter-ucx,0,0,0,0,0,0,0,0,0,0,0,0,0,0,FALSE,0,2022,2022-2023
DC,2023-03-31,inter-ui,9,11,8,3,2,7,2,4,1,16,14,77,23,34,FALSE,0.441558441558442,2022,2022-2023
DC,2023-03-31,intra-total,137,73,76,58,36,43,41,21,17,253,167,922,304,377,FALSE,0.408893709327549,2022,2022-2023
DC,2023-03-31,intra-ucfe,2,1,2,3,1,6,5,4,2,9,8,43,10,11,FALSE,0.255813953488372,2022,2022-2023
DC,2023-03-31,intra-ucx,0,0,0,0,0,0,0,0,0,0,0,0,0,0,FALSE,0,2022,2022-2023
DC,2023-03-31,intra-ui,135,72,74,55,35,37,36,17,15,244,159,879,294,366,FALSE,0.416382252559727,2022,2022-2023
DC,2023-04-30,inter-total,7,13,4,4,5,2,2,2,5,16,10,70,17,30,FALSE,0.428571428571429,2022,2022-2023
DC,2023-04-30,inter-ucfe,2,0,0,1,0,0,1,0,0,1,0,5,2,2,FALSE,0.4,2022,2022-2023
DC,2023-04-30,inter-ucx,0,0,0,0,0,0,0,0,0,0,0,0,0,0,FALSE,0,2022,2022-2023
DC,2023-04-30,inter-ui,5,13,4,3,5,2,1,2,5,15,10,65,15,28,FALSE,0.430769230769231,2022,2022-2023
DC,2023-04-30,intra-total,111,93,65,55,44,37,31,16,23,216,182,873,293,386,FALSE,0.442153493699886,2022,2022-2023
DC,2023-04-30,intra-ucfe,5,2,3,1,1,3,1,0,1,8,4,29,9,11,FALSE,0.379310344827586,2022,2022-2023
DC,2023-04-30,intra-ucx,0,0,0,0,0,0,0,0,0,0,0,0,0,0,FALSE,0,2022,2022-2023
DC,2023-04-30,intra-ui,106,91,62,54,43,34,30,16,22,208,178,844,284,375,FALSE,0.444312796208531,2022,2022-2023
DC,2023-05-31,inter-total,17,5,4,6,5,4,4,2,2,12,18,79,35,40,FALSE,0.506329113924051,2022,2022-2023
DC,2023-05-31,inter-ucfe,0,0,1,0,1,0,0,0,0,0,1,3,1,1,FALSE,0.333333333333333,2022,2022-2023
DC,2023-05-31,inter-ucx,0,0,0,0,0,0,0,0,0,0,0,0,0,0,FALSE,0,2022,2022-2023
DC,2023-05-31,inter-ui,17,5,3,6,4,4,4,2,2,12,17,76,34,39,FALSE,0.513157894736842,2022,2022-2023
DC,2023-05-31,intra-total,251,82,54,59,35,45,31,18,25,192,347,1139,598,680,FALSE,0.597014925373134,2022,2022-2023
DC,2023-05-31,intra-ucfe,1,4,2,0,2,2,2,1,2,8,7,31,8,12,FALSE,0.387096774193548,2022,2022-2023
DC,2023-05-31,intra-ucx,0,0,0,0,0,0,0,0,0,0,1,1,1,1,FALSE,1,2022,2022-2023
DC,2023-05-31,intra-ui,250,78,52,59,33,43,29,17,23,184,339,1107,589,667,FALSE,0.60252935862692,2022,2022-2023
DC,2023-06-30,inter-total,21,10,4,2,3,2,1,1,2,23,27,96,48,58,FALSE,0.604166666666667,2022,2022-2023
DC,2023-06-30,inter-ucfe,1,1,0,0,0,0,0,1,0,2,1,6,2,3,FALSE,0.5,2022,2022-2023
DC,2023-06-30,inter-ucx,0,0,0,0,0,0,0,0,0,0,0,0,0,0,FALSE,0,2022,2022-2023
DC,2023-06-30,inter-ui,20,9,4,2,3,2,1,0,2,21,26,90,46,55,FALSE,0.611111111111111,2022,2022-2023
DC,2023-06-30,intra-total,242,90,58,48,30,28,19,14,16,187,392,1124,634,724,FALSE,0.644128113879004,2022,2022-2023
DC,2023-06-30,intra-ucfe,1,2,1,0,2,2,2,1,1,20,7,39,8,10,FALSE,0.256410256410256,2022,2022-2023
DC,2023-06-30,intra-ucx,0,0,0,0,0,0,0,0,0,0,1,1,1,1,FALSE,1,2022,2022-2023
DC,2023-06-30,intra-ui,241,88,57,48,28,26,17,13,15,167,384,1084,625,713,FALSE,0.657749077490775,2022,2022-2023
DC,2023-07-31,inter-total,19,5,3,8,0,3,1,1,1,15,29,85,48,53,FALSE,0.623529411764706,2023,2023-2024
DC,2023-07-31,inter-ucfe,0,0,0,1,0,0,0,0,0,2,2,5,2,2,FALSE,0.4,2023,2023-2024
DC,2023-07-31,inter-ucx,0,0,0,0,0,0,0,0,0,0,1,1,1,1,FALSE,1,2023,2023-2024
DC,2023-07-31,inter-ui,19,5,3,7,0,3,1,1,1,13,26,79,45,50,FALSE,0.632911392405063,2023,2023-2024
DC,2023-07-31,intra-total,287,84,49,32,26,24,21,10,12,164,560,1269,847,931,FALSE,0.73364854215918,2023,2023-2024
DC,2023-07-31,intra-ucfe,2,1,3,2,2,1,1,1,0,8,7,28,9,10,FALSE,0.357142857142857,2023,2023-2024
DC,2023-07-31,intra-ucx,0,0,0,0,0,0,1,0,0,0,0,1,0,0,FALSE,0,2023,2023-2024
DC,2023-07-31,intra-ui,285,83,46,30,24,23,19,9,12,156,553,1240,838,921,FALSE,0.742741935483871,2023,2023-2024
DC,2023-08-31,inter-total,20,10,4,4,4,3,0,1,0,22,40,108,60,70,FALSE,0.648148148148148,2023,2023-2024
DC,2023-08-31,inter-ucfe,1,0,0,0,0,1,0,0,0,1,3,6,4,4,FALSE,0.666666666666667,2023,2023-2024
DC,2023-08-31,inter-ucx,0,0,0,0,0,0,0,0,0,0,0,0,0,0,FALSE,0,2023,2023-2024
DC,2023-08-31,inter-ui,19,10,4,4,4,2,0,1,0,21,37,102,56,66,FALSE,0.647058823529412,2023,2023-2024
DC,2023-08-31,intra-total,385,117,97,77,54,37,21,13,20,185,632,1638,1017,1134,FALSE,0.692307692307692,2023,2023-2024
DC,2023-08-31,intra-ucfe,5,2,1,2,1,1,0,0,2,5,13,32,18,20,FALSE,0.625,2023,2023-2024
DC,2023-08-31,intra-ucx,0,0,0,0,0,1,0,0,0,0,1,2,1,1,FALSE,0.5,2023,2023-2024
DC,2023-08-31,intra-ui,380,115,96,75,53,35,21,13,18,180,618,1604,998,1113,FALSE,0.693890274314215,2023,2023-2024
DC,2023-09-30,inter-total,15,5,3,9,1,3,5,1,2,5,32,81,47,52,FALSE,0.641975308641975,2023,2023-2024
DC,2023-09-30,inter-ucfe,1,0,0,0,1,2,0,0,0,0,2,6,3,3,FALSE,0.5,2023,2023-2024
DC,2023-09-30,inter-ucx,0,0,0,0,0,0,0,0,0,0,0,0,0,0,FALSE,0,2023,2023-2024
DC,2023-09-30,inter-ui,14,5,3,9,0,1,5,1,2,5,30,75,44,49,FALSE,0.653333333333333,2023,2023-2024
DC,2023-09-30,intra-total,257,61,45,42,44,26,32,34,17,107,462,1127,719,780,FALSE,0.692102928127773,2023,2023-2024
DC,2023-09-30,intra-ucfe,1,1,3,0,1,0,0,1,0,3,9,19,10,11,FALSE,0.578947368421053,2023,2023-2024
DC,2023-09-30,intra-ucx,0,0,1,0,0,0,0,0,0,1,0,2,0,0,FALSE,0,2023,2023-2024
DC,2023-09-30,intra-ui,256,60,41,42,43,26,32,33,17,103,453,1106,709,769,FALSE,0.695298372513562,2023,2023-2024
DC,2023-10-31,inter-total,21,6,3,4,6,1,1,1,0,5,37,85,58,64,FALSE,0.752941176470588,2023,2023-2024
DC,2023-10-31,inter-ucfe,3,0,0,0,0,0,0,0,0,0,1,4,4,4,FALSE,1,2023,2023-2024
DC,2023-10-31,inter-ucx,0,0,0,0,0,0,0,0,0,0,0,0,0,0,FALSE,0,2023,2023-2024
DC,2023-10-31,inter-ui,18,6,3,4,6,1,1,1,0,5,36,81,54,60,FALSE,0.740740740740741,2023,2023-2024
DC,2023-10-31,intra-total,275,73,49,34,25,24,13,19,13,134,576,1235,851,924,FALSE,0.748178137651822,2023,2023-2024
DC,2023-10-31,intra-ucfe,7,1,2,0,0,1,1,2,0,8,12,34,19,20,FALSE,0.588235294117647,2023,2023-2024
DC,2023-10-31,intra-ucx,0,0,0,1,0,0,0,0,0,0,2,3,2,2,FALSE,0.666666666666667,2023,2023-2024
DC,2023-10-31,intra-ui,268,72,47,33,25,23,12,17,13,126,562,1198,830,902,FALSE,0.752921535893155,2023,2023-2024
DC,2023-11-30,inter-total,18,6,2,5,6,2,3,2,2,10,22,78,40,46,FALSE,0.58974358974359,2023,2023-2024
DC,2023-11-30,inter-ucfe,1,0,0,0,0,0,0,0,0,0,2,3,3,3,FALSE,1,2023,2023-2024
DC,2023-11-30,inter-ucx,0,0,0,0,0,0,0,0,0,0,0,0,0,0,FALSE,0,2023,2023-2024
DC,2023-11-30,inter-ui,17,6,2,5,6,2,3,2,2,10,20,75,37,43,FALSE,0.573333333333333,2023,2023-2024
DC,2023-11-30,intra-total,256,94,48,46,40,18,19,9,12,131,558,1231,814,908,FALSE,0.737611697806661,2023,2023-2024
DC,2023-11-30,intra-ucfe,5,1,1,0,2,1,0,2,0,5,9,26,14,15,FALSE,0.576923076923077,2023,2023-2024
DC,2023-11-30,intra-ucx,1,0,0,0,0,0,0,0,0,0,1,2,2,2,FALSE,1,2023,2023-2024
DC,2023-11-30,intra-ui,250,93,47,46,38,17,19,7,12,126,548,1203,798,891,FALSE,0.740648379052369,2023,2023-2024
DC,2023-12-31,inter-total,18,7,3,2,5,2,4,2,3,4,29,79,47,54,FALSE,0.683544303797468,2023,2023-2024
DC,2023-12-31,inter-ucfe,1,0,0,0,1,0,0,0,0,0,2,4,3,3,FALSE,0.75,2023,2023-2024
DC,2023-12-31,inter-ucx,0,0,0,0,0,0,0,0,0,0,0,0,0,0,FALSE,0,2023,2023-2024
DC,2023-12-31,inter-ui,17,7,3,2,4,2,4,2,3,4,27,75,44,51,FALSE,0.68,2023,2023-2024
DC,2023-12-31,intra-total,268,54,35,45,30,28,22,20,13,99,573,1187,841,895,FALSE,0.754001684919966,2023,2023-2024
DC,2023-12-31,intra-ucfe,6,5,1,1,1,2,1,0,1,6,4,28,10,15,FALSE,0.535714285714286,2023,2023-2024
DC,2023-12-31,intra-ucx,0,0,0,0,0,0,0,0,0,1,0,1,0,0,FALSE,0,2023,2023-2024
DC,2023-12-31,intra-ui,262,49,34,44,29,26,21,20,12,92,569,1158,831,880,FALSE,0.75993091537133,2023,2023-2024
DC,2024-01-31,inter-total,25,3,3,5,1,2,2,2,0,15,41,99,66,69,FALSE,0.696969696969697,2023,2023-2024
DC,2024-01-31,inter-ucfe,0,0,0,0,0,0,0,0,0,0,0,0,0,0,FALSE,0,2023,2023-2024
DC,2024-01-31,inter-ucx,0,0,0,0,0,0,0,0,0,0,0,0,0,0,FALSE,0,2023,2023-2024
DC,2024-01-31,inter-ui,25,3,3,5,1,2,2,2,0,15,41,99,66,69,FALSE,0.696969696969697,2023,2023-2024
DC,2024-01-31,intra-total,330,74,55,39,35,27,12,14,12,110,643,1351,973,1047,FALSE,0.774981495188749,2023,2023-2024
DC,2024-01-31,intra-ucfe,2,5,1,3,2,1,0,1,0,3,5,23,7,12,FALSE,0.521739130434783,2023,2023-2024
DC,2024-01-31,intra-ucx,0,0,0,0,0,0,0,0,0,0,0,0,0,0,FALSE,0,2023,2023-2024
DC,2024-01-31,intra-ui,328,69,54,36,33,26,12,13,12,107,638,1328,966,1035,FALSE,0.779367469879518,2023,2023-2024
DC,2024-02-29,inter-total,24,0,0,0,1,1,0,1,0,4,6,37,30,30,FALSE,0.810810810810811,2023,2023-2024
DC,2024-02-29,inter-ucfe,0,0,0,0,0,0,0,0,0,1,0,1,0,0,FALSE,0,2023,2023-2024
DC,2024-02-29,inter-ucx,0,0,0,0,0,0,0,0,0,0,0,0,0,0,FALSE,0,2023,2023-2024
DC,2024-02-29,inter-ui,24,0,0,0,1,1,0,1,0,3,6,36,30,30,FALSE,0.833333333333333,2023,2023-2024
DC,2024-02-29,intra-total,193,17,4,6,3,5,2,6,2,11,60,309,253,270,FALSE,0.87378640776699,2023,2023-2024
DC,2024-02-29,intra-ucfe,4,0,0,0,1,0,0,0,0,0,2,7,6,6,FALSE,0.857142857142857,2023,2023-2024
DC,2024-02-29,intra-ucx,0,0,0,0,0,0,0,0,0,0,0,0,0,0,FALSE,0,2023,2023-2024
DC,2024-02-29,intra-ui,189,17,4,6,2,5,2,6,2,11,58,302,247,264,FALSE,0.874172185430464,2023,2023-2024
DC,2024-03-31,inter-total,35,21,12,10,4,1,4,4,1,8,22,122,57,78,FALSE,0.639344262295082,2023,2023-2024
DC,2024-03-31,inter-ucfe,1,2,0,0,2,0,0,0,0,0,0,5,1,3,FALSE,0.6,2023,2023-2024
DC,2024-03-31,inter-ucx,0,0,0,0,0,0,0,0,0,0,0,0,0,0,FALSE,0,2023,2023-2024
DC,2024-03-31,inter-ui,34,19,12,10,2,1,4,4,1,8,22,117,56,75,FALSE,0.641025641025641,2023,2023-2024
DC,2024-03-31,intra-total,87,69,37,60,47,33,27,20,22,59,50,511,137,206,FALSE,0.403131115459883,2023,2023-2024
DC,2024-03-31,intra-ucfe,0,0,0,0,1,0,0,0,1,1,0,3,0,0,FALSE,0,2023,2023-2024
DC,2024-03-31,intra-ucx,0,0,0,0,0,0,0,0,0,0,0,0,0,0,FALSE,0,2023,2023-2024
DC,2024-03-31,intra-ui,87,69,37,60,46,33,27,20,21,58,50,508,137,206,FALSE,0.405511811023622,2023,2023-2024
DC,2024-04-30,inter-total,25,35,11,3,7,19,14,11,11,15,56,207,81,116,FALSE,0.560386473429952,2023,2023-2024
DC,2024-04-30,inter-ucfe,0,0,0,0,0,0,0,0,1,1,0,2,0,0,FALSE,0,2023,2023-2024
DC,2024-04-30,inter-ucx,0,0,0,0,0,0,0,0,0,0,0,0,0,0,FALSE,0,2023,2023-2024
DC,2024-04-30,inter-ui,25,35,11,3,7,19,14,11,10,14,56,205,81,116,FALSE,0.565853658536585,2023,2023-2024
DC,2024-04-30,intra-total,104,97,43,44,47,61,50,40,24,79,181,770,285,382,FALSE,0.496103896103896,2023,2023-2024
DC,2024-04-30,intra-ucfe,0,1,2,2,1,0,2,1,0,1,1,11,1,2,FALSE,0.181818181818182,2023,2023-2024
DC,2024-04-30,intra-ucx,0,0,0,0,0,0,0,0,0,0,0,0,0,0,FALSE,0,2023,2023-2024
DC,2024-04-30,intra-ui,104,96,41,42,46,61,48,39,24,78,180,759,284,380,FALSE,0.500658761528327,2023,2023-2024
DC,2024-05-31,inter-total,34,18,13,11,12,9,10,8,5,48,113,281,147,165,FALSE,0.587188612099644,2023,2023-2024
DC,2024-05-31,inter-ucfe,0,0,0,0,0,1,0,0,0,3,3,7,3,3,FALSE,0.428571428571429,2023,2023-2024
DC,2024-05-31,inter-ucx,0,0,0,0,0,0,0,0,0,0,0,0,0,0,FALSE,0,2023,2023-2024
DC,2024-05-31,inter-ui,34,18,13,11,12,8,10,8,5,45,110,274,144,162,FALSE,0.591240875912409,2023,2023-2024
DC,2024-05-31,intra-total,114,69,41,35,18,26,36,52,27,145,401,964,515,584,FALSE,0.605809128630705,2023,2023-2024
DC,2024-05-31,intra-ucfe,0,0,2,0,0,0,0,0,1,6,2,11,2,2,FALSE,0.181818181818182,2023,2023-2024
DC,2024-05-31,intra-ucx,1,0,0,0,0,0,0,0,0,0,0,1,1,1,FALSE,1,2023,2023-2024
DC,2024-05-31,intra-ui,113,69,39,35,18,26,36,52,26,139,399,952,512,581,FALSE,0.610294117647059,2023,2023-2024
DC,2024-06-30,inter-total,71,34,13,10,6,10,11,4,8,39,115,321,186,220,FALSE,0.685358255451713,2023,2023-2024
DC,2024-06-30,inter-ucfe,0,0,1,3,1,0,0,0,0,0,1,6,1,1,FALSE,0.166666666666667,2023,2023-2024
DC,2024-06-30,inter-ucx,0,0,0,0,0,0,0,0,0,0,0,0,0,0,FALSE,0,2023,2023-2024
DC,2024-06-30,inter-ui,71,34,12,7,5,10,11,4,8,39,114,315,185,219,FALSE,0.695238095238095,2023,2023-2024
DC,2024-06-30,intra-total,265,84,43,34,20,21,10,22,24,147,375,1045,640,724,FALSE,0.692822966507177,2023,2023-2024
DC,2024-06-30,intra-ucfe,1,1,1,0,0,0,0,0,1,5,2,11,3,4,FALSE,0.363636363636364,2023,2023-2024
DC,2024-06-30,intra-ucx,0,0,0,0,0,0,0,0,0,1,0,1,0,0,FALSE,0,2023,2023-2024
DC,2024-06-30,intra-ui,264,83,42,34,20,21,10,22,23,141,373,1033,637,720,FALSE,0.696999031945789,2023,2023-2024
DC,2024-07-31,inter-total,107,37,15,7,9,12,10,7,8,56,127,395,234,271,FALSE,0.686075949367089,2024,2024-2025
DC,2024-07-31,inter-ucfe,2,0,1,0,0,0,0,0,0,6,6,15,8,8,FALSE,0.533333333333333,2024,2024-2025
DC,2024-07-31,inter-ucx,0,0,0,0,0,0,0,0,0,0,0,0,0,0,FALSE,0,2024,2024-2025
DC,2024-07-31,inter-ui,105,37,14,7,9,12,10,7,8,50,121,380,226,263,FALSE,0.692105263157895,2024,2024-2025
DC,2024-07-31,intra-total,415,143,49,25,34,38,21,14,19,178,520,1456,935,1078,FALSE,0.740384615384615,2024,2024-2025
DC,2024-07-31,intra-ucfe,3,0,0,1,0,1,0,3,1,5,4,18,7,7,FALSE,0.388888888888889,2024,2024-2025
DC,2024-07-31,intra-ucx,0,0,0,0,0,0,0,0,0,0,0,0,0,0,FALSE,0,2024,2024-2025
DC,2024-07-31,intra-ui,412,143,49,24,34,37,21,11,18,173,516,1438,928,1071,FALSE,0.744784422809458,2024,2024-2025
DC,2024-08-31,inter-total,68,29,6,11,4,3,6,4,5,40,136,312,204,233,FALSE,0.746794871794872,2024,2024-2025
DC,2024-08-31,inter-ucfe,0,0,1,1,0,0,2,0,0,5,0,9,0,0,FALSE,0,2024,2024-2025
DC,2024-08-31,inter-ucx,0,0,0,0,0,0,0,0,0,0,0,0,0,0,FALSE,0,2024,2024-2025
DC,2024-08-31,inter-ui,68,29,5,10,4,3,4,4,5,35,136,303,204,233,FALSE,0.768976897689769,2024,2024-2025
DC,2024-08-31,intra-total,249,122,40,28,25,23,11,14,11,106,399,1028,648,770,FALSE,0.749027237354086,2024,2024-2025
DC,2024-08-31,intra-ucfe,4,3,1,2,5,0,2,1,0,1,9,28,13,16,FALSE,0.571428571428571,2024,2024-2025
DC,2024-08-31,intra-ucx,0,0,0,0,0,0,0,0,0,0,0,0,0,0,FALSE,0,2024,2024-2025
DC,2024-08-31,intra-ui,245,119,39,26,20,23,9,13,11,105,390,1000,635,754,FALSE,0.754,2024,2024-2025
DC,2024-09-30,inter-total,55,21,10,4,5,10,6,4,1,25,68,209,123,144,FALSE,0.688995215311005,2024,2024-2025
DC,2024-09-30,inter-ucfe,0,0,1,0,1,2,0,1,1,2,1,9,1,1,FALSE,0.111111111111111,2024,2024-2025
DC,2024-09-30,inter-ucx,0,0,0,0,0,0,0,0,0,0,0,0,0,0,FALSE,0,2024,2024-2025
DC,2024-09-30,inter-ui,55,21,9,4,4,8,6,3,0,23,67,200,122,143,FALSE,0.715,2024,2024-2025
DC,2024-09-30,intra-total,268,92,41,21,25,22,19,16,9,110,311,934,579,671,FALSE,0.718415417558887,2024,2024-2025
DC,2024-09-30,intra-ucfe,3,0,0,1,0,2,3,1,0,6,4,20,7,7,FALSE,0.35,2024,2024-2025
DC,2024-09-30,intra-ucx,0,0,0,0,0,0,0,0,1,1,0,2,0,0,FALSE,0,2024,2024-2025
DC,2024-09-30,intra-ui,265,92,41,20,25,20,16,15,8,103,307,912,572,664,FALSE,0.728070175438597,2024,2024-2025
DC,2024-10-31,inter-total,97,11,11,10,10,5,11,3,7,31,91,287,188,199,FALSE,0.693379790940767,2024,2024-2025
DC,2024-10-31,inter-ucfe,3,0,2,0,0,0,0,1,1,3,1,11,4,4,FALSE,0.363636363636364,2024,2024-2025
DC,2024-10-31,inter-ucx,0,0,0,0,0,0,0,0,0,0,0,0,0,0,FALSE,0,2024,2024-2025
DC,2024-10-31,inter-ui,94,11,9,10,10,5,11,2,6,28,90,276,184,195,FALSE,0.706521739130435,2024,2024-2025
DC,2024-10-31,intra-total,362,76,32,36,32,29,25,14,16,105,396,1123,758,834,FALSE,0.742653606411398,2024,2024-2025
DC,2024-10-31,intra-ucfe,2,2,0,1,0,1,1,1,0,4,5,17,7,9,FALSE,0.529411764705882,2024,2024-2025
DC,2024-10-31,intra-ucx,2,0,0,0,0,0,0,0,0,0,1,3,3,3,FALSE,1,2024,2024-2025
DC,2024-10-31,intra-ui,358,74,32,35,32,28,24,13,16,101,390,1103,748,822,FALSE,0.745240253853128,2024,2024-2025
DC,2024-11-30,inter-total,36,29,10,11,18,12,5,8,7,41,67,244,103,132,FALSE,0.540983606557377,2024,2024-2025
DC,2024-11-30,inter-ucfe,0,2,0,1,0,0,1,3,3,3,1,14,1,3,FALSE,0.214285714285714,2024,2024-2025
DC,2024-11-30,inter-ucx,0,0,0,0,0,0,0,0,0,0,0,0,0,0,FALSE,0,2024,2024-2025
DC,2024-11-30,inter-ui,36,27,10,10,18,12,4,5,4,38,66,230,102,129,FALSE,0.560869565217391,2024,2024-2025
DC,2024-11-30,intra-total,197,110,55,46,41,34,30,24,10,125,331,1003,528,638,FALSE,0.636091724825524,2024,2024-2025
DC,2024-11-30,intra-ucfe,1,2,0,0,0,1,2,1,1,7,3,18,4,6,FALSE,0.333333333333333,2024,2024-2025
DC,2024-11-30,intra-ucx,0,0,0,0,0,0,0,0,0,0,0,0,0,0,FALSE,0,2024,2024-2025
DC,2024-11-30,intra-ui,196,108,55,46,41,33,28,23,9,118,328,985,524,632,FALSE,0.641624365482234,2024,2024-2025
DE,2019-01-31,inter-total,71,20,4,0,0,2,0,0,0,1,31,129,102,122,TRUE,0.790697674418605,2018,2018-2019
DE,2019-01-31,inter-ucfe,2,0,0,0,0,0,0,0,0,0,3,5,5,5,TRUE,1,2018,2018-2019
DE,2019-01-31,inter-ucx,0,0,0,0,0,0,0,0,0,0,0,0,0,0,TRUE,0,2018,2018-2019
DE,2019-01-31,inter-ui,69,20,4,0,0,2,0,0,0,1,28,124,97,117,TRUE,0.782258064516129,2018,2018-2019
DE,2019-01-31,intra-total,1532,224,45,11,11,10,1,5,6,5,351,2201,1883,2107,TRUE,0.85552021808269,2018,2018-2019
DE,2019-01-31,intra-ucfe,30,4,0,0,0,0,0,0,0,0,11,45,41,45,TRUE,0.911111111111111,2018,2018-2019
DE,2019-01-31,intra-ucx,0,1,0,0,0,0,0,0,0,0,1,2,1,2,TRUE,0.5,2018,2018-2019
DE,2019-01-31,intra-ui,1502,219,45,11,11,10,1,5,6,5,339,2154,1841,2060,TRUE,0.854688950789229,2018,2018-2019
DE,2019-02-28,inter-total,53,22,5,1,0,0,0,0,0,0,16,97,69,91,TRUE,0.711340206185567,2018,2018-2019
DE,2019-02-28,inter-ucfe,0,0,0,0,0,0,0,0,0,0,0,0,0,0,TRUE,0,2018,2018-2019
DE,2019-02-28,inter-ucx,0,0,0,0,0,0,0,0,0,0,0,0,0,0,TRUE,0,2018,2018-2019
DE,2019-02-28,inter-ui,53,22,5,1,0,0,0,0,0,0,16,97,69,91,TRUE,0.711340206185567,2018,2018-2019
DE,2019-02-28,intra-total,763,215,37,18,10,12,5,4,1,7,216,1288,979,1194,TRUE,0.760093167701863,2018,2018-2019
DE,2019-02-28,intra-ucfe,0,0,0,0,0,0,0,0,0,0,1,1,1,1,TRUE,1,2018,2018-2019
DE,2019-02-28,intra-ucx,0,0,0,0,0,0,0,0,0,0,0,0,0,0,TRUE,0,2018,2018-2019
DE,2019-02-28,intra-ui,763,215,37,18,10,12,5,4,1,7,215,1287,978,1193,TRUE,0.75990675990676,2018,2018-2019
DE,2019-03-31,inter-total,42,21,1,0,1,1,1,0,1,0,13,81,55,76,TRUE,0.679012345679012,2018,2018-2019
DE,2019-03-31,inter-ucfe,0,0,0,0,1,0,0,0,0,0,0,1,0,0,TRUE,0,2018,2018-2019
DE,2019-03-31,inter-ucx,0,0,0,0,0,0,0,0,0,0,0,0,0,0,TRUE,0,2018,2018-2019
DE,2019-03-31,inter-ui,42,21,1,0,0,1,1,0,1,0,13,80,55,76,TRUE,0.6875,2018,2018-2019
DE,2019-03-31,intra-total,406,167,24,7,7,11,12,4,2,10,159,809,565,732,TRUE,0.698393077873918,2018,2018-2019
DE,2019-03-31,intra-ucfe,0,0,0,0,0,0,0,0,0,0,1,1,1,1,TRUE,1,2018,2018-2019
DE,2019-03-31,intra-ucx,0,0,0,0,0,0,0,0,0,0,0,0,0,0,TRUE,0,2018,2018-2019
DE,2019-03-31,intra-ui,406,167,24,7,7,11,12,4,2,10,158,808,564,731,TRUE,0.698019801980198,2018,2018-2019
DE,2019-04-30,inter-total,35,19,7,1,1,0,0,0,0,0,14,77,49,68,TRUE,0.636363636363636,2018,2018-2019
DE,2019-04-30,inter-ucfe,0,0,0,0,0,0,0,0,0,0,0,0,0,0,TRUE,0,2018,2018-2019
DE,2019-04-30,inter-ucx,0,0,0,0,0,0,0,0,0,0,0,0,0,0,TRUE,0,2018,2018-2019
DE,2019-04-30,inter-ui,35,19,7,1,1,0,0,0,0,0,14,77,49,68,TRUE,0.636363636363636,2018,2018-2019
DE,2019-04-30,intra-total,463,147,48,4,8,13,4,4,1,12,166,870,629,776,TRUE,0.722988505747127,2018,2018-2019
DE,2019-04-30,intra-ucfe,0,1,0,0,1,0,0,0,0,0,0,2,0,1,TRUE,0,2018,2018-2019
DE,2019-04-30,intra-ucx,0,2,0,0,0,0,0,0,0,0,1,3,1,3,TRUE,0.333333333333333,2018,2018-2019
DE,2019-04-30,intra-ui,463,144,48,4,7,13,4,4,1,12,165,865,628,772,TRUE,0.726011560693642,2018,2018-2019
DE,2019-05-31,inter-total,35,9,7,2,0,0,0,0,0,0,14,67,49,58,TRUE,0.73134328358209,2018,2018-2019
DE,2019-05-31,inter-ucfe,0,0,0,0,0,0,0,0,0,0,0,0,0,0,TRUE,0,2018,2018-2019
DE,2019-05-31,inter-ucx,0,0,0,0,0,0,0,0,0,0,0,0,0,0,TRUE,0,2018,2018-2019
DE,2019-05-31,inter-ui,35,9,7,2,0,0,0,0,0,0,14,67,49,58,TRUE,0.73134328358209,2018,2018-2019
DE,2019-05-31,intra-total,348,151,27,12,9,17,5,3,1,3,136,712,484,635,TRUE,0.679775280898876,2018,2018-2019
DE,2019-05-31,intra-ucfe,0,0,0,0,0,1,0,0,0,0,0,1,0,0,TRUE,0,2018,2018-2019
DE,2019-05-31,intra-ucx,3,0,0,0,0,0,0,0,0,0,1,4,4,4,TRUE,1,2018,2018-2019
DE,2019-05-31,intra-ui,345,151,27,12,9,16,5,3,1,3,135,707,480,631,TRUE,0.678925035360679,2018,2018-2019
DE,2019-06-30,inter-total,44,15,6,6,5,1,0,0,0,1,19,97,63,78,TRUE,0.649484536082474,2018,2018-2019
DE,2019-06-30,inter-ucfe,0,0,0,0,0,0,0,0,0,0,0,0,0,0,TRUE,0,2018,2018-2019
DE,2019-06-30,inter-ucx,0,0,0,0,0,0,0,0,0,0,1,1,1,1,TRUE,1,2018,2018-2019
DE,2019-06-30,inter-ui,44,15,6,6,5,1,0,0,0,1,18,96,62,77,TRUE,0.645833333333333,2018,2018-2019
DE,2019-06-30,intra-total,587,116,52,21,13,8,6,2,1,3,158,967,745,861,TRUE,0.770423991726991,2018,2018-2019
DE,2019-06-30,intra-ucfe,0,0,1,0,0,0,0,0,0,0,0,1,0,0,TRUE,0,2018,2018-2019
DE,2019-06-30,intra-ucx,2,1,0,0,0,0,0,0,0,0,0,3,2,3,TRUE,0.666666666666667,2018,2018-2019
DE,2019-06-30,intra-ui,585,115,51,21,13,8,6,2,1,3,158,963,743,858,TRUE,0.771547248182762,2018,2018-2019
DE,2019-07-31,inter-total,52,18,6,1,2,0,1,1,0,0,21,102,73,91,TRUE,0.715686274509804,2019,2019-2020
DE,2019-07-31,inter-ucfe,1,0,0,0,0,0,0,0,0,0,0,1,1,1,TRUE,1,2019,2019-2020
DE,2019-07-31,inter-ucx,0,0,0,0,0,0,0,0,0,0,0,0,0,0,TRUE,0,2019,2019-2020
DE,2019-07-31,inter-ui,51,18,6,1,2,0,1,1,0,0,21,101,72,90,TRUE,0.712871287128713,2019,2019-2020
DE,2019-07-31,intra-total,903,207,60,18,18,18,7,4,5,6,213,1459,1116,1323,TRUE,0.764907470870459,2019,2019-2020
DE,2019-07-31,intra-ucfe,0,0,0,0,0,1,0,0,0,0,0,1,0,0,TRUE,0,2019,2019-2020
DE,2019-07-31,intra-ucx,1,0,1,1,0,0,0,0,0,0,0,3,1,1,TRUE,0.333333333333333,2019,2019-2020
DE,2019-07-31,intra-ui,902,207,59,17,18,17,7,4,5,6,213,1455,1115,1322,TRUE,0.766323024054983,2019,2019-2020
DE,2019-08-31,inter-total,32,23,7,2,2,4,0,0,0,2,22,94,54,77,TRUE,0.574468085106383,2019,2019-2020
DE,2019-08-31,inter-ucfe,0,1,0,0,0,0,0,0,0,0,0,1,0,1,TRUE,0,2019,2019-2020
DE,2019-08-31,inter-ucx,0,0,0,0,0,0,0,0,0,0,0,0,0,0,TRUE,0,2019,2019-2020
DE,2019-08-31,inter-ui,32,22,7,2,2,4,0,0,0,2,22,93,54,76,TRUE,0.580645161290323,2019,2019-2020
DE,2019-08-31,intra-total,469,184,72,20,17,11,10,6,3,2,171,965,640,824,TRUE,0.663212435233161,2019,2019-2020
DE,2019-08-31,intra-ucfe,0,1,0,0,0,0,0,1,0,0,0,2,0,1,TRUE,0,2019,2019-2020
DE,2019-08-31,intra-ucx,0,0,0,0,0,0,0,0,0,1,0,1,0,0,TRUE,0,2019,2019-2020
DE,2019-08-31,intra-ui,469,183,72,20,17,11,10,5,3,1,171,962,640,823,TRUE,0.665280665280665,2019,2019-2020
DE,2019-09-30,inter-total,34,13,6,0,0,2,0,1,2,1,22,81,56,69,TRUE,0.691358024691358,2019,2019-2020
DE,2019-09-30,inter-ucfe,0,0,0,0,0,0,0,0,0,0,0,0,0,0,TRUE,0,2019,2019-2020
DE,2019-09-30,inter-ucx,0,0,0,0,0,0,0,0,0,0,0,0,0,0,TRUE,0,2019,2019-2020
DE,2019-09-30,inter-ui,34,13,6,0,0,2,0,1,2,1,22,81,56,69,TRUE,0.691358024691358,2019,2019-2020
DE,2019-09-30,intra-total,279,170,70,23,6,11,11,6,4,5,127,712,406,576,TRUE,0.570224719101124,2019,2019-2020
DE,2019-09-30,intra-ucfe,0,1,0,1,0,0,0,0,0,0,0,2,0,1,TRUE,0,2019,2019-2020
DE,2019-09-30,intra-ucx,0,0,0,0,0,0,1,0,0,0,0,1,0,0,TRUE,0,2019,2019-2020
DE,2019-09-30,intra-ui,279,169,70,22,6,11,10,6,4,5,127,709,406,575,TRUE,0.572637517630465,2019,2019-2020
DE,2019-10-31,inter-total,40,22,5,1,0,1,0,0,0,0,16,85,56,78,TRUE,0.658823529411765,2019,2019-2020
DE,2019-10-31,inter-ucfe,0,0,0,0,0,0,0,0,0,0,0,0,0,0,TRUE,0,2019,2019-2020
DE,2019-10-31,inter-ucx,0,0,0,0,0,0,0,0,0,0,0,0,0,0,TRUE,0,2019,2019-2020
DE,2019-10-31,inter-ui,40,22,5,1,0,1,0,0,0,0,16,85,56,78,TRUE,0.658823529411765,2019,2019-2020
DE,2019-10-31,intra-total,363,188,49,14,7,7,6,5,3,5,163,810,526,714,TRUE,0.649382716049383,2019,2019-2020
DE,2019-10-31,intra-ucfe,0,2,1,0,0,0,0,0,0,0,0,3,0,2,TRUE,0,2019,2019-2020
DE,2019-10-31,intra-ucx,0,0,0,0,0,0,0,0,1,0,1,2,1,1,TRUE,0.5,2019,2019-2020
DE,2019-10-31,intra-ui,363,186,48,14,7,7,6,5,2,5,162,805,525,711,TRUE,0.652173913043478,2019,2019-2020
DE,2019-11-30,inter-total,41,23,4,2,1,1,1,0,0,1,19,93,60,83,TRUE,0.645161290322581,2019,2019-2020
DE,2019-11-30,inter-ucfe,0,0,0,0,0,0,0,0,0,0,0,0,0,0,TRUE,0,2019,2019-2020
DE,2019-11-30,inter-ucx,0,0,0,0,0,0,0,0,0,0,0,0,0,0,TRUE,0,2019,2019-2020
DE,2019-11-30,inter-ui,41,23,4,2,1,1,1,0,0,1,19,93,60,83,TRUE,0.645161290322581,2019,2019-2020
DE,2019-11-30,intra-total,434,170,28,12,4,6,6,1,1,6,156,824,590,760,TRUE,0.716019417475728,2019,2019-2020
DE,2019-11-30,intra-ucfe,0,0,0,0,1,0,0,0,0,0,0,1,0,0,TRUE,0,2019,2019-2020
DE,2019-11-30,intra-ucx,0,0,0,0,0,0,0,0,0,0,0,0,0,0,TRUE,0,2019,2019-2020
DE,2019-11-30,intra-ui,434,170,28,12,3,6,6,1,1,6,156,823,590,760,TRUE,0.716889428918591,2019,2019-2020
DE,2019-12-31,inter-total,62,14,4,2,0,1,0,2,0,1,29,115,91,105,TRUE,0.791304347826087,2019,2019-2020
DE,2019-12-31,inter-ucfe,0,0,0,0,0,0,0,0,0,0,0,0,0,0,TRUE,0,2019,2019-2020
DE,2019-12-31,inter-ucx,0,0,0,0,0,0,0,0,0,0,0,0,0,0,TRUE,0,2019,2019-2020
DE,2019-12-31,inter-ui,62,14,4,2,0,1,0,2,0,1,29,115,91,105,TRUE,0.791304347826087,2019,2019-2020
DE,2019-12-31,intra-total,884,180,37,9,5,11,12,8,6,6,243,1401,1127,1307,TRUE,0.804425410421128,2019,2019-2020
DE,2019-12-31,intra-ucfe,0,2,0,0,1,1,0,0,0,0,0,4,0,2,TRUE,0,2019,2019-2020
DE,2019-12-31,intra-ucx,0,0,0,0,1,0,1,0,0,0,0,2,0,0,TRUE,0,2019,2019-2020
DE,2019-12-31,intra-ui,884,178,37,9,3,10,11,8,6,6,243,1395,1127,1305,TRUE,0.807885304659498,2019,2019-2020
DE,2020-01-31,inter-total,81,31,5,1,1,1,1,0,0,3,38,162,119,150,TRUE,0.734567901234568,2019,2019-2020
DE,2020-01-31,inter-ucfe,0,0,0,0,0,0,0,0,0,0,0,0,0,0,TRUE,0,2019,2019-2020
DE,2020-01-31,inter-ucx,0,0,0,0,0,0,0,0,0,0,0,0,0,0,TRUE,0,2019,2019-2020
DE,2020-01-31,inter-ui,81,31,5,1,1,1,1,0,0,3,38,162,119,150,TRUE,0.734567901234568,2019,2019-2020
DE,2020-01-31,intra-total,1074,204,57,22,11,7,12,4,1,11,366,1769,1440,1644,TRUE,0.814019219898248,2019,2019-2020
DE,2020-01-31,intra-ucfe,0,0,0,1,0,1,1,0,0,0,0,3,0,0,TRUE,0,2019,2019-2020
DE,2020-01-31,intra-ucx,0,0,0,0,0,0,0,0,0,1,0,1,0,0,TRUE,0,2019,2019-2020
DE,2020-01-31,intra-ui,1074,204,57,21,11,6,11,4,1,10,366,1765,1440,1644,TRUE,0.81586402266289,2019,2019-2020
DE,2020-02-29,inter-total,54,12,9,5,1,1,2,3,0,2,27,116,81,93,TRUE,0.698275862068966,2019,2019-2020
DE,2020-02-29,inter-ucfe,0,0,0,0,0,0,0,0,0,0,0,0,0,0,TRUE,0,2019,2019-2020
DE,2020-02-29,inter-ucx,0,0,0,0,0,0,0,0,0,0,0,0,0,0,TRUE,0,2019,2019-2020
DE,2020-02-29,inter-ui,54,12,9,5,1,1,2,3,0,2,27,116,81,93,TRUE,0.698275862068966,2019,2019-2020
DE,2020-02-29,intra-total,685,198,67,32,10,13,6,4,4,11,280,1310,965,1163,TRUE,0.736641221374046,2019,2019-2020
DE,2020-02-29,intra-ucfe,0,1,0,1,0,0,0,0,0,0,0,2,0,1,TRUE,0,2019,2019-2020
DE,2020-02-29,intra-ucx,1,0,2,1,0,0,0,0,0,1,0,5,1,1,TRUE,0.2,2019,2019-2020
DE,2020-02-29,intra-ui,684,197,65,30,10,13,6,4,4,10,280,1303,964,1161,TRUE,0.73983115886416,2019,2019-2020
DE,2020-03-31,inter-total,1977,27,6,2,2,2,2,0,0,0,52,2070,2029,2056,TRUE,0.980193236714976,2019,2019-2020
DE,2020-03-31,inter-ucfe,0,0,0,0,0,0,0,0,0,0,0,0,0,0,TRUE,0,2019,2019-2020
DE,2020-03-31,inter-ucx,0,0,0,0,0,0,0,0,0,0,0,0,0,0,TRUE,0,2019,2019-2020
DE,2020-03-31,inter-ui,1977,27,6,2,2,2,2,0,0,0,52,2070,2029,2056,TRUE,0.980193236714976,2019,2019-2020
DE,2020-03-31,intra-total,6822,214,46,16,13,12,10,4,5,11,948,8101,7770,7984,TRUE,0.959140846809036,2019,2019-2020
DE,2020-03-31,intra-ucfe,1,0,0,0,0,0,1,0,0,0,1,3,2,2,TRUE,0.666666666666667,2019,2019-2020
DE,2020-03-31,intra-ucx,1,0,1,0,0,0,1,0,0,0,0,3,1,1,TRUE,0.333333333333333,2019,2019-2020
DE,2020-03-31,intra-ui,6820,214,45,16,13,12,8,4,5,11,947,8095,7767,7981,TRUE,0.959481161210624,2019,2019-2020
DE,2020-04-30,inter-total,3876,274,144,56,7,1,0,1,1,1,822,5183,4698,4972,TRUE,0.906424850472699,2019,2019-2020
DE,2020-04-30,inter-ucfe,0,0,0,0,0,0,0,0,0,0,0,0,0,0,TRUE,0,2019,2019-2020
DE,2020-04-30,inter-ucx,0,0,0,0,0,0,0,0,0,0,0,0,0,0,TRUE,0,2019,2019-2020
DE,2020-04-30,inter-ui,3876,274,144,56,7,1,0,1,1,1,822,5183,4698,4972,TRUE,0.906424850472699,2019,2019-2020
DE,2020-04-30,intra-total,17263,1842,775,310,68,5,8,5,7,10,3945,24238,21208,23050,TRUE,0.874989685617625,2019,2019-2020
DE,2020-04-30,intra-ucfe,0,0,0,0,0,0,0,0,0,0,0,0,0,0,TRUE,0,2019,2019-2020
DE,2020-04-30,intra-ucx,1,0,0,0,0,0,0,0,0,0,0,1,1,1,TRUE,1,2019,2019-2020
DE,2020-04-30,intra-ui,17262,1842,775,310,68,5,8,5,7,10,3945,24237,21207,23049,TRUE,0.874984527788093,2019,2019-2020
DE,2020-05-31,inter-total,592,89,132,145,108,60,34,9,2,1,160,1332,752,841,TRUE,0.564564564564565,2019,2019-2020
DE,2020-05-31,inter-ucfe,1,0,0,0,0,0,0,0,0,0,0,1,1,1,TRUE,1,2019,2019-2020
DE,2020-05-31,inter-ucx,0,0,0,1,0,0,0,0,0,0,0,1,0,0,TRUE,0,2019,2019-2020
DE,2020-05-31,inter-ui,591,89,132,144,108,60,34,9,2,1,160,1330,751,840,TRUE,0.564661654135338,2019,2019-2020
DE,2020-05-31,intra-total,5688,845,841,763,650,459,239,84,27,25,1371,10992,7059,7904,TRUE,0.642194323144105,2019,2019-2020
DE,2020-05-31,intra-ucfe,0,0,1,0,1,0,0,0,0,0,0,2,0,0,TRUE,0,2019,2019-2020
DE,2020-05-31,intra-ucx,1,1,0,1,0,0,0,0,0,0,1,4,2,3,TRUE,0.5,2019,2019-2020
DE,2020-05-31,intra-ui,5687,844,840,762,649,459,239,84,27,25,1370,10986,7057,7901,TRUE,0.642363007464045,2019,2019-2020
DE,2020-06-30,inter-total,263,19,28,23,23,32,42,48,35,68,35,616,298,317,TRUE,0.483766233766234,2019,2019-2020
DE,2020-06-30,inter-ucfe,0,0,0,0,0,0,0,0,1,0,0,1,0,0,TRUE,0,2019,2019-2020
DE,2020-06-30,inter-ucx,0,0,0,0,0,0,0,0,0,0,0,0,0,0,TRUE,0,2019,2019-2020
DE,2020-06-30,inter-ui,263,19,28,23,23,32,42,48,34,68,35,615,298,317,TRUE,0.484552845528455,2019,2019-2020
DE,2020-06-30,intra-total,2620,255,177,165,183,193,219,313,255,495,424,5299,3044,3299,TRUE,0.574448009058313,2019,2019-2020
DE,2020-06-30,intra-ucfe,0,0,0,0,0,0,0,0,1,0,1,2,1,1,TRUE,0.5,2019,2019-2020
DE,2020-06-30,intra-ucx,0,1,0,0,2,0,0,1,0,2,0,6,0,1,TRUE,0,2019,2019-2020
DE,2020-06-30,intra-ui,2620,254,177,165,181,193,219,312,254,493,423,5291,3043,3297,TRUE,0.575127575127575,2019,2019-2020
DE,2020-07-31,inter-total,154,12,10,12,8,11,9,18,13,148,19,414,173,185,TRUE,0.417874396135266,2020,2020-2021
DE,2020-07-31,inter-ucfe,0,0,0,0,0,0,0,0,0,2,1,3,1,1,TRUE,0.333333333333333,2020,2020-2021
DE,2020-07-31,inter-ucx,1,0,0,0,0,0,0,0,0,0,0,1,1,1,TRUE,1,2020,2020-2021
DE,2020-07-31,inter-ui,153,12,10,12,8,11,9,18,13,146,18,410,171,183,TRUE,0.417073170731707,2020,2020-2021
DE,2020-07-31,intra-total,1578,172,146,107,89,84,82,85,73,788,265,3469,1843,2015,TRUE,0.531277025079274,2020,2020-2021
DE,2020-07-31,intra-ucfe,3,0,0,0,0,1,0,1,0,3,0,8,3,3,TRUE,0.375,2020,2020-2021
DE,2020-07-31,intra-ucx,0,0,1,0,1,1,0,2,2,3,0,10,0,0,TRUE,0,2020,2020-2021
DE,2020-07-31,intra-ui,1575,172,145,107,88,82,82,82,71,782,265,3451,1840,2012,TRUE,0.533178788756882,2020,2020-2021
DE,2020-08-31,inter-total,91,13,16,6,8,3,7,5,7,130,13,299,104,117,TRUE,0.347826086956522,2020,2020-2021
DE,2020-08-31,inter-ucfe,1,0,0,0,0,0,0,0,0,0,0,1,1,1,TRUE,1,2020,2020-2021
DE,2020-08-31,inter-ucx,1,0,0,0,0,0,0,0,0,1,0,2,1,1,TRUE,0.5,2020,2020-2021
DE,2020-08-31,inter-ui,89,13,16,6,8,3,7,5,7,129,13,296,102,115,TRUE,0.344594594594595,2020,2020-2021
DE,2020-08-31,intra-total,874,111,90,59,62,46,52,46,24,744,147,2255,1021,1132,TRUE,0.452771618625277,2020,2020-2021
DE,2020-08-31,intra-ucfe,3,0,1,0,0,0,0,0,0,4,0,8,3,3,TRUE,0.375,2020,2020-2021
DE,2020-08-31,intra-ucx,6,3,0,1,2,1,0,2,1,10,2,28,8,11,TRUE,0.285714285714286,2020,2020-2021
DE,2020-08-31,intra-ui,865,108,89,58,60,45,52,44,23,730,145,2219,1010,1118,TRUE,0.455159981973862,2020,2020-2021
DE,2020-09-30,inter-total,70,7,6,4,6,5,4,6,4,64,6,182,76,83,TRUE,0.417582417582418,2020,2020-2021
DE,2020-09-30,inter-ucfe,0,0,0,0,0,0,0,0,0,0,0,0,0,0,TRUE,0,2020,2020-2021
DE,2020-09-30,inter-ucx,0,0,0,0,0,0,0,0,0,0,0,0,0,0,TRUE,0,2020,2020-2021
DE,2020-09-30,inter-ui,70,7,6,4,6,5,4,6,4,64,6,182,76,83,TRUE,0.417582417582418,2020,2020-2021
DE,2020-09-30,intra-total,460,86,57,48,31,56,29,24,34,418,114,1357,574,660,TRUE,0.422991893883567,2020,2020-2021
DE,2020-09-30,intra-ucfe,1,1,1,1,0,0,1,0,0,0,1,6,2,3,TRUE,0.333333333333333,2020,2020-2021
DE,2020-09-30,intra-ucx,1,0,0,0,0,0,0,0,0,0,2,3,3,3,TRUE,1,2020,2020-2021
DE,2020-09-30,intra-ui,458,85,56,47,31,56,28,24,34,418,111,1348,569,654,TRUE,0.422106824925816,2020,2020-2021
DE,2020-10-31,inter-total,46,2,3,3,2,3,0,3,3,117,5,187,51,53,TRUE,0.272727272727273,2020,2020-2021
DE,2020-10-31,inter-ucfe,0,0,0,0,0,0,0,0,0,1,0,1,0,0,TRUE,0,2020,2020-2021
DE,2020-10-31,inter-ucx,0,0,0,0,0,0,0,0,0,0,0,0,0,0,TRUE,0,2020,2020-2021
DE,2020-10-31,inter-ui,46,2,3,3,2,3,0,3,3,116,5,186,51,53,TRUE,0.274193548387097,2020,2020-2021
DE,2020-10-31,intra-total,433,50,31,41,28,22,27,26,31,633,58,1380,491,541,TRUE,0.355797101449275,2020,2020-2021
DE,2020-10-31,intra-ucfe,2,0,1,1,0,0,0,0,1,6,0,11,2,2,TRUE,0.181818181818182,2020,2020-2021
DE,2020-10-31,intra-ucx,2,1,1,0,0,0,0,0,0,8,1,13,3,4,TRUE,0.230769230769231,2020,2020-2021
DE,2020-10-31,intra-ui,429,49,29,40,28,22,27,26,30,619,57,1356,486,535,TRUE,0.358407079646018,2020,2020-2021
DE,2020-11-30,inter-total,65,2,3,2,1,2,4,1,4,56,9,149,74,76,TRUE,0.496644295302014,2020,2020-2021
DE,2020-11-30,inter-ucfe,0,0,0,0,0,0,0,0,0,1,0,1,0,0,TRUE,0,2020,2020-2021
DE,2020-11-30,inter-ucx,1,0,0,0,0,0,0,0,0,0,0,1,1,1,TRUE,1,2020,2020-2021
DE,2020-11-30,inter-ui,64,2,3,2,1,2,4,1,4,55,9,147,73,75,TRUE,0.496598639455782,2020,2020-2021
DE,2020-11-30,intra-total,495,39,33,36,21,19,25,24,20,378,65,1155,560,599,TRUE,0.484848484848485,2020,2020-2021
DE,2020-11-30,intra-ucfe,9,5,2,1,0,0,0,0,0,3,2,22,11,16,TRUE,0.5,2020,2020-2021
DE,2020-11-30,intra-ucx,0,0,1,0,0,0,0,0,0,4,1,6,1,1,TRUE,0.166666666666667,2020,2020-2021
DE,2020-11-30,intra-ui,486,34,30,35,21,19,25,24,20,371,62,1127,548,582,TRUE,0.486246672582076,2020,2020-2021
DE,2020-12-31,inter-total,93,8,5,2,4,2,1,0,2,72,6,195,99,107,TRUE,0.507692307692308,2020,2020-2021
DE,2020-12-31,inter-ucfe,2,1,0,0,0,0,0,0,0,0,0,3,2,3,TRUE,0.666666666666667,2020,2020-2021
DE,2020-12-31,inter-ucx,0,0,0,0,0,0,0,0,0,0,0,0,0,0,TRUE,0,2020,2020-2021
DE,2020-12-31,inter-ui,91,7,5,2,4,2,1,0,2,72,6,192,97,104,TRUE,0.505208333333333,2020,2020-2021
DE,2020-12-31,intra-total,707,48,43,35,34,27,30,25,26,458,114,1547,821,869,TRUE,0.530704589528119,2020,2020-2021
DE,2020-12-31,intra-ucfe,2,3,3,2,1,0,1,0,1,2,2,17,4,7,TRUE,0.235294117647059,2020,2020-2021
DE,2020-12-31,intra-ucx,2,1,0,1,0,0,0,0,0,3,2,9,4,5,TRUE,0.444444444444444,2020,2020-2021
DE,2020-12-31,intra-ui,703,44,40,32,33,27,29,25,25,453,110,1521,813,857,TRUE,0.534516765285996,2020,2020-2021
DE,2021-01-31,inter-total,91,2,4,8,9,2,9,3,5,42,18,193,109,111,TRUE,0.564766839378238,2020,2020-2021
DE,2021-01-31,inter-ucfe,0,0,0,0,1,0,0,0,0,0,0,1,0,0,TRUE,0,2020,2020-2021
DE,2021-01-31,inter-ucx,0,0,0,0,0,0,0,0,0,0,0,0,0,0,TRUE,0,2020,2020-2021
DE,2021-01-31,inter-ui,91,2,4,8,8,2,9,3,5,42,18,192,109,111,TRUE,0.567708333333333,2020,2020-2021
DE,2021-01-31,intra-total,993,72,50,51,42,34,41,30,17,309,162,1801,1155,1227,TRUE,0.641310383120489,2020,2020-2021
DE,2021-01-31,intra-ucfe,6,1,0,0,0,0,2,0,0,0,2,11,8,9,TRUE,0.727272727272727,2020,2020-2021
DE,2021-01-31,intra-ucx,3,0,1,0,1,1,0,0,0,1,0,7,3,3,TRUE,0.428571428571429,2020,2020-2021
DE,2021-01-31,intra-ui,984,71,49,51,41,33,39,30,17,308,160,1783,1144,1215,TRUE,0.641615255187886,2020,2020-2021
DE,2021-02-28,inter-total,86,6,0,4,4,1,2,2,3,50,9,167,95,101,TRUE,0.568862275449102,2020,2020-2021
DE,2021-02-28,inter-ucfe,0,1,0,0,0,0,0,0,1,0,0,2,0,1,TRUE,0,2020,2020-2021
DE,2021-02-28,inter-ucx,0,0,0,0,0,0,0,0,0,0,0,0,0,0,TRUE,0,2020,2020-2021
DE,2021-02-28,inter-ui,86,5,0,4,4,1,2,2,2,50,9,165,95,100,TRUE,0.575757575757576,2020,2020-2021
DE,2021-02-28,intra-total,762,59,63,55,42,39,26,31,16,379,122,1594,884,943,TRUE,0.554579673776663,2020,2020-2021
DE,2021-02-28,intra-ucfe,5,1,1,1,1,1,0,0,0,3,2,15,7,8,TRUE,0.466666666666667,2020,2020-2021
DE,2021-02-28,intra-ucx,0,0,0,1,0,0,0,0,0,1,0,2,0,0,TRUE,0,2020,2020-2021
DE,2021-02-28,intra-ui,757,58,62,53,41,38,26,31,16,375,120,1577,877,935,TRUE,0.556119213696893,2020,2020-2021
DE,2021-03-31,inter-total,53,1,4,2,1,3,5,2,6,73,8,158,61,62,TRUE,0.386075949367089,2020,2020-2021
DE,2021-03-31,inter-ucfe,0,0,0,0,0,0,0,0,0,0,0,0,0,0,TRUE,0,2020,2020-2021
DE,2021-03-31,inter-ucx,0,0,0,0,0,0,0,0,0,2,0,2,0,0,TRUE,0,2020,2020-2021
DE,2021-03-31,inter-ui,53,1,4,2,1,3,5,2,6,71,8,156,61,62,TRUE,0.391025641025641,2020,2020-2021
DE,2021-03-31,intra-total,639,49,49,39,37,38,45,44,36,499,81,1556,720,769,TRUE,0.462724935732648,2020,2020-2021
DE,2021-03-31,intra-ucfe,3,0,0,0,0,2,3,0,0,3,0,11,3,3,TRUE,0.272727272727273,2020,2020-2021
DE,2021-03-31,intra-ucx,1,0,0,0,0,1,1,0,0,1,2,6,3,3,TRUE,0.5,2020,2020-2021
DE,2021-03-31,intra-ui,635,49,49,39,37,35,41,44,36,495,79,1539,714,763,TRUE,0.463937621832359,2020,2020-2021
DE,2021-04-30,inter-total,83,4,1,2,0,1,2,4,0,38,15,150,98,102,TRUE,0.653333333333333,2020,2020-2021
DE,2021-04-30,inter-ucfe,1,0,0,0,0,0,0,0,0,0,0,1,1,1,TRUE,1,2020,2020-2021
DE,2021-04-30,inter-ucx,0,0,0,0,0,0,0,0,0,0,0,0,0,0,TRUE,0,2020,2020-2021
DE,2021-04-30,inter-ui,82,4,1,2,0,1,2,4,0,38,15,149,97,101,TRUE,0.651006711409396,2020,2020-2021
DE,2021-04-30,intra-total,1407,38,15,12,20,18,8,14,13,353,66,1964,1473,1511,TRUE,0.75,2020,2020-2021
DE,2021-04-30,intra-ucfe,3,0,0,0,0,1,0,0,0,3,1,8,4,4,TRUE,0.5,2020,2020-2021
DE,2021-04-30,intra-ucx,1,0,0,0,0,0,0,0,0,2,1,4,2,2,TRUE,0.5,2020,2020-2021
DE,2021-04-30,intra-ui,1403,38,15,12,20,17,8,14,13,348,64,1952,1467,1505,TRUE,0.751536885245902,2020,2020-2021
DE,2021-05-31,inter-total,99,3,2,0,1,0,2,0,2,44,7,160,106,109,TRUE,0.6625,2020,2020-2021
DE,2021-05-31,inter-ucfe,0,0,0,0,0,0,0,0,0,1,0,1,0,0,TRUE,0,2020,2020-2021
DE,2021-05-31,inter-ucx,0,0,0,0,0,0,0,0,0,0,0,0,0,0,TRUE,0,2020,2020-2021
DE,2021-05-31,inter-ui,99,3,2,0,1,0,2,0,2,43,7,159,106,109,TRUE,0.666666666666667,2020,2020-2021
DE,2021-05-31,intra-total,2233,24,24,34,19,18,15,13,11,319,55,2765,2288,2312,TRUE,0.82748643761302,2020,2020-2021
DE,2021-05-31,intra-ucfe,1,1,1,2,0,0,0,0,0,2,0,7,1,2,TRUE,0.142857142857143,2020,2020-2021
DE,2021-05-31,intra-ucx,2,0,1,0,0,0,0,0,0,2,1,6,3,3,TRUE,0.5,2020,2020-2021
DE,2021-05-31,intra-ui,2230,23,22,32,19,18,15,13,11,315,54,2752,2284,2307,TRUE,0.829941860465116,2020,2020-2021
DE,2021-06-30,inter-total,50,6,4,0,1,4,3,2,0,46,4,120,54,60,TRUE,0.45,2020,2020-2021
DE,2021-06-30,inter-ucfe,0,0,0,0,0,0,0,0,0,0,0,0,0,0,TRUE,0,2020,2020-2021
DE,2021-06-30,inter-ucx,0,0,0,0,0,0,0,0,0,0,0,0,0,0,TRUE,0,2020,2020-2021
DE,2021-06-30,inter-ui,50,6,4,0,1,4,3,2,0,46,4,120,54,60,TRUE,0.45,2020,2020-2021
DE,2021-06-30,intra-total,1690,17,23,11,14,9,19,14,21,254,57,2129,1747,1764,TRUE,0.820573038985439,2020,2020-2021
DE,2021-06-30,intra-ucfe,0,0,1,0,0,0,1,0,0,1,0,3,0,0,TRUE,0,2020,2020-2021
DE,2021-06-30,intra-ucx,1,0,1,0,0,0,0,0,1,0,0,3,1,1,TRUE,0.333333333333333,2020,2020-2021
DE,2021-06-30,intra-ui,1689,17,21,11,14,9,18,14,20,253,57,2123,1746,1763,TRUE,0.822421102213848,2020,2020-2021
DE,2021-07-31,inter-total,4,1,5,1,2,1,0,0,3,27,1,45,5,6,TRUE,0.111111111111111,2021,2021-2022
DE,2021-07-31,inter-ucfe,0,0,0,0,0,0,0,0,0,0,0,0,0,0,TRUE,0,2021,2021-2022
DE,2021-07-31,inter-ucx,0,0,0,0,0,0,0,0,0,0,0,0,0,0,TRUE,0,2021,2021-2022
DE,2021-07-31,inter-ui,4,1,5,1,2,1,0,0,3,27,1,45,5,6,TRUE,0.111111111111111,2021,2021-2022
DE,2021-07-31,intra-total,112,96,107,43,28,21,7,10,10,242,74,750,186,282,TRUE,0.248,2021,2021-2022
DE,2021-07-31,intra-ucfe,0,0,0,0,0,0,0,0,0,0,2,2,2,2,TRUE,1,2021,2021-2022
DE,2021-07-31,intra-ucx,0,0,0,0,0,0,0,0,0,0,1,1,1,1,TRUE,1,2021,2021-2022
DE,2021-07-31,intra-ui,112,96,107,43,28,21,7,10,10,242,71,747,183,279,TRUE,0.244979919678715,2021,2021-2022
DE,2021-08-31,inter-total,3,4,8,3,3,1,3,2,0,24,1,52,4,8,TRUE,0.0769230769230769,2021,2021-2022
DE,2021-08-31,inter-ucfe,0,0,0,0,0,0,0,0,0,0,0,0,0,0,TRUE,0,2021,2021-2022
DE,2021-08-31,inter-ucx,0,0,0,0,0,0,0,0,0,0,0,0,0,0,TRUE,0,2021,2021-2022
DE,2021-08-31,inter-ui,3,4,8,3,3,1,3,2,0,24,1,52,4,8,TRUE,0.0769230769230769,2021,2021-2022
DE,2021-08-31,intra-total,127,57,43,51,52,47,33,20,17,280,73,800,200,257,TRUE,0.25,2021,2021-2022
DE,2021-08-31,intra-ucfe,0,0,0,0,0,0,1,0,0,1,0,2,0,0,TRUE,0,2021,2021-2022
DE,2021-08-31,intra-ucx,0,0,0,0,0,0,0,1,0,0,0,1,0,0,TRUE,0,2021,2021-2022
DE,2021-08-31,intra-ui,127,57,43,51,52,47,32,19,17,279,73,797,200,257,TRUE,0.250941028858218,2021,2021-2022
DE,2021-09-30,inter-total,17,0,0,1,0,0,0,0,0,42,2,62,19,19,TRUE,0.306451612903226,2021,2021-2022
DE,2021-09-30,inter-ucfe,0,0,0,0,0,0,0,0,0,1,0,1,0,0,TRUE,0,2021,2021-2022
DE,2021-09-30,inter-ucx,0,0,0,0,0,0,0,0,0,0,0,0,0,0,TRUE,0,2021,2021-2022
DE,2021-09-30,inter-ui,17,0,0,1,0,0,0,0,0,41,2,61,19,19,TRUE,0.311475409836066,2021,2021-2022
DE,2021-09-30,intra-total,156,20,19,19,16,16,17,19,23,327,32,664,188,208,TRUE,0.283132530120482,2021,2021-2022
DE,2021-09-30,intra-ucfe,0,0,0,0,0,0,0,0,0,2,0,2,0,0,TRUE,0,2021,2021-2022
DE,2021-09-30,intra-ucx,1,0,0,1,0,0,0,0,0,0,0,2,1,1,TRUE,0.5,2021,2021-2022
DE,2021-09-30,intra-ui,155,20,19,18,16,16,17,19,23,325,32,660,187,207,TRUE,0.283333333333333,2021,2021-2022
DE,2021-10-31,inter-total,11,0,0,1,1,1,0,3,0,47,1,65,12,12,TRUE,0.184615384615385,2021,2021-2022
DE,2021-10-31,inter-ucfe,0,0,0,0,0,0,0,0,0,0,0,0,0,0,TRUE,0,2021,2021-2022
DE,2021-10-31,inter-ucx,0,0,0,0,0,0,0,1,0,0,0,1,0,0,TRUE,0,2021,2021-2022
DE,2021-10-31,inter-ui,11,0,0,1,1,1,0,2,0,47,1,64,12,12,TRUE,0.1875,2021,2021-2022
DE,2021-10-31,intra-total,130,14,9,23,14,16,11,13,6,350,19,605,149,163,TRUE,0.246280991735537,2021,2021-2022
DE,2021-10-31,intra-ucfe,0,0,0,0,0,0,0,0,0,3,1,4,1,1,TRUE,0.25,2021,2021-2022
DE,2021-10-31,intra-ucx,1,0,0,1,0,1,0,0,0,3,0,6,1,1,TRUE,0.166666666666667,2021,2021-2022
DE,2021-10-31,intra-ui,129,14,9,22,14,15,11,13,6,344,18,595,147,161,TRUE,0.247058823529412,2021,2021-2022
DE,2021-11-30,inter-total,15,0,2,0,0,1,1,0,1,43,1,64,16,16,TRUE,0.25,2021,2021-2022
DE,2021-11-30,inter-ucfe,0,0,0,0,0,0,0,0,0,0,0,0,0,0,TRUE,0,2021,2021-2022
DE,2021-11-30,inter-ucx,0,0,0,0,0,0,0,0,0,1,0,1,0,0,TRUE,0,2021,2021-2022
DE,2021-11-30,inter-ui,15,0,2,0,0,1,1,0,1,42,1,63,16,16,TRUE,0.253968253968254,2021,2021-2022
DE,2021-11-30,intra-total,128,18,9,7,6,8,12,6,11,356,16,577,144,162,TRUE,0.249566724436742,2021,2021-2022
DE,2021-11-30,intra-ucfe,0,0,0,1,0,0,0,0,0,1,0,2,0,0,TRUE,0,2021,2021-2022
DE,2021-11-30,intra-ucx,0,0,0,0,0,0,0,0,1,1,0,2,0,0,TRUE,0,2021,2021-2022
DE,2021-11-30,intra-ui,128,18,9,6,6,8,12,6,10,354,16,573,144,162,TRUE,0.25130890052356,2021,2021-2022
DE,2021-12-31,inter-total,13,2,3,1,3,0,0,1,0,34,7,64,20,22,TRUE,0.3125,2021,2021-2022
DE,2021-12-31,inter-ucfe,0,0,0,0,0,0,0,0,0,0,0,0,0,0,TRUE,0,2021,2021-2022
DE,2021-12-31,inter-ucx,0,0,0,0,0,0,0,0,0,0,0,0,0,0,TRUE,0,2021,2021-2022
DE,2021-12-31,inter-ui,13,2,3,1,3,0,0,1,0,34,7,64,20,22,TRUE,0.3125,2021,2021-2022
DE,2021-12-31,intra-total,202,25,32,18,14,20,10,11,9,375,60,776,262,287,TRUE,0.337628865979382,2021,2021-2022
DE,2021-12-31,intra-ucfe,0,0,0,0,0,0,1,1,1,2,0,5,0,0,TRUE,0,2021,2021-2022
DE,2021-12-31,intra-ucx,1,0,0,0,0,0,0,0,0,0,0,1,1,1,TRUE,1,2021,2021-2022
DE,2021-12-31,intra-ui,201,25,32,18,14,20,9,10,8,373,60,770,261,286,TRUE,0.338961038961039,2021,2021-2022
DE,2022-01-31,inter-total,33,3,2,1,0,2,3,3,0,34,2,83,35,38,TRUE,0.421686746987952,2021,2021-2022
DE,2022-01-31,inter-ucfe,0,0,0,0,0,0,0,0,0,0,0,0,0,0,TRUE,0,2021,2021-2022
DE,2022-01-31,inter-ucx,0,0,0,0,0,0,0,0,0,0,0,0,0,0,TRUE,0,2021,2021-2022
DE,2022-01-31,inter-ui,33,3,2,1,0,2,3,3,0,34,2,83,35,38,TRUE,0.421686746987952,2021,2021-2022
DE,2022-01-31,intra-total,457,41,41,26,23,25,6,8,11,269,101,1008,558,599,TRUE,0.553571428571429,2021,2021-2022
DE,2022-01-31,intra-ucfe,0,1,0,0,0,0,0,0,0,3,0,4,0,1,TRUE,0,2021,2021-2022
DE,2022-01-31,intra-ucx,0,0,0,0,1,0,0,0,0,0,0,1,0,0,TRUE,0,2021,2021-2022
DE,2022-01-31,intra-ui,457,40,41,26,22,25,6,8,11,266,101,1003,558,598,TRUE,0.556331006979063,2021,2021-2022
DE,2022-02-28,inter-total,25,1,0,3,2,0,2,0,3,44,4,84,29,30,TRUE,0.345238095238095,2021,2021-2022
DE,2022-02-28,inter-ucfe,0,0,0,0,0,0,0,0,0,1,0,1,0,0,TRUE,0,2021,2021-2022
DE,2022-02-28,inter-ucx,0,0,0,0,0,0,0,0,0,0,0,0,0,0,TRUE,0,2021,2021-2022
DE,2022-02-28,inter-ui,25,1,0,3,2,0,2,0,3,43,4,83,29,30,TRUE,0.349397590361446,2021,2021-2022
DE,2022-02-28,intra-total,242,38,34,31,34,26,14,16,14,390,62,901,304,342,TRUE,0.337402885682575,2021,2021-2022
DE,2022-02-28,intra-ucfe,0,0,0,0,0,0,0,0,0,1,0,1,0,0,TRUE,0,2021,2021-2022
DE,2022-02-28,intra-ucx,0,0,0,0,0,0,0,0,0,0,0,0,0,0,TRUE,0,2021,2021-2022
DE,2022-02-28,intra-ui,242,38,34,31,34,26,14,16,14,389,62,900,304,342,TRUE,0.337777777777778,2021,2021-2022
DE,2022-03-31,inter-total,18,1,2,2,5,4,4,6,3,42,5,92,23,24,TRUE,0.25,2021,2021-2022
DE,2022-03-31,inter-ucfe,0,0,0,0,0,0,0,0,0,0,0,0,0,0,TRUE,0,2021,2021-2022
DE,2022-03-31,inter-ucx,0,0,0,0,0,0,0,0,0,0,0,0,0,0,TRUE,0,2021,2021-2022
DE,2022-03-31,inter-ui,18,1,2,2,5,4,4,6,3,42,5,92,23,24,TRUE,0.25,2021,2021-2022
DE,2022-03-31,intra-total,162,37,32,30,24,56,60,51,47,299,32,830,194,231,TRUE,0.233734939759036,2021,2021-2022
DE,2022-03-31,intra-ucfe,0,0,0,1,0,0,0,0,0,1,0,2,0,0,TRUE,0,2021,2021-2022
DE,2022-03-31,intra-ucx,0,0,0,0,0,0,1,0,0,0,0,1,0,0,TRUE,0,2021,2021-2022
DE,2022-03-31,intra-ui,162,37,32,29,24,56,59,51,47,298,32,827,194,231,TRUE,0.234582829504232,2021,2021-2022
DE,2022-04-30,inter-total,8,6,2,2,3,1,4,1,1,31,5,64,13,19,TRUE,0.203125,2021,2021-2022
DE,2022-04-30,inter-ucfe,0,0,0,0,0,0,0,0,0,0,0,0,0,0,TRUE,0,2021,2021-2022
DE,2022-04-30,inter-ucx,0,0,0,0,0,0,0,0,0,0,0,0,0,0,TRUE,0,2021,2021-2022
DE,2022-04-30,inter-ui,8,6,2,2,3,1,4,1,1,31,5,64,13,19,TRUE,0.203125,2021,2021-2022
DE,2022-04-30,intra-total,154,38,35,42,26,20,15,16,12,253,52,663,206,244,TRUE,0.310708898944193,2021,2021-2022
DE,2022-04-30,intra-ucfe,1,0,0,0,0,0,0,0,0,4,1,6,2,2,TRUE,0.333333333333333,2021,2021-2022
DE,2022-04-30,intra-ucx,0,0,0,0,0,0,0,0,0,0,0,0,0,0,TRUE,0,2021,2021-2022
DE,2022-04-30,intra-ui,153,38,35,42,26,20,15,16,12,249,51,657,204,242,TRUE,0.310502283105023,2021,2021-2022
DE,2022-05-31,inter-total,19,7,1,1,1,0,0,1,0,24,8,62,27,34,TRUE,0.435483870967742,2021,2021-2022
DE,2022-05-31,inter-ucfe,0,0,0,0,0,0,0,0,0,0,0,0,0,0,TRUE,0,2021,2021-2022
DE,2022-05-31,inter-ucx,0,0,0,0,0,0,0,0,0,0,0,0,0,0,TRUE,0,2021,2021-2022
DE,2022-05-31,inter-ui,19,7,1,1,1,0,0,1,0,24,8,62,27,34,TRUE,0.435483870967742,2021,2021-2022
DE,2022-05-31,intra-total,124,58,37,20,9,8,7,7,5,161,79,515,203,261,TRUE,0.394174757281553,2021,2021-2022
DE,2022-05-31,intra-ucfe,0,0,0,2,0,0,0,0,0,2,0,4,0,0,TRUE,0,2021,2021-2022
DE,2022-05-31,intra-ucx,0,1,0,0,0,0,0,0,0,1,1,3,1,2,TRUE,0.333333333333333,2021,2021-2022
DE,2022-05-31,intra-ui,124,57,37,18,9,8,7,7,5,158,78,508,202,259,TRUE,0.397637795275591,2021,2021-2022
DE,2022-06-30,inter-total,11,3,1,0,3,3,2,1,1,19,4,48,15,18,TRUE,0.3125,2021,2021-2022
DE,2022-06-30,inter-ucfe,0,0,0,0,0,0,0,0,0,0,0,0,0,0,TRUE,0,2021,2021-2022
DE,2022-06-30,inter-ucx,0,0,0,0,0,0,0,0,0,0,0,0,0,0,TRUE,0,2021,2021-2022
DE,2022-06-30,inter-ui,11,3,1,0,3,3,2,1,1,19,4,48,15,18,TRUE,0.3125,2021,2021-2022
DE,2022-06-30,intra-total,221,63,37,37,17,17,16,10,13,136,58,625,279,342,TRUE,0.4464,2021,2021-2022
DE,2022-06-30,intra-ucfe,1,0,0,1,0,0,0,0,0,1,0,3,1,1,TRUE,0.333333333333333,2021,2021-2022
DE,2022-06-30,intra-ucx,0,0,0,0,0,0,0,0,0,0,0,0,0,0,TRUE,0,2021,2021-2022
DE,2022-06-30,intra-ui,220,63,37,36,17,17,16,10,13,135,58,622,278,341,TRUE,0.446945337620579,2021,2021-2022
DE,2022-07-31,inter-total,14,7,4,2,1,1,0,0,1,6,6,42,20,27,TRUE,0.476190476190476,2022,2022-2023
DE,2022-07-31,inter-ucfe,0,0,0,0,0,0,0,0,0,0,0,0,0,0,TRUE,0,2022,2022-2023
DE,2022-07-31,inter-ucx,0,0,0,0,0,0,0,0,0,0,0,0,0,0,TRUE,0,2022,2022-2023
DE,2022-07-31,inter-ui,14,7,4,2,1,1,0,0,1,6,6,42,20,27,TRUE,0.476190476190476,2022,2022-2023
DE,2022-07-31,intra-total,282,106,75,46,29,11,6,4,6,110,116,791,398,504,TRUE,0.503160556257901,2022,2022-2023
DE,2022-07-31,intra-ucfe,2,1,0,1,0,0,1,0,0,1,0,6,2,3,TRUE,0.333333333333333,2022,2022-2023
DE,2022-07-31,intra-ucx,1,0,1,0,0,0,0,0,0,0,0,2,1,1,TRUE,0.5,2022,2022-2023
DE,2022-07-31,intra-ui,279,105,74,45,29,11,5,4,6,109,116,783,395,500,TRUE,0.504469987228608,2022,2022-2023
DE,2022-08-31,inter-total,23,7,3,6,6,0,0,0,1,15,13,74,36,43,TRUE,0.486486486486487,2022,2022-2023
DE,2022-08-31,inter-ucfe,0,0,0,0,0,0,0,0,0,0,0,0,0,0,TRUE,0,2022,2022-2023
DE,2022-08-31,inter-ucx,0,0,0,0,0,0,0,0,0,0,0,0,0,0,TRUE,0,2022,2022-2023
DE,2022-08-31,inter-ui,23,7,3,6,6,0,0,0,1,15,13,74,36,43,TRUE,0.486486486486487,2022,2022-2023
DE,2022-08-31,intra-total,314,101,66,52,38,28,20,19,8,109,98,853,412,513,TRUE,0.483001172332943,2022,2022-2023
DE,2022-08-31,intra-ucfe,0,0,0,0,0,0,0,0,0,0,1,1,1,1,TRUE,1,2022,2022-2023
DE,2022-08-31,intra-ucx,0,1,0,0,0,0,0,0,0,0,2,3,2,3,TRUE,0.666666666666667,2022,2022-2023
DE,2022-08-31,intra-ui,314,100,66,52,38,28,20,19,8,109,95,849,409,509,TRUE,0.481743227326266,2022,2022-2023
DE,2022-09-30,inter-total,16,6,4,3,0,0,1,0,0,7,6,43,22,28,TRUE,0.511627906976744,2022,2022-2023
DE,2022-09-30,inter-ucfe,0,0,0,0,0,0,0,0,0,0,0,0,0,0,TRUE,0,2022,2022-2023
DE,2022-09-30,inter-ucx,0,0,0,0,0,0,0,0,0,1,0,1,0,0,TRUE,0,2022,2022-2023
DE,2022-09-30,inter-ui,16,6,4,3,0,0,1,0,0,6,6,42,22,28,TRUE,0.523809523809524,2022,2022-2023
DE,2022-09-30,intra-total,119,84,38,26,24,19,17,20,14,128,87,576,206,290,TRUE,0.357638888888889,2022,2022-2023
DE,2022-09-30,intra-ucfe,0,1,0,0,0,0,0,0,0,0,0,1,0,1,TRUE,0,2022,2022-2023
DE,2022-09-30,intra-ucx,2,1,0,0,0,0,0,0,0,1,0,4,2,3,TRUE,0.5,2022,2022-2023
DE,2022-09-30,intra-ui,117,82,38,26,24,19,17,20,14,127,87,571,204,286,TRUE,0.357267950963222,2022,2022-2023
DE,2022-10-31,inter-total,17,9,7,3,3,1,0,1,0,19,8,68,25,34,TRUE,0.367647058823529,2022,2022-2023
DE,2022-10-31,inter-ucfe,0,0,0,0,0,0,0,0,0,0,0,0,0,0,TRUE,0,2022,2022-2023
DE,2022-10-31,inter-ucx,0,0,0,0,0,0,0,0,0,0,0,0,0,0,TRUE,0,2022,2022-2023
DE,2022-10-31,inter-ui,17,9,7,3,3,1,0,1,0,19,8,68,25,34,TRUE,0.367647058823529,2022,2022-2023
DE,2022-10-31,intra-total,180,68,46,26,19,14,15,8,11,144,87,618,267,335,TRUE,0.432038834951456,2022,2022-2023
DE,2022-10-31,intra-ucfe,0,1,1,0,0,0,0,1,0,0,0,3,0,1,TRUE,0,2022,2022-2023
DE,2022-10-31,intra-ucx,0,0,0,0,0,0,0,0,0,1,1,2,1,1,TRUE,0.5,2022,2022-2023
DE,2022-10-31,intra-ui,180,67,45,26,19,14,15,7,11,143,86,613,266,333,TRUE,0.433931484502447,2022,2022-2023
DE,2022-11-30,inter-total,15,6,9,3,3,1,0,1,0,9,8,55,23,29,TRUE,0.418181818181818,2022,2022-2023
DE,2022-11-30,inter-ucfe,0,0,0,0,0,0,0,0,0,0,0,0,0,0,TRUE,0,2022,2022-2023
DE,2022-11-30,inter-ucx,0,0,0,0,0,0,0,0,0,0,0,0,0,0,TRUE,0,2022,2022-2023
DE,2022-11-30,inter-ui,15,6,9,3,3,1,0,1,0,9,8,55,23,29,TRUE,0.418181818181818,2022,2022-2023
DE,2022-11-30,intra-total,253,100,59,41,26,13,5,6,6,99,119,727,372,472,TRUE,0.511691884456671,2022,2022-2023
DE,2022-11-30,intra-ucfe,0,0,0,2,0,0,0,0,0,0,1,3,1,1,TRUE,0.333333333333333,2022,2022-2023
DE,2022-11-30,intra-ucx,0,0,0,0,0,0,0,0,0,0,0,0,0,0,TRUE,0,2022,2022-2023
DE,2022-11-30,intra-ui,253,100,59,39,26,13,5,6,6,99,118,724,371,471,TRUE,0.512430939226519,2022,2022-2023
DE,2022-12-31,inter-total,21,12,7,6,4,2,1,2,0,13,17,85,38,50,TRUE,0.447058823529412,2022,2022-2023
DE,2022-12-31,inter-ucfe,0,0,0,0,0,0,0,0,0,0,0,0,0,0,TRUE,0,2022,2022-2023
DE,2022-12-31,inter-ucx,0,0,0,0,0,0,0,0,0,0,0,0,0,0,TRUE,0,2022,2022-2023
DE,2022-12-31,inter-ui,21,12,7,6,4,2,1,2,0,13,17,85,38,50,TRUE,0.447058823529412,2022,2022-2023
DE,2022-12-31,intra-total,367,137,95,58,23,14,23,7,17,117,147,1005,514,651,TRUE,0.511442786069652,2022,2022-2023
DE,2022-12-31,intra-ucfe,2,0,0,1,0,0,0,0,0,0,0,3,2,2,TRUE,0.666666666666667,2022,2022-2023
DE,2022-12-31,intra-ucx,1,0,1,0,0,0,0,0,1,0,0,3,1,1,TRUE,0.333333333333333,2022,2022-2023
DE,2022-12-31,intra-ui,364,137,94,57,23,14,23,7,16,117,147,999,511,648,TRUE,0.511511511511512,2022,2022-2023
DE,2023-01-31,inter-total,37,11,8,9,2,4,0,1,0,11,15,98,52,63,TRUE,0.530612244897959,2022,2022-2023
DE,2023-01-31,inter-ucfe,0,0,0,0,0,0,0,0,0,0,0,0,0,0,TRUE,0,2022,2022-2023
DE,2023-01-31,inter-ucx,0,0,0,0,0,0,0,0,0,0,0,0,0,0,TRUE,0,2022,2022-2023
DE,2023-01-31,inter-ui,37,11,8,9,2,4,0,1,0,11,15,98,52,63,TRUE,0.530612244897959,2022,2022-2023
DE,2023-01-31,intra-total,461,126,92,42,29,19,12,8,8,92,229,1118,690,816,TRUE,0.617173524150268,2022,2022-2023
DE,2023-01-31,intra-ucfe,0,0,0,0,0,0,0,1,1,3,0,5,0,0,TRUE,0,2022,2022-2023
DE,2023-01-31,intra-ucx,0,1,1,0,0,0,1,1,0,1,0,5,0,1,TRUE,0,2022,2022-2023
DE,2023-01-31,intra-ui,461,125,91,42,29,19,11,6,7,88,229,1108,690,815,TRUE,0.622743682310469,2022,2022-2023
DE,2023-02-28,inter-total,25,9,9,8,7,1,2,1,0,18,15,95,40,49,TRUE,0.421052631578947,2022,2022-2023
DE,2023-02-28,inter-ucfe,0,0,0,0,0,0,0,0,0,0,0,0,0,0,TRUE,0,2022,2022-2023
DE,2023-02-28,inter-ucx,0,0,0,0,0,0,0,0,0,0,0,0,0,0,TRUE,0,2022,2022-2023
DE,2023-02-28,inter-ui,25,9,9,8,7,1,2,1,0,18,15,95,40,49,TRUE,0.421052631578947,2022,2022-2023
DE,2023-02-28,intra-total,288,144,100,64,46,28,14,9,5,112,160,970,448,592,TRUE,0.461855670103093,2022,2022-2023
DE,2023-02-28,intra-ucfe,1,1,1,0,1,0,0,0,0,0,0,4,1,2,TRUE,0.25,2022,2022-2023
DE,2023-02-28,intra-ucx,0,0,0,0,0,0,0,0,0,0,0,0,0,0,TRUE,0,2022,2022-2023
DE,2023-02-28,intra-ui,287,143,99,64,45,28,14,9,5,112,160,966,447,590,TRUE,0.462732919254658,2022,2022-2023
DE,2023-03-31,inter-total,20,9,8,5,6,2,1,3,2,11,8,75,28,37,TRUE,0.373333333333333,2022,2022-2023
DE,2023-03-31,inter-ucfe,0,0,0,0,0,0,0,0,0,0,0,0,0,0,TRUE,0,2022,2022-2023
DE,2023-03-31,inter-ucx,0,0,0,0,0,0,0,0,0,0,0,0,0,0,TRUE,0,2022,2022-2023
DE,2023-03-31,inter-ui,20,9,8,5,6,2,1,3,2,11,8,75,28,37,TRUE,0.373333333333333,2022,2022-2023
DE,2023-03-31,intra-total,212,137,86,59,43,30,23,14,20,108,128,860,340,477,TRUE,0.395348837209302,2022,2022-2023
DE,2023-03-31,intra-ucfe,0,1,0,0,0,0,0,0,1,1,0,3,0,1,TRUE,0,2022,2022-2023
DE,2023-03-31,intra-ucx,0,0,0,0,1,0,0,0,0,0,0,1,0,0,TRUE,0,2022,2022-2023
DE,2023-03-31,intra-ui,212,136,86,59,42,30,23,14,19,107,128,856,340,476,TRUE,0.397196261682243,2022,2022-2023
DE,2023-04-30,inter-total,18,9,3,2,3,1,0,0,1,5,16,58,34,43,TRUE,0.586206896551724,2022,2022-2023
DE,2023-04-30,inter-ucfe,0,0,0,0,0,0,0,0,0,0,0,0,0,0,TRUE,0,2022,2022-2023
DE,2023-04-30,inter-ucx,0,0,0,0,0,0,0,0,0,0,0,0,0,0,TRUE,0,2022,2022-2023
DE,2023-04-30,inter-ui,18,9,3,2,3,1,0,0,1,5,16,58,34,43,TRUE,0.586206896551724,2022,2022-2023
DE,2023-04-30,intra-total,201,87,49,33,29,13,16,11,11,88,120,658,321,408,TRUE,0.487841945288754,2022,2022-2023
DE,2023-04-30,intra-ucfe,0,0,0,0,0,0,0,0,0,0,0,0,0,0,TRUE,0,2022,2022-2023
DE,2023-04-30,intra-ucx,0,0,1,0,1,0,0,1,0,0,0,3,0,0,TRUE,0,2022,2022-2023
DE,2023-04-30,intra-ui,201,87,48,33,28,13,16,10,11,88,120,655,321,408,TRUE,0.490076335877863,2022,2022-2023
DE,2023-05-31,inter-total,19,12,7,3,5,0,1,1,2,8,10,68,29,41,TRUE,0.426470588235294,2022,2022-2023
DE,2023-05-31,inter-ucfe,0,0,0,0,0,0,0,0,0,0,0,0,0,0,TRUE,0,2022,2022-2023
DE,2023-05-31,inter-ucx,0,0,0,0,0,0,0,0,0,0,0,0,0,0,TRUE,0,2022,2022-2023
DE,2023-05-31,inter-ui,19,12,7,3,5,0,1,1,2,8,10,68,29,41,TRUE,0.426470588235294,2022,2022-2023
DE,2023-05-31,intra-total,182,113,78,37,21,14,10,8,8,79,115,665,297,410,TRUE,0.446616541353384,2022,2022-2023
DE,2023-05-31,intra-ucfe,0,1,1,1,0,0,0,0,0,0,0,3,0,1,TRUE,0,2022,2022-2023
DE,2023-05-31,intra-ucx,1,0,0,0,0,0,0,0,0,0,1,2,2,2,TRUE,1,2022,2022-2023
DE,2023-05-31,intra-ui,181,112,77,36,21,14,10,8,8,79,114,660,295,407,TRUE,0.446969696969697,2022,2022-2023
DE,2023-06-30,inter-total,20,8,4,1,0,1,2,1,2,4,18,61,38,46,TRUE,0.622950819672131,2022,2022-2023
DE,2023-06-30,inter-ucfe,0,0,0,0,0,0,0,0,0,0,0,0,0,0,TRUE,0,2022,2022-2023
DE,2023-06-30,inter-ucx,0,0,0,0,0,0,0,0,0,0,0,0,0,0,TRUE,0,2022,2022-2023
DE,2023-06-30,inter-ui,20,8,4,1,0,1,2,1,2,4,18,61,38,46,TRUE,0.622950819672131,2022,2022-2023
DE,2023-06-30,intra-total,444,144,78,28,17,10,11,6,7,57,198,1000,642,786,TRUE,0.642,2022,2022-2023
DE,2023-06-30,intra-ucfe,0,0,0,0,0,0,0,0,0,1,1,2,1,1,TRUE,0.5,2022,2022-2023
DE,2023-06-30,intra-ucx,0,0,1,1,0,0,0,0,0,1,0,3,0,0,TRUE,0,2022,2022-2023
DE,2023-06-30,intra-ui,444,144,77,27,17,10,11,6,7,55,197,995,641,785,TRUE,0.644221105527638,2022,2022-2023
DE,2023-07-31,inter-total,36,13,8,2,0,1,0,1,0,5,12,78,48,61,TRUE,0.615384615384615,2023,2023-2024
DE,2023-07-31,inter-ucfe,0,0,0,0,0,0,0,0,0,0,1,1,1,1,TRUE,1,2023,2023-2024
DE,2023-07-31,inter-ucx,0,0,0,0,0,0,0,0,0,0,0,0,0,0,TRUE,0,2023,2023-2024
DE,2023-07-31,inter-ui,36,13,8,2,0,1,0,1,0,5,11,77,47,60,TRUE,0.61038961038961,2023,2023-2024
DE,2023-07-31,intra-total,473,180,99,37,22,13,6,10,5,58,176,1079,649,829,TRUE,0.601482854494903,2023,2023-2024
DE,2023-07-31,intra-ucfe,0,0,0,0,0,0,1,0,0,0,1,2,1,1,TRUE,0.5,2023,2023-2024
DE,2023-07-31,intra-ucx,0,0,2,0,0,0,0,0,0,2,0,4,0,0,TRUE,0,2023,2023-2024
DE,2023-07-31,intra-ui,473,180,97,37,22,13,5,10,5,56,175,1073,648,828,TRUE,0.603914259086673,2023,2023-2024
DE,2023-08-31,inter-total,35,11,7,1,2,1,0,0,1,8,15,81,50,61,TRUE,0.617283950617284,2023,2023-2024
DE,2023-08-31,inter-ucfe,0,0,0,0,0,0,0,0,0,0,0,0,0,0,TRUE,0,2023,2023-2024
DE,2023-08-31,inter-ucx,0,0,0,0,0,0,0,0,0,0,0,0,0,0,TRUE,0,2023,2023-2024
DE,2023-08-31,inter-ui,35,11,7,1,2,1,0,0,1,8,15,81,50,61,TRUE,0.617283950617284,2023,2023-2024
DE,2023-08-31,intra-total,384,130,98,58,31,22,13,5,8,80,159,988,543,673,TRUE,0.549595141700405,2023,2023-2024
DE,2023-08-31,intra-ucfe,1,0,0,0,1,0,0,0,0,0,0,2,1,1,TRUE,0.5,2023,2023-2024
DE,2023-08-31,intra-ucx,0,0,0,0,0,0,0,0,0,0,0,0,0,0,TRUE,0,2023,2023-2024
DE,2023-08-31,intra-ui,383,130,98,58,30,22,13,5,8,80,159,986,542,672,TRUE,0.549695740365112,2023,2023-2024
DE,2023-09-30,inter-total,25,17,10,8,2,7,2,3,0,8,8,90,33,50,TRUE,0.366666666666667,2023,2023-2024
DE,2023-09-30,inter-ucfe,0,0,0,0,0,0,0,0,0,0,0,0,0,0,TRUE,0,2023,2023-2024
DE,2023-09-30,inter-ucx,0,0,0,0,0,0,0,0,0,0,0,0,0,0,TRUE,0,2023,2023-2024
DE,2023-09-30,inter-ui,25,17,10,8,2,7,2,3,0,8,8,90,33,50,TRUE,0.366666666666667,2023,2023-2024
DE,2023-09-30,intra-total,226,171,124,64,33,26,10,13,7,140,160,974,386,557,TRUE,0.396303901437372,2023,2023-2024
DE,2023-09-30,intra-ucfe,1,0,0,1,0,0,1,0,0,0,2,5,3,3,TRUE,0.6,2023,2023-2024
DE,2023-09-30,intra-ucx,0,0,0,0,0,0,0,0,0,0,0,0,0,0,TRUE,0,2023,2023-2024
DE,2023-09-30,intra-ui,225,171,124,63,33,26,9,13,7,140,158,969,383,554,TRUE,0.395252837977296,2023,2023-2024
DE,2023-10-31,inter-total,31,19,11,6,3,0,2,1,0,5,15,93,46,65,TRUE,0.494623655913979,2023,2023-2024
DE,2023-10-31,inter-ucfe,0,0,0,0,0,0,0,0,0,0,0,0,0,0,TRUE,0,2023,2023-2024
DE,2023-10-31,inter-ucx,0,0,0,0,0,0,0,0,0,0,0,0,0,0,TRUE,0,2023,2023-2024
DE,2023-10-31,inter-ui,31,19,11,6,3,0,2,1,0,5,15,93,46,65,TRUE,0.494623655913979,2023,2023-2024
DE,2023-10-31,intra-total,216,174,97,31,14,17,8,7,7,84,127,782,343,517,TRUE,0.438618925831202,2023,2023-2024
DE,2023-10-31,intra-ucfe,0,0,0,0,0,0,0,0,0,0,1,1,1,1,TRUE,1,2023,2023-2024
DE,2023-10-31,intra-ucx,1,1,0,0,0,0,0,0,0,0,0,2,1,2,TRUE,0.5,2023,2023-2024
DE,2023-10-31,intra-ui,215,173,97,31,14,17,8,7,7,84,126,779,341,514,TRUE,0.437740693196406,2023,2023-2024
DE,2023-11-30,inter-total,37,18,4,4,3,1,1,0,2,9,13,92,50,68,TRUE,0.543478260869565,2023,2023-2024
DE,2023-11-30,inter-ucfe,0,0,0,0,0,0,0,0,0,0,0,0,0,0,TRUE,0,2023,2023-2024
DE,2023-11-30,inter-ucx,0,0,0,0,1,0,0,0,0,0,0,1,0,0,TRUE,0,2023,2023-2024
DE,2023-11-30,inter-ui,37,18,4,4,2,1,1,0,2,9,13,91,50,68,TRUE,0.54945054945055,2023,2023-2024
DE,2023-11-30,intra-total,322,182,92,26,20,8,11,5,6,52,147,871,469,651,TRUE,0.538461538461538,2023,2023-2024
DE,2023-11-30,intra-ucfe,0,1,0,0,0,0,0,0,0,2,0,3,0,1,TRUE,0,2023,2023-2024
DE,2023-11-30,intra-ucx,0,0,0,1,0,0,0,0,0,0,0,1,0,0,TRUE,0,2023,2023-2024
DE,2023-11-30,intra-ui,322,181,92,25,20,8,11,5,6,50,147,867,469,650,TRUE,0.540945790080738,2023,2023-2024
DE,2023-12-31,inter-total,48,15,4,6,4,2,0,0,1,11,13,104,61,76,TRUE,0.586538461538462,2023,2023-2024
DE,2023-12-31,inter-ucfe,0,0,0,0,0,0,0,0,0,0,0,0,0,0,TRUE,0,2023,2023-2024
DE,2023-12-31,inter-ucx,0,0,0,0,0,0,0,0,0,0,0,0,0,0,TRUE,0,2023,2023-2024
DE,2023-12-31,inter-ui,48,15,4,6,4,2,0,0,1,11,13,104,61,76,TRUE,0.586538461538462,2023,2023-2024
DE,2023-12-31,intra-total,454,124,93,71,28,21,8,11,4,66,190,1070,644,768,TRUE,0.601869158878505,2023,2023-2024
DE,2023-12-31,intra-ucfe,0,1,0,0,0,0,0,0,0,0,0,1,0,1,TRUE,0,2023,2023-2024
DE,2023-12-31,intra-ucx,0,0,0,0,0,0,0,0,0,0,0,0,0,0,TRUE,0,2023,2023-2024
DE,2023-12-31,intra-ui,454,123,93,71,28,21,8,11,4,66,190,1069,644,767,TRUE,0.60243217960711,2023,2023-2024
DE,2024-01-31,inter-total,59,8,8,7,7,3,1,0,0,7,18,118,77,85,TRUE,0.652542372881356,2023,2023-2024
DE,2024-01-31,inter-ucfe,0,0,0,0,0,0,0,0,0,0,0,0,0,0,TRUE,0,2023,2023-2024
DE,2024-01-31,inter-ucx,0,0,0,0,0,0,0,0,0,0,0,0,0,0,TRUE,0,2023,2023-2024
DE,2024-01-31,inter-ui,59,8,8,7,7,3,1,0,0,7,18,118,77,85,TRUE,0.652542372881356,2023,2023-2024
DE,2024-01-31,intra-total,651,127,97,48,62,34,24,17,7,72,248,1387,899,1026,TRUE,0.64816149963951,2023,2023-2024
DE,2024-01-31,intra-ucfe,1,0,0,0,0,0,0,0,0,0,0,1,1,1,TRUE,1,2023,2023-2024
DE,2024-01-31,intra-ucx,0,0,1,0,0,0,0,0,0,0,0,1,0,0,TRUE,0,2023,2023-2024
DE,2024-01-31,intra-ui,650,127,96,48,62,34,24,17,7,72,248,1385,898,1025,TRUE,0.648375451263538,2023,2023-2024
DE,2024-02-29,inter-total,38,10,13,5,3,6,2,2,0,2,15,96,53,63,TRUE,0.552083333333333,2023,2023-2024
DE,2024-02-29,inter-ucfe,0,0,0,0,0,0,0,0,0,0,0,0,0,0,TRUE,0,2023,2023-2024
DE,2024-02-29,inter-ucx,0,0,0,0,0,0,0,0,0,0,0,0,0,0,TRUE,0,2023,2023-2024
DE,2024-02-29,inter-ui,38,10,13,5,3,6,2,2,0,2,15,96,53,63,TRUE,0.552083333333333,2023,2023-2024
DE,2024-02-29,intra-total,341,129,84,58,52,44,18,16,6,62,174,984,515,644,TRUE,0.523373983739837,2023,2023-2024
DE,2024-02-29,intra-ucfe,0,0,0,1,0,0,0,0,0,0,0,1,0,0,TRUE,0,2023,2023-2024
DE,2024-02-29,intra-ucx,0,0,0,0,0,0,0,0,0,0,0,0,0,0,TRUE,0,2023,2023-2024
DE,2024-02-29,intra-ui,341,129,84,57,52,44,18,16,6,62,174,983,515,644,TRUE,0.523906408952187,2023,2023-2024
DE,2024-03-31,inter-total,17,8,16,13,4,6,2,5,4,7,8,90,25,33,TRUE,0.277777777777778,2023,2023-2024
DE,2024-03-31,inter-ucfe,0,0,0,0,0,0,0,0,0,0,0,0,0,0,TRUE,0,2023,2023-2024
DE,2024-03-31,inter-ucx,0,0,0,0,0,0,0,0,0,0,0,0,0,0,TRUE,0,2023,2023-2024
DE,2024-03-31,inter-ui,17,8,16,13,4,6,2,5,4,7,8,90,25,33,TRUE,0.277777777777778,2023,2023-2024
DE,2024-03-31,intra-total,168,83,88,84,37,26,19,24,20,61,95,705,263,346,TRUE,0.373049645390071,2023,2023-2024
DE,2024-03-31,intra-ucfe,0,0,0,0,0,0,0,0,0,0,0,0,0,0,TRUE,0,2023,2023-2024
DE,2024-03-31,intra-ucx,0,0,2,0,0,0,0,0,0,1,2,5,2,2,TRUE,0.4,2023,2023-2024
DE,2024-03-31,intra-ui,168,83,86,84,37,26,19,24,20,60,93,700,261,344,TRUE,0.372857142857143,2023,2023-2024
DE,2024-04-30,inter-total,17,14,9,5,5,3,2,1,2,8,11,77,28,42,TRUE,0.363636363636364,2023,2023-2024
DE,2024-04-30,inter-ucfe,0,0,0,0,0,0,0,0,0,0,0,0,0,0,TRUE,0,2023,2023-2024
DE,2024-04-30,inter-ucx,0,0,0,0,0,0,0,1,0,0,0,1,0,0,TRUE,0,2023,2023-2024
DE,2024-04-30,inter-ui,17,14,9,5,5,3,2,0,2,8,11,76,28,42,TRUE,0.368421052631579,2023,2023-2024
DE,2024-04-30,intra-total,152,67,61,49,51,40,30,24,15,125,88,702,240,307,TRUE,0.341880341880342,2023,2023-2024
DE,2024-04-30,intra-ucfe,1,0,0,1,0,1,0,0,0,3,0,6,1,1,TRUE,0.166666666666667,2023,2023-2024
DE,2024-04-30,intra-ucx,0,0,0,0,0,0,0,1,0,1,0,2,0,0,TRUE,0,2023,2023-2024
DE,2024-04-30,intra-ui,151,67,61,48,51,39,30,23,15,121,88,694,239,306,TRUE,0.344380403458213,2023,2023-2024
DE,2024-05-31,inter-total,19,6,13,12,5,4,3,1,3,13,13,92,32,38,TRUE,0.347826086956522,2023,2023-2024
DE,2024-05-31,inter-ucfe,0,0,0,0,0,0,0,0,0,0,0,0,0,0,TRUE,0,2023,2023-2024
DE,2024-05-31,inter-ucx,0,0,0,0,0,0,0,0,0,0,0,0,0,0,TRUE,0,2023,2023-2024
DE,2024-05-31,inter-ui,19,6,13,12,5,4,3,1,3,13,13,92,32,38,TRUE,0.347826086956522,2023,2023-2024
DE,2024-05-31,intra-total,185,67,66,63,39,37,22,17,17,111,106,730,291,358,TRUE,0.398630136986301,2023,2023-2024
DE,2024-05-31,intra-ucfe,0,0,0,0,0,0,0,0,0,0,0,0,0,0,TRUE,0,2023,2023-2024
DE,2024-05-31,intra-ucx,1,0,0,1,0,0,0,0,0,0,1,3,2,2,TRUE,0.666666666666667,2023,2023-2024
DE,2024-05-31,intra-ui,184,67,66,62,39,37,22,17,17,111,105,727,289,356,TRUE,0.397524071526823,2023,2023-2024
DE,2024-06-30,inter-total,21,3,3,3,3,2,5,3,2,21,8,74,29,32,TRUE,0.391891891891892,2023,2023-2024
DE,2024-06-30,inter-ucfe,0,0,0,0,0,0,0,0,0,0,0,0,0,0,TRUE,0,2023,2023-2024
DE,2024-06-30,inter-ucx,0,0,0,1,0,0,0,0,0,0,0,1,0,0,TRUE,0,2023,2023-2024
DE,2024-06-30,inter-ui,21,3,3,2,3,2,5,3,2,21,8,73,29,32,TRUE,0.397260273972603,2023,2023-2024
DE,2024-06-30,intra-total,326,66,59,44,43,37,32,21,22,173,101,924,427,493,TRUE,0.462121212121212,2023,2023-2024
DE,2024-06-30,intra-ucfe,1,0,0,0,0,0,0,0,0,0,0,1,1,1,TRUE,1,2023,2023-2024
DE,2024-06-30,intra-ucx,0,0,0,0,0,0,0,0,1,1,0,2,0,0,TRUE,0,2023,2023-2024
DE,2024-06-30,intra-ui,325,66,59,44,43,37,32,21,21,172,101,921,426,492,TRUE,0.462540716612378,2023,2023-2024
DE,2024-07-31,inter-total,30,7,6,6,6,4,2,2,1,14,18,96,48,55,TRUE,0.5,2024,2024-2025
DE,2024-07-31,inter-ucfe,0,0,0,0,0,0,0,0,0,0,0,0,0,0,TRUE,0,2024,2024-2025
DE,2024-07-31,inter-ucx,0,0,0,0,0,0,0,0,0,0,0,0,0,0,TRUE,0,2024,2024-2025
DE,2024-07-31,inter-ui,30,7,6,6,6,4,2,2,1,14,18,96,48,55,TRUE,0.5,2024,2024-2025
DE,2024-07-31,intra-total,401,107,85,65,57,46,26,34,15,153,183,1172,584,691,TRUE,0.498293515358362,2024,2024-2025
DE,2024-07-31,intra-ucfe,0,0,0,0,0,0,0,0,0,0,0,0,0,0,TRUE,0,2024,2024-2025
DE,2024-07-31,intra-ucx,0,0,0,0,0,0,0,0,0,0,0,0,0,0,TRUE,0,2024,2024-2025
DE,2024-07-31,intra-ui,401,107,85,65,57,46,26,34,15,153,183,1172,584,691,TRUE,0.498293515358362,2024,2024-2025
DE,2024-08-31,inter-total,25,13,9,4,1,1,2,5,2,21,10,93,35,48,TRUE,0.376344086021505,2024,2024-2025
DE,2024-08-31,inter-ucfe,0,0,0,0,0,0,0,0,0,0,0,0,0,0,TRUE,0,2024,2024-2025
DE,2024-08-31,inter-ucx,0,0,0,0,0,0,0,0,0,0,0,0,0,0,TRUE,0,2024,2024-2025
DE,2024-08-31,inter-ui,25,13,9,4,1,1,2,5,2,21,10,93,35,48,TRUE,0.376344086021505,2024,2024-2025
DE,2024-08-31,intra-total,292,92,49,43,26,37,31,28,22,154,117,891,409,501,TRUE,0.459034792368126,2024,2024-2025
DE,2024-08-31,intra-ucfe,0,0,0,0,0,0,0,1,0,2,0,3,0,0,TRUE,0,2024,2024-2025
DE,2024-08-31,intra-ucx,0,0,0,0,0,0,0,1,0,1,0,2,0,0,TRUE,0,2024,2024-2025
DE,2024-08-31,intra-ui,292,92,49,43,26,37,31,26,22,151,117,886,409,501,TRUE,0.461625282167043,2024,2024-2025
DE,2024-09-30,inter-total,19,9,6,3,5,5,2,3,1,17,10,80,29,38,TRUE,0.3625,2024,2024-2025
DE,2024-09-30,inter-ucfe,0,0,0,0,0,0,0,0,0,0,0,0,0,0,TRUE,0,2024,2024-2025
DE,2024-09-30,inter-ucx,0,0,0,0,0,0,0,0,0,0,0,0,0,0,TRUE,0,2024,2024-2025
DE,2024-09-30,inter-ui,19,9,6,3,5,5,2,3,1,17,10,80,29,38,TRUE,0.3625,2024,2024-2025
DE,2024-09-30,intra-total,165,44,39,43,35,40,25,18,21,181,84,695,249,293,TRUE,0.358273381294964,2024,2024-2025
DE,2024-09-30,intra-ucfe,0,0,0,0,0,0,0,1,0,0,0,1,0,0,TRUE,0,2024,2024-2025
DE,2024-09-30,intra-ucx,0,0,0,0,0,1,0,1,0,0,0,2,0,0,TRUE,0,2024,2024-2025
DE,2024-09-30,intra-ui,165,44,39,43,35,39,25,16,21,181,84,692,249,293,TRUE,0.359826589595376,2024,2024-2025
DE,2024-10-31,inter-total,15,4,8,6,5,1,1,3,1,18,13,75,28,32,TRUE,0.373333333333333,2024,2024-2025
DE,2024-10-31,inter-ucfe,0,0,0,0,0,0,0,0,0,0,0,0,0,0,TRUE,0,2024,2024-2025
DE,2024-10-31,inter-ucx,0,0,0,0,0,0,0,0,0,0,0,0,0,0,TRUE,0,2024,2024-2025
DE,2024-10-31,inter-ui,15,4,8,6,5,1,1,3,1,18,13,75,28,32,TRUE,0.373333333333333,2024,2024-2025
DE,2024-10-31,intra-total,149,58,49,30,22,31,27,22,22,218,93,721,242,300,TRUE,0.335644937586685,2024,2024-2025
DE,2024-10-31,intra-ucfe,0,0,0,0,0,0,0,0,0,2,0,2,0,0,TRUE,0,2024,2024-2025
DE,2024-10-31,intra-ucx,0,1,2,2,0,1,0,0,0,0,0,6,0,1,TRUE,0,2024,2024-2025
DE,2024-10-31,intra-ui,149,57,47,28,22,30,27,22,22,216,93,713,242,299,TRUE,0.339410939691445,2024,2024-2025
DE,2024-11-30,inter-total,17,8,4,3,1,3,2,2,3,17,10,70,27,35,TRUE,0.385714285714286,2024,2024-2025
DE,2024-11-30,inter-ucfe,0,1,0,0,0,0,0,0,1,1,0,3,0,1,TRUE,0,2024,2024-2025
DE,2024-11-30,inter-ucx,0,0,0,0,0,0,0,0,0,0,0,0,0,0,TRUE,0,2024,2024-2025
DE,2024-11-30,inter-ui,17,7,4,3,1,3,2,2,2,16,10,67,27,34,TRUE,0.402985074626866,2024,2024-2025
DE,2024-11-30,intra-total,178,50,47,44,19,30,19,14,12,184,78,675,256,306,TRUE,0.379259259259259,2024,2024-2025
DE,2024-11-30,intra-ucfe,0,0,0,0,0,0,0,0,0,1,0,1,0,0,TRUE,0,2024,2024-2025
DE,2024-11-30,intra-ucx,0,0,0,0,0,0,0,0,0,1,0,1,0,0,TRUE,0,2024,2024-2025
DE,2024-11-30,intra-ui,178,50,47,44,19,30,19,14,12,182,78,673,256,306,TRUE,0.38038632986627,2024,2024-2025
DE,2024-12-31,inter-total,24,17,7,6,3,0,3,3,2,12,22,99,46,63,TRUE,0.464646464646465,2024,2024-2025
DE,2024-12-31,inter-ucfe,0,0,1,1,0,0,0,0,0,0,0,2,0,0,TRUE,0,2024,2024-2025
DE,2024-12-31,inter-ucx,0,0,0,0,0,0,0,0,0,0,0,0,0,0,TRUE,0,2024,2024-2025
DE,2024-12-31,inter-ui,24,17,6,5,3,0,3,3,2,12,22,97,46,63,TRUE,0.474226804123711,2024,2024-2025
DE,2024-12-31,intra-total,341,129,69,29,27,31,19,18,18,172,214,1067,555,684,TRUE,0.520149953139644,2024,2024-2025
DE,2024-12-31,intra-ucfe,0,0,0,0,0,0,0,0,0,0,1,1,1,1,TRUE,1,2024,2024-2025
DE,2024-12-31,intra-ucx,0,1,0,0,0,0,0,0,0,0,0,1,0,1,TRUE,0,2024,2024-2025
DE,2024-12-31,intra-ui,341,128,69,29,27,31,19,18,18,172,213,1065,554,682,TRUE,0.52018779342723,2024,2024-2025
FL,2019-01-31,inter-total,150,16,5,1,7,2,7,2,2,9,70,271,220,236,FALSE,0.870848708487085,2018,2018-2019
FL,2019-01-31,inter-ucfe,2,0,0,0,0,0,0,0,0,0,2,4,4,4,FALSE,1,2018,2018-2019
FL,2019-01-31,inter-ucx,0,0,0,0,0,0,0,0,0,0,0,0,0,0,FALSE,0,2018,2018-2019
FL,2019-01-31,inter-ui,148,16,5,1,7,2,7,2,2,9,68,267,216,232,FALSE,0.868913857677903,2018,2018-2019
FL,2019-01-31,intra-total,5468,729,264,177,175,158,133,113,81,442,4263,12003,9731,10460,FALSE,0.87144880446555,2018,2018-2019
FL,2019-01-31,intra-ucfe,205,8,1,0,0,1,0,2,1,1,62,281,267,275,FALSE,0.97864768683274,2018,2018-2019
FL,2019-01-31,intra-ucx,24,2,0,1,0,0,0,0,0,1,11,39,35,37,FALSE,0.948717948717949,2018,2018-2019
FL,2019-01-31,intra-ui,5239,719,263,176,175,157,133,111,80,440,4190,11683,9429,10148,FALSE,0.868612513909099,2018,2018-2019
FL,2019-02-28,inter-total,142,14,6,1,7,1,1,2,2,4,73,253,215,229,FALSE,0.905138339920949,2018,2018-2019
FL,2019-02-28,inter-ucfe,2,1,0,0,0,0,0,0,1,0,2,6,4,5,FALSE,0.833333333333333,2018,2018-2019
FL,2019-02-28,inter-ucx,0,0,0,0,0,0,0,0,0,0,0,0,0,0,FALSE,0,2018,2018-2019
FL,2019-02-28,inter-ui,140,13,6,1,7,1,1,2,1,4,71,247,211,224,FALSE,0.906882591093117,2018,2018-2019
FL,2019-02-28,intra-total,5191,641,222,193,159,166,134,75,50,227,4072,11130,9263,9904,FALSE,0.88984725965858,2018,2018-2019
FL,2019-02-28,intra-ucfe,14,6,4,6,0,1,1,0,0,3,25,60,39,45,FALSE,0.75,2018,2018-2019
FL,2019-02-28,intra-ucx,16,1,1,0,0,0,0,0,0,1,7,26,23,24,FALSE,0.923076923076923,2018,2018-2019
FL,2019-02-28,intra-ui,5161,634,217,187,159,165,133,75,50,223,4040,11044,9201,9835,FALSE,0.890528793915248,2018,2018-2019
FL,2019-03-31,inter-total,115,12,5,4,8,2,4,3,0,3,60,216,175,187,FALSE,0.865740740740741,2018,2018-2019
FL,2019-03-31,inter-ucfe,0,0,0,0,0,0,0,0,0,1,1,2,1,1,FALSE,0.5,2018,2018-2019
FL,2019-03-31,inter-ucx,0,0,0,0,0,0,0,0,0,0,1,1,1,1,FALSE,1,2018,2018-2019
FL,2019-03-31,inter-ui,115,12,5,4,8,2,4,3,0,2,58,213,173,185,FALSE,0.868544600938967,2018,2018-2019
FL,2019-03-31,intra-total,4838,576,134,169,179,137,112,86,54,275,3615,10175,8453,9029,FALSE,0.887371007371007,2018,2018-2019
FL,2019-03-31,intra-ucfe,16,0,0,0,1,1,0,1,0,2,11,32,27,27,FALSE,0.84375,2018,2018-2019
FL,2019-03-31,intra-ucx,21,1,0,0,0,2,0,0,0,0,11,35,32,33,FALSE,0.942857142857143,2018,2018-2019
FL,2019-03-31,intra-ui,4801,575,134,169,178,134,112,85,54,273,3593,10108,8394,8969,FALSE,0.887316976652157,2018,2018-2019
FL,2019-04-30,inter-total,113,9,4,3,3,1,1,0,0,2,45,181,158,167,FALSE,0.922651933701657,2018,2018-2019
FL,2019-04-30,inter-ucfe,2,1,0,0,0,0,0,0,0,0,0,3,2,3,FALSE,1,2018,2018-2019
FL,2019-04-30,inter-ucx,0,0,0,0,0,0,0,0,0,0,0,0,0,0,FALSE,0,2018,2018-2019
FL,2019-04-30,inter-ui,111,8,4,3,3,1,1,0,0,2,45,178,156,164,FALSE,0.921348314606742,2018,2018-2019
FL,2019-04-30,intra-total,4605,608,182,193,146,93,67,30,28,145,3776,9873,8381,8989,FALSE,0.910462878557683,2018,2018-2019
FL,2019-04-30,intra-ucfe,10,7,1,2,1,0,0,1,1,1,8,32,18,25,FALSE,0.78125,2018,2018-2019
FL,2019-04-30,intra-ucx,21,4,2,0,0,0,0,1,1,0,13,42,34,38,FALSE,0.904761904761905,2018,2018-2019
FL,2019-04-30,intra-ui,4574,597,179,191,145,93,67,28,26,144,3755,9799,8329,8926,FALSE,0.910909276456781,2018,2018-2019
FL,2019-05-31,inter-total,147,4,2,2,1,4,3,0,1,2,75,241,222,226,FALSE,0.937759336099585,2018,2018-2019
FL,2019-05-31,inter-ucfe,3,0,0,0,0,0,0,0,0,0,0,3,3,3,FALSE,1,2018,2018-2019
FL,2019-05-31,inter-ucx,0,0,0,0,0,0,0,0,0,0,0,0,0,0,FALSE,0,2018,2018-2019
FL,2019-05-31,inter-ui,144,4,2,2,1,4,3,0,1,2,75,238,219,223,FALSE,0.936974789915966,2018,2018-2019
FL,2019-05-31,intra-total,5147,694,211,166,113,66,43,26,15,96,4998,11575,10145,10839,FALSE,0.936414686825054,2018,2018-2019
FL,2019-05-31,intra-ucfe,8,3,1,4,2,2,1,0,0,0,13,34,21,24,FALSE,0.705882352941177,2018,2018-2019
FL,2019-05-31,intra-ucx,17,0,1,0,1,0,0,0,0,0,12,31,29,29,FALSE,0.935483870967742,2018,2018-2019
FL,2019-05-31,intra-ui,5122,691,209,162,110,64,42,26,15,96,4973,11510,10095,10786,FALSE,0.937098175499566,2018,2018-2019
FL,2019-06-30,inter-total,112,11,7,4,1,3,2,0,1,0,78,219,190,201,FALSE,0.917808219178082,2018,2018-2019
FL,2019-06-30,inter-ucfe,0,1,1,0,0,0,0,0,0,0,0,2,0,1,FALSE,0.5,2018,2018-2019
FL,2019-06-30,inter-ucx,0,0,0,0,0,0,0,0,0,0,0,0,0,0,FALSE,0,2018,2018-2019
FL,2019-06-30,inter-ui,112,10,6,4,1,3,2,0,1,0,78,217,190,200,FALSE,0.921658986175115,2018,2018-2019
FL,2019-06-30,intra-total,5403,724,200,183,104,60,46,24,18,63,4937,11762,10340,11064,FALSE,0.940656350960721,2018,2018-2019
FL,2019-06-30,intra-ucfe,11,3,0,0,0,0,0,0,0,0,7,21,18,21,FALSE,1,2018,2018-2019
FL,2019-06-30,intra-ucx,21,2,0,1,0,0,0,0,0,1,13,38,34,36,FALSE,0.947368421052632,2018,2018-2019
FL,2019-06-30,intra-ui,5371,719,200,182,104,60,46,24,18,62,4917,11703,10288,11007,FALSE,0.940528069725711,2018,2018-2019
FL,2019-07-31,inter-total,164,15,6,5,2,2,1,1,0,1,81,278,245,260,FALSE,0.935251798561151,2019,2019-2020
FL,2019-07-31,inter-ucfe,1,1,0,0,0,0,0,0,0,0,2,4,3,4,FALSE,1,2019,2019-2020
FL,2019-07-31,inter-ucx,0,0,0,1,0,0,0,0,0,0,0,1,0,0,FALSE,0,2019,2019-2020
FL,2019-07-31,inter-ui,163,14,6,4,2,2,1,1,0,1,79,273,242,256,FALSE,0.937728937728938,2019,2019-2020
FL,2019-07-31,intra-total,6580,1110,304,240,141,82,46,31,24,62,5985,14605,12565,13675,FALSE,0.93632317699418,2019,2019-2020
FL,2019-07-31,intra-ucfe,4,1,1,0,0,1,1,1,0,0,11,20,15,16,FALSE,0.8,2019,2019-2020
FL,2019-07-31,intra-ucx,19,3,0,0,1,0,0,0,0,0,13,36,32,35,FALSE,0.972222222222222,2019,2019-2020
FL,2019-07-31,intra-ui,6557,1106,303,240,140,81,45,30,24,62,5961,14549,12518,13624,FALSE,0.93642174719912,2019,2019-2020
FL,2019-08-31,inter-total,118,13,7,6,3,2,1,0,1,3,99,253,217,230,FALSE,0.909090909090909,2019,2019-2020
FL,2019-08-31,inter-ucfe,0,0,0,0,0,0,0,0,0,0,2,2,2,2,FALSE,1,2019,2019-2020
FL,2019-08-31,inter-ucx,0,0,0,0,0,0,0,0,0,0,0,0,0,0,FALSE,0,2019,2019-2020
FL,2019-08-31,inter-ui,118,13,7,6,3,2,1,0,1,3,97,251,215,228,FALSE,0.908366533864542,2019,2019-2020
FL,2019-08-31,intra-total,5129,959,321,300,202,129,89,49,31,92,5919,13220,11048,12007,FALSE,0.908245083207262,2019,2019-2020
FL,2019-08-31,intra-ucfe,15,5,0,1,0,1,0,0,0,2,10,34,25,30,FALSE,0.882352941176471,2019,2019-2020
FL,2019-08-31,intra-ucx,23,3,0,1,0,0,0,0,0,0,15,42,38,41,FALSE,0.976190476190476,2019,2019-2020
FL,2019-08-31,intra-ui,5091,951,321,298,202,128,89,49,31,90,5894,13144,10985,11936,FALSE,0.908094948265368,2019,2019-2020
FL,2019-09-30,inter-total,95,12,11,4,0,1,1,3,1,4,65,197,160,172,FALSE,0.873096446700508,2019,2019-2020
FL,2019-09-30,inter-ucfe,0,0,0,0,0,0,0,0,0,0,1,1,1,1,FALSE,1,2019,2019-2020
FL,2019-09-30,inter-ucx,0,0,0,0,0,0,0,0,0,0,0,0,0,0,FALSE,0,2019,2019-2020
FL,2019-09-30,inter-ui,95,12,11,4,0,1,1,3,1,4,64,196,159,171,FALSE,0.872448979591837,2019,2019-2020
FL,2019-09-30,intra-total,4017,1075,302,251,196,98,78,45,30,100,4352,10544,8369,9444,FALSE,0.89567526555387,2019,2019-2020
FL,2019-09-30,intra-ucfe,13,6,1,4,1,4,1,0,0,1,11,42,24,30,FALSE,0.714285714285714,2019,2019-2020
FL,2019-09-30,intra-ucx,19,0,0,0,0,0,0,0,0,1,12,32,31,31,FALSE,0.96875,2019,2019-2020
FL,2019-09-30,intra-ui,3985,1069,301,247,195,94,77,45,30,98,4329,10470,8314,9383,FALSE,0.896179560649475,2019,2019-2020
FL,2019-10-31,inter-total,106,11,5,3,5,3,3,1,0,5,65,207,171,182,FALSE,0.879227053140097,2019,2019-2020
FL,2019-10-31,inter-ucfe,0,0,0,0,0,0,0,0,0,0,1,1,1,1,FALSE,1,2019,2019-2020
FL,2019-10-31,inter-ucx,0,0,0,0,0,0,0,0,0,0,0,0,0,0,FALSE,0,2019,2019-2020
FL,2019-10-31,inter-ui,106,11,5,3,5,3,3,1,0,5,64,206,170,181,FALSE,0.878640776699029,2019,2019-2020
FL,2019-10-31,intra-total,4802,1076,274,274,193,116,77,50,41,122,5528,12553,10330,11406,FALSE,0.908627419740301,2019,2019-2020
FL,2019-10-31,intra-ucfe,17,8,1,1,1,0,1,1,0,3,13,46,30,38,FALSE,0.826086956521739,2019,2019-2020
FL,2019-10-31,intra-ucx,24,7,3,1,0,1,0,0,0,0,10,46,34,41,FALSE,0.891304347826087,2019,2019-2020
FL,2019-10-31,intra-ui,4761,1061,270,272,192,115,76,49,41,119,5505,12461,10266,11327,FALSE,0.908996067731322,2019,2019-2020
FL,2019-11-30,inter-total,100,9,3,3,2,2,3,0,0,0,66,188,166,175,FALSE,0.930851063829787,2019,2019-2020
FL,2019-11-30,inter-ucfe,1,0,0,1,0,0,1,0,0,0,1,4,2,2,FALSE,0.5,2019,2019-2020
FL,2019-11-30,inter-ucx,0,0,0,0,0,0,0,0,0,0,0,0,0,0,FALSE,0,2019,2019-2020
FL,2019-11-30,inter-ui,99,9,3,2,2,2,2,0,0,0,65,184,164,173,FALSE,0.940217391304348,2019,2019-2020
FL,2019-11-30,intra-total,4385,753,181,156,125,79,35,22,23,81,3999,9839,8384,9137,FALSE,0.928651285699766,2019,2019-2020
FL,2019-11-30,intra-ucfe,8,4,2,1,2,3,0,0,0,0,8,28,16,20,FALSE,0.714285714285714,2019,2019-2020
FL,2019-11-30,intra-ucx,21,0,1,1,0,0,0,1,0,0,5,29,26,26,FALSE,0.896551724137931,2019,2019-2020
FL,2019-11-30,intra-ui,4356,749,178,154,123,76,35,21,23,81,3986,9782,8342,9091,FALSE,0.92936004906972,2019,2019-2020
FL,2019-12-31,inter-total,101,15,5,1,4,2,3,1,1,5,66,204,167,182,FALSE,0.892156862745098,2019,2019-2020
FL,2019-12-31,inter-ucfe,2,0,0,0,0,0,0,0,0,0,1,3,3,3,FALSE,1,2019,2019-2020
FL,2019-12-31,inter-ucx,0,0,0,0,0,0,0,0,0,0,0,0,0,0,FALSE,0,2019,2019-2020
FL,2019-12-31,inter-ui,99,15,5,1,4,2,3,1,1,5,65,201,164,179,FALSE,0.890547263681592,2019,2019-2020
FL,2019-12-31,intra-total,3488,1004,263,167,177,130,77,44,35,70,4126,9581,7614,8618,FALSE,0.899488571130362,2019,2019-2020
FL,2019-12-31,intra-ucfe,16,3,0,0,4,2,1,1,2,1,7,37,23,26,FALSE,0.702702702702703,2019,2019-2020
FL,2019-12-31,intra-ucx,13,6,0,1,3,0,0,0,0,0,12,35,25,31,FALSE,0.885714285714286,2019,2019-2020
FL,2019-12-31,intra-ui,3459,995,263,166,170,128,76,43,33,69,4107,9509,7566,8561,FALSE,0.900304974234935,2019,2019-2020
FL,2020-01-31,inter-total,131,6,4,6,6,2,2,0,0,3,55,215,186,192,FALSE,0.893023255813954,2019,2019-2020
FL,2020-01-31,inter-ucfe,1,0,0,0,0,0,0,0,0,0,0,1,1,1,FALSE,1,2019,2019-2020
FL,2020-01-31,inter-ucx,0,0,0,0,0,0,0,0,0,0,0,0,0,0,FALSE,0,2019,2019-2020
FL,2020-01-31,inter-ui,130,6,4,6,6,2,2,0,0,3,55,214,185,191,FALSE,0.892523364485981,2019,2019-2020
FL,2020-01-31,intra-total,3794,859,321,239,288,169,133,83,43,130,3921,9980,7715,8574,FALSE,0.859118236472946,2019,2019-2020
FL,2020-01-31,intra-ucfe,11,3,2,0,2,1,3,1,0,1,8,32,19,22,FALSE,0.6875,2019,2019-2020
FL,2020-01-31,intra-ucx,18,3,1,1,1,0,0,0,0,0,10,34,28,31,FALSE,0.911764705882353,2019,2019-2020
FL,2020-01-31,intra-ui,3765,853,318,238,285,168,130,82,43,129,3903,9914,7668,8521,FALSE,0.859491628000807,2019,2019-2020
FL,2020-02-29,inter-total,106,13,6,2,5,4,2,2,1,4,75,220,181,194,FALSE,0.881818181818182,2019,2019-2020
FL,2020-02-29,inter-ucfe,0,1,0,0,0,0,0,0,0,0,0,1,0,1,FALSE,1,2019,2019-2020
FL,2020-02-29,inter-ucx,0,0,0,0,0,0,0,0,0,0,0,0,0,0,FALSE,0,2019,2019-2020
FL,2020-02-29,inter-ui,106,12,6,2,5,4,2,2,1,4,75,219,181,193,FALSE,0.881278538812785,2019,2019-2020
FL,2020-02-29,intra-total,3244,912,247,192,220,225,197,112,55,105,4168,9677,7412,8324,FALSE,0.860183941304123,2019,2019-2020
FL,2020-02-29,intra-ucfe,11,3,0,2,0,0,1,1,0,2,6,26,17,20,FALSE,0.769230769230769,2019,2019-2020
FL,2020-02-29,intra-ucx,13,2,1,0,0,0,3,0,0,0,4,23,17,19,FALSE,0.826086956521739,2019,2019-2020
FL,2020-02-29,intra-ui,3220,907,246,190,220,225,193,111,55,103,4158,9628,7378,8285,FALSE,0.860511009555463,2019,2019-2020
FL,2020-03-31,inter-total,72,22,1,4,3,5,1,2,2,2,40,154,112,134,FALSE,0.87012987012987,2019,2019-2020
FL,2020-03-31,inter-ucfe,0,0,0,0,0,0,0,0,0,0,0,0,0,0,FALSE,0,2019,2019-2020
FL,2020-03-31,inter-ucx,0,0,0,0,0,0,0,0,0,0,0,0,0,0,FALSE,0,2019,2019-2020
FL,2020-03-31,inter-ui,72,22,1,4,3,5,1,2,2,2,40,154,112,134,FALSE,0.87012987012987,2019,2019-2020
FL,2020-03-31,intra-total,3416,938,277,304,249,204,216,149,71,101,2817,8742,6233,7171,FALSE,0.820292839167239,2019,2019-2020
FL,2020-03-31,intra-ucfe,12,4,3,4,2,2,1,1,0,0,4,33,16,20,FALSE,0.606060606060606,2019,2019-2020
FL,2020-03-31,intra-ucx,10,3,0,1,0,0,1,0,0,0,11,26,21,24,FALSE,0.923076923076923,2019,2019-2020
FL,2020-03-31,intra-ui,3394,931,274,299,247,202,214,148,71,101,2802,8683,6196,7127,FALSE,0.82079926292756,2019,2019-2020
FL,2020-04-30,inter-total,208,456,314,113,18,5,0,2,2,5,358,1481,566,1022,FALSE,0.690074274139095,2019,2019-2020
FL,2020-04-30,inter-ucfe,1,0,0,1,0,0,0,0,0,0,0,2,1,1,FALSE,0.5,2019,2019-2020
FL,2020-04-30,inter-ucx,0,0,0,0,0,0,0,0,0,0,0,0,0,0,FALSE,0,2019,2019-2020
FL,2020-04-30,inter-ui,207,456,314,112,18,5,0,2,2,5,358,1479,565,1021,FALSE,0.690331304935767,2019,2019-2020
FL,2020-04-30,intra-total,25740,97462,64873,17974,1736,268,141,100,67,174,79012,287547,104752,202214,FALSE,0.703238079340073,2019,2019-2020
FL,2020-04-30,intra-ucfe,3,19,12,8,4,3,1,0,0,3,12,65,15,34,FALSE,0.523076923076923,2019,2019-2020
FL,2020-04-30,intra-ucx,7,14,8,6,0,0,0,1,0,4,20,60,27,41,FALSE,0.683333333333333,2019,2019-2020
FL,2020-04-30,intra-ui,25730,97429,64853,17960,1732,265,140,99,67,167,78980,287422,104710,202139,FALSE,0.70328297764263,2019,2019-2020
FL,2020-05-31,inter-total,271,277,279,353,361,193,105,36,11,12,1071,2969,1342,1619,FALSE,0.545301448299091,2019,2019-2020
FL,2020-05-31,inter-ucfe,0,0,0,0,0,1,0,0,0,0,0,1,0,0,FALSE,0,2019,2019-2020
FL,2020-05-31,inter-ucx,0,0,0,0,0,0,0,0,0,0,0,0,0,0,FALSE,0,2019,2019-2020
FL,2020-05-31,inter-ui,271,277,279,353,361,192,105,36,11,12,1071,2968,1342,1619,FALSE,0.545485175202156,2019,2019-2020
FL,2020-05-31,intra-total,42956,52591,56061,65741,57931,30096,15838,5082,985,528,88410,416219,131366,183957,FALSE,0.441971654345429,2019,2019-2020
FL,2020-05-31,intra-ucfe,2,0,7,20,20,16,5,6,0,2,3,81,5,5,FALSE,0.0617283950617284,2019,2019-2020
FL,2020-05-31,intra-ucx,5,19,36,37,53,22,14,7,6,3,7,209,12,31,FALSE,0.148325358851675,2019,2019-2020
FL,2020-05-31,intra-ui,42949,52572,56018,65684,57858,30058,15819,5069,979,523,88400,415929,131349,183921,FALSE,0.442193258945637,2019,2019-2020
FL,2020-06-30,inter-total,214,61,83,161,149,397,492,230,177,216,121,2301,335,396,FALSE,0.172099087353325,2019,2019-2020
FL,2020-06-30,inter-ucfe,0,0,0,0,0,0,0,0,1,0,0,1,0,0,FALSE,0,2019,2019-2020
FL,2020-06-30,inter-ucx,0,0,0,0,0,1,1,0,0,1,0,3,0,0,FALSE,0,2019,2019-2020
FL,2020-06-30,inter-ui,214,61,83,161,149,396,491,230,176,215,121,2297,335,396,FALSE,0.17239878101872,2019,2019-2020
FL,2020-06-30,intra-total,49963,13056,18771,18934,37326,62224,66617,36150,27423,37807,24091,392362,74054,87110,FALSE,0.222014364286042,2019,2019-2020
FL,2020-06-30,intra-ucfe,4,0,0,2,4,7,7,13,13,25,1,76,5,5,FALSE,0.0657894736842105,2019,2019-2020
FL,2020-06-30,intra-ucx,10,1,2,7,3,6,5,9,20,28,4,95,14,15,FALSE,0.157894736842105,2019,2019-2020
FL,2020-06-30,intra-ui,49949,13055,18769,18925,37319,62211,66605,36128,27390,37754,24086,392191,74035,87090,FALSE,0.222060169662231,2019,2019-2020
FL,2020-07-31,inter-total,313,44,16,16,13,7,18,22,29,361,94,933,407,451,FALSE,0.483386923901393,2020,2020-2021
FL,2020-07-31,inter-ucfe,0,0,0,0,0,0,0,0,0,2,0,2,0,0,FALSE,0,2020,2020-2021
FL,2020-07-31,inter-ucx,0,0,0,0,0,0,0,0,0,1,0,1,0,0,FALSE,0,2020,2020-2021
FL,2020-07-31,inter-ui,313,44,16,16,13,7,18,22,29,358,94,930,407,451,FALSE,0.48494623655914,2020,2020-2021
FL,2020-07-31,intra-total,74094,17961,7997,5380,4420,2780,4555,8626,6841,59554,30501,222709,104595,122556,FALSE,0.550296575351692,2020,2020-2021
FL,2020-07-31,intra-ucfe,10,1,1,3,0,6,1,6,4,71,13,116,23,24,FALSE,0.206896551724138,2020,2020-2021
FL,2020-07-31,intra-ucx,25,6,2,3,2,3,1,2,1,47,10,102,35,41,FALSE,0.401960784313726,2020,2020-2021
FL,2020-07-31,intra-ui,74059,17954,7994,5374,4418,2771,4553,8618,6836,59436,30478,222491,104537,122491,FALSE,0.55054361749464,2020,2020-2021
FL,2020-08-31,inter-total,167,37,14,9,10,5,5,8,4,114,53,426,220,257,FALSE,0.603286384976526,2020,2020-2021
FL,2020-08-31,inter-ucfe,1,0,1,0,0,0,0,0,0,0,1,3,2,2,FALSE,0.666666666666667,2020,2020-2021
FL,2020-08-31,inter-ucx,0,0,0,0,0,0,0,0,0,0,0,0,0,0,FALSE,0,2020,2020-2021
FL,2020-08-31,inter-ui,166,37,13,9,10,5,5,8,4,114,52,423,218,255,FALSE,0.602836879432624,2020,2020-2021
FL,2020-08-31,intra-total,47119,12150,3259,1149,968,830,813,968,1159,17014,18408,103837,65527,77677,FALSE,0.7480666814334,2020,2020-2021
FL,2020-08-31,intra-ucfe,13,11,8,2,3,2,1,1,0,34,10,85,23,34,FALSE,0.4,2020,2020-2021
FL,2020-08-31,intra-ucx,15,13,6,10,4,2,1,1,0,16,14,82,29,42,FALSE,0.51219512195122,2020,2020-2021
FL,2020-08-31,intra-ui,47091,12126,3245,1137,961,826,811,966,1159,16964,18384,103670,65475,77601,FALSE,0.748538632198322,2020,2020-2021
FL,2020-09-30,inter-total,210,39,8,10,3,8,7,4,3,120,75,487,285,324,FALSE,0.665297741273101,2020,2020-2021
FL,2020-09-30,inter-ucfe,1,1,0,0,0,0,0,0,0,0,0,2,1,2,FALSE,1,2020,2020-2021
FL,2020-09-30,inter-ucx,0,0,0,1,0,0,0,0,0,0,0,1,0,0,FALSE,0,2020,2020-2021
FL,2020-09-30,inter-ui,209,38,8,9,3,8,7,4,3,120,75,484,284,322,FALSE,0.665289256198347,2020,2020-2021
FL,2020-09-30,intra-total,30555,7062,2451,1157,1114,887,898,958,802,18198,10930,75012,41485,48547,FALSE,0.647189782968058,2020,2020-2021
FL,2020-09-30,intra-ucfe,5,7,3,1,1,0,1,3,1,22,12,56,17,24,FALSE,0.428571428571429,2020,2020-2021
FL,2020-09-30,intra-ucx,16,2,6,0,1,1,1,2,0,16,8,53,24,26,FALSE,0.490566037735849,2020,2020-2021
FL,2020-09-30,intra-ui,30534,7053,2442,1156,1112,886,896,953,801,18160,10910,74903,41444,48497,FALSE,0.647464053509205,2020,2020-2021
FL,2020-10-31,inter-total,318,61,14,6,6,9,8,3,4,173,116,718,434,495,FALSE,0.68941504178273,2020,2020-2021
FL,2020-10-31,inter-ucfe,1,0,1,0,0,0,0,0,0,0,0,2,1,1,FALSE,0.5,2020,2020-2021
FL,2020-10-31,inter-ucx,0,0,0,0,0,0,0,0,0,0,0,0,0,0,FALSE,0,2020,2020-2021
FL,2020-10-31,inter-ui,317,61,13,6,6,9,8,3,4,173,116,716,433,494,FALSE,0.689944134078212,2020,2020-2021
FL,2020-10-31,intra-total,25042,4781,1401,559,469,474,426,449,445,24341,8962,67349,34004,38785,FALSE,0.575880859404,2020,2020-2021
FL,2020-10-31,intra-ucfe,19,3,2,1,1,1,1,3,2,25,13,71,32,35,FALSE,0.492957746478873,2020,2020-2021
FL,2020-10-31,intra-ucx,33,5,5,2,4,0,2,3,1,19,11,85,44,49,FALSE,0.576470588235294,2020,2020-2021
FL,2020-10-31,intra-ui,24990,4773,1394,556,464,473,423,443,442,24297,8938,67193,33928,38701,FALSE,0.575967734734273,2020,2020-2021
FL,2020-11-30,inter-total,231,53,21,18,9,9,9,6,5,108,94,563,325,378,FALSE,0.671403197158082,2020,2020-2021
FL,2020-11-30,inter-ucfe,0,0,0,0,0,0,0,0,0,0,1,1,1,1,FALSE,1,2020,2020-2021
FL,2020-11-30,inter-ucx,0,0,0,0,0,0,0,0,0,0,0,0,0,0,FALSE,0,2020,2020-2021
FL,2020-11-30,inter-ui,231,53,21,18,9,9,9,6,5,108,93,562,324,377,FALSE,0.670818505338078,2020,2020-2021
FL,2020-11-30,intra-total,14039,3769,1227,549,459,400,279,260,255,12139,5557,38933,19596,23365,FALSE,0.600133562787353,2020,2020-2021
FL,2020-11-30,intra-ucfe,15,6,2,3,0,0,1,0,0,9,21,57,36,42,FALSE,0.736842105263158,2020,2020-2021
FL,2020-11-30,intra-ucx,55,4,2,2,0,0,1,0,0,22,13,99,68,72,FALSE,0.727272727272727,2020,2020-2021
FL,2020-11-30,intra-ui,13969,3759,1223,544,459,400,277,260,255,12108,5523,38777,19492,23251,FALSE,0.599608015060474,2020,2020-2021
FL,2020-12-31,inter-total,275,97,42,22,5,2,6,4,8,100,151,712,426,523,FALSE,0.734550561797753,2020,2020-2021
FL,2020-12-31,inter-ucfe,0,0,2,0,0,0,0,0,0,0,0,2,0,0,FALSE,0,2020,2020-2021
FL,2020-12-31,inter-ucx,0,0,0,0,0,0,0,0,0,0,0,0,0,0,FALSE,0,2020,2020-2021
FL,2020-12-31,inter-ui,275,97,40,22,5,2,6,4,8,100,151,710,426,523,FALSE,0.736619718309859,2020,2020-2021
FL,2020-12-31,intra-total,11565,5814,2050,1216,300,218,220,162,148,8207,7913,37813,19478,25292,FALSE,0.668870494274456,2020,2020-2021
FL,2020-12-31,intra-ucfe,8,21,8,2,3,2,2,1,1,15,14,77,22,43,FALSE,0.558441558441558,2020,2020-2021
FL,2020-12-31,intra-ucx,19,17,2,2,1,0,1,0,1,12,17,72,36,53,FALSE,0.736111111111111,2020,2020-2021
FL,2020-12-31,intra-ui,11538,5776,2040,1212,296,216,217,161,146,8180,7882,37664,19420,25196,FALSE,0.668967714528462,2020,2020-2021
FL,2021-01-31,inter-total,454,84,26,9,7,6,3,3,3,51,197,843,651,735,FALSE,0.871886120996441,2020,2020-2021
FL,2021-01-31,inter-ucfe,0,0,1,0,0,0,0,0,0,0,0,1,0,0,FALSE,0,2020,2020-2021
FL,2021-01-31,inter-ucx,1,0,0,1,0,0,0,0,0,0,0,2,1,1,FALSE,0.5,2020,2020-2021
FL,2021-01-31,inter-ui,453,84,25,8,7,6,3,3,3,51,197,840,650,734,FALSE,0.873809523809524,2020,2020-2021
FL,2021-01-31,intra-total,18899,4560,1508,485,342,322,241,184,125,3683,9548,39897,28447,33007,FALSE,0.827305311176279,2020,2020-2021
FL,2021-01-31,intra-ucfe,23,16,5,3,4,4,2,2,6,18,18,101,41,57,FALSE,0.564356435643564,2020,2020-2021
FL,2021-01-31,intra-ucx,28,14,4,3,1,0,2,1,2,7,10,72,38,52,FALSE,0.722222222222222,2020,2020-2021
FL,2021-01-31,intra-ui,18848,4530,1499,479,337,318,237,181,117,3658,9520,39724,28368,32898,FALSE,0.828164333903937,2020,2020-2021
FL,2021-02-28,inter-total,196,50,11,5,6,2,0,3,1,27,126,427,322,372,FALSE,0.871194379391101,2020,2020-2021
FL,2021-02-28,inter-ucfe,1,0,0,1,0,0,0,0,0,1,0,3,1,1,FALSE,0.333333333333333,2020,2020-2021
FL,2021-02-28,inter-ucx,0,0,0,0,0,0,0,0,0,0,0,0,0,0,FALSE,0,2020,2020-2021
FL,2021-02-28,inter-ui,195,50,11,4,6,2,0,3,1,26,126,424,321,371,FALSE,0.875,2020,2020-2021
FL,2021-02-28,intra-total,33152,4864,968,310,221,220,181,148,184,2482,8800,51530,41952,46816,FALSE,0.908519309140307,2020,2020-2021
FL,2021-02-28,intra-ucfe,6,6,6,2,1,0,3,1,2,22,17,66,23,29,FALSE,0.439393939393939,2020,2020-2021
FL,2021-02-28,intra-ucx,11,17,6,10,3,10,2,4,1,4,17,85,28,45,FALSE,0.529411764705882,2020,2020-2021
FL,2021-02-28,intra-ui,33135,4841,956,298,217,210,176,143,181,2456,8766,51379,41901,46742,FALSE,0.909749119289982,2020,2020-2021
FL,2021-03-31,inter-total,82,74,27,12,9,9,8,4,5,41,83,354,165,239,FALSE,0.675141242937853,2020,2020-2021
FL,2021-03-31,inter-ucfe,0,0,0,0,0,0,0,0,1,0,0,1,0,0,FALSE,0,2020,2020-2021
FL,2021-03-31,inter-ucx,1,0,0,0,0,0,0,0,0,0,1,2,2,2,FALSE,1,2020,2020-2021
FL,2021-03-31,inter-ui,81,74,27,12,9,9,8,4,4,41,82,351,163,237,FALSE,0.675213675213675,2020,2020-2021
FL,2021-03-31,intra-total,6915,5620,2173,800,537,442,343,248,186,3260,6382,26906,13297,18917,FALSE,0.703077380509923,2020,2020-2021
FL,2021-03-31,intra-ucfe,2,12,5,2,3,0,1,1,0,9,7,42,9,21,FALSE,0.5,2020,2020-2021
FL,2021-03-31,intra-ucx,1,13,5,3,2,1,0,1,0,18,5,49,6,19,FALSE,0.387755102040816,2020,2020-2021
FL,2021-03-31,intra-ui,6912,5595,2163,795,532,441,342,246,186,3233,6370,26815,13282,18877,FALSE,0.703971657654298,2020,2020-2021
FL,2021-04-30,inter-total,129,47,13,13,13,18,13,6,9,43,64,368,193,240,FALSE,0.652173913043478,2020,2020-2021
FL,2021-04-30,inter-ucfe,0,0,0,0,0,0,1,0,0,1,0,2,0,0,FALSE,0,2020,2020-2021
FL,2021-04-30,inter-ucx,0,0,0,0,0,0,0,0,0,1,0,1,0,0,FALSE,0,2020,2020-2021
FL,2021-04-30,inter-ui,129,47,13,13,13,18,12,6,9,41,64,365,193,240,FALSE,0.657534246575342,2020,2020-2021
FL,2021-04-30,intra-total,10509,4669,1242,705,743,773,737,646,410,2945,6494,29873,17003,21672,FALSE,0.725471161249289,2020,2020-2021
FL,2021-04-30,intra-ucfe,5,4,8,1,2,1,6,1,1,21,8,58,13,17,FALSE,0.293103448275862,2020,2020-2021
FL,2021-04-30,intra-ucx,2,5,2,5,2,3,0,0,0,22,4,45,6,11,FALSE,0.244444444444444,2020,2020-2021
FL,2021-04-30,intra-ui,10502,4660,1232,699,739,769,731,645,409,2902,6482,29770,16984,21644,FALSE,0.727040644944575,2020,2020-2021
FL,2021-05-31,inter-total,113,28,23,11,11,17,9,12,11,85,46,366,159,187,FALSE,0.510928961748634,2020,2020-2021
FL,2021-05-31,inter-ucfe,0,0,0,0,0,0,0,0,0,0,2,2,2,2,FALSE,1,2020,2020-2021
FL,2021-05-31,inter-ucx,0,0,0,0,0,0,1,1,0,3,0,5,0,0,FALSE,0,2020,2020-2021
FL,2021-05-31,inter-ui,113,28,23,11,11,17,8,11,11,82,44,359,157,185,FALSE,0.515320334261839,2020,2020-2021
FL,2021-05-31,intra-total,10162,3473,886,438,356,277,235,261,238,2878,4592,23796,14754,18227,FALSE,0.765969070432005,2020,2020-2021
FL,2021-05-31,intra-ucfe,12,11,5,2,3,1,0,2,2,24,7,69,19,30,FALSE,0.434782608695652,2020,2020-2021
FL,2021-05-31,intra-ucx,11,8,2,3,2,2,1,1,4,11,14,59,25,33,FALSE,0.559322033898305,2020,2020-2021
FL,2021-05-31,intra-ui,10139,3454,879,433,351,274,234,258,232,2843,4571,23668,14710,18164,FALSE,0.767449721142471,2020,2020-2021
FL,2021-06-30,inter-total,68,32,3,7,7,4,2,3,4,50,33,213,101,133,FALSE,0.624413145539906,2020,2020-2021
FL,2021-06-30,inter-ucfe,0,0,0,0,0,0,0,0,0,1,0,1,0,0,FALSE,0,2020,2020-2021
FL,2021-06-30,inter-ucx,0,1,0,0,0,0,0,0,0,0,0,1,0,1,FALSE,1,2020,2020-2021
FL,2021-06-30,inter-ui,68,31,3,7,7,4,2,3,4,49,33,211,101,132,FALSE,0.625592417061611,2020,2020-2021
FL,2021-06-30,intra-total,4387,2335,666,403,379,381,307,263,239,2272,3215,14847,7602,9937,FALSE,0.669293459958241,2020,2020-2021
FL,2021-06-30,intra-ucfe,0,3,1,1,3,0,0,0,2,13,5,28,5,8,FALSE,0.285714285714286,2020,2020-2021
FL,2021-06-30,intra-ucx,9,2,2,1,3,1,2,1,3,18,4,46,13,15,FALSE,0.326086956521739,2020,2020-2021
FL,2021-06-30,intra-ui,4378,2330,663,401,373,380,305,262,234,2241,3206,14773,7584,9914,FALSE,0.671089149123401,2020,2020-2021
FL,2021-07-31,inter-total,85,16,1,1,0,1,1,3,3,28,34,173,119,135,FALSE,0.780346820809249,2021,2021-2022
FL,2021-07-31,inter-ucfe,0,0,0,0,0,0,0,0,0,1,0,1,0,0,FALSE,0,2021,2021-2022
FL,2021-07-31,inter-ucx,0,0,0,0,0,0,0,0,0,0,0,0,0,0,FALSE,0,2021,2021-2022
FL,2021-07-31,inter-ui,85,16,1,1,0,1,1,3,3,27,34,172,119,135,FALSE,0.784883720930233,2021,2021-2022
FL,2021-07-31,intra-total,4601,2157,363,164,129,129,152,169,202,1812,2884,12762,7485,9642,FALSE,0.755524212505877,2021,2021-2022
FL,2021-07-31,intra-ucfe,4,3,0,0,0,0,0,1,0,18,1,27,5,8,FALSE,0.296296296296296,2021,2021-2022
FL,2021-07-31,intra-ucx,12,13,7,1,0,0,1,0,0,10,9,53,21,34,FALSE,0.641509433962264,2021,2021-2022
FL,2021-07-31,intra-ui,4585,2141,356,163,129,129,151,168,202,1784,2874,12682,7459,9600,FALSE,0.756978394574988,2021,2021-2022
FL,2021-08-31,inter-total,95,17,8,2,0,1,0,0,1,25,31,180,126,143,FALSE,0.794444444444444,2021,2021-2022
FL,2021-08-31,inter-ucfe,0,0,0,0,0,0,0,0,0,0,1,1,1,1,FALSE,1,2021,2021-2022
FL,2021-08-31,inter-ucx,1,0,0,0,0,0,0,0,0,1,1,3,2,2,FALSE,0.666666666666667,2021,2021-2022
FL,2021-08-31,inter-ui,94,17,8,2,0,1,0,0,1,24,29,176,123,140,FALSE,0.795454545454545,2021,2021-2022
FL,2021-08-31,intra-total,5001,1879,419,202,176,108,103,95,93,2185,3032,13293,8033,9912,FALSE,0.74565560821485,2021,2021-2022
FL,2021-08-31,intra-ucfe,2,3,1,0,0,1,0,1,0,17,5,30,7,10,FALSE,0.333333333333333,2021,2021-2022
FL,2021-08-31,intra-ucx,11,12,3,1,2,0,0,0,1,13,14,57,25,37,FALSE,0.649122807017544,2021,2021-2022
FL,2021-08-31,intra-ui,4988,1864,415,201,174,107,103,94,92,2155,3013,13206,8001,9865,FALSE,0.747008935332425,2021,2021-2022
FL,2021-09-30,inter-total,130,21,6,1,1,3,1,2,0,46,22,233,152,173,FALSE,0.742489270386266,2021,2021-2022
FL,2021-09-30,inter-ucfe,0,1,0,0,0,0,0,0,0,2,2,5,2,3,FALSE,0.6,2021,2021-2022
FL,2021-09-30,inter-ucx,0,0,0,0,0,0,0,0,0,0,0,0,0,0,FALSE,0,2021,2021-2022
FL,2021-09-30,inter-ui,130,20,6,1,1,3,1,2,0,44,20,228,150,170,FALSE,0.745614035087719,2021,2021-2022
FL,2021-09-30,intra-total,9040,1285,303,119,102,104,94,78,78,2529,2326,16058,11366,12651,FALSE,0.787831610412256,2021,2021-2022
FL,2021-09-30,intra-ucfe,10,3,3,2,1,2,0,1,2,14,11,49,21,24,FALSE,0.489795918367347,2021,2021-2022
FL,2021-09-30,intra-ucx,16,15,2,0,0,0,0,0,0,62,9,104,25,40,FALSE,0.384615384615385,2021,2021-2022
FL,2021-09-30,intra-ui,9014,1267,298,117,101,102,94,77,76,2453,2306,15905,11320,12587,FALSE,0.791386356491669,2021,2021-2022
FL,2021-10-31,inter-total,117,15,5,5,3,4,0,0,1,54,28,232,145,160,FALSE,0.689655172413793,2021,2021-2022
FL,2021-10-31,inter-ucfe,0,0,0,0,0,0,0,0,0,2,1,3,1,1,FALSE,0.333333333333333,2021,2021-2022
FL,2021-10-31,inter-ucx,0,0,0,0,0,0,0,0,0,0,0,0,0,0,FALSE,0,2021,2021-2022
FL,2021-10-31,inter-ui,117,15,5,5,3,4,0,0,1,52,27,229,144,159,FALSE,0.694323144104803,2021,2021-2022
FL,2021-10-31,intra-total,8428,1464,343,149,92,100,92,78,73,3191,2948,16958,11376,12840,FALSE,0.757164759995282,2021,2021-2022
FL,2021-10-31,intra-ucfe,13,8,1,6,0,1,0,1,0,15,8,53,21,29,FALSE,0.547169811320755,2021,2021-2022
FL,2021-10-31,intra-ucx,23,4,5,1,0,0,1,0,0,34,14,82,37,41,FALSE,0.5,2021,2021-2022
FL,2021-10-31,intra-ui,8392,1452,337,142,92,99,91,77,73,3142,2926,16823,11318,12770,FALSE,0.759079831183499,2021,2021-2022
FL,2021-11-30,inter-total,110,23,4,2,3,1,1,1,0,25,27,197,137,160,FALSE,0.812182741116751,2021,2021-2022
FL,2021-11-30,inter-ucfe,0,0,0,0,1,0,0,0,0,0,0,1,0,0,FALSE,0,2021,2021-2022
FL,2021-11-30,inter-ucx,0,0,0,0,0,0,1,0,0,1,0,2,0,0,FALSE,0,2021,2021-2022
FL,2021-11-30,inter-ui,110,23,4,2,2,1,0,1,0,24,27,194,137,160,FALSE,0.824742268041237,2021,2021-2022
FL,2021-11-30,intra-total,4614,1251,367,167,170,112,79,76,82,1939,1839,10696,6453,7704,FALSE,0.720269259536275,2021,2021-2022
FL,2021-11-30,intra-ucfe,8,5,3,2,2,1,1,1,0,6,5,34,13,18,FALSE,0.529411764705882,2021,2021-2022
FL,2021-11-30,intra-ucx,16,8,3,0,0,0,0,0,0,3,6,36,22,30,FALSE,0.833333333333333,2021,2021-2022
FL,2021-11-30,intra-ui,4590,1238,361,165,168,111,78,75,82,1930,1828,10626,6418,7656,FALSE,0.720496894409938,2021,2021-2022
FL,2021-12-31,inter-total,78,14,2,5,3,3,2,4,1,16,23,151,101,115,FALSE,0.76158940397351,2021,2021-2022
FL,2021-12-31,inter-ucfe,0,0,0,0,0,1,0,0,0,1,0,2,0,0,FALSE,0,2021,2021-2022
FL,2021-12-31,inter-ucx,0,0,0,0,0,0,0,0,0,1,0,1,0,0,FALSE,0,2021,2021-2022
FL,2021-12-31,inter-ui,78,14,2,5,3,2,2,4,1,14,23,148,101,115,FALSE,0.777027027027027,2021,2021-2022
FL,2021-12-31,intra-total,4308,1084,251,117,98,100,87,92,107,1743,1692,9679,6000,7084,FALSE,0.731893790680855,2021,2021-2022
FL,2021-12-31,intra-ucfe,7,4,3,1,0,0,0,0,0,12,8,35,15,19,FALSE,0.542857142857143,2021,2021-2022
FL,2021-12-31,intra-ucx,22,10,3,0,0,0,0,0,1,1,14,51,36,46,FALSE,0.901960784313725,2021,2021-2022
FL,2021-12-31,intra-ui,4279,1070,245,116,98,100,87,92,106,1730,1670,9593,5949,7019,FALSE,0.731679349525696,2021,2021-2022
FL,2022-01-31,inter-total,54,13,4,1,0,2,1,0,1,26,27,129,81,94,FALSE,0.728682170542636,2021,2021-2022
FL,2022-01-31,inter-ucfe,1,0,0,0,0,0,0,0,0,0,0,1,1,1,FALSE,1,2021,2021-2022
FL,2022-01-31,inter-ucx,0,0,0,0,0,0,0,0,0,1,0,1,0,0,FALSE,0,2021,2021-2022
FL,2022-01-31,inter-ui,53,13,4,1,0,2,1,0,1,25,27,127,80,93,FALSE,0.732283464566929,2021,2021-2022
FL,2022-01-31,intra-total,3237,1020,305,91,65,75,58,51,42,1217,1719,7880,4956,5976,FALSE,0.758375634517766,2021,2021-2022
FL,2022-01-31,intra-ucfe,6,5,1,2,0,1,1,2,0,22,3,43,9,14,FALSE,0.325581395348837,2021,2021-2022
FL,2022-01-31,intra-ucx,13,7,0,0,2,0,0,0,0,1,12,35,25,32,FALSE,0.914285714285714,2021,2021-2022
FL,2022-01-31,intra-ui,3218,1008,304,89,63,74,57,49,42,1194,1704,7802,4922,5930,FALSE,0.760061522686491,2021,2021-2022
FL,2022-02-28,inter-total,40,10,5,3,1,0,1,0,0,19,23,102,63,73,FALSE,0.715686274509804,2021,2021-2022
FL,2022-02-28,inter-ucfe,0,0,0,0,0,0,0,0,0,1,0,1,0,0,FALSE,0,2021,2021-2022
FL,2022-02-28,inter-ucx,0,0,0,0,0,0,0,0,0,0,0,0,0,0,FALSE,0,2021,2021-2022
FL,2022-02-28,inter-ui,40,10,5,3,1,0,1,0,0,18,23,101,63,73,FALSE,0.722772277227723,2021,2021-2022
FL,2022-02-28,intra-total,3847,853,229,100,71,51,53,39,58,1312,1418,8031,5265,6118,FALSE,0.761798032623584,2021,2021-2022
FL,2022-02-28,intra-ucfe,17,7,2,1,0,0,1,0,0,6,11,45,28,35,FALSE,0.777777777777778,2021,2021-2022
FL,2022-02-28,intra-ucx,15,8,2,1,0,0,0,0,0,4,3,33,18,26,FALSE,0.787878787878788,2021,2021-2022
FL,2022-02-28,intra-ui,3815,838,225,98,71,51,52,39,58,1302,1404,7953,5219,6057,FALSE,0.761599396454168,2021,2021-2022
FL,2022-03-31,inter-total,75,20,9,7,8,2,5,0,2,28,33,189,108,128,FALSE,0.677248677248677,2021,2021-2022
FL,2022-03-31,inter-ucfe,1,0,0,0,0,0,0,0,0,1,1,3,2,2,FALSE,0.666666666666667,2021,2021-2022
FL,2022-03-31,inter-ucx,1,0,0,0,0,0,0,0,0,0,0,1,1,1,FALSE,1,2021,2021-2022
FL,2022-03-31,inter-ui,73,20,9,7,8,2,5,0,2,27,32,185,105,125,FALSE,0.675675675675676,2021,2021-2022
FL,2022-03-31,intra-total,4302,1020,266,176,135,123,101,84,53,3559,1699,11518,6001,7021,FALSE,0.609567633269665,2021,2021-2022
FL,2022-03-31,intra-ucfe,16,5,2,1,2,0,0,0,0,9,8,43,24,29,FALSE,0.674418604651163,2021,2021-2022
FL,2022-03-31,intra-ucx,13,2,0,0,0,1,0,0,0,1,8,25,21,23,FALSE,0.92,2021,2021-2022
FL,2022-03-31,intra-ui,4273,1013,264,175,133,122,101,84,53,3549,1683,11450,5956,6969,FALSE,0.608646288209607,2021,2021-2022
FL,2022-04-30,inter-total,96,14,2,1,2,2,1,0,1,12,32,163,128,142,FALSE,0.871165644171779,2021,2021-2022
FL,2022-04-30,inter-ucfe,4,0,0,0,0,0,0,0,0,0,0,4,4,4,FALSE,1,2021,2021-2022
FL,2022-04-30,inter-ucx,0,0,0,0,0,0,0,0,0,0,0,0,0,0,FALSE,0,2021,2021-2022
FL,2022-04-30,inter-ui,92,14,2,1,2,2,1,0,1,12,32,159,124,138,FALSE,0.867924528301887,2021,2021-2022
FL,2022-04-30,intra-total,4488,910,181,78,51,45,25,44,58,1142,1748,8770,6236,7146,FALSE,0.814823261117446,2021,2021-2022
FL,2022-04-30,intra-ucfe,16,4,1,0,0,1,1,1,1,5,8,38,24,28,FALSE,0.736842105263158,2021,2021-2022
FL,2022-04-30,intra-ucx,16,6,0,0,0,0,0,0,1,0,9,32,25,31,FALSE,0.96875,2021,2021-2022
FL,2022-04-30,intra-ui,4456,900,180,78,51,44,24,43,56,1137,1731,8700,6187,7087,FALSE,0.814597701149425,2021,2021-2022
FL,2022-05-31,inter-total,101,21,2,4,0,1,2,1,0,8,42,182,143,164,FALSE,0.901098901098901,2021,2021-2022
FL,2022-05-31,inter-ucfe,0,0,0,0,0,0,0,0,0,2,0,2,0,0,FALSE,0,2021,2021-2022
FL,2022-05-31,inter-ucx,0,0,0,0,0,0,0,0,0,0,0,0,0,0,FALSE,0,2021,2021-2022
FL,2022-05-31,inter-ui,101,21,2,4,0,1,2,1,0,6,42,180,143,164,FALSE,0.911111111111111,2021,2021-2022
FL,2022-05-31,intra-total,5380,1205,304,131,91,68,47,31,37,779,2253,10326,7633,8838,FALSE,0.855897733875654,2021,2021-2022
FL,2022-05-31,intra-ucfe,19,9,2,1,1,0,0,0,0,3,6,41,25,34,FALSE,0.829268292682927,2021,2021-2022
FL,2022-05-31,intra-ucx,19,5,1,0,0,1,0,0,0,3,7,36,26,31,FALSE,0.861111111111111,2021,2021-2022
FL,2022-05-31,intra-ui,5342,1191,301,130,90,67,47,31,37,773,2240,10249,7582,8773,FALSE,0.855985949848766,2021,2021-2022
FL,2022-06-30,inter-total,100,13,5,0,1,2,2,0,0,10,37,170,137,150,FALSE,0.882352941176471,2021,2021-2022
FL,2022-06-30,inter-ucfe,1,0,0,0,0,0,0,0,0,1,0,2,1,1,FALSE,0.5,2021,2021-2022
FL,2022-06-30,inter-ucx,0,0,0,0,0,0,0,0,0,0,0,0,0,0,FALSE,0,2021,2021-2022
FL,2022-06-30,inter-ui,99,13,5,0,1,2,2,0,0,9,37,168,136,149,FALSE,0.886904761904762,2021,2021-2022
FL,2022-06-30,intra-total,6056,1118,228,64,54,46,44,30,25,870,2214,10749,8270,9388,FALSE,0.873383570564704,2021,2021-2022
FL,2022-06-30,intra-ucfe,53,6,0,0,1,1,1,0,0,4,13,79,66,72,FALSE,0.911392405063291,2021,2021-2022
FL,2022-06-30,intra-ucx,9,5,2,0,0,1,0,0,0,1,7,25,16,21,FALSE,0.84,2021,2021-2022
FL,2022-06-30,intra-ui,5994,1107,226,64,53,44,43,30,25,865,2194,10645,8188,9295,FALSE,0.873179896665101,2021,2021-2022
FL,2022-07-31,inter-total,138,26,9,1,0,1,2,1,3,12,47,240,185,211,FALSE,0.879166666666667,2022,2022-2023
FL,2022-07-31,inter-ucfe,0,1,0,0,0,0,1,0,0,0,0,2,0,1,FALSE,0.5,2022,2022-2023
FL,2022-07-31,inter-ucx,0,0,0,0,0,0,0,0,0,0,1,1,1,1,FALSE,1,2022,2022-2023
FL,2022-07-31,inter-ui,138,25,9,1,0,1,1,1,3,12,46,237,184,209,FALSE,0.881856540084388,2022,2022-2023
FL,2022-07-31,intra-total,9139,1947,405,147,91,81,47,32,34,695,3439,16057,12578,14525,FALSE,0.904589898486641,2022,2022-2023
FL,2022-07-31,intra-ucfe,22,13,2,1,0,2,0,0,0,1,22,63,44,57,FALSE,0.904761904761905,2022,2022-2023
FL,2022-07-31,intra-ucx,20,8,1,0,0,2,0,0,0,2,13,46,33,41,FALSE,0.891304347826087,2022,2022-2023
FL,2022-07-31,intra-ui,9097,1926,402,146,91,77,47,32,34,692,3404,15948,12501,14427,FALSE,0.904627539503386,2022,2022-2023
FL,2022-08-31,inter-total,144,12,4,1,2,1,1,0,0,9,29,203,173,185,FALSE,0.911330049261084,2022,2022-2023
FL,2022-08-31,inter-ucfe,2,1,0,0,0,0,0,0,0,0,1,4,3,4,FALSE,1,2022,2022-2023
FL,2022-08-31,inter-ucx,0,0,0,0,0,0,0,0,0,0,0,0,0,0,FALSE,0,2022,2022-2023
FL,2022-08-31,inter-ui,142,11,4,1,2,1,1,0,0,9,28,199,170,181,FALSE,0.909547738693467,2022,2022-2023
FL,2022-08-31,intra-total,8403,1270,261,110,81,71,65,53,44,590,2391,13339,10794,12064,FALSE,0.904415623360072,2022,2022-2023
FL,2022-08-31,intra-ucfe,14,11,0,3,0,0,0,0,1,0,8,37,22,33,FALSE,0.891891891891892,2022,2022-2023
FL,2022-08-31,intra-ucx,19,6,0,0,1,0,0,0,0,1,8,35,27,33,FALSE,0.942857142857143,2022,2022-2023
FL,2022-08-31,intra-ui,8370,1253,261,107,80,71,65,53,43,589,2375,13267,10745,11998,FALSE,0.904349136956358,2022,2022-2023
FL,2022-09-30,inter-total,127,19,0,1,2,0,1,0,1,7,35,193,162,181,FALSE,0.937823834196891,2022,2022-2023
FL,2022-09-30,inter-ucfe,1,0,0,0,0,0,0,0,0,1,1,3,2,2,FALSE,0.666666666666667,2022,2022-2023
FL,2022-09-30,inter-ucx,0,0,0,0,0,0,0,0,0,0,0,0,0,0,FALSE,0,2022,2022-2023
FL,2022-09-30,inter-ui,126,19,0,1,2,0,1,0,1,6,34,190,160,179,FALSE,0.942105263157895,2022,2022-2023
FL,2022-09-30,intra-total,6468,979,197,81,74,74,47,72,57,558,2077,10684,8545,9524,FALSE,0.891426432047922,2022,2022-2023
FL,2022-09-30,intra-ucfe,12,9,3,0,1,0,0,1,0,1,11,38,23,32,FALSE,0.842105263157895,2022,2022-2023
FL,2022-09-30,intra-ucx,11,3,0,2,1,1,0,0,0,0,10,28,21,24,FALSE,0.857142857142857,2022,2022-2023
FL,2022-09-30,intra-ui,6445,967,194,79,72,73,47,71,57,557,2056,10618,8501,9468,FALSE,0.891693350913543,2022,2022-2023
FL,2022-10-31,inter-total,108,18,5,0,0,1,0,0,2,10,24,168,132,150,FALSE,0.892857142857143,2022,2022-2023
FL,2022-10-31,inter-ucfe,0,0,0,0,0,0,0,0,0,0,0,0,0,0,FALSE,0,2022,2022-2023
FL,2022-10-31,inter-ucx,0,0,0,0,0,0,0,0,0,0,0,0,0,0,FALSE,0,2022,2022-2023
FL,2022-10-31,inter-ui,108,18,5,0,0,1,0,0,2,10,24,168,132,150,FALSE,0.892857142857143,2022,2022-2023
FL,2022-10-31,intra-total,5888,3266,702,62,64,31,44,40,30,508,3960,14595,9848,13114,FALSE,0.898526892771497,2022,2022-2023
FL,2022-10-31,intra-ucfe,7,0,0,1,0,2,0,0,0,2,8,20,15,15,FALSE,0.75,2022,2022-2023
FL,2022-10-31,intra-ucx,15,2,0,0,0,0,0,0,0,0,8,25,23,25,FALSE,1,2022,2022-2023
FL,2022-10-31,intra-ui,5866,3264,702,61,64,29,44,40,30,506,3944,14550,9810,13074,FALSE,0.898556701030928,2022,2022-2023
FL,2022-11-30,inter-total,108,42,13,4,6,2,4,1,1,6,59,246,167,209,FALSE,0.849593495934959,2022,2022-2023
FL,2022-11-30,inter-ucfe,0,0,0,0,0,0,0,0,0,0,0,0,0,0,FALSE,0,2022,2022-2023
FL,2022-11-30,inter-ucx,0,0,0,0,0,0,0,0,0,0,0,0,0,0,FALSE,0,2022,2022-2023
FL,2022-11-30,inter-ui,108,42,13,4,6,2,4,1,1,6,59,246,167,209,FALSE,0.849593495934959,2022,2022-2023
FL,2022-11-30,intra-total,6633,2035,712,541,417,386,101,58,18,513,3423,14837,10056,12091,FALSE,0.814922154074274,2022,2022-2023
FL,2022-11-30,intra-ucfe,6,1,1,0,0,1,0,0,0,0,6,15,12,13,FALSE,0.866666666666667,2022,2022-2023
FL,2022-11-30,intra-ucx,16,9,1,0,0,0,0,0,0,1,6,33,22,31,FALSE,0.939393939393939,2022,2022-2023
FL,2022-11-30,intra-ui,6611,2025,710,541,417,385,101,58,18,512,3411,14789,10022,12047,FALSE,0.814591926431807,2022,2022-2023
FL,2022-12-31,inter-total,84,37,8,2,2,2,0,4,1,3,63,206,147,184,FALSE,0.893203883495146,2022,2022-2023
FL,2022-12-31,inter-ucfe,1,0,0,0,0,0,0,0,0,0,0,1,1,1,FALSE,1,2022,2022-2023
FL,2022-12-31,inter-ucx,0,0,1,0,0,0,0,0,0,0,0,1,0,0,FALSE,0,2022,2022-2023
FL,2022-12-31,inter-ui,83,37,7,2,2,2,0,4,1,3,63,204,146,183,FALSE,0.897058823529412,2022,2022-2023
FL,2022-12-31,intra-total,5244,1507,510,208,153,153,173,191,196,1411,2646,12392,7890,9397,FALSE,0.758311814073596,2022,2022-2023
FL,2022-12-31,intra-ucfe,8,2,0,1,0,1,1,0,0,7,7,27,15,17,FALSE,0.62962962962963,2022,2022-2023
FL,2022-12-31,intra-ucx,15,6,3,0,0,0,0,1,0,0,11,36,26,32,FALSE,0.888888888888889,2022,2022-2023
FL,2022-12-31,intra-ui,5221,1499,507,207,153,152,172,190,196,1404,2628,12329,7849,9348,FALSE,0.75821234487793,2022,2022-2023
FL,2023-01-31,inter-total,113,34,6,1,4,2,2,0,1,9,57,229,170,204,FALSE,0.890829694323144,2022,2022-2023
FL,2023-01-31,inter-ucfe,0,0,0,0,0,0,0,0,0,0,0,0,0,0,FALSE,0,2022,2022-2023
FL,2023-01-31,inter-ucx,0,0,0,0,0,0,0,0,0,0,0,0,0,0,FALSE,0,2022,2022-2023
FL,2023-01-31,inter-ui,113,34,6,1,4,2,2,0,1,9,57,229,170,204,FALSE,0.890829694323144,2022,2022-2023
FL,2023-01-31,intra-total,5881,1529,460,195,153,148,105,82,85,1128,2565,12331,8446,9975,FALSE,0.808936825885979,2022,2022-2023
FL,2023-01-31,intra-ucfe,7,3,1,0,0,0,0,0,1,2,2,16,9,12,FALSE,0.75,2022,2022-2023
FL,2023-01-31,intra-ucx,19,12,2,0,1,1,0,0,0,0,10,45,29,41,FALSE,0.911111111111111,2022,2022-2023
FL,2023-01-31,intra-ui,5855,1514,457,195,152,147,105,82,84,1126,2553,12270,8408,9922,FALSE,0.808638956805216,2022,2022-2023
FL,2023-02-28,inter-total,103,20,1,1,0,1,2,1,0,10,52,191,155,175,FALSE,0.916230366492147,2022,2022-2023
FL,2023-02-28,inter-ucfe,0,0,0,0,0,0,0,0,0,0,0,0,0,0,FALSE,0,2022,2022-2023
FL,2023-02-28,inter-ucx,0,0,0,0,0,0,0,0,0,0,0,0,0,0,FALSE,0,2022,2022-2023
FL,2023-02-28,inter-ui,103,20,1,1,0,1,2,1,0,10,52,191,155,175,FALSE,0.916230366492147,2022,2022-2023
FL,2023-02-28,intra-total,5993,1297,326,107,92,61,56,49,43,547,2513,11084,8506,9803,FALSE,0.884428004330567,2022,2022-2023
FL,2023-02-28,intra-ucfe,5,5,2,0,0,0,0,0,0,0,7,19,12,17,FALSE,0.894736842105263,2022,2022-2023
FL,2023-02-28,intra-ucx,15,3,1,0,0,0,0,0,0,1,6,26,21,24,FALSE,0.923076923076923,2022,2022-2023
FL,2023-02-28,intra-ui,5973,1289,323,107,92,61,56,49,43,546,2500,11039,8473,9762,FALSE,0.884319231814476,2022,2022-2023
FL,2023-03-31,inter-total,117,20,5,4,4,6,2,3,3,7,36,207,153,173,FALSE,0.835748792270531,2022,2022-2023
FL,2023-03-31,inter-ucfe,0,0,0,0,0,0,0,0,0,1,2,3,2,2,FALSE,0.666666666666667,2022,2022-2023
FL,2023-03-31,inter-ucx,0,0,0,0,0,0,0,0,0,0,1,1,1,1,FALSE,1,2022,2022-2023
FL,2023-03-31,inter-ui,117,20,5,4,4,6,2,3,3,6,33,203,150,170,FALSE,0.83743842364532,2022,2022-2023
FL,2023-03-31,intra-total,6386,1690,387,138,123,90,80,52,48,649,2894,12537,9280,10970,FALSE,0.875009970487357,2022,2022-2023
FL,2023-03-31,intra-ucfe,11,3,1,0,0,0,0,1,0,0,9,25,20,23,FALSE,0.92,2022,2022-2023
FL,2023-03-31,intra-ucx,18,11,1,0,0,0,0,0,0,0,8,38,26,37,FALSE,0.973684210526316,2022,2022-2023
FL,2023-03-31,intra-ui,6357,1676,385,138,123,90,80,51,48,649,2877,12474,9234,10910,FALSE,0.874619207952541,2022,2022-2023
FL,2023-04-30,inter-total,123,24,2,2,3,2,0,1,0,15,34,206,157,181,FALSE,0.878640776699029,2022,2022-2023
FL,2023-04-30,inter-ucfe,0,0,0,0,0,0,0,0,0,0,0,0,0,0,FALSE,0,2022,2022-2023
FL,2023-04-30,inter-ucx,0,0,0,0,0,0,0,0,0,0,0,0,0,0,FALSE,0,2022,2022-2023
FL,2023-04-30,inter-ui,123,24,2,2,3,2,0,1,0,15,34,206,157,181,FALSE,0.878640776699029,2022,2022-2023
FL,2023-04-30,intra-total,6181,1284,274,133,121,104,88,68,64,1726,2291,12334,8472,9756,FALSE,0.79098427112048,2022,2022-2023
FL,2023-04-30,intra-ucfe,7,1,0,0,0,0,0,0,0,2,6,16,13,14,FALSE,0.875,2022,2022-2023
FL,2023-04-30,intra-ucx,27,6,0,0,0,0,0,0,1,0,12,46,39,45,FALSE,0.978260869565217,2022,2022-2023
FL,2023-04-30,intra-ui,6147,1277,274,133,121,104,88,68,63,1724,2273,12272,8420,9697,FALSE,0.790172750977836,2022,2022-2023
FL,2023-05-31,inter-total,138,23,6,1,1,1,4,1,1,16,49,241,187,210,FALSE,0.871369294605809,2022,2022-2023
FL,2023-05-31,inter-ucfe,0,0,0,0,0,0,0,0,0,0,0,0,0,0,FALSE,0,2022,2022-2023
FL,2023-05-31,inter-ucx,0,0,0,0,0,0,0,0,0,0,1,1,1,1,FALSE,1,2022,2022-2023
FL,2023-05-31,inter-ui,138,23,6,1,1,1,4,1,1,16,48,240,186,209,FALSE,0.870833333333333,2022,2022-2023
FL,2023-05-31,intra-total,6992,1428,343,108,98,76,95,73,47,932,2650,12842,9642,11070,FALSE,0.862015262420184,2022,2022-2023
FL,2023-05-31,intra-ucfe,7,4,0,0,0,0,1,0,0,2,6,20,13,17,FALSE,0.85,2022,2022-2023
FL,2023-05-31,intra-ucx,25,5,0,0,1,0,0,1,0,1,10,43,35,40,FALSE,0.930232558139535,2022,2022-2023
FL,2023-05-31,intra-ui,6960,1419,343,108,97,76,94,72,47,929,2634,12779,9594,11013,FALSE,0.861804523045622,2022,2022-2023
FL,2023-06-30,inter-total,47,18,8,1,0,1,2,1,1,5,35,119,82,100,FALSE,0.840336134453782,2022,2022-2023
FL,2023-06-30,inter-ucfe,1,0,0,0,0,0,0,0,0,0,0,1,1,1,FALSE,1,2022,2022-2023
FL,2023-06-30,inter-ucx,0,0,0,0,0,0,0,0,0,0,0,0,0,0,FALSE,0,2022,2022-2023
FL,2023-06-30,inter-ui,46,18,8,1,0,1,2,1,1,5,35,118,81,99,FALSE,0.838983050847458,2022,2022-2023
FL,2023-06-30,intra-total,3297,1587,552,245,127,102,93,66,46,719,2388,9222,5685,7272,FALSE,0.788549121665582,2022,2022-2023
FL,2023-06-30,intra-ucfe,8,3,1,0,0,0,0,0,0,2,3,17,11,14,FALSE,0.823529411764706,2022,2022-2023
FL,2023-06-30,intra-ucx,16,8,2,0,0,0,0,0,0,1,13,40,29,37,FALSE,0.925,2022,2022-2023
FL,2023-06-30,intra-ui,3273,1576,549,245,127,102,93,66,46,716,2372,9165,5645,7221,FALSE,0.787888707037643,2022,2022-2023
FL,2023-07-31,inter-total,111,48,22,21,17,11,2,0,0,27,63,322,174,222,FALSE,0.68944099378882,2023,2023-2024
FL,2023-07-31,inter-ucfe,0,0,0,0,0,0,0,0,0,0,0,0,0,0,FALSE,0,2023,2023-2024
FL,2023-07-31,inter-ucx,0,0,0,0,0,0,0,0,0,0,0,0,0,0,FALSE,0,2023,2023-2024
FL,2023-07-31,inter-ui,111,48,22,21,17,11,2,0,0,27,63,322,174,222,FALSE,0.68944099378882,2023,2023-2024
FL,2023-07-31,intra-total,6791,3002,1751,1026,798,542,160,117,58,1582,3965,19792,10756,13758,FALSE,0.695129345189976,2023,2023-2024
FL,2023-07-31,intra-ucfe,11,3,1,0,1,0,1,0,0,0,2,19,13,16,FALSE,0.842105263157895,2023,2023-2024
FL,2023-07-31,intra-ucx,22,5,0,0,0,0,0,0,0,0,6,33,28,33,FALSE,1,2023,2023-2024
FL,2023-07-31,intra-ui,6758,2994,1750,1026,797,542,159,117,58,1582,3957,19740,10715,13709,FALSE,0.694478216818642,2023,2023-2024
FL,2023-08-31,inter-total,208,26,2,4,2,2,1,0,0,14,48,307,256,282,FALSE,0.9185667752443,2023,2023-2024
FL,2023-08-31,inter-ucfe,1,0,0,0,0,1,0,0,0,0,0,2,1,1,FALSE,0.5,2023,2023-2024
FL,2023-08-31,inter-ucx,0,0,0,0,0,1,0,0,0,0,0,1,0,0,FALSE,0,2023,2023-2024
FL,2023-08-31,inter-ui,207,26,2,4,2,0,1,0,0,14,48,304,255,281,FALSE,0.924342105263158,2023,2023-2024
FL,2023-08-31,intra-total,9516,1819,395,157,136,112,81,87,69,861,3345,16578,12861,14680,FALSE,0.885510918084208,2023,2023-2024
FL,2023-08-31,intra-ucfe,10,7,1,1,1,1,0,0,0,0,6,27,16,23,FALSE,0.851851851851852,2023,2023-2024
FL,2023-08-31,intra-ucx,29,5,2,0,0,2,1,0,0,3,6,48,35,40,FALSE,0.833333333333333,2023,2023-2024
FL,2023-08-31,intra-ui,9477,1807,392,156,135,109,80,87,69,858,3333,16503,12810,14617,FALSE,0.88571774828819,2023,2023-2024
FL,2023-09-30,inter-total,128,19,3,0,2,0,2,1,1,21,41,218,169,188,FALSE,0.862385321100918,2023,2023-2024
FL,2023-09-30,inter-ucfe,0,0,0,0,0,0,0,0,0,0,0,0,0,0,FALSE,0,2023,2023-2024
FL,2023-09-30,inter-ucx,0,0,0,0,0,0,0,0,0,0,0,0,0,0,FALSE,0,2023,2023-2024
FL,2023-09-30,inter-ui,128,19,3,0,2,0,2,1,1,21,41,218,169,188,FALSE,0.862385321100918,2023,2023-2024
FL,2023-09-30,intra-total,7416,1355,337,141,103,97,88,70,57,1034,2824,13522,10240,11595,FALSE,0.857491495340926,2023,2023-2024
FL,2023-09-30,intra-ucfe,14,3,0,0,0,0,0,0,0,5,10,32,24,27,FALSE,0.84375,2023,2023-2024
FL,2023-09-30,intra-ucx,22,4,1,0,0,0,0,0,0,1,5,33,27,31,FALSE,0.939393939393939,2023,2023-2024
FL,2023-09-30,intra-ui,7380,1348,336,141,103,97,88,70,57,1028,2809,13457,10189,11537,FALSE,0.857323326149959,2023,2023-2024
FL,2023-10-31,inter-total,151,10,1,2,3,1,2,1,2,7,38,218,189,199,FALSE,0.912844036697248,2023,2023-2024
FL,2023-10-31,inter-ucfe,0,0,0,0,0,0,0,0,0,0,1,1,1,1,FALSE,1,2023,2023-2024
FL,2023-10-31,inter-ucx,0,0,0,0,0,0,0,0,0,0,0,0,0,0,FALSE,0,2023,2023-2024
FL,2023-10-31,inter-ui,151,10,1,2,3,1,2,1,2,7,37,217,188,198,FALSE,0.912442396313364,2023,2023-2024
FL,2023-10-31,intra-total,9089,684,187,110,120,100,94,83,58,619,2811,13955,11900,12584,FALSE,0.90175564313866,2023,2023-2024
FL,2023-10-31,intra-ucfe,15,1,0,0,0,0,1,0,0,2,4,23,19,20,FALSE,0.869565217391304,2023,2023-2024
FL,2023-10-31,intra-ucx,25,4,0,0,0,0,0,0,0,1,17,47,42,46,FALSE,0.978723404255319,2023,2023-2024
FL,2023-10-31,intra-ui,9049,679,187,110,120,100,93,83,58,616,2790,13885,11839,12518,FALSE,0.901548433561397,2023,2023-2024
FL,2023-11-30,inter-total,161,10,2,2,2,0,1,0,1,10,52,241,213,223,FALSE,0.925311203319502,2023,2023-2024
FL,2023-11-30,inter-ucfe,1,0,0,0,0,0,0,0,0,0,1,2,2,2,FALSE,1,2023,2023-2024
FL,2023-11-30,inter-ucx,0,0,0,0,0,0,0,0,0,0,0,0,0,0,FALSE,0,2023,2023-2024
FL,2023-11-30,inter-ui,160,10,2,2,2,0,1,0,1,10,51,239,211,221,FALSE,0.924686192468619,2023,2023-2024
FL,2023-11-30,intra-total,7248,704,184,92,74,65,61,35,30,792,3217,12502,10465,11169,FALSE,0.893377059670453,2023,2023-2024
FL,2023-11-30,intra-ucfe,7,1,1,0,0,1,0,0,0,2,10,22,17,18,FALSE,0.818181818181818,2023,2023-2024
FL,2023-11-30,intra-ucx,29,3,0,0,0,0,0,0,0,0,10,42,39,42,FALSE,1,2023,2023-2024
FL,2023-11-30,intra-ui,7212,700,183,92,74,64,61,35,30,790,3197,12438,10409,11109,FALSE,0.893150024119633,2023,2023-2024
FL,2023-12-31,inter-total,158,6,2,2,0,1,1,1,0,2,48,221,206,212,FALSE,0.959276018099547,2023,2023-2024
FL,2023-12-31,inter-ucfe,3,0,0,0,0,0,0,0,0,0,1,4,4,4,FALSE,1,2023,2023-2024
FL,2023-12-31,inter-ucx,0,0,0,0,0,0,0,0,0,0,0,0,0,0,FALSE,0,2023,2023-2024
FL,2023-12-31,inter-ui,155,6,2,2,0,1,1,1,0,2,47,217,202,208,FALSE,0.95852534562212,2023,2023-2024
FL,2023-12-31,intra-total,7116,426,152,96,71,63,56,45,47,408,2409,10889,9525,9951,FALSE,0.91385802185692,2023,2023-2024
FL,2023-12-31,intra-ucfe,14,0,1,0,0,0,1,0,0,0,4,20,18,18,FALSE,0.9,2023,2023-2024
FL,2023-12-31,intra-ucx,20,3,0,0,0,0,0,0,0,0,11,34,31,34,FALSE,1,2023,2023-2024
FL,2023-12-31,intra-ui,7082,423,151,96,71,63,55,45,47,408,2394,10835,9476,9899,FALSE,0.913613290263037,2023,2023-2024
FL,2024-01-31,inter-total,185,7,3,1,2,0,0,1,0,10,67,276,252,259,FALSE,0.938405797101449,2023,2023-2024
FL,2024-01-31,inter-ucfe,1,0,0,0,0,0,0,0,0,0,0,1,1,1,FALSE,1,2023,2023-2024
FL,2024-01-31,inter-ucx,0,0,0,0,0,0,0,0,0,0,0,0,0,0,FALSE,0,2023,2023-2024
FL,2024-01-31,inter-ui,184,7,3,1,2,0,0,1,0,10,67,275,251,258,FALSE,0.938181818181818,2023,2023-2024
FL,2024-01-31,intra-total,8469,431,150,119,81,69,55,48,42,449,2703,12616,11172,11603,FALSE,0.919705136334813,2023,2023-2024
FL,2024-01-31,intra-ucfe,17,1,0,0,1,0,0,0,0,1,5,25,22,23,FALSE,0.92,2023,2023-2024
FL,2024-01-31,intra-ucx,21,1,0,0,1,0,0,0,0,1,8,32,29,30,FALSE,0.9375,2023,2023-2024
FL,2024-01-31,intra-ui,8431,429,150,119,79,69,55,48,42,447,2690,12559,11121,11550,FALSE,0.919659208535711,2023,2023-2024
FL,2024-02-29,inter-total,196,9,3,0,1,0,1,0,1,6,47,264,243,252,FALSE,0.954545454545455,2023,2023-2024
FL,2024-02-29,inter-ucfe,0,0,0,0,0,0,0,0,0,0,0,0,0,0,FALSE,0,2023,2023-2024
FL,2024-02-29,inter-ucx,0,0,0,0,0,0,0,0,0,0,0,0,0,0,FALSE,0,2023,2023-2024
FL,2024-02-29,inter-ui,196,9,3,0,1,0,1,0,1,6,47,264,243,252,FALSE,0.954545454545455,2023,2023-2024
FL,2024-02-29,intra-total,8487,618,236,96,62,45,42,43,36,260,2968,12893,11455,12073,FALSE,0.936399596680369,2023,2023-2024
FL,2024-02-29,intra-ucfe,13,1,1,0,0,1,0,0,0,0,3,19,16,17,FALSE,0.894736842105263,2023,2023-2024
FL,2024-02-29,intra-ucx,20,1,0,0,0,0,0,0,0,1,13,35,33,34,FALSE,0.971428571428571,2023,2023-2024
FL,2024-02-29,intra-ui,8454,616,235,96,62,44,42,43,36,259,2952,12839,11406,12022,FALSE,0.936365760573253,2023,2023-2024
FL,2024-03-31,inter-total,92,4,1,2,1,2,0,0,1,3,34,140,126,130,FALSE,0.928571428571429,2023,2023-2024
FL,2024-03-31,inter-ucfe,0,0,0,0,0,0,0,0,0,0,0,0,0,0,FALSE,0,2023,2023-2024
FL,2024-03-31,inter-ucx,0,0,0,0,0,0,0,0,0,0,0,0,0,0,FALSE,0,2023,2023-2024
FL,2024-03-31,inter-ui,92,4,1,2,1,2,0,0,1,3,34,140,126,130,FALSE,0.928571428571429,2023,2023-2024
FL,2024-03-31,intra-total,3884,635,172,117,73,57,34,35,23,257,2085,7372,5969,6604,FALSE,0.895822029300054,2023,2023-2024
FL,2024-03-31,intra-ucfe,7,2,1,0,1,1,0,0,0,0,3,15,10,12,FALSE,0.8,2023,2023-2024
FL,2024-03-31,intra-ucx,16,1,0,0,0,0,0,0,0,0,9,26,25,26,FALSE,1,2023,2023-2024
FL,2024-03-31,intra-ui,3861,632,171,117,72,56,34,35,23,257,2073,7331,5934,6566,FALSE,0.895648615468558,2023,2023-2024
FL,2024-04-30,inter-total,89,11,2,3,3,2,2,1,1,7,37,158,126,137,FALSE,0.867088607594937,2023,2023-2024
FL,2024-04-30,inter-ucfe,0,0,0,0,0,0,0,0,0,1,0,1,0,0,FALSE,0,2023,2023-2024
FL,2024-04-30,inter-ucx,0,0,0,0,0,0,0,0,0,0,0,0,0,0,FALSE,0,2023,2023-2024
FL,2024-04-30,inter-ui,89,11,2,3,3,2,2,1,1,6,37,157,126,137,FALSE,0.872611464968153,2023,2023-2024
FL,2024-04-30,intra-total,4141,808,239,191,183,164,94,61,47,340,2766,9034,6907,7715,FALSE,0.85399601505424,2023,2023-2024
FL,2024-04-30,intra-ucfe,8,1,0,1,0,0,0,0,0,1,4,15,12,13,FALSE,0.866666666666667,2023,2023-2024
FL,2024-04-30,intra-ucx,19,0,0,0,0,1,0,0,0,0,11,31,30,30,FALSE,0.967741935483871,2023,2023-2024
FL,2024-04-30,intra-ui,4114,807,239,190,183,163,94,61,47,339,2751,8988,6865,7672,FALSE,0.853582554517134,2023,2023-2024
FL,2024-05-31,inter-total,85,6,3,6,0,0,2,2,0,7,44,155,129,135,FALSE,0.870967741935484,2023,2023-2024
FL,2024-05-31,inter-ucfe,0,0,0,0,0,0,0,0,0,0,0,0,0,0,FALSE,0,2023,2023-2024
FL,2024-05-31,inter-ucx,0,0,0,0,0,0,0,0,0,0,1,1,1,1,FALSE,1,2023,2023-2024
FL,2024-05-31,inter-ui,85,6,3,6,0,0,2,2,0,7,43,154,128,134,FALSE,0.87012987012987,2023,2023-2024
FL,2024-05-31,intra-total,3704,955,226,146,148,104,101,150,145,322,2898,8899,6602,7557,FALSE,0.849196538936959,2023,2023-2024
FL,2024-05-31,intra-ucfe,6,1,0,0,0,0,0,0,0,2,2,11,8,9,FALSE,0.818181818181818,2023,2023-2024
FL,2024-05-31,intra-ucx,12,2,1,0,0,0,0,0,0,0,3,18,15,17,FALSE,0.944444444444444,2023,2023-2024
FL,2024-05-31,intra-ui,3686,952,225,146,148,104,101,150,145,320,2893,8870,6579,7531,FALSE,0.849041713641488,2023,2023-2024
FL,2024-06-30,inter-total,81,9,1,1,3,3,2,3,1,15,49,168,130,139,FALSE,0.827380952380952,2023,2023-2024
FL,2024-06-30,inter-ucfe,1,0,0,0,0,0,0,0,0,0,0,1,1,1,FALSE,1,2023,2023-2024
FL,2024-06-30,inter-ucx,0,0,0,0,0,0,0,0,0,0,0,0,0,0,FALSE,0,2023,2023-2024
FL,2024-06-30,inter-ui,80,9,1,1,3,3,2,3,1,15,49,167,129,138,FALSE,0.826347305389222,2023,2023-2024
FL,2024-06-30,intra-total,3835,853,315,186,176,172,121,143,221,1306,2883,10211,6718,7571,FALSE,0.741455293311135,2023,2023-2024
FL,2024-06-30,intra-ucfe,3,2,1,0,0,0,1,0,1,2,3,13,6,8,FALSE,0.615384615384615,2023,2023-2024
FL,2024-06-30,intra-ucx,6,0,0,1,3,0,0,0,0,1,8,19,14,14,FALSE,0.736842105263158,2023,2023-2024
FL,2024-06-30,intra-ui,3826,851,314,185,173,172,120,143,220,1303,2872,10179,6698,7549,FALSE,0.741624914038707,2023,2023-2024
FL,2024-07-31,inter-total,71,7,2,2,2,1,3,1,1,21,44,155,115,122,FALSE,0.787096774193548,2024,2024-2025
FL,2024-07-31,inter-ucfe,0,0,0,0,0,0,0,0,0,0,0,0,0,0,FALSE,0,2024,2024-2025
FL,2024-07-31,inter-ucx,0,0,0,0,0,0,0,0,0,0,0,0,0,0,FALSE,0,2024,2024-2025
FL,2024-07-31,inter-ui,71,7,2,2,2,1,3,1,1,21,44,155,115,122,FALSE,0.787096774193548,2024,2024-2025
FL,2024-07-31,intra-total,4041,886,373,337,263,196,197,230,210,2375,2838,11946,6879,7765,FALSE,0.650008371002846,2024,2024-2025
FL,2024-07-31,intra-ucfe,6,0,1,0,0,0,0,1,0,3,3,14,9,9,FALSE,0.642857142857143,2024,2024-2025
FL,2024-07-31,intra-ucx,12,2,0,0,2,1,0,0,0,9,4,30,16,18,FALSE,0.6,2024,2024-2025
FL,2024-07-31,intra-ui,4023,884,372,337,261,195,197,229,210,2363,2831,11902,6854,7738,FALSE,0.650142833137288,2024,2024-2025
FL,2024-08-31,inter-total,75,15,3,2,1,5,3,0,2,28,41,175,116,131,FALSE,0.748571428571429,2024,2024-2025
FL,2024-08-31,inter-ucfe,0,1,0,0,0,0,0,0,0,0,0,1,0,1,FALSE,1,2024,2024-2025
FL,2024-08-31,inter-ucx,0,0,0,0,0,0,0,0,0,0,0,0,0,0,FALSE,0,2024,2024-2025
FL,2024-08-31,inter-ui,75,14,3,2,1,5,3,0,2,28,41,174,116,130,FALSE,0.747126436781609,2024,2024-2025
FL,2024-08-31,intra-total,3852,982,303,232,272,265,348,357,281,2002,2850,11744,6702,7684,FALSE,0.654291553133515,2024,2024-2025
FL,2024-08-31,intra-ucfe,7,0,0,0,0,0,0,1,0,2,6,16,13,13,FALSE,0.8125,2024,2024-2025
FL,2024-08-31,intra-ucx,7,3,1,2,0,0,0,0,0,9,6,28,13,16,FALSE,0.571428571428571,2024,2024-2025
FL,2024-08-31,intra-ui,3838,979,302,230,272,265,348,356,281,1991,2838,11700,6676,7655,FALSE,0.654273504273504,2024,2024-2025
FL,2024-09-30,inter-total,48,6,1,1,3,1,1,0,4,13,22,100,70,76,FALSE,0.76,2024,2024-2025
FL,2024-09-30,inter-ucfe,0,0,0,0,0,0,0,0,0,0,0,0,0,0,FALSE,0,2024,2024-2025
FL,2024-09-30,inter-ucx,0,0,0,0,0,0,0,0,0,0,0,0,0,0,FALSE,0,2024,2024-2025
FL,2024-09-30,inter-ui,48,6,1,1,3,1,1,0,4,13,22,100,70,76,FALSE,0.76,2024,2024-2025
FL,2024-09-30,intra-total,2628,625,184,137,123,175,181,197,217,1487,1604,7558,4232,4857,FALSE,0.642630325482932,2024,2024-2025
FL,2024-09-30,intra-ucfe,2,0,0,1,0,1,0,0,0,5,2,11,4,4,FALSE,0.363636363636364,2024,2024-2025
FL,2024-09-30,intra-ucx,10,3,1,1,0,2,0,1,0,2,7,27,17,20,FALSE,0.740740740740741,2024,2024-2025
FL,2024-09-30,intra-ui,2616,622,183,135,123,172,181,196,217,1480,1595,7520,4211,4833,FALSE,0.642686170212766,2024,2024-2025
FL,2024-10-31,inter-total,48,10,4,4,4,5,4,5,3,16,36,139,84,94,FALSE,0.676258992805756,2024,2024-2025
FL,2024-10-31,inter-ucfe,0,0,0,0,0,0,0,0,0,1,0,1,0,0,FALSE,0,2024,2024-2025
FL,2024-10-31,inter-ucx,0,0,0,0,0,0,0,0,0,0,0,0,0,0,FALSE,0,2024,2024-2025
FL,2024-10-31,inter-ui,48,10,4,4,4,5,4,5,3,15,36,138,84,94,FALSE,0.681159420289855,2024,2024-2025
FL,2024-10-31,intra-total,2381,1199,855,473,503,463,429,365,234,1729,2135,10766,4516,5715,FALSE,0.530837822775404,2024,2024-2025
FL,2024-10-31,intra-ucfe,5,1,1,1,1,1,2,2,0,5,4,23,9,10,FALSE,0.434782608695652,2024,2024-2025
FL,2024-10-31,intra-ucx,15,1,2,0,2,1,1,0,0,6,9,37,24,25,FALSE,0.675675675675676,2024,2024-2025
FL,2024-10-31,intra-ui,2361,1197,852,472,500,461,426,363,234,1718,2122,10706,4483,5680,FALSE,0.530543620399776,2024,2024-2025
FL,2024-11-30,inter-total,26,8,2,3,1,3,4,3,5,19,20,94,46,54,FALSE,0.574468085106383,2024,2024-2025
FL,2024-11-30,inter-ucfe,0,0,0,0,0,0,0,1,0,0,0,1,0,0,FALSE,0,2024,2024-2025
FL,2024-11-30,inter-ucx,0,0,0,0,0,0,0,0,0,1,0,1,0,0,FALSE,0,2024,2024-2025
FL,2024-11-30,inter-ui,26,8,2,3,1,3,4,2,5,18,20,92,46,54,FALSE,0.586956521739131,2024,2024-2025
FL,2024-11-30,intra-total,1749,744,450,441,387,362,287,288,323,1855,1415,8301,3164,3908,FALSE,0.470786652210577,2024,2024-2025
FL,2024-11-30,intra-ucfe,5,2,3,0,1,0,0,0,1,2,9,23,14,16,FALSE,0.695652173913044,2024,2024-2025
FL,2024-11-30,intra-ucx,15,1,1,1,0,1,0,0,0,0,5,24,20,21,FALSE,0.875,2024,2024-2025
FL,2024-11-30,intra-ui,1729,741,446,440,386,361,287,288,322,1853,1401,8254,3130,3871,FALSE,0.468984734674097,2024,2024-2025
FL,2024-12-31,inter-total,44,13,6,3,2,3,5,2,1,28,27,134,71,84,FALSE,0.626865671641791,2024,2024-2025
FL,2024-12-31,inter-ucfe,0,0,1,0,0,0,0,0,0,2,1,4,1,1,FALSE,0.25,2024,2024-2025
FL,2024-12-31,inter-ucx,0,0,0,0,0,0,0,0,0,0,0,0,0,0,FALSE,0,2024,2024-2025
FL,2024-12-31,inter-ui,44,13,5,3,2,3,5,2,1,26,26,130,70,83,FALSE,0.638461538461538,2024,2024-2025
FL,2024-12-31,intra-total,1777,857,367,298,237,233,227,237,199,2013,1379,7824,3156,4013,FALSE,0.51290899795501,2024,2024-2025
FL,2024-12-31,intra-ucfe,4,5,0,2,0,0,0,1,0,3,1,16,5,10,FALSE,0.625,2024,2024-2025
FL,2024-12-31,intra-ucx,11,1,0,0,0,0,0,0,0,0,5,17,16,17,FALSE,1,2024,2024-2025
FL,2024-12-31,intra-ui,1762,851,367,296,237,233,227,236,199,2010,1373,7791,3135,3986,FALSE,0.511615967141574,2024,2024-2025
GA,2019-01-31,inter-total,36,79,20,12,4,4,5,1,1,2,106,270,142,221,TRUE,0.525925925925926,2018,2018-2019
GA,2019-01-31,inter-ucfe,1,3,0,1,1,0,0,0,0,0,0,6,1,4,TRUE,0.166666666666667,2018,2018-2019
GA,2019-01-31,inter-ucx,0,1,0,0,0,0,0,0,0,0,0,1,0,1,TRUE,0,2018,2018-2019
GA,2019-01-31,inter-ui,35,75,20,11,3,4,5,1,1,2,106,263,141,216,TRUE,0.536121673003802,2018,2018-2019
GA,2019-01-31,intra-total,8746,3853,1131,321,109,85,118,99,49,98,5987,20596,14733,18586,TRUE,0.715333074383375,2018,2018-2019
GA,2019-01-31,intra-ucfe,107,283,58,9,2,0,0,2,1,0,303,765,410,693,TRUE,0.535947712418301,2018,2018-2019
GA,2019-01-31,intra-ucx,14,9,3,3,0,3,0,0,0,0,16,48,30,39,TRUE,0.625,2018,2018-2019
GA,2019-01-31,intra-ui,8625,3561,1070,309,107,82,118,97,48,98,5668,19783,14293,17854,TRUE,0.722489005711975,2018,2018-2019
GA,2019-02-28,inter-total,31,55,27,15,8,3,2,2,3,8,67,221,98,153,TRUE,0.443438914027149,2018,2018-2019
GA,2019-02-28,inter-ucfe,0,1,2,1,0,0,0,0,0,0,2,6,2,3,TRUE,0.333333333333333,2018,2018-2019
GA,2019-02-28,inter-ucx,0,0,0,0,0,0,0,0,0,0,0,0,0,0,TRUE,0,2018,2018-2019
GA,2019-02-28,inter-ui,31,54,25,14,8,3,2,2,3,8,65,215,96,150,TRUE,0.446511627906977,2018,2018-2019
GA,2019-02-28,intra-total,2930,2430,754,311,233,275,176,127,39,105,2899,10279,5829,8259,TRUE,0.567078509582644,2018,2018-2019
GA,2019-02-28,intra-ucfe,3,9,2,3,6,0,0,0,0,1,7,31,10,19,TRUE,0.32258064516129,2018,2018-2019
GA,2019-02-28,intra-ucx,18,8,6,3,0,3,0,1,0,2,7,48,25,33,TRUE,0.520833333333333,2018,2018-2019
GA,2019-02-28,intra-ui,2909,2413,746,305,227,272,176,126,39,102,2885,10200,5794,8207,TRUE,0.568039215686274,2018,2018-2019
GA,2019-03-31,inter-total,33,65,22,8,5,3,4,2,2,5,76,225,109,174,TRUE,0.484444444444445,2018,2018-2019
GA,2019-03-31,inter-ucfe,0,4,2,2,2,0,0,0,0,0,0,10,0,4,TRUE,0,2018,2018-2019
GA,2019-03-31,inter-ucx,0,1,0,0,0,0,0,0,0,0,0,1,0,1,TRUE,0,2018,2018-2019
GA,2019-03-31,inter-ui,33,60,20,6,3,3,4,2,2,5,76,214,109,169,TRUE,0.509345794392523,2018,2018-2019
GA,2019-03-31,intra-total,2383,1969,360,132,113,143,113,84,50,119,2598,8064,4981,6950,TRUE,0.617683531746032,2018,2018-2019
GA,2019-03-31,intra-ucfe,1,9,1,2,0,2,1,2,3,2,7,30,8,17,TRUE,0.266666666666667,2018,2018-2019
GA,2019-03-31,intra-ucx,27,6,1,2,1,1,0,4,0,1,21,64,48,54,TRUE,0.75,2018,2018-2019
GA,2019-03-31,intra-ui,2355,1954,358,128,112,140,112,78,47,116,2570,7970,4925,6879,TRUE,0.617942283563363,2018,2018-2019
GA,2019-04-30,inter-total,23,49,12,4,6,4,3,3,3,7,82,196,105,154,TRUE,0.535714285714286,2018,2018-2019
GA,2019-04-30,inter-ucfe,0,2,1,0,0,0,0,0,0,1,1,5,1,3,TRUE,0.2,2018,2018-2019
GA,2019-04-30,inter-ucx,0,0,0,0,0,0,0,0,0,0,0,0,0,0,TRUE,0,2018,2018-2019
GA,2019-04-30,inter-ui,23,47,11,4,6,4,3,3,3,6,81,191,104,151,TRUE,0.544502617801047,2018,2018-2019
GA,2019-04-30,intra-total,3000,2012,346,103,67,105,128,69,30,126,2626,8612,5626,7638,TRUE,0.653274500696702,2018,2018-2019
GA,2019-04-30,intra-ucfe,6,13,2,2,3,0,1,0,0,4,9,40,15,28,TRUE,0.375,2018,2018-2019
GA,2019-04-30,intra-ucx,18,4,4,3,1,1,0,0,0,1,19,51,37,41,TRUE,0.725490196078431,2018,2018-2019
GA,2019-04-30,intra-ui,2976,1995,340,98,63,104,127,69,30,121,2598,8521,5574,7569,TRUE,0.65414857411102,2018,2018-2019
GA,2019-05-31,inter-total,28,56,13,9,7,1,3,0,1,3,90,211,118,174,TRUE,0.559241706161138,2018,2018-2019
GA,2019-05-31,inter-ucfe,0,1,0,0,0,0,0,0,0,0,1,2,1,2,TRUE,0.5,2018,2018-2019
GA,2019-05-31,inter-ucx,0,0,0,0,0,0,0,0,0,0,0,0,0,0,TRUE,0,2018,2018-2019
GA,2019-05-31,inter-ui,28,55,13,9,7,1,3,0,1,3,89,209,117,172,TRUE,0.559808612440191,2018,2018-2019
GA,2019-05-31,intra-total,2737,2130,395,118,78,111,135,59,35,78,3087,8963,5824,7954,TRUE,0.649782438915542,2018,2018-2019
GA,2019-05-31,intra-ucfe,12,7,6,3,0,3,0,1,2,0,9,43,21,28,TRUE,0.488372093023256,2018,2018-2019
GA,2019-05-31,intra-ucx,19,11,4,2,3,0,1,0,1,1,19,61,38,49,TRUE,0.622950819672131,2018,2018-2019
GA,2019-05-31,intra-ui,2706,2112,385,113,75,108,134,58,32,77,3059,8859,5765,7877,TRUE,0.650750649057456,2018,2018-2019
GA,2019-06-30,inter-total,29,79,22,8,4,7,3,3,2,7,90,254,119,198,TRUE,0.468503937007874,2018,2018-2019
GA,2019-06-30,inter-ucfe,0,0,0,0,0,0,0,0,0,0,0,0,0,0,TRUE,0,2018,2018-2019
GA,2019-06-30,inter-ucx,0,1,0,0,0,0,0,0,0,0,0,1,0,1,TRUE,0,2018,2018-2019
GA,2019-06-30,inter-ui,29,78,22,8,4,7,3,3,2,7,90,253,119,197,TRUE,0.470355731225297,2018,2018-2019
GA,2019-06-30,intra-total,2303,2037,402,112,90,123,117,72,22,70,2788,8136,5091,7128,TRUE,0.625737463126844,2018,2018-2019
GA,2019-06-30,intra-ucfe,2,8,2,2,4,0,1,0,0,0,10,29,12,20,TRUE,0.413793103448276,2018,2018-2019
GA,2019-06-30,intra-ucx,22,7,3,1,1,0,0,1,0,0,18,53,40,47,TRUE,0.754716981132076,2018,2018-2019
GA,2019-06-30,intra-ui,2279,2022,397,109,85,123,116,71,22,70,2760,8054,5039,7061,TRUE,0.625651850012416,2018,2018-2019
GA,2019-07-31,inter-total,25,63,27,8,5,4,1,3,1,5,94,236,119,182,TRUE,0.504237288135593,2019,2019-2020
GA,2019-07-31,inter-ucfe,0,0,1,0,0,0,0,0,0,2,0,3,0,0,TRUE,0,2019,2019-2020
GA,2019-07-31,inter-ucx,0,0,1,0,0,0,0,0,0,0,1,2,1,1,TRUE,0.5,2019,2019-2020
GA,2019-07-31,inter-ui,25,63,25,8,5,4,1,3,1,3,93,231,118,181,TRUE,0.510822510822511,2019,2019-2020
GA,2019-07-31,intra-total,4131,2568,591,144,94,126,117,92,29,70,3436,11398,7567,10135,TRUE,0.663888401473943,2019,2019-2020
GA,2019-07-31,intra-ucfe,4,11,5,4,2,1,1,1,1,1,7,38,11,22,TRUE,0.289473684210526,2019,2019-2020
GA,2019-07-31,intra-ucx,12,9,5,4,2,1,0,0,0,1,15,49,27,36,TRUE,0.551020408163265,2019,2019-2020
GA,2019-07-31,intra-ui,4115,2548,581,136,90,124,116,91,28,68,3414,11311,7529,10077,TRUE,0.665635222349925,2019,2019-2020
GA,2019-08-31,inter-total,53,39,16,11,10,1,5,6,0,2,59,202,112,151,TRUE,0.554455445544555,2019,2019-2020
GA,2019-08-31,inter-ucfe,1,0,0,0,2,0,1,0,0,1,0,5,1,1,TRUE,0.2,2019,2019-2020
GA,2019-08-31,inter-ucx,0,0,0,0,0,0,0,0,0,0,0,0,0,0,TRUE,0,2019,2019-2020
GA,2019-08-31,inter-ui,52,39,16,11,8,1,4,6,0,1,59,197,111,150,TRUE,0.563451776649746,2019,2019-2020
GA,2019-08-31,intra-total,2285,1791,853,324,131,121,370,85,50,74,1891,7975,4176,5967,TRUE,0.523636363636364,2019,2019-2020
GA,2019-08-31,intra-ucfe,2,4,6,2,1,1,2,0,2,2,5,27,7,11,TRUE,0.259259259259259,2019,2019-2020
GA,2019-08-31,intra-ucx,12,10,9,7,0,4,0,0,0,1,15,58,27,37,TRUE,0.46551724137931,2019,2019-2020
GA,2019-08-31,intra-ui,2271,1777,838,315,130,116,368,85,48,71,1871,7890,4142,5919,TRUE,0.524968314321927,2019,2019-2020
GA,2019-09-30,inter-total,26,44,31,13,8,5,3,5,3,4,52,194,78,122,TRUE,0.402061855670103,2019,2019-2020
GA,2019-09-30,inter-ucfe,1,0,1,1,0,1,0,0,0,0,0,4,1,1,TRUE,0.25,2019,2019-2020
GA,2019-09-30,inter-ucx,0,0,0,0,0,0,0,0,0,0,0,0,0,0,TRUE,0,2019,2019-2020
GA,2019-09-30,inter-ui,25,44,30,12,8,4,3,5,3,4,52,190,77,121,TRUE,0.405263157894737,2019,2019-2020
GA,2019-09-30,intra-total,2435,1866,1243,311,134,131,149,399,47,96,1702,8513,4137,6003,TRUE,0.485962645365911,2019,2019-2020
GA,2019-09-30,intra-ucfe,6,5,5,3,3,0,2,0,2,1,7,34,13,18,TRUE,0.382352941176471,2019,2019-2020
GA,2019-09-30,intra-ucx,11,8,4,4,3,1,1,1,1,0,11,45,22,30,TRUE,0.488888888888889,2019,2019-2020
GA,2019-09-30,intra-ui,2418,1853,1234,304,128,130,146,398,44,95,1684,8434,4102,5955,TRUE,0.486364714251838,2019,2019-2020
GA,2019-10-31,inter-total,12,57,28,5,3,2,4,2,4,3,56,176,68,125,TRUE,0.386363636363636,2019,2019-2020
GA,2019-10-31,inter-ucfe,0,1,0,0,0,0,0,0,0,0,1,2,1,2,TRUE,0.5,2019,2019-2020
GA,2019-10-31,inter-ucx,0,0,0,0,0,0,0,0,0,0,0,0,0,0,TRUE,0,2019,2019-2020
GA,2019-10-31,inter-ui,12,56,28,5,3,2,4,2,4,3,55,174,67,123,TRUE,0.385057471264368,2019,2019-2020
GA,2019-10-31,intra-total,4073,2419,963,211,107,102,133,141,63,121,2152,10485,6225,8644,TRUE,0.593705293276109,2019,2019-2020
GA,2019-10-31,intra-ucfe,7,12,5,2,0,4,2,0,0,3,4,39,11,23,TRUE,0.282051282051282,2019,2019-2020
GA,2019-10-31,intra-ucx,16,17,6,4,3,1,1,0,1,1,15,65,31,48,TRUE,0.476923076923077,2019,2019-2020
GA,2019-10-31,intra-ui,4050,2390,952,205,104,97,130,141,62,117,2133,10381,6183,8573,TRUE,0.595607359599268,2019,2019-2020
GA,2019-11-30,inter-total,17,36,14,6,7,2,3,1,3,5,66,160,83,119,TRUE,0.51875,2019,2019-2020
GA,2019-11-30,inter-ucfe,0,0,0,0,1,0,0,0,1,1,0,3,0,0,TRUE,0,2019,2019-2020
GA,2019-11-30,inter-ucx,0,0,0,0,0,0,0,0,0,0,0,0,0,0,TRUE,0,2019,2019-2020
GA,2019-11-30,inter-ui,17,36,14,6,6,2,3,1,2,4,66,157,83,119,TRUE,0.528662420382166,2019,2019-2020
GA,2019-11-30,intra-total,2742,1963,679,202,111,92,109,94,44,110,2041,8187,4783,6746,TRUE,0.584218883595945,2019,2019-2020
GA,2019-11-30,intra-ucfe,6,1,4,7,0,1,0,2,2,3,3,29,9,10,TRUE,0.310344827586207,2019,2019-2020
GA,2019-11-30,intra-ucx,6,9,4,4,1,1,0,2,2,1,6,36,12,21,TRUE,0.333333333333333,2019,2019-2020
GA,2019-11-30,intra-ui,2730,1953,671,191,110,90,109,90,40,106,2032,8122,4762,6715,TRUE,0.586308790938193,2019,2019-2020
GA,2019-12-31,inter-total,25,99,19,12,7,8,5,4,5,3,78,265,103,202,TRUE,0.388679245283019,2019,2019-2020
GA,2019-12-31,inter-ucfe,0,6,2,0,0,0,1,0,0,2,0,11,0,6,TRUE,0,2019,2019-2020
GA,2019-12-31,inter-ucx,0,0,0,0,1,0,0,0,0,0,0,1,0,0,TRUE,0,2019,2019-2020
GA,2019-12-31,inter-ui,25,93,17,12,6,8,4,4,5,1,78,253,103,196,TRUE,0.407114624505929,2019,2019-2020
GA,2019-12-31,intra-total,6394,2675,995,231,115,103,130,99,50,122,3273,14187,9667,12342,TRUE,0.681398463381969,2019,2019-2020
GA,2019-12-31,intra-ucfe,0,4,3,3,4,1,2,0,0,0,6,23,6,10,TRUE,0.260869565217391,2019,2019-2020
GA,2019-12-31,intra-ucx,7,10,5,2,2,1,0,0,0,0,21,48,28,38,TRUE,0.583333333333333,2019,2019-2020
GA,2019-12-31,intra-ui,6387,2661,987,226,109,101,128,99,50,122,3246,14116,9633,12294,TRUE,0.682417115330122,2019,2019-2020
GA,2020-01-31,inter-total,27,53,19,15,9,2,4,4,0,6,71,210,98,151,TRUE,0.466666666666667,2019,2019-2020
GA,2020-01-31,inter-ucfe,1,0,0,2,2,1,0,0,0,0,1,7,2,2,TRUE,0.285714285714286,2019,2019-2020
GA,2020-01-31,inter-ucx,0,0,0,0,0,0,0,0,0,0,1,1,1,1,TRUE,1,2019,2019-2020
GA,2020-01-31,inter-ui,26,53,19,13,7,1,4,4,0,6,69,202,95,148,TRUE,0.47029702970297,2019,2019-2020
GA,2020-01-31,intra-total,8747,3854,1362,452,182,105,109,139,66,137,6749,21902,15496,19350,TRUE,0.707515295406812,2019,2019-2020
GA,2020-01-31,intra-ucfe,6,6,5,3,2,1,1,0,0,5,6,35,12,18,TRUE,0.342857142857143,2019,2019-2020
GA,2020-01-31,intra-ucx,4,8,5,2,0,0,1,0,2,2,7,31,11,19,TRUE,0.354838709677419,2019,2019-2020
GA,2020-01-31,intra-ui,8737,3840,1352,447,180,104,107,139,64,130,6736,21836,15473,19313,TRUE,0.708600476277707,2019,2019-2020
GA,2020-02-29,inter-total,24,44,12,9,7,6,3,6,1,5,93,210,117,161,TRUE,0.557142857142857,2019,2019-2020
GA,2020-02-29,inter-ucfe,0,0,0,1,0,1,0,1,0,0,0,3,0,0,TRUE,0,2019,2019-2020
GA,2020-02-29,inter-ucx,0,0,0,1,0,0,0,0,0,0,0,1,0,0,TRUE,0,2019,2019-2020
GA,2020-02-29,inter-ui,24,44,12,7,7,5,3,5,1,5,93,206,117,161,TRUE,0.567961165048544,2019,2019-2020
GA,2020-02-29,intra-total,2629,2578,721,325,315,252,138,113,60,117,2536,9784,5165,7743,TRUE,0.527902698282911,2019,2019-2020
GA,2020-02-29,intra-ucfe,7,8,6,6,2,2,1,0,0,4,7,43,14,22,TRUE,0.325581395348837,2019,2019-2020
GA,2020-02-29,intra-ucx,13,15,5,4,2,0,3,0,0,3,10,55,23,38,TRUE,0.418181818181818,2019,2019-2020
GA,2020-02-29,intra-ui,2609,2555,710,315,311,250,134,113,60,110,2519,9686,5128,7683,TRUE,0.529423910799092,2019,2019-2020
GA,2020-03-31,inter-total,24,59,17,9,3,5,2,1,1,10,55,186,79,138,TRUE,0.424731182795699,2019,2019-2020
GA,2020-03-31,inter-ucfe,1,0,0,0,0,0,0,0,0,0,1,2,2,2,TRUE,1,2019,2019-2020
GA,2020-03-31,inter-ucx,0,0,0,0,0,0,0,0,0,0,0,0,0,0,TRUE,0,2019,2019-2020
GA,2020-03-31,inter-ui,23,59,17,9,3,5,2,1,1,10,54,184,77,136,TRUE,0.418478260869565,2019,2019-2020
GA,2020-03-31,intra-total,36937,3015,481,187,100,94,138,94,51,122,21987,63206,58924,61939,TRUE,0.932253267094896,2019,2019-2020
GA,2020-03-31,intra-ucfe,8,6,4,5,0,1,2,0,0,3,10,39,18,24,TRUE,0.461538461538462,2019,2019-2020
GA,2020-03-31,intra-ucx,11,6,0,2,3,0,1,1,0,0,7,31,18,24,TRUE,0.580645161290323,2019,2019-2020
GA,2020-03-31,intra-ui,36918,3003,477,180,97,93,135,93,51,119,21970,63136,58888,61891,TRUE,0.93271667511404,2019,2019-2020
GA,2020-04-30,inter-total,154,293,105,31,10,3,4,2,0,3,306,911,460,753,TRUE,0.504939626783754,2019,2019-2020
GA,2020-04-30,inter-ucfe,0,0,1,0,0,0,0,0,0,0,0,1,0,0,TRUE,0,2019,2019-2020
GA,2020-04-30,inter-ucx,0,0,0,0,0,0,0,0,0,0,0,0,0,0,TRUE,0,2019,2019-2020
GA,2020-04-30,inter-ui,154,293,104,31,10,3,4,2,0,3,306,910,460,753,TRUE,0.505494505494506,2019,2019-2020
GA,2020-04-30,intra-total,171649,76533,27427,14296,5307,620,224,122,53,78,150534,446843,322183,398716,TRUE,0.721020582173157,2019,2019-2020
GA,2020-04-30,intra-ucfe,4,7,6,9,2,0,1,0,1,0,3,33,7,14,TRUE,0.212121212121212,2019,2019-2020
GA,2020-04-30,intra-ucx,7,7,9,7,1,0,0,0,0,1,9,41,16,23,TRUE,0.390243902439024,2019,2019-2020
GA,2020-04-30,intra-ui,171638,76519,27412,14280,5304,620,223,122,52,77,150522,446769,322160,398679,TRUE,0.721088526733055,2019,2019-2020
GA,2020-05-31,inter-total,184,708,253,214,147,63,25,4,3,11,689,2301,873,1581,TRUE,0.379400260756193,2019,2019-2020
GA,2020-05-31,inter-ucfe,1,0,1,0,0,0,1,0,0,0,0,3,1,1,TRUE,0.333333333333333,2019,2019-2020
GA,2020-05-31,inter-ucx,0,0,0,1,0,0,0,0,0,0,2,3,2,2,TRUE,0.666666666666667,2019,2019-2020
GA,2020-05-31,inter-ui,183,708,252,213,147,63,24,4,3,11,687,2295,870,1578,TRUE,0.379084967320261,2019,2019-2020
GA,2020-05-31,intra-total,39465,35190,30228,25049,14691,10085,3895,1412,640,1058,43661,205374,83126,118316,TRUE,0.404754253216084,2019,2019-2020
GA,2020-05-31,intra-ucfe,10,1,9,13,12,5,5,3,0,1,1,60,11,12,TRUE,0.183333333333333,2019,2019-2020
GA,2020-05-31,intra-ucx,12,10,11,18,15,6,4,2,3,1,7,89,19,29,TRUE,0.213483146067416,2019,2019-2020
GA,2020-05-31,intra-ui,39443,35179,30208,25018,14664,10074,3886,1407,637,1056,43653,205225,83096,118275,TRUE,0.404901936898526,2019,2019-2020
GA,2020-06-30,inter-total,115,200,23,19,35,69,30,18,11,21,438,979,553,753,TRUE,0.564862104187947,2019,2019-2020
GA,2020-06-30,inter-ucfe,0,0,0,0,1,1,0,0,0,0,0,2,0,0,TRUE,0,2019,2019-2020
GA,2020-06-30,inter-ucx,0,0,0,0,1,0,0,0,1,0,1,3,1,1,TRUE,0.333333333333333,2019,2019-2020
GA,2020-06-30,inter-ui,115,200,23,19,33,68,30,18,10,21,437,974,552,752,TRUE,0.566735112936345,2019,2019-2020
GA,2020-06-30,intra-total,18370,16481,5143,8863,9674,3501,3928,3709,4264,5072,32642,111647,51012,67493,TRUE,0.456904350318414,2019,2019-2020
GA,2020-06-30,intra-ucfe,16,3,6,4,1,7,6,9,5,11,4,72,20,23,TRUE,0.277777777777778,2019,2019-2020
GA,2020-06-30,intra-ucx,18,6,3,11,5,9,8,2,7,5,3,77,21,27,TRUE,0.272727272727273,2019,2019-2020
GA,2020-06-30,intra-ui,18336,16472,5134,8848,9668,3485,3914,3698,4252,5056,32635,111498,50971,67443,TRUE,0.457147213402931,2019,2019-2020
GA,2020-07-31,inter-total,62,176,14,18,29,72,11,8,8,39,381,818,443,619,TRUE,0.541564792176039,2020,2020-2021
GA,2020-07-31,inter-ucfe,0,0,0,0,0,0,0,0,0,0,0,0,0,0,TRUE,0,2020,2020-2021
GA,2020-07-31,inter-ucx,0,0,0,0,0,1,0,0,0,1,0,2,0,0,TRUE,0,2020,2020-2021
GA,2020-07-31,inter-ui,62,176,14,18,29,71,11,8,8,38,381,816,443,619,TRUE,0.542892156862745,2020,2020-2021
GA,2020-07-31,intra-total,18082,11485,4091,8291,2973,1061,1186,992,1329,6191,28234,83915,46316,57801,TRUE,0.551939462551391,2020,2020-2021
GA,2020-07-31,intra-ucfe,9,0,5,6,2,2,5,5,3,24,1,62,10,10,TRUE,0.161290322580645,2020,2020-2021
GA,2020-07-31,intra-ucx,13,3,0,4,8,13,7,2,5,16,2,73,15,18,TRUE,0.205479452054795,2020,2020-2021
GA,2020-07-31,intra-ui,18060,11482,4086,8281,2963,1046,1174,985,1321,6151,28231,83780,46291,57773,TRUE,0.552530436858439,2020,2020-2021
GA,2020-08-31,inter-total,31,106,20,7,9,6,10,9,8,35,94,335,125,231,TRUE,0.373134328358209,2020,2020-2021
GA,2020-08-31,inter-ucfe,0,0,0,0,0,0,0,0,0,1,0,1,0,0,TRUE,0,2020,2020-2021
GA,2020-08-31,inter-ucx,0,0,0,0,0,0,1,0,0,0,0,1,0,0,TRUE,0,2020,2020-2021
GA,2020-08-31,inter-ui,31,106,20,7,9,6,9,9,8,34,94,333,125,231,TRUE,0.375375375375375,2020,2020-2021
GA,2020-08-31,intra-total,5481,3650,1502,2169,3297,781,433,435,595,4259,4790,27392,10271,13921,TRUE,0.374963492990654,2020,2020-2021
GA,2020-08-31,intra-ucfe,11,1,1,3,1,3,4,4,2,19,2,51,13,14,TRUE,0.254901960784314,2020,2020-2021
GA,2020-08-31,intra-ucx,8,1,2,0,4,5,6,2,6,15,1,50,9,10,TRUE,0.18,2020,2020-2021
GA,2020-08-31,intra-ui,5462,3648,1499,2166,3292,773,423,429,587,4225,4787,27291,10249,13897,TRUE,0.375545051482174,2020,2020-2021
GA,2020-09-30,inter-total,25,42,3,4,3,6,11,5,5,50,113,267,138,180,TRUE,0.51685393258427,2020,2020-2021
GA,2020-09-30,inter-ucfe,1,0,0,0,0,0,0,0,0,0,0,1,1,1,TRUE,1,2020,2020-2021
GA,2020-09-30,inter-ucx,0,0,0,0,0,0,0,0,0,0,0,0,0,0,TRUE,0,2020,2020-2021
GA,2020-09-30,inter-ui,24,42,3,4,3,6,11,5,5,50,113,266,137,179,TRUE,0.515037593984962,2020,2020-2021
GA,2020-09-30,intra-total,3623,1205,374,441,634,1348,1738,746,404,3963,3238,17714,6861,8066,TRUE,0.387320763238117,2020,2020-2021
GA,2020-09-30,intra-ucfe,4,1,1,3,3,5,6,8,2,21,0,54,4,5,TRUE,0.0740740740740741,2020,2020-2021
GA,2020-09-30,intra-ucx,17,2,0,1,1,4,5,8,2,39,3,82,20,22,TRUE,0.24390243902439,2020,2020-2021
GA,2020-09-30,intra-ui,3602,1202,373,437,630,1339,1727,730,400,3903,3235,17578,6837,8039,TRUE,0.388952099214928,2020,2020-2021
GA,2020-10-31,inter-total,22,20,9,2,3,1,7,4,4,49,67,188,89,109,TRUE,0.473404255319149,2020,2020-2021
GA,2020-10-31,inter-ucfe,0,0,0,0,0,0,0,0,0,1,0,1,0,0,TRUE,0,2020,2020-2021
GA,2020-10-31,inter-ucx,0,1,0,0,0,0,0,0,0,0,0,1,0,1,TRUE,0,2020,2020-2021
GA,2020-10-31,inter-ui,22,19,9,2,3,1,7,4,4,48,67,186,89,108,TRUE,0.478494623655914,2020,2020-2021
GA,2020-10-31,intra-total,4415,1471,466,581,676,696,1259,710,255,3462,2772,16763,7187,8658,TRUE,0.428741871979956,2020,2020-2021
GA,2020-10-31,intra-ucfe,6,0,0,1,1,3,6,2,1,15,4,39,10,10,TRUE,0.256410256410256,2020,2020-2021
GA,2020-10-31,intra-ucx,16,7,7,3,5,6,14,4,2,25,13,102,29,36,TRUE,0.284313725490196,2020,2020-2021
GA,2020-10-31,intra-ui,4393,1464,459,577,670,687,1239,704,252,3422,2755,16622,7148,8612,TRUE,0.430032487065335,2020,2020-2021
GA,2020-11-30,inter-total,17,35,2,3,3,2,5,5,10,66,74,222,91,126,TRUE,0.40990990990991,2020,2020-2021
GA,2020-11-30,inter-ucfe,0,0,1,1,0,0,0,0,0,0,0,2,0,0,TRUE,0,2020,2020-2021
GA,2020-11-30,inter-ucx,0,0,0,0,0,0,0,0,0,0,0,0,0,0,TRUE,0,2020,2020-2021
GA,2020-11-30,inter-ui,17,35,1,2,3,2,5,5,10,66,74,220,91,126,TRUE,0.413636363636364,2020,2020-2021
GA,2020-11-30,intra-total,2541,1458,747,597,389,257,318,286,146,2852,2528,12119,5069,6527,TRUE,0.418268834062216,2020,2020-2021
GA,2020-11-30,intra-ucfe,16,4,6,4,2,1,0,2,1,17,6,59,22,26,TRUE,0.372881355932203,2020,2020-2021
GA,2020-11-30,intra-ucx,13,5,6,5,3,5,3,1,0,13,8,62,21,26,TRUE,0.338709677419355,2020,2020-2021
GA,2020-11-30,intra-ui,2512,1449,735,588,384,251,315,283,145,2822,2514,11998,5026,6475,TRUE,0.418903150525088,2020,2020-2021
GA,2020-12-31,inter-total,52,49,2,7,7,2,7,3,5,40,116,290,168,217,TRUE,0.579310344827586,2020,2020-2021
GA,2020-12-31,inter-ucfe,1,2,0,0,0,0,0,0,0,1,1,5,2,4,TRUE,0.4,2020,2020-2021
GA,2020-12-31,inter-ucx,0,0,0,0,0,1,0,0,0,0,0,1,0,0,TRUE,0,2020,2020-2021
GA,2020-12-31,inter-ui,51,47,2,7,7,1,7,3,5,39,115,284,166,213,TRUE,0.584507042253521,2020,2020-2021
GA,2020-12-31,intra-total,7383,1187,352,305,190,197,277,200,139,3286,3476,16992,10859,12046,TRUE,0.639065442561205,2020,2020-2021
GA,2020-12-31,intra-ucfe,16,2,6,3,6,9,3,1,0,20,13,79,29,31,TRUE,0.367088607594937,2020,2020-2021
GA,2020-12-31,intra-ucx,8,1,1,2,2,1,4,4,1,10,8,42,16,17,TRUE,0.380952380952381,2020,2020-2021
GA,2020-12-31,intra-ui,7359,1184,345,300,182,187,270,195,138,3256,3455,16871,10814,11998,TRUE,0.64098156600083,2020,2020-2021
GA,2021-01-31,inter-total,22,47,6,5,2,3,6,1,2,40,107,241,129,176,TRUE,0.535269709543568,2020,2020-2021
GA,2021-01-31,inter-ucfe,0,0,0,1,0,0,0,0,0,0,0,1,0,0,TRUE,0,2020,2020-2021
GA,2021-01-31,inter-ucx,0,0,0,0,0,0,0,0,0,0,0,0,0,0,TRUE,0,2020,2020-2021
GA,2021-01-31,inter-ui,22,47,6,4,2,3,6,1,2,40,107,240,129,176,TRUE,0.5375,2020,2020-2021
GA,2021-01-31,intra-total,7734,2657,509,325,206,202,212,164,111,2669,3633,18422,11367,14024,TRUE,0.617033981109543,2020,2020-2021
GA,2021-01-31,intra-ucfe,10,5,4,1,3,2,5,1,4,16,8,59,18,23,TRUE,0.305084745762712,2020,2020-2021
GA,2021-01-31,intra-ucx,8,2,2,1,2,0,3,1,1,15,3,38,11,13,TRUE,0.289473684210526,2020,2020-2021
GA,2021-01-31,intra-ui,7716,2650,503,323,201,200,204,162,106,2638,3622,18325,11338,13988,TRUE,0.618717598908595,2020,2020-2021
GA,2021-02-28,inter-total,18,24,3,2,0,2,3,2,2,28,84,168,102,126,TRUE,0.607142857142857,2020,2020-2021
GA,2021-02-28,inter-ucfe,1,1,0,0,0,0,0,0,0,0,0,2,1,2,TRUE,0.5,2020,2020-2021
GA,2021-02-28,inter-ucx,0,0,0,0,0,0,0,0,0,0,0,0,0,0,TRUE,0,2020,2020-2021
GA,2021-02-28,inter-ui,17,23,3,2,0,2,3,2,2,28,84,166,101,124,TRUE,0.608433734939759,2020,2020-2021
GA,2021-02-28,intra-total,3202,2460,1074,490,289,282,267,148,80,2519,1857,12668,5059,7519,TRUE,0.399352699715819,2020,2020-2021
GA,2021-02-28,intra-ucfe,10,9,6,5,2,0,5,2,1,21,7,68,17,26,TRUE,0.25,2020,2020-2021
GA,2021-02-28,intra-ucx,28,7,4,1,1,3,4,4,1,13,13,79,41,48,TRUE,0.518987341772152,2020,2020-2021
GA,2021-02-28,intra-ui,3164,2444,1064,484,286,279,258,142,78,2485,1837,12521,5001,7445,TRUE,0.399408992891942,2020,2020-2021
GA,2021-03-31,inter-total,21,34,4,2,0,2,3,3,3,76,90,238,111,145,TRUE,0.466386554621849,2020,2020-2021
GA,2021-03-31,inter-ucfe,0,0,1,0,0,0,0,0,0,0,0,1,0,0,TRUE,0,2020,2020-2021
GA,2021-03-31,inter-ucx,0,0,0,0,0,0,0,0,0,0,0,0,0,0,TRUE,0,2020,2020-2021
GA,2021-03-31,inter-ui,21,34,3,2,0,2,3,3,3,76,90,237,111,145,TRUE,0.468354430379747,2020,2020-2021
GA,2021-03-31,intra-total,19298,2463,749,283,279,237,285,216,152,3903,2491,30356,21789,24252,TRUE,0.717782316510739,2020,2020-2021
GA,2021-03-31,intra-ucfe,21,4,9,2,2,2,4,0,1,17,8,70,29,33,TRUE,0.414285714285714,2020,2020-2021
GA,2021-03-31,intra-ucx,22,5,3,3,0,1,4,2,1,3,5,49,27,32,TRUE,0.551020408163265,2020,2020-2021
GA,2021-03-31,intra-ui,19255,2454,737,278,277,234,277,214,150,3883,2478,30237,21733,24187,TRUE,0.718755167510004,2020,2020-2021
GA,2021-04-30,inter-total,13,19,2,2,2,3,5,3,2,76,52,179,65,84,TRUE,0.363128491620112,2020,2020-2021
GA,2021-04-30,inter-ucfe,0,0,0,0,0,0,0,0,0,0,0,0,0,0,TRUE,0,2020,2020-2021
GA,2021-04-30,inter-ucx,0,0,0,0,0,0,0,0,0,0,0,0,0,0,TRUE,0,2020,2020-2021
GA,2021-04-30,inter-ui,13,19,2,2,2,3,5,3,2,76,52,179,65,84,TRUE,0.363128491620112,2020,2020-2021
GA,2021-04-30,intra-total,19461,3228,912,412,205,146,237,117,96,2979,7100,34893,26561,29789,TRUE,0.761212850715043,2020,2020-2021
GA,2021-04-30,intra-ucfe,4,3,4,1,3,1,2,1,2,29,7,57,11,14,TRUE,0.192982456140351,2020,2020-2021
GA,2021-04-30,intra-ucx,9,1,0,6,3,0,1,0,2,6,5,33,14,15,TRUE,0.424242424242424,2020,2020-2021
GA,2021-04-30,intra-ui,19448,3224,908,405,199,145,234,116,92,2944,7088,34803,26536,29760,TRUE,0.762463006062696,2020,2020-2021
GA,2021-05-31,inter-total,25,43,6,1,2,1,4,0,0,46,62,190,87,130,TRUE,0.457894736842105,2020,2020-2021
GA,2021-05-31,inter-ucfe,1,0,0,0,0,0,0,0,0,2,0,3,1,1,TRUE,0.333333333333333,2020,2020-2021
GA,2021-05-31,inter-ucx,0,0,0,0,0,0,0,0,0,0,0,0,0,0,TRUE,0,2020,2020-2021
GA,2021-05-31,inter-ui,24,43,6,1,2,1,4,0,0,44,62,187,86,129,TRUE,0.459893048128342,2020,2020-2021
GA,2021-05-31,intra-total,6085,1110,690,833,594,466,319,166,129,2663,1691,14746,7776,8886,TRUE,0.527329445273295,2020,2020-2021
GA,2021-05-31,intra-ucfe,5,1,1,1,1,3,0,1,0,14,0,27,5,6,TRUE,0.185185185185185,2020,2020-2021
GA,2021-05-31,intra-ucx,5,0,0,2,4,0,1,1,0,7,3,23,8,8,TRUE,0.347826086956522,2020,2020-2021
GA,2021-05-31,intra-ui,6075,1109,689,830,589,463,318,164,129,2642,1688,14696,7763,8872,TRUE,0.52823897659227,2020,2020-2021
GA,2021-06-30,inter-total,14,36,7,5,4,6,5,2,2,53,84,218,98,134,TRUE,0.44954128440367,2020,2020-2021
GA,2021-06-30,inter-ucfe,0,1,0,1,0,0,0,0,0,1,0,3,0,1,TRUE,0,2020,2020-2021
GA,2021-06-30,inter-ucx,0,0,0,0,0,0,0,0,0,0,0,0,0,0,TRUE,0,2020,2020-2021
GA,2021-06-30,inter-ui,14,35,7,4,4,6,5,2,2,52,84,215,98,133,TRUE,0.455813953488372,2020,2020-2021
GA,2021-06-30,intra-total,4875,1830,1066,871,1047,1051,792,486,393,3649,1487,17547,6362,8192,TRUE,0.362569100131077,2020,2020-2021
GA,2021-06-30,intra-ucfe,10,1,4,1,0,2,2,1,1,9,5,36,15,16,TRUE,0.416666666666667,2020,2020-2021
GA,2021-06-30,intra-ucx,5,0,1,0,1,1,0,3,1,5,3,20,8,8,TRUE,0.4,2020,2020-2021
GA,2021-06-30,intra-ui,4860,1829,1061,870,1046,1048,790,482,391,3635,1479,17491,6339,8168,TRUE,0.362414956263221,2020,2020-2021
GA,2021-07-31,inter-total,9,22,4,2,3,2,4,3,5,64,37,155,46,68,TRUE,0.296774193548387,2021,2021-2022
GA,2021-07-31,inter-ucfe,0,0,0,0,0,0,0,0,0,1,0,1,0,0,TRUE,0,2021,2021-2022
GA,2021-07-31,inter-ucx,0,0,0,0,0,0,0,0,0,1,0,1,0,0,TRUE,0,2021,2021-2022
GA,2021-07-31,inter-ui,9,22,4,2,3,2,4,3,5,62,37,153,46,68,TRUE,0.300653594771242,2021,2021-2022
GA,2021-07-31,intra-total,3751,1089,566,357,313,279,402,345,292,3610,1783,12787,5534,6623,TRUE,0.432783295534527,2021,2021-2022
GA,2021-07-31,intra-ucfe,5,3,3,1,0,1,2,2,1,13,2,33,7,10,TRUE,0.212121212121212,2021,2021-2022
GA,2021-07-31,intra-ucx,0,0,0,0,1,2,1,1,0,5,1,11,1,1,TRUE,0.0909090909090909,2021,2021-2022
GA,2021-07-31,intra-ui,3746,1086,563,356,312,276,399,342,291,3592,1780,12743,5526,6612,TRUE,0.43364984697481,2021,2021-2022
GA,2021-08-31,inter-total,15,18,2,1,2,5,2,5,8,36,48,142,63,81,TRUE,0.443661971830986,2021,2021-2022
GA,2021-08-31,inter-ucfe,0,0,0,0,0,0,0,0,0,2,0,2,0,0,TRUE,0,2021,2021-2022
GA,2021-08-31,inter-ucx,0,0,0,0,0,0,0,0,0,0,0,0,0,0,TRUE,0,2021,2021-2022
GA,2021-08-31,inter-ui,15,18,2,1,2,5,2,5,8,34,48,140,63,81,TRUE,0.45,2021,2021-2022
GA,2021-08-31,intra-total,2863,1152,479,256,221,235,302,378,684,3854,1499,11923,4362,5514,TRUE,0.365847521596914,2021,2021-2022
GA,2021-08-31,intra-ucfe,15,6,0,3,5,1,2,2,0,18,5,57,20,26,TRUE,0.350877192982456,2021,2021-2022
GA,2021-08-31,intra-ucx,6,1,0,0,0,2,1,0,0,9,0,19,6,7,TRUE,0.315789473684211,2021,2021-2022
GA,2021-08-31,intra-ui,2842,1145,479,253,216,232,299,376,684,3827,1494,11847,4336,5481,TRUE,0.36599983118089,2021,2021-2022
GA,2021-09-30,inter-total,11,19,2,10,17,12,8,3,3,18,46,149,57,76,TRUE,0.38255033557047,2021,2021-2022
GA,2021-09-30,inter-ucfe,0,0,0,0,0,0,1,0,0,1,0,2,0,0,TRUE,0,2021,2021-2022
GA,2021-09-30,inter-ucx,0,1,0,0,0,0,0,0,0,0,0,1,0,1,TRUE,0,2021,2021-2022
GA,2021-09-30,inter-ui,11,18,2,10,17,12,7,3,3,17,46,146,57,75,TRUE,0.39041095890411,2021,2021-2022
GA,2021-09-30,intra-total,2504,894,355,376,455,453,390,218,175,2553,1442,9815,3946,4840,TRUE,0.402037697401936,2021,2021-2022
GA,2021-09-30,intra-ucfe,7,3,5,3,0,0,1,1,0,13,3,36,10,13,TRUE,0.277777777777778,2021,2021-2022
GA,2021-09-30,intra-ucx,7,2,0,1,0,2,2,1,1,6,1,23,8,10,TRUE,0.347826086956522,2021,2021-2022
GA,2021-09-30,intra-ui,2490,889,350,372,455,451,387,216,174,2534,1438,9756,3928,4817,TRUE,0.402624026240262,2021,2021-2022
GA,2021-10-31,inter-total,8,17,5,5,7,5,2,2,2,40,42,135,50,67,TRUE,0.37037037037037,2021,2021-2022
GA,2021-10-31,inter-ucfe,0,0,0,0,0,0,0,0,0,2,2,4,2,2,TRUE,0.5,2021,2021-2022
GA,2021-10-31,inter-ucx,0,0,0,0,0,0,0,0,0,1,0,1,0,0,TRUE,0,2021,2021-2022
GA,2021-10-31,inter-ui,8,17,5,5,7,5,2,2,2,37,40,130,48,65,TRUE,0.369230769230769,2021,2021-2022
GA,2021-10-31,intra-total,1530,963,415,256,231,149,148,105,106,3603,1321,8827,2851,3814,TRUE,0.322986292058457,2021,2021-2022
GA,2021-10-31,intra-ucfe,12,5,2,2,0,0,2,1,2,13,7,46,19,24,TRUE,0.41304347826087,2021,2021-2022
GA,2021-10-31,intra-ucx,9,0,2,2,1,1,1,1,0,7,3,27,12,12,TRUE,0.444444444444444,2021,2021-2022
GA,2021-10-31,intra-ui,1509,958,411,252,230,148,145,103,104,3583,1311,8754,2820,3778,TRUE,0.322138450993831,2021,2021-2022
GA,2021-11-30,inter-total,7,16,6,3,3,3,2,0,0,24,37,101,44,60,TRUE,0.435643564356436,2021,2021-2022
GA,2021-11-30,inter-ucfe,0,0,0,0,0,0,0,0,0,0,0,0,0,0,TRUE,0,2021,2021-2022
GA,2021-11-30,inter-ucx,0,0,0,0,0,0,0,0,0,0,0,0,0,0,TRUE,0,2021,2021-2022
GA,2021-11-30,inter-ui,7,16,6,3,3,3,2,0,0,24,37,101,44,60,TRUE,0.435643564356436,2021,2021-2022
GA,2021-11-30,intra-total,536,931,556,205,118,79,61,56,54,783,715,4094,1251,2182,TRUE,0.305569125549585,2021,2021-2022
GA,2021-11-30,intra-ucfe,8,2,2,1,1,2,1,0,1,11,1,30,9,11,TRUE,0.3,2021,2021-2022
GA,2021-11-30,intra-ucx,5,5,1,3,2,0,0,1,1,6,7,31,12,17,TRUE,0.387096774193548,2021,2021-2022
GA,2021-11-30,intra-ui,523,924,553,201,115,77,60,55,52,766,707,4033,1230,2154,TRUE,0.304983882965534,2021,2021-2022
GA,2021-12-31,inter-total,13,43,8,7,5,2,2,2,0,23,52,157,65,108,TRUE,0.414012738853503,2021,2021-2022
GA,2021-12-31,inter-ucfe,0,0,0,0,0,0,0,0,0,0,0,0,0,0,TRUE,0,2021,2021-2022
GA,2021-12-31,inter-ucx,0,0,0,1,0,0,0,0,0,0,0,1,0,0,TRUE,0,2021,2021-2022
GA,2021-12-31,inter-ui,13,43,8,6,5,2,2,2,0,23,52,156,65,108,TRUE,0.416666666666667,2021,2021-2022
GA,2021-12-31,intra-total,593,1185,569,273,150,131,124,77,57,721,729,4609,1322,2507,TRUE,0.286830114992406,2021,2021-2022
GA,2021-12-31,intra-ucfe,5,4,2,1,2,2,1,1,1,12,1,32,6,10,TRUE,0.1875,2021,2021-2022
GA,2021-12-31,intra-ucx,4,1,0,0,1,1,0,1,1,1,5,15,9,10,TRUE,0.6,2021,2021-2022
GA,2021-12-31,intra-ui,584,1180,567,272,147,128,123,75,55,708,723,4562,1307,2487,TRUE,0.286497150372644,2021,2021-2022
GA,2022-01-31,inter-total,10,25,6,3,7,5,4,3,0,15,49,127,59,84,TRUE,0.464566929133858,2021,2021-2022
GA,2022-01-31,inter-ucfe,0,1,0,0,0,1,0,0,0,0,2,4,2,3,TRUE,0.5,2021,2021-2022
GA,2022-01-31,inter-ucx,0,0,0,0,0,0,0,0,0,0,0,0,0,0,TRUE,0,2021,2021-2022
GA,2022-01-31,inter-ui,10,24,6,3,7,4,4,3,0,15,47,123,57,81,TRUE,0.463414634146342,2021,2021-2022
GA,2022-01-31,intra-total,1985,1853,967,323,160,151,107,85,48,526,2153,8358,4138,5991,TRUE,0.495094520220148,2021,2021-2022
GA,2022-01-31,intra-ucfe,5,2,2,0,1,1,0,1,1,5,2,20,7,9,TRUE,0.35,2021,2021-2022
GA,2022-01-31,intra-ucx,2,2,1,2,2,1,0,0,0,3,4,17,6,8,TRUE,0.352941176470588,2021,2021-2022
GA,2022-01-31,intra-ui,1978,1849,964,321,157,149,107,84,47,518,2147,8321,4125,5974,TRUE,0.495733685855066,2021,2021-2022
GA,2022-02-28,inter-total,12,28,11,7,2,3,1,2,1,13,40,120,52,80,TRUE,0.433333333333333,2021,2021-2022
GA,2022-02-28,inter-ucfe,0,0,0,0,0,0,0,0,0,0,0,0,0,0,TRUE,0,2021,2021-2022
GA,2022-02-28,inter-ucx,0,0,0,0,0,0,0,0,0,0,0,0,0,0,TRUE,0,2021,2021-2022
GA,2022-02-28,inter-ui,12,28,11,7,2,3,1,2,1,13,40,120,52,80,TRUE,0.433333333333333,2021,2021-2022
GA,2022-02-28,intra-total,807,1445,860,573,306,245,158,103,63,598,828,5986,1635,3080,TRUE,0.2731373204143,2021,2021-2022
GA,2022-02-28,intra-ucfe,3,1,2,2,1,1,1,0,0,7,6,24,9,10,TRUE,0.375,2021,2021-2022
GA,2022-02-28,intra-ucx,9,3,2,2,1,0,2,0,1,2,3,25,12,15,TRUE,0.48,2021,2021-2022
GA,2022-02-28,intra-ui,795,1441,856,569,304,244,155,103,62,589,819,5937,1614,3055,TRUE,0.271854471955533,2021,2021-2022
GA,2022-03-31,inter-total,10,31,4,5,6,2,1,2,3,18,44,126,54,85,TRUE,0.428571428571429,2021,2021-2022
GA,2022-03-31,inter-ucfe,0,0,0,0,0,0,0,0,0,0,0,0,0,0,TRUE,0,2021,2021-2022
GA,2022-03-31,inter-ucx,0,0,0,0,0,0,0,0,0,0,0,0,0,0,TRUE,0,2021,2021-2022
GA,2022-03-31,inter-ui,10,31,4,5,6,2,1,2,3,18,44,126,54,85,TRUE,0.428571428571429,2021,2021-2022
GA,2022-03-31,intra-total,1251,1507,516,228,145,117,128,104,116,699,1715,6526,2966,4473,TRUE,0.454489733374196,2021,2021-2022
GA,2022-03-31,intra-ucfe,9,4,2,0,2,3,4,1,1,8,5,39,14,18,TRUE,0.358974358974359,2021,2021-2022
GA,2022-03-31,intra-ucx,5,1,1,2,1,1,0,0,1,2,3,17,8,9,TRUE,0.470588235294118,2021,2021-2022
GA,2022-03-31,intra-ui,1237,1502,513,226,142,113,124,103,114,689,1707,6470,2944,4446,TRUE,0.455023183925811,2021,2021-2022
GA,2022-04-30,inter-total,10,22,5,1,1,2,2,0,1,11,28,83,38,60,TRUE,0.457831325301205,2021,2021-2022
GA,2022-04-30,inter-ucfe,0,0,0,0,0,0,0,0,0,0,0,0,0,0,TRUE,0,2021,2021-2022
GA,2022-04-30,inter-ucx,1,0,0,0,0,0,0,0,0,0,0,1,1,1,TRUE,1,2021,2021-2022
GA,2022-04-30,inter-ui,9,22,5,1,1,2,2,0,1,11,28,82,37,59,TRUE,0.451219512195122,2021,2021-2022
GA,2022-04-30,intra-total,914,1072,347,174,130,121,83,66,53,766,1695,5421,2609,3681,TRUE,0.48127651724774,2021,2021-2022
GA,2022-04-30,intra-ucfe,12,9,2,0,0,3,4,1,1,4,11,47,23,32,TRUE,0.48936170212766,2021,2021-2022
GA,2022-04-30,intra-ucx,6,2,2,2,3,3,1,0,1,5,9,34,15,17,TRUE,0.441176470588235,2021,2021-2022
GA,2022-04-30,intra-ui,896,1061,343,172,127,115,78,65,51,757,1675,5340,2571,3632,TRUE,0.481460674157303,2021,2021-2022
GA,2022-05-31,inter-total,8,32,9,1,4,1,1,1,1,31,31,120,39,71,TRUE,0.325,2021,2021-2022
GA,2022-05-31,inter-ucfe,0,0,0,0,0,0,0,0,0,0,0,0,0,0,TRUE,0,2021,2021-2022
GA,2022-05-31,inter-ucx,0,0,1,0,0,0,0,0,0,0,0,1,0,0,TRUE,0,2021,2021-2022
GA,2022-05-31,inter-ui,8,32,8,1,4,1,1,1,1,31,31,119,39,71,TRUE,0.327731092436975,2021,2021-2022
GA,2022-05-31,intra-total,1084,1268,451,225,106,65,50,55,48,545,1843,5740,2927,4195,TRUE,0.50993031358885,2021,2021-2022
GA,2022-05-31,intra-ucfe,14,9,7,2,2,0,2,0,0,6,10,52,24,33,TRUE,0.461538461538462,2021,2021-2022
GA,2022-05-31,intra-ucx,9,5,4,3,2,1,3,0,1,3,6,37,15,20,TRUE,0.405405405405405,2021,2021-2022
GA,2022-05-31,intra-ui,1061,1254,440,220,102,64,45,55,47,536,1827,5651,2888,4142,TRUE,0.51105998938241,2021,2021-2022
GA,2022-06-30,inter-total,9,51,12,6,2,3,1,0,0,10,55,149,64,115,TRUE,0.429530201342282,2021,2021-2022
GA,2022-06-30,inter-ucfe,0,0,0,1,0,0,0,0,0,1,1,3,1,1,TRUE,0.333333333333333,2021,2021-2022
GA,2022-06-30,inter-ucx,1,0,0,0,0,0,0,0,0,0,0,1,1,1,TRUE,1,2021,2021-2022
GA,2022-06-30,inter-ui,8,51,12,5,2,3,1,0,0,9,54,145,62,113,TRUE,0.427586206896552,2021,2021-2022
GA,2022-06-30,intra-total,1315,2363,753,308,176,147,107,64,41,1215,1869,8358,3184,5547,TRUE,0.380952380952381,2021,2021-2022
GA,2022-06-30,intra-ucfe,10,12,7,4,0,1,3,1,0,4,4,46,14,26,TRUE,0.304347826086957,2021,2021-2022
GA,2022-06-30,intra-ucx,12,3,3,3,2,3,1,0,0,8,8,43,20,23,TRUE,0.465116279069768,2021,2021-2022
GA,2022-06-30,intra-ui,1293,2348,743,301,174,143,103,63,41,1203,1857,8269,3150,5498,TRUE,0.380940863465957,2021,2021-2022
GA,2022-07-31,inter-total,7,25,4,6,2,4,1,3,1,17,46,116,53,78,TRUE,0.456896551724138,2022,2022-2023
GA,2022-07-31,inter-ucfe,0,0,0,0,0,0,0,0,0,0,0,0,0,0,TRUE,0,2022,2022-2023
GA,2022-07-31,inter-ucx,0,0,0,0,0,0,0,0,0,0,0,0,0,0,TRUE,0,2022,2022-2023
GA,2022-07-31,inter-ui,7,25,4,6,2,4,1,3,1,17,46,116,53,78,TRUE,0.456896551724138,2022,2022-2023
GA,2022-07-31,intra-total,1911,2304,671,367,218,146,98,42,50,1065,1767,8639,3678,5982,TRUE,0.425743720338002,2022,2022-2023
GA,2022-07-31,intra-ucfe,23,11,9,19,14,3,7,0,1,6,12,105,35,46,TRUE,0.333333333333333,2022,2022-2023
GA,2022-07-31,intra-ucx,12,6,4,0,1,1,1,0,0,6,6,37,18,24,TRUE,0.486486486486487,2022,2022-2023
GA,2022-07-31,intra-ui,1876,2287,658,348,203,142,90,42,49,1053,1749,8497,3625,5912,TRUE,0.426621160409556,2022,2022-2023
GA,2022-08-31,inter-total,8,24,5,8,6,3,0,1,1,20,32,108,40,64,TRUE,0.37037037037037,2022,2022-2023
GA,2022-08-31,inter-ucfe,0,1,0,0,1,0,0,0,0,0,0,2,0,1,TRUE,0,2022,2022-2023
GA,2022-08-31,inter-ucx,0,0,0,0,0,0,0,0,0,0,0,0,0,0,TRUE,0,2022,2022-2023
GA,2022-08-31,inter-ui,8,23,5,8,5,3,0,1,1,20,32,106,40,63,TRUE,0.377358490566038,2022,2022-2023
GA,2022-08-31,intra-total,1449,2322,829,374,278,145,115,105,78,1412,2163,9270,3612,5934,TRUE,0.389644012944984,2022,2022-2023
GA,2022-08-31,intra-ucfe,14,7,7,6,8,2,6,1,0,10,16,77,30,37,TRUE,0.38961038961039,2022,2022-2023
GA,2022-08-31,intra-ucx,9,9,6,7,3,2,1,0,1,8,11,57,20,29,TRUE,0.350877192982456,2022,2022-2023
GA,2022-08-31,intra-ui,1426,2306,816,361,267,141,108,104,77,1394,2136,9136,3562,5868,TRUE,0.389886164623468,2022,2022-2023
GA,2022-09-30,inter-total,16,16,4,4,5,1,5,1,2,14,29,97,45,61,TRUE,0.463917525773196,2022,2022-2023
GA,2022-09-30,inter-ucfe,1,0,0,0,0,0,0,0,0,0,0,1,1,1,TRUE,1,2022,2022-2023
GA,2022-09-30,inter-ucx,1,0,0,0,0,0,0,0,0,1,0,2,1,1,TRUE,0.5,2022,2022-2023
GA,2022-09-30,inter-ui,14,16,4,4,5,1,5,1,2,13,29,94,43,59,TRUE,0.457446808510638,2022,2022-2023
GA,2022-09-30,intra-total,1038,1628,494,246,153,179,113,104,76,1353,1714,7098,2752,4380,TRUE,0.387714849253311,2022,2022-2023
GA,2022-09-30,intra-ucfe,7,6,4,1,0,1,0,0,0,14,11,44,18,24,TRUE,0.409090909090909,2022,2022-2023
GA,2022-09-30,intra-ucx,5,8,5,1,1,0,2,0,0,2,5,29,10,18,TRUE,0.344827586206897,2022,2022-2023
GA,2022-09-30,intra-ui,1026,1614,485,244,152,178,111,104,76,1337,1698,7025,2724,4338,TRUE,0.387758007117438,2022,2022-2023
GA,2022-10-31,inter-total,13,19,10,3,6,3,3,3,0,18,32,110,45,64,TRUE,0.409090909090909,2022,2022-2023
GA,2022-10-31,inter-ucfe,0,0,0,0,0,0,0,0,0,0,0,0,0,0,TRUE,0,2022,2022-2023
GA,2022-10-31,inter-ucx,0,0,0,0,0,0,0,0,0,0,0,0,0,0,TRUE,0,2022,2022-2023
GA,2022-10-31,inter-ui,13,19,10,3,6,3,3,3,0,18,32,110,45,64,TRUE,0.409090909090909,2022,2022-2023
GA,2022-10-31,intra-total,1241,1368,536,299,172,126,87,68,62,1148,1378,6485,2619,3987,TRUE,0.403855050115651,2022,2022-2023
GA,2022-10-31,intra-ucfe,6,4,2,3,0,2,0,2,0,16,3,38,9,13,TRUE,0.236842105263158,2022,2022-2023
GA,2022-10-31,intra-ucx,4,4,0,2,1,1,1,1,0,2,6,22,10,14,TRUE,0.454545454545455,2022,2022-2023
GA,2022-10-31,intra-ui,1231,1360,534,294,171,123,86,65,62,1130,1369,6425,2600,3960,TRUE,0.404669260700389,2022,2022-2023
GA,2022-11-30,inter-total,30,36,7,7,7,4,5,0,4,25,36,161,66,102,TRUE,0.409937888198758,2022,2022-2023
GA,2022-11-30,inter-ucfe,0,0,0,0,0,0,0,0,1,0,0,1,0,0,TRUE,0,2022,2022-2023
GA,2022-11-30,inter-ucx,0,0,0,0,0,0,0,0,0,0,0,0,0,0,TRUE,0,2022,2022-2023
GA,2022-11-30,inter-ui,30,36,7,7,7,4,5,0,3,25,36,160,66,102,TRUE,0.4125,2022,2022-2023
GA,2022-11-30,intra-total,1763,2232,1174,505,267,186,89,69,42,1133,1604,9064,3367,5599,TRUE,0.371469549867608,2022,2022-2023
GA,2022-11-30,intra-ucfe,4,2,4,2,0,4,1,0,0,2,2,21,6,8,TRUE,0.285714285714286,2022,2022-2023
GA,2022-11-30,intra-ucx,4,6,4,1,3,0,3,0,0,1,12,34,16,22,TRUE,0.470588235294118,2022,2022-2023
GA,2022-11-30,intra-ui,1755,2224,1166,502,264,182,85,69,42,1130,1590,9009,3345,5569,TRUE,0.371295371295371,2022,2022-2023
GA,2022-12-31,inter-total,16,16,14,6,6,2,2,0,2,12,24,100,40,56,TRUE,0.4,2022,2022-2023
GA,2022-12-31,inter-ucfe,0,0,1,0,0,0,0,0,0,0,0,1,0,0,TRUE,0,2022,2022-2023
GA,2022-12-31,inter-ucx,1,0,0,0,0,0,0,0,0,0,0,1,1,1,TRUE,1,2022,2022-2023
GA,2022-12-31,inter-ui,15,16,13,6,6,2,2,0,2,12,24,98,39,55,TRUE,0.397959183673469,2022,2022-2023
GA,2022-12-31,intra-total,2518,2303,1062,504,217,168,91,81,46,771,3022,10783,5540,7843,TRUE,0.513771677640731,2022,2022-2023
GA,2022-12-31,intra-ucfe,6,5,1,3,3,0,1,1,0,2,7,29,13,18,TRUE,0.448275862068966,2022,2022-2023
GA,2022-12-31,intra-ucx,5,3,6,1,0,2,0,0,0,4,11,32,16,19,TRUE,0.5,2022,2022-2023
GA,2022-12-31,intra-ui,2507,2295,1055,500,214,166,90,80,46,765,3004,10722,5511,7806,TRUE,0.513989927252378,2022,2022-2023
GA,2023-01-31,inter-total,15,23,10,4,5,3,2,2,1,10,24,99,39,62,TRUE,0.393939393939394,2022,2022-2023
GA,2023-01-31,inter-ucfe,0,0,0,1,0,0,0,0,0,1,0,2,0,0,TRUE,0,2022,2022-2023
GA,2023-01-31,inter-ucx,0,0,0,0,1,0,0,0,0,0,0,1,0,0,TRUE,0,2022,2022-2023
GA,2023-01-31,inter-ui,15,23,10,3,4,3,2,2,1,9,24,96,39,62,TRUE,0.40625,2022,2022-2023
GA,2023-01-31,intra-total,4136,3074,1285,652,402,283,181,146,75,827,3867,14928,8003,11077,TRUE,0.53610664523044,2022,2022-2023
GA,2023-01-31,intra-ucfe,7,3,3,1,1,0,1,0,0,5,7,28,14,17,TRUE,0.5,2022,2022-2023
GA,2023-01-31,intra-ucx,4,6,5,4,1,0,0,1,0,2,10,33,14,20,TRUE,0.424242424242424,2022,2022-2023
GA,2023-01-31,intra-ui,4125,3065,1277,647,400,283,180,145,75,820,3850,14867,7975,11040,TRUE,0.536422950158068,2022,2022-2023
GA,2023-02-28,inter-total,23,20,12,7,3,3,4,2,0,13,34,121,57,77,TRUE,0.471074380165289,2022,2022-2023
GA,2023-02-28,inter-ucfe,0,0,0,0,0,0,0,0,0,0,0,0,0,0,TRUE,0,2022,2022-2023
GA,2023-02-28,inter-ucx,0,0,0,0,0,0,0,0,0,1,0,1,0,0,TRUE,0,2022,2022-2023
GA,2023-02-28,inter-ui,23,20,12,7,3,3,4,2,0,12,34,120,57,77,TRUE,0.475,2022,2022-2023
GA,2023-02-28,intra-total,1437,2551,798,513,429,307,193,114,74,981,2568,9965,4005,6556,TRUE,0.401906673356749,2022,2022-2023
GA,2023-02-28,intra-ucfe,3,3,1,3,2,1,1,0,1,6,3,24,6,9,TRUE,0.25,2022,2022-2023
GA,2023-02-28,intra-ucx,8,3,3,1,2,1,0,1,0,1,6,26,14,17,TRUE,0.538461538461538,2022,2022-2023
GA,2023-02-28,intra-ui,1426,2545,794,509,425,305,192,113,73,974,2559,9915,3985,6530,TRUE,0.401916288451841,2022,2022-2023
GA,2023-03-31,inter-total,30,30,10,6,6,4,3,1,4,13,41,148,71,101,TRUE,0.47972972972973,2022,2022-2023
GA,2023-03-31,inter-ucfe,0,0,0,0,0,0,0,0,0,1,0,1,0,0,TRUE,0,2022,2022-2023
GA,2023-03-31,inter-ucx,0,0,0,0,0,0,0,0,0,0,0,0,0,0,TRUE,0,2022,2022-2023
GA,2023-03-31,inter-ui,30,30,10,6,6,4,3,1,4,12,41,147,71,101,TRUE,0.482993197278912,2022,2022-2023
GA,2023-03-31,intra-total,1609,2377,650,355,194,110,78,109,133,1320,2736,9671,4345,6722,TRUE,0.449281356633233,2022,2022-2023
GA,2023-03-31,intra-ucfe,3,9,2,0,0,1,0,0,0,4,5,24,8,17,TRUE,0.333333333333333,2022,2022-2023
GA,2023-03-31,intra-ucx,13,3,7,2,2,1,1,0,1,3,8,41,21,24,TRUE,0.51219512195122,2022,2022-2023
GA,2023-03-31,intra-ui,1593,2365,641,353,192,108,77,109,132,1313,2723,9606,4316,6681,TRUE,0.449302519258797,2022,2022-2023
GA,2023-04-30,inter-total,32,31,16,7,2,4,3,1,1,14,48,159,80,111,TRUE,0.50314465408805,2022,2022-2023
GA,2023-04-30,inter-ucfe,0,0,0,0,0,0,0,0,0,1,0,1,0,0,TRUE,0,2022,2022-2023
GA,2023-04-30,inter-ucx,0,0,0,0,0,0,0,0,0,0,0,0,0,0,TRUE,0,2022,2022-2023
GA,2023-04-30,inter-ui,32,31,16,7,2,4,3,1,1,13,48,158,80,111,TRUE,0.506329113924051,2022,2022-2023
GA,2023-04-30,intra-total,1345,2342,793,345,137,93,69,51,35,884,1228,7322,2573,4915,TRUE,0.351406719475553,2022,2022-2023
GA,2023-04-30,intra-ucfe,7,5,1,2,2,2,2,0,0,6,5,32,12,17,TRUE,0.375,2022,2022-2023
GA,2023-04-30,intra-ucx,4,5,1,1,1,0,0,0,0,0,15,27,19,24,TRUE,0.703703703703704,2022,2022-2023
GA,2023-04-30,intra-ui,1334,2332,791,342,134,91,67,51,35,878,1208,7263,2542,4874,TRUE,0.349993115792372,2022,2022-2023
GA,2023-05-31,inter-total,37,42,17,15,6,5,7,2,0,12,79,222,116,158,TRUE,0.522522522522523,2022,2022-2023
GA,2023-05-31,inter-ucfe,0,0,0,0,0,0,0,0,0,1,0,1,0,0,TRUE,0,2022,2022-2023
GA,2023-05-31,inter-ucx,0,0,0,0,0,0,0,0,0,0,0,0,0,0,TRUE,0,2022,2022-2023
GA,2023-05-31,inter-ui,37,42,17,15,6,5,7,2,0,11,79,221,116,158,TRUE,0.524886877828054,2022,2022-2023
GA,2023-05-31,intra-total,1563,2458,918,395,190,98,62,42,37,1084,2216,9063,3779,6237,TRUE,0.416970098201479,2022,2022-2023
GA,2023-05-31,intra-ucfe,5,7,1,3,3,0,1,1,0,2,8,31,13,20,TRUE,0.419354838709677,2022,2022-2023
GA,2023-05-31,intra-ucx,8,10,1,3,1,0,0,0,0,1,9,33,17,27,TRUE,0.515151515151515,2022,2022-2023
GA,2023-05-31,intra-ui,1550,2441,916,389,186,98,61,41,37,1081,2199,8999,3749,6190,TRUE,0.416601844649405,2022,2022-2023
GA,2023-06-30,inter-total,31,31,24,9,7,8,3,2,1,15,62,193,93,124,TRUE,0.481865284974093,2022,2022-2023
GA,2023-06-30,inter-ucfe,0,0,1,0,0,0,0,0,0,0,0,1,0,0,TRUE,0,2022,2022-2023
GA,2023-06-30,inter-ucx,0,0,0,0,0,0,0,0,0,0,0,0,0,0,TRUE,0,2022,2022-2023
GA,2023-06-30,inter-ui,31,31,23,9,7,8,3,2,1,15,62,192,93,124,TRUE,0.484375,2022,2022-2023
GA,2023-06-30,intra-total,1089,3004,870,344,186,103,79,52,30,547,1811,8115,2900,5904,TRUE,0.357362908194701,2022,2022-2023
GA,2023-06-30,intra-ucfe,7,0,2,3,2,1,1,1,1,2,5,25,12,12,TRUE,0.48,2022,2022-2023
GA,2023-06-30,intra-ucx,3,6,4,0,1,1,0,0,0,1,9,25,12,18,TRUE,0.48,2022,2022-2023
GA,2023-06-30,intra-ui,1079,2998,864,341,183,101,78,51,29,544,1797,8065,2876,5874,TRUE,0.356602603843769,2022,2022-2023
GA,2023-07-31,inter-total,33,52,15,13,8,6,2,0,3,5,47,184,80,132,TRUE,0.434782608695652,2023,2023-2024
GA,2023-07-31,inter-ucfe,0,1,0,0,0,0,0,0,0,0,1,2,1,2,TRUE,0.5,2023,2023-2024
GA,2023-07-31,inter-ucx,0,0,0,0,0,0,0,0,0,0,0,0,0,0,TRUE,0,2023,2023-2024
GA,2023-07-31,inter-ui,33,51,15,13,8,6,2,0,3,5,46,182,79,130,TRUE,0.434065934065934,2023,2023-2024
GA,2023-07-31,intra-total,965,3779,2069,658,271,129,169,103,33,675,1159,10010,2124,5903,TRUE,0.212187812187812,2023,2023-2024
GA,2023-07-31,intra-ucfe,11,3,4,3,2,2,1,0,0,5,6,37,17,20,TRUE,0.45945945945946,2023,2023-2024
GA,2023-07-31,intra-ucx,4,5,3,1,2,0,0,0,0,0,3,18,7,12,TRUE,0.388888888888889,2023,2023-2024
GA,2023-07-31,intra-ui,950,3771,2062,654,267,127,168,103,33,670,1150,9955,2100,5871,TRUE,0.210949271722752,2023,2023-2024
GA,2023-08-31,inter-total,34,58,28,7,10,8,7,4,2,19,59,236,93,151,TRUE,0.39406779661017,2023,2023-2024
GA,2023-08-31,inter-ucfe,0,1,0,0,0,0,0,0,0,0,0,1,0,1,TRUE,0,2023,2023-2024
GA,2023-08-31,inter-ucx,0,0,0,0,0,0,0,0,0,0,0,0,0,0,TRUE,0,2023,2023-2024
GA,2023-08-31,inter-ui,34,57,28,7,10,8,7,4,2,19,59,235,93,150,TRUE,0.395744680851064,2023,2023-2024
GA,2023-08-31,intra-total,1722,3195,1447,790,439,271,113,65,51,767,3492,12352,5214,8409,TRUE,0.422117875647668,2023,2023-2024
GA,2023-08-31,intra-ucfe,7,5,6,2,0,2,1,0,0,2,10,35,17,22,TRUE,0.485714285714286,2023,2023-2024
GA,2023-08-31,intra-ucx,6,11,2,1,2,0,1,1,1,2,8,35,14,25,TRUE,0.4,2023,2023-2024
GA,2023-08-31,intra-ui,1709,3179,1439,787,437,269,111,64,50,763,3474,12282,5183,8362,TRUE,0.421999674320143,2023,2023-2024
GA,2023-09-30,inter-total,21,41,6,9,7,5,1,6,2,30,40,168,61,102,TRUE,0.363095238095238,2023,2023-2024
GA,2023-09-30,inter-ucfe,0,0,0,0,0,0,0,0,0,0,0,0,0,0,TRUE,0,2023,2023-2024
GA,2023-09-30,inter-ucx,0,0,0,0,0,0,0,0,0,0,0,0,0,0,TRUE,0,2023,2023-2024
GA,2023-09-30,inter-ui,21,41,6,9,7,5,1,6,2,30,40,168,61,102,TRUE,0.363095238095238,2023,2023-2024
GA,2023-09-30,intra-total,1519,2240,715,457,238,145,101,76,56,601,2838,8986,4357,6597,TRUE,0.484865346093924,2023,2023-2024
GA,2023-09-30,intra-ucfe,1,4,0,1,0,0,0,0,0,3,5,14,6,10,TRUE,0.428571428571429,2023,2023-2024
GA,2023-09-30,intra-ucx,13,4,2,2,3,0,0,1,1,1,5,32,18,22,TRUE,0.5625,2023,2023-2024
GA,2023-09-30,intra-ui,1505,2232,713,454,235,145,101,75,55,597,2828,8940,4333,6565,TRUE,0.484675615212528,2023,2023-2024
GA,2023-10-31,inter-total,18,46,18,9,7,3,3,3,1,16,40,164,58,104,TRUE,0.353658536585366,2023,2023-2024
GA,2023-10-31,inter-ucfe,0,0,1,0,0,0,0,0,0,0,0,1,0,0,TRUE,0,2023,2023-2024
GA,2023-10-31,inter-ucx,0,0,0,0,0,0,0,0,0,0,0,0,0,0,TRUE,0,2023,2023-2024
GA,2023-10-31,inter-ui,18,46,17,9,7,3,3,3,1,16,40,163,58,104,TRUE,0.355828220858896,2023,2023-2024
GA,2023-10-31,intra-total,1651,2219,551,263,137,86,56,39,27,700,2602,8331,4253,6472,TRUE,0.510502940823431,2023,2023-2024
GA,2023-10-31,intra-ucfe,0,6,2,0,1,0,2,0,0,3,2,16,2,8,TRUE,0.125,2023,2023-2024
GA,2023-10-31,intra-ucx,11,5,1,0,1,0,1,0,0,2,9,30,20,25,TRUE,0.666666666666667,2023,2023-2024
GA,2023-10-31,intra-ui,1640,2208,548,263,135,86,53,39,27,695,2591,8285,4231,6439,TRUE,0.510681955340978,2023,2023-2024
GA,2023-11-30,inter-total,12,20,11,4,6,2,2,1,2,10,31,101,43,63,TRUE,0.425742574257426,2023,2023-2024
GA,2023-11-30,inter-ucfe,0,0,1,0,0,0,1,0,0,0,0,2,0,0,TRUE,0,2023,2023-2024
GA,2023-11-30,inter-ucx,0,0,0,0,0,0,0,0,0,0,0,0,0,0,TRUE,0,2023,2023-2024
GA,2023-11-30,inter-ui,12,20,10,4,6,2,1,1,2,10,31,99,43,63,TRUE,0.434343434343434,2023,2023-2024
GA,2023-11-30,intra-total,2345,2164,610,201,106,70,37,37,26,595,2455,8646,4800,6964,TRUE,0.555170020818876,2023,2023-2024
GA,2023-11-30,intra-ucfe,4,4,1,3,1,1,1,0,0,3,3,21,7,11,TRUE,0.333333333333333,2023,2023-2024
GA,2023-11-30,intra-ucx,4,4,3,2,0,0,0,0,0,0,6,19,10,14,TRUE,0.526315789473684,2023,2023-2024
GA,2023-11-30,intra-ui,2337,2156,606,196,105,69,36,37,26,592,2446,8606,4783,6939,TRUE,0.555775040669301,2023,2023-2024
GA,2023-12-31,inter-total,13,41,10,14,5,3,2,2,0,16,29,135,42,83,TRUE,0.311111111111111,2023,2023-2024
GA,2023-12-31,inter-ucfe,0,0,0,0,0,0,0,0,0,0,0,0,0,0,TRUE,0,2023,2023-2024
GA,2023-12-31,inter-ucx,0,0,0,0,0,0,0,0,0,0,0,0,0,0,TRUE,0,2023,2023-2024
GA,2023-12-31,inter-ui,13,41,10,14,5,3,2,2,0,16,29,135,42,83,TRUE,0.311111111111111,2023,2023-2024
GA,2023-12-31,intra-total,2499,3236,915,359,142,84,61,32,38,737,2103,10206,4602,7838,TRUE,0.450911228689007,2023,2023-2024
GA,2023-12-31,intra-ucfe,0,2,1,1,3,0,1,0,1,2,6,17,6,8,TRUE,0.352941176470588,2023,2023-2024
GA,2023-12-31,intra-ucx,3,7,1,0,0,1,1,0,0,0,10,23,13,20,TRUE,0.565217391304348,2023,2023-2024
GA,2023-12-31,intra-ui,2496,3227,913,358,139,83,59,32,37,735,2087,10166,4583,7810,TRUE,0.45081644698013,2023,2023-2024
GA,2024-01-31,inter-total,28,37,20,13,11,8,3,1,3,9,40,173,68,105,TRUE,0.393063583815029,2023,2023-2024
GA,2024-01-31,inter-ucfe,1,1,0,0,0,0,0,1,0,0,0,3,1,2,TRUE,0.333333333333333,2023,2023-2024
GA,2024-01-31,inter-ucx,0,0,0,0,0,0,0,0,0,0,0,0,0,0,TRUE,0,2023,2023-2024
GA,2024-01-31,inter-ui,27,36,20,13,11,8,3,0,3,9,40,170,67,103,TRUE,0.394117647058824,2023,2023-2024
GA,2024-01-31,intra-total,4259,3376,1831,796,356,182,131,107,55,728,3383,15204,7642,11018,TRUE,0.502630886608787,2023,2023-2024
GA,2024-01-31,intra-ucfe,2,2,0,1,2,2,2,1,0,2,3,17,5,7,TRUE,0.294117647058824,2023,2023-2024
GA,2024-01-31,intra-ucx,7,7,3,1,2,0,0,0,0,1,7,28,14,21,TRUE,0.5,2023,2023-2024
GA,2024-01-31,intra-ui,4250,3367,1828,794,352,180,129,106,55,725,3373,15159,7623,10990,TRUE,0.502869582426281,2023,2023-2024
GA,2024-02-29,inter-total,22,24,6,11,4,4,7,2,0,15,32,127,54,78,TRUE,0.425196850393701,2023,2023-2024
GA,2024-02-29,inter-ucfe,0,0,0,0,0,0,0,0,0,0,0,0,0,0,TRUE,0,2023,2023-2024
GA,2024-02-29,inter-ucx,0,0,0,0,0,0,0,0,0,0,0,0,0,0,TRUE,0,2023,2023-2024
GA,2024-02-29,inter-ui,22,24,6,11,4,4,7,2,0,15,32,127,54,78,TRUE,0.425196850393701,2023,2023-2024
GA,2024-02-29,intra-total,1325,3259,1299,513,324,215,127,91,60,671,1665,9549,2990,6249,TRUE,0.313121792857891,2023,2023-2024
GA,2024-02-29,intra-ucfe,6,7,2,2,3,0,0,0,0,6,7,33,13,20,TRUE,0.393939393939394,2023,2023-2024
GA,2024-02-29,intra-ucx,5,4,3,4,1,0,0,2,0,1,2,22,7,11,TRUE,0.318181818181818,2023,2023-2024
GA,2024-02-29,intra-ui,1314,3248,1294,507,320,215,127,89,60,664,1656,9494,2970,6218,TRUE,0.312829155255951,2023,2023-2024
GA,2024-03-31,inter-total,29,33,9,12,7,1,2,3,2,8,44,150,73,106,TRUE,0.486666666666667,2023,2023-2024
GA,2024-03-31,inter-ucfe,0,0,1,0,0,0,0,0,0,0,0,1,0,0,TRUE,0,2023,2023-2024
GA,2024-03-31,inter-ucx,0,0,0,0,0,0,0,0,0,0,1,1,1,1,TRUE,1,2023,2023-2024
GA,2024-03-31,inter-ui,29,33,8,12,7,1,2,3,2,8,43,148,72,105,TRUE,0.486486486486487,2023,2023-2024
GA,2024-03-31,intra-total,1316,2385,791,367,169,119,73,51,69,634,2517,8491,3833,6218,TRUE,0.451419149687905,2023,2023-2024
GA,2024-03-31,intra-ucfe,10,15,5,3,3,0,2,0,0,5,12,55,22,37,TRUE,0.4,2023,2023-2024
GA,2024-03-31,intra-ucx,5,5,5,2,1,0,1,0,0,2,11,32,16,21,TRUE,0.5,2023,2023-2024
GA,2024-03-31,intra-ui,1301,2365,781,362,165,119,70,51,69,627,2494,8404,3795,6160,TRUE,0.451570680628272,2023,2023-2024
GA,2024-04-30,inter-total,18,30,9,14,5,3,3,1,5,15,49,152,67,97,TRUE,0.440789473684211,2023,2023-2024
GA,2024-04-30,inter-ucfe,0,0,0,0,0,0,0,0,1,0,2,3,2,2,TRUE,0.666666666666667,2023,2023-2024
GA,2024-04-30,inter-ucx,0,0,0,0,0,0,0,0,0,0,0,0,0,0,TRUE,0,2023,2023-2024
GA,2024-04-30,inter-ui,18,30,9,14,5,3,3,1,4,15,47,149,65,95,TRUE,0.436241610738255,2023,2023-2024
GA,2024-04-30,intra-total,1596,2219,591,206,120,83,70,51,26,736,2374,8072,3970,6189,TRUE,0.491823587710605,2023,2023-2024
GA,2024-04-30,intra-ucfe,5,8,3,4,0,3,5,0,0,3,12,43,17,25,TRUE,0.395348837209302,2023,2023-2024
GA,2024-04-30,intra-ucx,10,3,2,1,1,1,1,1,0,3,5,28,15,18,TRUE,0.535714285714286,2023,2023-2024
GA,2024-04-30,intra-ui,1581,2208,586,201,119,79,64,50,26,730,2357,8001,3938,6146,TRUE,0.492188476440445,2023,2023-2024
GA,2024-05-31,inter-total,21,36,10,7,4,5,1,0,2,21,48,155,69,105,TRUE,0.445161290322581,2023,2023-2024
GA,2024-05-31,inter-ucfe,0,0,1,0,0,0,0,0,0,0,0,1,0,0,TRUE,0,2023,2023-2024
GA,2024-05-31,inter-ucx,0,0,0,0,0,0,0,0,0,0,0,0,0,0,TRUE,0,2023,2023-2024
GA,2024-05-31,inter-ui,21,36,9,7,4,5,1,0,2,21,48,154,69,105,TRUE,0.448051948051948,2023,2023-2024
GA,2024-05-31,intra-total,1509,2357,541,186,121,74,60,26,23,692,2758,8347,4267,6624,TRUE,0.511201629327902,2023,2023-2024
GA,2024-05-31,intra-ucfe,7,7,3,0,2,1,2,0,1,4,11,38,18,25,TRUE,0.473684210526316,2023,2023-2024
GA,2024-05-31,intra-ucx,6,4,6,3,1,0,0,1,0,1,11,33,17,21,TRUE,0.515151515151515,2023,2023-2024
GA,2024-05-31,intra-ui,1496,2346,532,183,118,73,58,25,22,687,2736,8276,4232,6578,TRUE,0.511358144030933,2023,2023-2024
GA,2024-06-30,inter-total,14,37,7,9,2,4,1,1,3,9,40,127,54,91,TRUE,0.425196850393701,2023,2023-2024
GA,2024-06-30,inter-ucfe,0,0,0,1,0,0,0,0,0,0,0,1,0,0,TRUE,0,2023,2023-2024
GA,2024-06-30,inter-ucx,0,0,0,0,0,0,0,0,0,0,0,0,0,0,TRUE,0,2023,2023-2024
GA,2024-06-30,inter-ui,14,37,7,8,2,4,1,1,3,9,40,126,54,91,TRUE,0.428571428571429,2023,2023-2024
GA,2024-06-30,intra-total,995,2673,782,223,116,59,39,21,24,524,1183,6639,2178,4851,TRUE,0.328061455038409,2023,2023-2024
GA,2024-06-30,intra-ucfe,7,4,7,3,0,1,0,1,0,6,5,34,12,16,TRUE,0.352941176470588,2023,2023-2024
GA,2024-06-30,intra-ucx,3,7,3,4,0,1,0,0,0,0,3,21,6,13,TRUE,0.285714285714286,2023,2023-2024
GA,2024-06-30,intra-ui,985,2662,772,216,116,57,39,20,24,518,1175,6584,2160,4822,TRUE,0.328068043742406,2023,2023-2024
GA,2024-07-31,inter-total,16,33,7,3,3,2,2,0,0,6,46,118,62,95,TRUE,0.525423728813559,2024,2024-2025
GA,2024-07-31,inter-ucfe,0,0,0,0,0,0,0,0,0,0,0,0,0,0,TRUE,0,2024,2024-2025
GA,2024-07-31,inter-ucx,0,0,0,0,0,0,0,0,0,0,0,0,0,0,TRUE,0,2024,2024-2025
GA,2024-07-31,inter-ui,16,33,7,3,3,2,2,0,0,6,46,118,62,95,TRUE,0.525423728813559,2024,2024-2025
GA,2024-07-31,intra-total,2382,3408,1484,431,179,99,70,47,38,669,1656,10463,4038,7446,TRUE,0.385931377234063,2024,2024-2025
GA,2024-07-31,intra-ucfe,7,1,3,0,1,1,0,0,0,5,2,20,9,10,TRUE,0.45,2024,2024-2025
GA,2024-07-31,intra-ucx,6,6,3,4,0,1,1,2,0,2,10,35,16,22,TRUE,0.457142857142857,2024,2024-2025
GA,2024-07-31,intra-ui,2369,3401,1478,427,178,97,69,45,38,662,1644,10408,4013,7414,TRUE,0.385568793235972,2024,2024-2025
GA,2024-08-31,inter-total,20,38,9,13,7,3,0,2,3,16,38,149,58,96,TRUE,0.389261744966443,2024,2024-2025
GA,2024-08-31,inter-ucfe,1,0,0,0,0,0,0,1,0,0,0,2,1,1,TRUE,0.5,2024,2024-2025
GA,2024-08-31,inter-ucx,0,0,0,0,0,0,0,0,1,0,0,1,0,0,TRUE,0,2024,2024-2025
GA,2024-08-31,inter-ui,19,38,9,13,7,3,0,1,2,16,38,146,57,95,TRUE,0.39041095890411,2024,2024-2025
GA,2024-08-31,intra-total,1288,2831,871,324,213,141,99,45,43,682,2268,8805,3556,6387,TRUE,0.403861442362294,2024,2024-2025
GA,2024-08-31,intra-ucfe,3,1,3,1,4,0,1,1,1,4,4,23,7,8,TRUE,0.304347826086957,2024,2024-2025
GA,2024-08-31,intra-ucx,3,3,1,1,3,0,0,0,0,1,6,18,9,12,TRUE,0.5,2024,2024-2025
GA,2024-08-31,intra-ui,1282,2827,867,322,206,141,98,44,42,677,2258,8764,3540,6367,TRUE,0.403925148334094,2024,2024-2025
GA,2024-09-30,inter-total,24,26,7,5,5,2,3,2,1,13,30,118,54,80,TRUE,0.457627118644068,2024,2024-2025
GA,2024-09-30,inter-ucfe,0,0,1,0,0,0,2,0,0,0,0,3,0,0,TRUE,0,2024,2024-2025
GA,2024-09-30,inter-ucx,0,0,0,0,0,0,0,0,0,0,0,0,0,0,TRUE,0,2024,2024-2025
GA,2024-09-30,inter-ui,24,26,6,5,5,2,1,2,1,13,30,115,54,80,TRUE,0.469565217391304,2024,2024-2025
GA,2024-09-30,intra-total,1578,2413,669,271,158,80,58,60,41,625,2415,8368,3993,6406,TRUE,0.477174952198853,2024,2024-2025
GA,2024-09-30,intra-ucfe,2,4,1,1,2,1,1,1,3,4,3,23,5,9,TRUE,0.217391304347826,2024,2024-2025
GA,2024-09-30,intra-ucx,6,2,2,4,2,1,0,0,0,4,8,29,14,16,TRUE,0.482758620689655,2024,2024-2025
GA,2024-09-30,intra-ui,1570,2407,666,266,154,78,57,59,38,617,2404,8316,3974,6381,TRUE,0.477873977873978,2024,2024-2025
GA,2024-10-31,inter-total,16,32,10,5,2,2,4,2,1,15,32,121,48,80,TRUE,0.396694214876033,2024,2024-2025
GA,2024-10-31,inter-ucfe,0,0,0,0,0,0,0,1,0,0,0,1,0,0,TRUE,0,2024,2024-2025
GA,2024-10-31,inter-ucx,0,0,0,0,0,0,0,0,0,0,0,0,0,0,TRUE,0,2024,2024-2025
GA,2024-10-31,inter-ui,16,32,10,5,2,2,4,1,1,15,32,120,48,80,TRUE,0.4,2024,2024-2025
GA,2024-10-31,intra-total,2243,2659,816,277,153,131,83,54,35,913,2895,10259,5138,7797,TRUE,0.50082854079345,2024,2024-2025
GA,2024-10-31,intra-ucfe,3,3,3,0,0,1,1,0,1,6,5,23,8,11,TRUE,0.347826086956522,2024,2024-2025
GA,2024-10-31,intra-ucx,7,2,4,4,2,1,0,1,0,0,5,26,12,14,TRUE,0.461538461538462,2024,2024-2025
GA,2024-10-31,intra-ui,2233,2654,809,273,151,129,82,53,34,907,2885,10210,5118,7772,TRUE,0.501273261508325,2024,2024-2025
GA,2024-11-30,inter-total,10,23,5,3,4,1,1,2,0,20,19,88,29,52,TRUE,0.329545454545455,2024,2024-2025
GA,2024-11-30,inter-ucfe,0,0,0,0,0,0,0,0,0,1,0,1,0,0,TRUE,0,2024,2024-2025
GA,2024-11-30,inter-ucx,0,0,0,0,0,0,0,0,0,0,0,0,0,0,TRUE,0,2024,2024-2025
GA,2024-11-30,inter-ui,10,23,5,3,4,1,1,2,0,19,19,87,29,52,TRUE,0.333333333333333,2024,2024-2025
GA,2024-11-30,intra-total,1300,1918,589,374,246,166,75,33,29,739,2092,7561,3392,5310,TRUE,0.448617907684169,2024,2024-2025
GA,2024-11-30,intra-ucfe,3,0,1,1,0,0,1,0,0,2,3,11,6,6,TRUE,0.545454545454545,2024,2024-2025
GA,2024-11-30,intra-ucx,4,4,1,1,0,1,0,0,0,0,7,18,11,15,TRUE,0.611111111111111,2024,2024-2025
GA,2024-11-30,intra-ui,1293,1914,587,372,246,165,74,33,29,737,2082,7532,3375,5289,TRUE,0.448088157195964,2024,2024-2025
GA,2024-12-31,inter-total,19,33,8,5,8,4,2,1,1,11,26,118,45,78,TRUE,0.38135593220339,2024,2024-2025
GA,2024-12-31,inter-ucfe,0,0,0,0,0,0,0,0,0,0,0,0,0,0,TRUE,0,2024,2024-2025
GA,2024-12-31,inter-ucx,0,0,0,0,0,0,0,0,0,0,0,0,0,0,TRUE,0,2024,2024-2025
GA,2024-12-31,inter-ui,19,33,8,5,8,4,2,1,1,11,26,118,45,78,TRUE,0.38135593220339,2024,2024-2025
GA,2024-12-31,intra-total,3599,2493,872,311,184,104,73,89,72,924,2526,11247,6125,8618,TRUE,0.544589668356006,2024,2024-2025
GA,2024-12-31,intra-ucfe,0,2,2,1,1,0,0,1,1,2,3,13,3,5,TRUE,0.230769230769231,2024,2024-2025
GA,2024-12-31,intra-ucx,3,2,2,1,2,1,1,0,0,2,6,20,9,11,TRUE,0.45,2024,2024-2025
GA,2024-12-31,intra-ui,3596,2489,868,309,181,103,72,88,71,920,2517,11214,6113,8602,TRUE,0.545122168717674,2024,2024-2025
HI,2019-01-31,inter-total,39,8,1,3,5,1,0,1,0,2,32,92,71,79,FALSE,0.858695652173913,2018,2018-2019
HI,2019-01-31,inter-ucfe,2,0,0,0,1,0,0,0,0,0,2,5,4,4,FALSE,0.8,2018,2018-2019
HI,2019-01-31,inter-ucx,0,0,0,0,0,0,0,0,0,0,0,0,0,0,FALSE,0,2018,2018-2019
HI,2019-01-31,inter-ui,37,8,1,3,4,1,0,1,0,2,30,87,67,75,FALSE,0.862068965517241,2018,2018-2019
HI,2019-01-31,intra-total,1037,186,78,29,15,9,7,10,7,66,805,2249,1842,2028,FALSE,0.901734104046243,2018,2018-2019
HI,2019-01-31,intra-ucfe,4,53,7,1,0,0,0,1,0,1,49,116,53,106,FALSE,0.913793103448276,2018,2018-2019
HI,2019-01-31,intra-ucx,5,0,1,0,0,1,0,0,0,0,7,14,12,12,FALSE,0.857142857142857,2018,2018-2019
HI,2019-01-31,intra-ui,1028,133,70,28,15,8,7,9,7,65,749,2119,1777,1910,FALSE,0.901368570080226,2018,2018-2019
HI,2019-02-28,inter-total,38,4,2,4,1,1,0,0,0,3,31,84,69,73,FALSE,0.869047619047619,2018,2018-2019
HI,2019-02-28,inter-ucfe,0,0,0,0,0,1,0,0,0,0,2,3,2,2,FALSE,0.666666666666667,2018,2018-2019
HI,2019-02-28,inter-ucx,0,0,0,0,0,0,0,0,0,0,0,0,0,0,FALSE,0,2018,2018-2019
HI,2019-02-28,inter-ui,38,4,2,4,1,0,0,0,0,3,29,81,67,71,FALSE,0.876543209876543,2018,2018-2019
HI,2019-02-28,intra-total,692,100,39,32,22,12,5,4,4,17,506,1433,1198,1298,FALSE,0.905792044661549,2018,2018-2019
HI,2019-02-28,intra-ucfe,1,6,1,0,2,2,0,0,0,3,1,16,2,8,FALSE,0.5,2018,2018-2019
HI,2019-02-28,intra-ucx,7,1,0,0,0,0,0,0,0,0,2,10,9,10,FALSE,1,2018,2018-2019
HI,2019-02-28,intra-ui,684,93,38,32,20,10,5,4,4,14,503,1407,1187,1280,FALSE,0.909737029140014,2018,2018-2019
HI,2019-03-31,inter-total,27,9,5,3,1,1,0,1,0,0,20,67,47,56,FALSE,0.835820895522388,2018,2018-2019
HI,2019-03-31,inter-ucfe,2,1,0,0,0,0,0,0,0,0,0,3,2,3,FALSE,1,2018,2018-2019
HI,2019-03-31,inter-ucx,0,0,0,0,0,0,0,0,0,0,0,0,0,0,FALSE,0,2018,2018-2019
HI,2019-03-31,inter-ui,25,8,5,3,1,1,0,1,0,0,20,64,45,53,FALSE,0.828125,2018,2018-2019
HI,2019-03-31,intra-total,629,71,39,14,13,9,3,3,2,19,468,1270,1097,1168,FALSE,0.919685039370079,2018,2018-2019
HI,2019-03-31,intra-ucfe,3,1,0,1,2,0,1,1,0,1,4,14,7,8,FALSE,0.571428571428571,2018,2018-2019
HI,2019-03-31,intra-ucx,6,0,0,0,0,0,0,0,0,0,3,9,9,9,FALSE,1,2018,2018-2019
HI,2019-03-31,intra-ui,620,70,39,13,11,9,2,2,2,18,461,1247,1081,1151,FALSE,0.923015236567763,2018,2018-2019
HI,2019-04-30,inter-total,38,7,8,3,3,1,0,1,1,1,22,85,60,67,FALSE,0.788235294117647,2018,2018-2019
HI,2019-04-30,inter-ucfe,2,0,2,0,0,0,0,0,0,0,1,5,3,3,FALSE,0.6,2018,2018-2019
HI,2019-04-30,inter-ucx,0,0,0,0,0,0,0,0,0,0,0,0,0,0,FALSE,0,2018,2018-2019
HI,2019-04-30,inter-ui,36,7,6,3,3,1,0,1,1,1,21,80,57,64,FALSE,0.8,2018,2018-2019
HI,2019-04-30,intra-total,773,63,32,16,7,10,3,1,3,19,516,1443,1289,1352,FALSE,0.936936936936937,2018,2018-2019
HI,2019-04-30,intra-ucfe,0,1,2,1,1,0,0,0,1,1,6,13,6,7,FALSE,0.538461538461538,2018,2018-2019
HI,2019-04-30,intra-ucx,8,0,2,1,0,0,0,0,0,0,3,14,11,11,FALSE,0.785714285714286,2018,2018-2019
HI,2019-04-30,intra-ui,765,62,28,14,6,10,3,1,2,18,507,1416,1272,1334,FALSE,0.942090395480226,2018,2018-2019
HI,2019-05-31,inter-total,25,4,0,2,1,2,0,1,0,3,30,68,55,59,FALSE,0.867647058823529,2018,2018-2019
HI,2019-05-31,inter-ucfe,0,0,0,0,0,0,0,0,0,1,3,4,3,3,FALSE,0.75,2018,2018-2019
HI,2019-05-31,inter-ucx,0,0,0,1,0,0,0,0,0,0,0,1,0,0,FALSE,0,2018,2018-2019
HI,2019-05-31,inter-ui,25,4,0,1,1,2,0,1,0,2,27,63,52,56,FALSE,0.888888888888889,2018,2018-2019
HI,2019-05-31,intra-total,768,75,41,19,7,5,6,4,2,9,517,1453,1285,1360,FALSE,0.935994494150034,2018,2018-2019
HI,2019-05-31,intra-ucfe,1,0,0,0,0,0,0,0,0,0,6,7,7,7,FALSE,1,2018,2018-2019
HI,2019-05-31,intra-ucx,7,0,0,0,0,1,0,0,0,0,7,15,14,14,FALSE,0.933333333333333,2018,2018-2019
HI,2019-05-31,intra-ui,760,75,41,19,7,4,6,4,2,9,504,1431,1264,1339,FALSE,0.93570929419986,2018,2018-2019
HI,2019-06-30,inter-total,32,5,0,4,1,0,0,0,0,3,28,73,60,65,FALSE,0.89041095890411,2018,2018-2019
HI,2019-06-30,inter-ucfe,0,0,0,1,0,0,0,0,0,0,2,3,2,2,FALSE,0.666666666666667,2018,2018-2019
HI,2019-06-30,inter-ucx,0,0,0,0,0,0,0,0,0,0,0,0,0,0,FALSE,0,2018,2018-2019
HI,2019-06-30,inter-ui,32,5,0,3,1,0,0,0,0,3,26,70,58,63,FALSE,0.9,2018,2018-2019
HI,2019-06-30,intra-total,962,87,34,19,14,7,9,3,4,12,471,1622,1433,1520,FALSE,0.93711467324291,2018,2018-2019
HI,2019-06-30,intra-ucfe,1,2,0,0,0,0,0,0,1,1,3,8,4,6,FALSE,0.75,2018,2018-2019
HI,2019-06-30,intra-ucx,4,0,1,0,0,0,0,0,0,0,3,8,7,7,FALSE,0.875,2018,2018-2019
HI,2019-06-30,intra-ui,957,85,33,19,14,7,9,3,3,11,465,1606,1422,1507,FALSE,0.938356164383562,2018,2018-2019
HI,2019-07-31,inter-total,30,13,4,6,1,0,1,1,2,2,34,94,64,77,FALSE,0.819148936170213,2019,2019-2020
HI,2019-07-31,inter-ucfe,1,1,0,0,0,0,0,0,0,1,4,7,5,6,FALSE,0.857142857142857,2019,2019-2020
HI,2019-07-31,inter-ucx,0,0,0,0,0,0,0,0,0,0,0,0,0,0,FALSE,0,2019,2019-2020
HI,2019-07-31,inter-ui,29,12,4,6,1,0,1,1,2,1,30,87,59,71,FALSE,0.816091954022989,2019,2019-2020
HI,2019-07-31,intra-total,841,124,59,23,13,10,9,2,1,19,544,1645,1385,1509,FALSE,0.917325227963526,2019,2019-2020
HI,2019-07-31,intra-ucfe,0,0,0,0,0,0,0,0,0,1,3,4,3,3,FALSE,0.75,2019,2019-2020
HI,2019-07-31,intra-ucx,4,1,0,1,0,0,0,0,0,1,6,13,10,11,FALSE,0.846153846153846,2019,2019-2020
HI,2019-07-31,intra-ui,837,123,59,22,13,10,9,2,1,17,535,1628,1372,1495,FALSE,0.918304668304668,2019,2019-2020
HI,2019-08-31,inter-total,30,5,3,3,3,2,0,2,0,1,36,85,66,71,FALSE,0.835294117647059,2019,2019-2020
HI,2019-08-31,inter-ucfe,1,0,0,0,0,0,0,0,0,0,3,4,4,4,FALSE,1,2019,2019-2020
HI,2019-08-31,inter-ucx,0,0,0,0,0,0,0,0,0,0,0,0,0,0,FALSE,0,2019,2019-2020
HI,2019-08-31,inter-ui,29,5,3,3,3,2,0,2,0,1,33,81,62,67,FALSE,0.82716049382716,2019,2019-2020
HI,2019-08-31,intra-total,649,85,43,24,12,8,11,7,4,7,459,1309,1108,1193,FALSE,0.911382734912147,2019,2019-2020
HI,2019-08-31,intra-ucfe,0,2,2,0,0,1,1,1,0,0,3,10,3,5,FALSE,0.5,2019,2019-2020
HI,2019-08-31,intra-ucx,11,1,0,0,0,0,0,0,0,1,1,14,12,13,FALSE,0.928571428571429,2019,2019-2020
HI,2019-08-31,intra-ui,638,82,41,24,12,7,10,6,4,6,455,1285,1093,1175,FALSE,0.914396887159533,2019,2019-2020
HI,2019-09-30,inter-total,39,10,1,4,1,1,2,1,0,3,27,89,66,76,FALSE,0.853932584269663,2019,2019-2020
HI,2019-09-30,inter-ucfe,0,2,0,1,0,0,0,0,0,0,7,10,7,9,FALSE,0.9,2019,2019-2020
HI,2019-09-30,inter-ucx,0,0,0,0,0,0,0,0,0,0,0,0,0,0,FALSE,0,2019,2019-2020
HI,2019-09-30,inter-ui,39,8,1,3,1,1,2,1,0,3,20,79,59,67,FALSE,0.848101265822785,2019,2019-2020
HI,2019-09-30,intra-total,668,68,29,18,11,7,8,0,6,9,410,1234,1078,1146,FALSE,0.928687196110211,2019,2019-2020
HI,2019-09-30,intra-ucfe,4,2,1,0,0,0,0,0,0,0,4,11,8,10,FALSE,0.909090909090909,2019,2019-2020
HI,2019-09-30,intra-ucx,7,0,0,0,0,0,1,0,0,0,3,11,10,10,FALSE,0.909090909090909,2019,2019-2020
HI,2019-09-30,intra-ui,657,66,28,18,11,7,7,0,6,9,403,1212,1060,1126,FALSE,0.929042904290429,2019,2019-2020
HI,2019-10-31,inter-total,20,9,3,1,0,1,2,2,0,3,31,72,51,60,FALSE,0.833333333333333,2019,2019-2020
HI,2019-10-31,inter-ucfe,1,1,0,0,0,0,0,0,0,0,2,4,3,4,FALSE,1,2019,2019-2020
HI,2019-10-31,inter-ucx,0,0,0,0,0,0,0,0,0,0,0,0,0,0,FALSE,0,2019,2019-2020
HI,2019-10-31,inter-ui,19,8,3,1,0,1,2,2,0,3,29,68,48,56,FALSE,0.823529411764706,2019,2019-2020
HI,2019-10-31,intra-total,616,68,25,15,10,5,3,4,2,9,404,1161,1020,1088,FALSE,0.937123169681309,2019,2019-2020
HI,2019-10-31,intra-ucfe,3,0,0,0,0,0,0,0,0,0,2,5,5,5,FALSE,1,2019,2019-2020
HI,2019-10-31,intra-ucx,4,0,1,0,0,0,0,0,0,0,6,11,10,10,FALSE,0.909090909090909,2019,2019-2020
HI,2019-10-31,intra-ui,609,68,24,15,10,5,3,4,2,9,396,1145,1005,1073,FALSE,0.937117903930131,2019,2019-2020
HI,2019-11-30,inter-total,27,6,3,2,1,1,1,1,1,2,34,79,61,67,FALSE,0.848101265822785,2019,2019-2020
HI,2019-11-30,inter-ucfe,0,0,1,0,0,0,0,0,0,0,1,2,1,1,FALSE,0.5,2019,2019-2020
HI,2019-11-30,inter-ucx,0,0,0,0,0,0,0,0,0,0,1,1,1,1,FALSE,1,2019,2019-2020
HI,2019-11-30,inter-ui,27,6,2,2,1,1,1,1,1,2,32,76,59,65,FALSE,0.855263157894737,2019,2019-2020
HI,2019-11-30,intra-total,569,87,46,24,8,6,5,4,4,7,445,1205,1014,1101,FALSE,0.913692946058091,2019,2019-2020
HI,2019-11-30,intra-ucfe,1,0,2,0,1,0,0,0,0,0,3,7,4,4,FALSE,0.571428571428571,2019,2019-2020
HI,2019-11-30,intra-ucx,3,3,0,0,0,0,0,0,0,1,9,16,12,15,FALSE,0.9375,2019,2019-2020
HI,2019-11-30,intra-ui,565,84,44,24,7,6,5,4,4,6,433,1182,998,1082,FALSE,0.915397631133672,2019,2019-2020
HI,2019-12-31,inter-total,39,3,3,2,0,0,2,1,0,3,22,75,61,64,FALSE,0.853333333333333,2019,2019-2020
HI,2019-12-31,inter-ucfe,1,0,0,1,0,0,1,0,0,0,2,5,3,3,FALSE,0.6,2019,2019-2020
HI,2019-12-31,inter-ucx,0,0,0,0,0,0,0,0,0,0,0,0,0,0,FALSE,0,2019,2019-2020
HI,2019-12-31,inter-ui,38,3,3,1,0,0,1,1,0,3,20,70,58,61,FALSE,0.871428571428572,2019,2019-2020
HI,2019-12-31,intra-total,667,65,42,22,9,5,9,4,1,5,405,1234,1072,1137,FALSE,0.921393841166937,2019,2019-2020
HI,2019-12-31,intra-ucfe,1,1,1,0,0,1,0,0,0,1,4,9,5,6,FALSE,0.666666666666667,2019,2019-2020
HI,2019-12-31,intra-ucx,8,0,0,0,0,0,0,1,0,0,2,11,10,10,FALSE,0.909090909090909,2019,2019-2020
HI,2019-12-31,intra-ui,658,64,41,22,9,4,9,3,1,4,399,1214,1057,1121,FALSE,0.92339373970346,2019,2019-2020
HI,2020-01-31,inter-total,33,7,0,3,0,2,0,0,0,1,31,77,64,71,FALSE,0.922077922077922,2019,2019-2020
HI,2020-01-31,inter-ucfe,1,1,0,0,0,0,0,0,0,0,0,2,1,2,FALSE,1,2019,2019-2020
HI,2020-01-31,inter-ucx,0,0,0,0,0,0,0,0,0,0,0,0,0,0,FALSE,0,2019,2019-2020
HI,2020-01-31,inter-ui,32,6,0,3,0,2,0,0,0,1,31,75,63,69,FALSE,0.92,2019,2019-2020
HI,2020-01-31,intra-total,991,150,65,31,14,4,3,2,4,2,724,1990,1715,1865,FALSE,0.937185929648241,2019,2019-2020
HI,2020-01-31,intra-ucfe,0,1,2,0,0,0,0,0,0,0,5,8,5,6,FALSE,0.75,2019,2019-2020
HI,2020-01-31,intra-ucx,4,1,0,0,0,0,1,0,0,0,5,11,9,10,FALSE,0.909090909090909,2019,2019-2020
HI,2020-01-31,intra-ui,987,148,63,31,14,4,2,2,4,2,714,1971,1701,1849,FALSE,0.938102486047691,2019,2019-2020
HI,2020-02-29,inter-total,16,9,5,3,0,3,0,0,0,0,22,58,38,47,FALSE,0.810344827586207,2019,2019-2020
HI,2020-02-29,inter-ucfe,0,0,0,1,0,0,0,0,0,0,2,3,2,2,FALSE,0.666666666666667,2019,2019-2020
HI,2020-02-29,inter-ucx,0,0,0,0,0,0,0,0,0,0,0,0,0,0,FALSE,0,2019,2019-2020
HI,2020-02-29,inter-ui,16,9,5,2,0,3,0,0,0,0,20,55,36,45,FALSE,0.818181818181818,2019,2019-2020
HI,2020-02-29,intra-total,624,107,43,38,16,9,6,2,4,2,415,1266,1039,1146,FALSE,0.90521327014218,2019,2019-2020
HI,2020-02-29,intra-ucfe,0,1,0,0,0,0,0,0,0,0,9,10,9,10,FALSE,1,2019,2019-2020
HI,2020-02-29,intra-ucx,5,2,0,0,0,0,0,0,0,0,2,9,7,9,FALSE,1,2019,2019-2020
HI,2020-02-29,intra-ui,619,104,43,38,16,9,6,2,4,2,404,1247,1023,1127,FALSE,0.903769045709703,2019,2019-2020
HI,2020-03-31,inter-total,27,12,3,2,0,0,3,0,1,2,23,73,50,62,FALSE,0.849315068493151,2019,2019-2020
HI,2020-03-31,inter-ucfe,1,0,0,0,0,0,0,0,0,0,4,5,5,5,FALSE,1,2019,2019-2020
HI,2020-03-31,inter-ucx,0,0,0,0,0,0,0,0,0,0,0,0,0,0,FALSE,0,2019,2019-2020
HI,2020-03-31,inter-ui,26,12,3,2,0,0,3,0,1,2,19,68,45,57,FALSE,0.838235294117647,2019,2019-2020
HI,2020-03-31,intra-total,2255,174,42,18,5,3,3,4,7,8,622,3141,2877,3051,FALSE,0.97134670487106,2019,2019-2020
HI,2020-03-31,intra-ucfe,2,3,2,0,0,0,1,0,0,1,5,14,7,10,FALSE,0.714285714285714,2019,2019-2020
HI,2020-03-31,intra-ucx,3,1,1,0,0,0,0,0,0,0,4,9,7,8,FALSE,0.888888888888889,2019,2019-2020
HI,2020-03-31,intra-ui,2250,170,39,18,5,3,2,4,7,7,613,3118,2863,3033,FALSE,0.972738935214881,2019,2019-2020
HI,2020-04-30,inter-total,29,31,24,17,16,6,1,0,0,3,46,173,75,106,FALSE,0.61271676300578,2019,2019-2020
HI,2020-04-30,inter-ucfe,0,0,0,0,0,0,0,0,0,1,0,1,0,0,FALSE,0,2019,2019-2020
HI,2020-04-30,inter-ucx,0,0,0,0,0,0,0,0,0,0,0,0,0,0,FALSE,0,2019,2019-2020
HI,2020-04-30,inter-ui,29,31,24,17,16,6,1,0,0,2,46,172,75,106,FALSE,0.616279069767442,2019,2019-2020
HI,2020-04-30,intra-total,6649,15697,13393,6341,1187,39,12,7,3,12,11278,54618,17927,33624,FALSE,0.615621223772383,2019,2019-2020
HI,2020-04-30,intra-ucfe,0,3,6,1,0,0,1,0,0,1,0,12,0,3,FALSE,0.25,2019,2019-2020
HI,2020-04-30,intra-ucx,0,2,3,1,1,0,0,0,0,0,0,7,0,2,FALSE,0.285714285714286,2019,2019-2020
HI,2020-04-30,intra-ui,6649,15692,13384,6339,1186,39,11,7,3,11,11278,54599,17927,33619,FALSE,0.615743878093005,2019,2019-2020
HI,2020-05-31,inter-total,78,87,99,69,93,76,39,25,11,3,86,666,164,251,FALSE,0.376876876876877,2019,2019-2020
HI,2020-05-31,inter-ucfe,0,0,0,0,1,0,1,0,0,0,0,2,0,0,FALSE,0,2019,2019-2020
HI,2020-05-31,inter-ucx,0,0,0,0,0,0,0,0,0,0,0,0,0,0,FALSE,0,2019,2019-2020
HI,2020-05-31,inter-ui,78,87,99,69,92,76,38,25,11,3,86,664,164,251,FALSE,0.378012048192771,2019,2019-2020
HI,2020-05-31,intra-total,6378,5515,7352,8946,9271,7088,5145,3335,1402,353,7569,62354,13947,19462,FALSE,0.312121114924464,2019,2019-2020
HI,2020-05-31,intra-ucfe,1,9,18,21,17,12,8,10,3,0,7,106,8,17,FALSE,0.160377358490566,2019,2019-2020
HI,2020-05-31,intra-ucx,0,0,3,5,1,6,3,2,0,0,0,20,0,0,FALSE,0,2019,2019-2020
HI,2020-05-31,intra-ui,6377,5506,7331,8920,9253,7070,5134,3323,1399,353,7562,62228,13939,19445,FALSE,0.312479912579546,2019,2019-2020
HI,2020-06-30,inter-total,50,38,22,12,14,31,33,36,32,150,59,477,109,147,FALSE,0.308176100628931,2019,2019-2020
HI,2020-06-30,inter-ucfe,0,1,0,0,0,0,0,0,0,1,0,2,0,1,FALSE,0.5,2019,2019-2020
HI,2020-06-30,inter-ucx,0,0,0,0,0,0,0,0,0,0,0,0,0,0,FALSE,0,2019,2019-2020
HI,2020-06-30,inter-ui,50,37,22,12,14,31,33,36,32,149,59,475,109,146,FALSE,0.307368421052632,2019,2019-2020
HI,2020-06-30,intra-total,3389,1425,932,829,904,1214,1532,2199,2545,6447,3572,24988,6961,8386,FALSE,0.335601088522491,2019,2019-2020
HI,2020-06-30,intra-ucfe,0,7,6,5,7,3,5,7,11,25,8,84,8,15,FALSE,0.178571428571429,2019,2019-2020
HI,2020-06-30,intra-ucx,0,2,0,0,2,0,1,3,3,9,0,20,0,2,FALSE,0.1,2019,2019-2020
HI,2020-06-30,intra-ui,3389,1416,926,824,895,1211,1526,2189,2531,6413,3564,24884,6953,8369,FALSE,0.336320527246423,2019,2019-2020
HI,2020-07-31,inter-total,34,20,13,10,9,12,11,14,18,265,31,437,65,85,FALSE,0.194508009153318,2020,2020-2021
HI,2020-07-31,inter-ucfe,0,0,0,0,0,0,1,0,1,4,0,6,0,0,FALSE,0,2020,2020-2021
HI,2020-07-31,inter-ucx,0,0,0,0,0,0,0,0,0,1,0,1,0,0,FALSE,0,2020,2020-2021
HI,2020-07-31,inter-ui,34,20,13,10,9,12,10,14,17,260,31,430,65,85,FALSE,0.197674418604651,2020,2020-2021
HI,2020-07-31,intra-total,2424,917,531,353,269,280,277,285,311,5666,2589,13902,5013,5930,FALSE,0.426557329880593,2020,2020-2021
HI,2020-07-31,intra-ucfe,0,5,0,1,1,1,2,1,0,30,5,46,5,10,FALSE,0.217391304347826,2020,2020-2021
HI,2020-07-31,intra-ucx,4,3,6,8,5,4,4,5,3,17,9,68,13,16,FALSE,0.235294117647059,2020,2020-2021
HI,2020-07-31,intra-ui,2420,909,525,344,263,275,271,279,308,5619,2575,13788,4995,5904,FALSE,0.428198433420366,2020,2020-2021
HI,2020-08-31,inter-total,9,19,9,9,12,19,11,15,16,295,15,429,24,43,FALSE,0.1002331002331,2020,2020-2021
HI,2020-08-31,inter-ucfe,0,0,0,0,1,0,0,0,0,2,0,3,0,0,FALSE,0,2020,2020-2021
HI,2020-08-31,inter-ucx,0,0,0,0,0,0,0,0,0,5,1,6,1,1,FALSE,0.166666666666667,2020,2020-2021
HI,2020-08-31,inter-ui,9,19,9,9,11,19,11,15,16,288,14,420,23,42,FALSE,0.1,2020,2020-2021
HI,2020-08-31,intra-total,1298,576,314,234,232,239,212,198,154,4199,1560,9216,2858,3434,FALSE,0.372612847222222,2020,2020-2021
HI,2020-08-31,intra-ucfe,0,1,4,0,2,1,1,2,1,26,2,40,2,3,FALSE,0.075,2020,2020-2021
HI,2020-08-31,intra-ucx,7,4,1,6,3,0,0,1,1,26,9,58,16,20,FALSE,0.344827586206897,2020,2020-2021
HI,2020-08-31,intra-ui,1291,571,309,228,227,238,211,195,152,4147,1549,9118,2840,3411,FALSE,0.374095196314981,2020,2020-2021
HI,2020-09-30,inter-total,27,14,13,8,5,4,6,8,11,186,18,300,45,59,FALSE,0.196666666666667,2020,2020-2021
HI,2020-09-30,inter-ucfe,0,0,0,0,0,1,0,1,1,6,1,10,1,1,FALSE,0.1,2020,2020-2021
HI,2020-09-30,inter-ucx,0,0,0,0,0,0,0,0,0,2,0,2,0,0,FALSE,0,2020,2020-2021
HI,2020-09-30,inter-ui,27,14,13,8,5,3,6,7,10,178,17,288,44,58,FALSE,0.201388888888889,2020,2020-2021
HI,2020-09-30,intra-total,1785,581,316,193,157,156,123,143,170,2456,1782,7862,3567,4148,FALSE,0.527601119308064,2020,2020-2021
HI,2020-09-30,intra-ucfe,1,3,3,5,0,1,1,3,1,15,2,35,3,6,FALSE,0.171428571428571,2020,2020-2021
HI,2020-09-30,intra-ucx,6,3,1,3,2,1,0,3,0,16,4,39,10,13,FALSE,0.333333333333333,2020,2020-2021
HI,2020-09-30,intra-ui,1778,575,312,185,155,154,122,137,169,2425,1776,7788,3554,4129,FALSE,0.530174627632255,2020,2020-2021
HI,2020-10-31,inter-total,15,11,4,2,3,2,3,6,3,103,8,160,23,34,FALSE,0.2125,2020,2020-2021
HI,2020-10-31,inter-ucfe,0,1,0,0,0,0,0,1,0,4,0,6,0,1,FALSE,0.166666666666667,2020,2020-2021
HI,2020-10-31,inter-ucx,0,0,0,0,0,0,0,0,0,2,0,2,0,0,FALSE,0,2020,2020-2021
HI,2020-10-31,inter-ui,15,10,4,2,3,2,3,5,3,97,8,152,23,33,FALSE,0.217105263157895,2020,2020-2021
HI,2020-10-31,intra-total,949,321,169,128,131,112,73,71,54,1499,781,4288,1730,2051,FALSE,0.478311567164179,2020,2020-2021
HI,2020-10-31,intra-ucfe,1,2,0,2,4,1,1,0,0,10,1,22,2,4,FALSE,0.181818181818182,2020,2020-2021
HI,2020-10-31,intra-ucx,8,1,1,2,0,0,1,0,0,3,4,20,12,13,FALSE,0.65,2020,2020-2021
HI,2020-10-31,intra-ui,940,318,168,124,127,111,71,71,54,1486,776,4246,1716,2034,FALSE,0.479039095619407,2020,2020-2021
HI,2020-11-30,inter-total,16,6,4,7,2,3,5,8,0,98,7,156,23,29,FALSE,0.185897435897436,2020,2020-2021
HI,2020-11-30,inter-ucfe,0,0,0,1,0,1,1,0,0,8,0,11,0,0,FALSE,0,2020,2020-2021
HI,2020-11-30,inter-ucx,0,0,0,0,0,0,0,0,0,3,0,3,0,0,FALSE,0,2020,2020-2021
HI,2020-11-30,inter-ui,16,6,4,6,2,2,4,8,0,87,7,142,23,29,FALSE,0.204225352112676,2020,2020-2021
HI,2020-11-30,intra-total,820,257,158,108,94,73,60,53,54,1232,773,3682,1593,1850,FALSE,0.502444323737099,2020,2020-2021
HI,2020-11-30,intra-ucfe,0,3,2,1,2,0,0,1,0,7,1,17,1,4,FALSE,0.235294117647059,2020,2020-2021
HI,2020-11-30,intra-ucx,3,3,0,3,1,0,0,0,1,7,0,18,3,6,FALSE,0.333333333333333,2020,2020-2021
HI,2020-11-30,intra-ui,817,251,156,104,91,73,60,52,53,1218,772,3647,1589,1840,FALSE,0.504524266520428,2020,2020-2021
HI,2020-12-31,inter-total,10,7,1,5,1,0,1,6,2,54,11,98,21,28,FALSE,0.285714285714286,2020,2020-2021
HI,2020-12-31,inter-ucfe,0,0,0,0,0,0,0,1,0,2,0,3,0,0,FALSE,0,2020,2020-2021
HI,2020-12-31,inter-ucx,0,0,0,0,0,0,0,0,0,0,0,0,0,0,FALSE,0,2020,2020-2021
HI,2020-12-31,inter-ui,10,7,1,5,1,0,1,5,2,52,11,95,21,28,FALSE,0.294736842105263,2020,2020-2021
HI,2020-12-31,intra-total,579,177,130,80,49,53,34,44,34,856,659,2695,1238,1415,FALSE,0.525046382189239,2020,2020-2021
HI,2020-12-31,intra-ucfe,0,1,2,2,1,1,1,2,1,12,0,23,0,1,FALSE,0.0434782608695652,2020,2020-2021
HI,2020-12-31,intra-ucx,0,1,1,1,0,0,0,0,0,6,0,9,0,1,FALSE,0.111111111111111,2020,2020-2021
HI,2020-12-31,intra-ui,579,175,127,77,48,52,33,42,33,838,659,2663,1238,1413,FALSE,0.530604581299287,2020,2020-2021
HI,2021-01-31,inter-total,9,2,3,1,3,0,1,0,1,35,4,59,13,15,FALSE,0.254237288135593,2020,2020-2021
HI,2021-01-31,inter-ucfe,0,0,0,0,0,0,0,0,1,5,0,6,0,0,FALSE,0,2020,2020-2021
HI,2021-01-31,inter-ucx,0,0,0,0,0,0,0,0,0,0,0,0,0,0,FALSE,0,2020,2020-2021
HI,2021-01-31,inter-ui,9,2,3,1,3,0,1,0,0,30,4,53,13,15,FALSE,0.283018867924528,2020,2020-2021
HI,2021-01-31,intra-total,482,91,60,49,41,39,30,29,25,601,401,1848,883,974,FALSE,0.527056277056277,2020,2020-2021
HI,2021-01-31,intra-ucfe,0,1,2,0,2,0,0,3,1,4,2,15,2,3,FALSE,0.2,2020,2020-2021
HI,2021-01-31,intra-ucx,1,1,0,1,2,2,1,2,0,6,0,16,1,2,FALSE,0.125,2020,2020-2021
HI,2021-01-31,intra-ui,481,89,58,48,37,37,29,24,24,591,399,1817,880,969,FALSE,0.533296642817832,2020,2020-2021
HI,2021-02-28,inter-total,6,2,1,2,0,2,0,1,1,24,6,45,12,14,FALSE,0.311111111111111,2020,2020-2021
HI,2021-02-28,inter-ucfe,0,0,0,0,0,0,0,0,0,6,0,6,0,0,FALSE,0,2020,2020-2021
HI,2021-02-28,inter-ucx,0,0,0,0,0,0,0,0,0,1,0,1,0,0,FALSE,0,2020,2020-2021
HI,2021-02-28,inter-ui,6,2,1,2,0,2,0,1,1,17,6,38,12,14,FALSE,0.368421052631579,2020,2020-2021
HI,2021-02-28,intra-total,530,102,56,28,48,27,26,37,30,633,244,1761,774,876,FALSE,0.497444633730835,2020,2020-2021
HI,2021-02-28,intra-ucfe,0,3,1,0,1,0,0,1,1,6,1,14,1,4,FALSE,0.285714285714286,2020,2020-2021
HI,2021-02-28,intra-ucx,2,0,2,0,1,0,0,0,2,5,1,13,3,3,FALSE,0.230769230769231,2020,2020-2021
HI,2021-02-28,intra-ui,528,99,53,28,46,27,26,36,27,622,242,1734,770,869,FALSE,0.501153402537486,2020,2020-2021
HI,2021-03-31,inter-total,11,3,4,2,0,2,1,1,2,66,3,95,14,17,FALSE,0.178947368421053,2020,2020-2021
HI,2021-03-31,inter-ucfe,0,0,0,0,0,0,0,0,0,8,0,8,0,0,FALSE,0,2020,2020-2021
HI,2021-03-31,inter-ucx,0,0,1,0,0,0,0,0,0,0,0,1,0,0,FALSE,0,2020,2020-2021
HI,2021-03-31,inter-ui,11,3,3,2,0,2,1,1,2,58,3,86,14,17,FALSE,0.197674418604651,2020,2020-2021
HI,2021-03-31,intra-total,693,83,62,48,49,47,26,25,31,634,287,1985,980,1063,FALSE,0.53551637279597,2020,2020-2021
HI,2021-03-31,intra-ucfe,1,0,2,0,0,2,0,0,1,19,0,25,1,1,FALSE,0.04,2020,2020-2021
HI,2021-03-31,intra-ucx,2,0,1,0,0,2,0,0,0,3,0,8,2,2,FALSE,0.25,2020,2020-2021
HI,2021-03-31,intra-ui,690,83,59,48,49,43,26,25,30,612,287,1952,977,1060,FALSE,0.543032786885246,2020,2020-2021
HI,2021-04-30,inter-total,3,7,15,8,2,4,2,0,3,72,7,123,10,17,FALSE,0.138211382113821,2020,2020-2021
HI,2021-04-30,inter-ucfe,0,0,1,0,0,0,0,0,0,7,0,8,0,0,FALSE,0,2020,2020-2021
HI,2021-04-30,inter-ucx,0,0,0,0,0,0,0,0,0,0,0,0,0,0,FALSE,0,2020,2020-2021
HI,2021-04-30,inter-ui,3,7,14,8,2,4,2,0,3,65,7,115,10,17,FALSE,0.147826086956522,2020,2020-2021
HI,2021-04-30,intra-total,645,775,1439,898,256,97,55,72,59,893,876,6065,1521,2296,FALSE,0.378565539983512,2020,2020-2021
HI,2021-04-30,intra-ucfe,0,1,0,1,2,1,0,0,1,16,0,22,0,1,FALSE,0.0454545454545455,2020,2020-2021
HI,2021-04-30,intra-ucx,0,4,1,0,0,2,0,0,2,3,0,12,0,4,FALSE,0.333333333333333,2020,2020-2021
HI,2021-04-30,intra-ui,645,770,1438,897,254,94,55,72,56,874,876,6031,1521,2291,FALSE,0.379870668214227,2020,2020-2021
HI,2021-05-31,inter-total,8,0,3,1,6,0,2,4,2,31,4,61,12,12,FALSE,0.19672131147541,2020,2020-2021
HI,2021-05-31,inter-ucfe,0,0,0,0,0,0,0,0,0,4,0,4,0,0,FALSE,0,2020,2020-2021
HI,2021-05-31,inter-ucx,0,0,0,0,0,0,0,0,0,1,0,1,0,0,FALSE,0,2020,2020-2021
HI,2021-05-31,inter-ui,8,0,3,1,6,0,2,4,2,26,4,56,12,12,FALSE,0.214285714285714,2020,2020-2021
HI,2021-05-31,intra-total,466,244,191,168,176,195,182,125,76,453,706,2982,1172,1416,FALSE,0.474849094567404,2020,2020-2021
HI,2021-05-31,intra-ucfe,0,2,6,1,0,0,3,1,0,13,0,26,0,2,FALSE,0.0769230769230769,2020,2020-2021
HI,2021-05-31,intra-ucx,1,4,1,0,1,1,0,0,0,9,3,20,4,8,FALSE,0.4,2020,2020-2021
HI,2021-05-31,intra-ui,465,238,184,167,175,194,179,124,76,431,703,2936,1168,1406,FALSE,0.478882833787466,2020,2020-2021
HI,2021-06-30,inter-total,2,4,0,6,0,2,2,0,4,39,9,68,11,15,FALSE,0.220588235294118,2020,2020-2021
HI,2021-06-30,inter-ucfe,0,0,0,3,0,0,0,0,1,4,1,9,1,1,FALSE,0.111111111111111,2020,2020-2021
HI,2021-06-30,inter-ucx,0,0,0,0,0,0,0,0,0,2,0,2,0,0,FALSE,0,2020,2020-2021
HI,2021-06-30,inter-ui,2,4,0,3,0,2,2,0,3,33,8,57,10,14,FALSE,0.245614035087719,2020,2020-2021
HI,2021-06-30,intra-total,447,197,140,76,81,76,82,95,115,777,614,2700,1061,1258,FALSE,0.465925925925926,2020,2020-2021
HI,2021-06-30,intra-ucfe,0,1,2,2,0,2,0,2,0,10,1,20,1,2,FALSE,0.1,2020,2020-2021
HI,2021-06-30,intra-ucx,0,1,0,0,1,1,0,1,0,8,4,16,4,5,FALSE,0.3125,2020,2020-2021
HI,2021-06-30,intra-ui,447,195,138,74,80,73,82,92,115,759,609,2664,1056,1251,FALSE,0.469594594594595,2020,2020-2021
HI,2021-07-31,inter-total,6,2,1,2,0,0,1,3,4,24,10,53,16,18,FALSE,0.339622641509434,2021,2021-2022
HI,2021-07-31,inter-ucfe,0,0,0,0,0,0,1,0,1,2,0,4,0,0,FALSE,0,2021,2021-2022
HI,2021-07-31,inter-ucx,0,0,0,0,0,0,0,0,0,1,0,1,0,0,FALSE,0,2021,2021-2022
HI,2021-07-31,inter-ui,6,2,1,2,0,0,0,3,3,21,10,48,16,18,FALSE,0.375,2021,2021-2022
HI,2021-07-31,intra-total,413,147,73,56,42,39,46,41,42,744,544,2187,957,1104,FALSE,0.50480109739369,2021,2021-2022
HI,2021-07-31,intra-ucfe,0,3,0,0,0,0,0,1,0,14,0,18,0,3,FALSE,0.166666666666667,2021,2021-2022
HI,2021-07-31,intra-ucx,4,0,0,0,0,0,2,0,0,8,1,15,5,5,FALSE,0.333333333333333,2021,2021-2022
HI,2021-07-31,intra-ui,409,144,73,56,42,39,44,40,42,722,543,2154,952,1096,FALSE,0.508820798514392,2021,2021-2022
HI,2021-08-31,inter-total,3,1,1,0,1,2,1,2,1,40,1,53,4,5,FALSE,0.0943396226415094,2021,2021-2022
HI,2021-08-31,inter-ucfe,0,0,0,0,0,0,0,0,0,3,0,3,0,0,FALSE,0,2021,2021-2022
HI,2021-08-31,inter-ucx,0,0,0,0,0,0,0,0,0,1,0,1,0,0,FALSE,0,2021,2021-2022
HI,2021-08-31,inter-ui,3,1,1,0,1,2,1,2,1,36,1,49,4,5,FALSE,0.102040816326531,2021,2021-2022
HI,2021-08-31,intra-total,416,140,99,56,52,54,52,30,31,816,625,2371,1041,1181,FALSE,0.498102066638549,2021,2021-2022
HI,2021-08-31,intra-ucfe,0,2,1,0,2,1,2,0,0,9,1,18,1,3,FALSE,0.166666666666667,2021,2021-2022
HI,2021-08-31,intra-ucx,3,1,0,0,0,0,0,0,0,5,0,9,3,4,FALSE,0.444444444444444,2021,2021-2022
HI,2021-08-31,intra-ui,413,137,98,56,50,53,50,30,31,802,624,2344,1037,1174,FALSE,0.500853242320819,2021,2021-2022
HI,2021-09-30,inter-total,11,2,3,3,0,3,1,3,4,27,6,63,17,19,FALSE,0.301587301587302,2021,2021-2022
HI,2021-09-30,inter-ucfe,0,0,0,0,0,0,0,1,0,2,0,3,0,0,FALSE,0,2021,2021-2022
HI,2021-09-30,inter-ucx,0,0,0,0,0,0,0,1,0,0,0,1,0,0,FALSE,0,2021,2021-2022
HI,2021-09-30,inter-ui,11,2,3,3,0,3,1,1,4,25,6,59,17,19,FALSE,0.322033898305085,2021,2021-2022
HI,2021-09-30,intra-total,907,109,106,48,51,35,32,29,39,736,798,2890,1705,1814,FALSE,0.627681660899654,2021,2021-2022
HI,2021-09-30,intra-ucfe,0,1,1,0,2,3,1,0,0,10,1,19,1,2,FALSE,0.105263157894737,2021,2021-2022
HI,2021-09-30,intra-ucx,3,1,0,2,0,0,0,1,1,6,1,15,4,5,FALSE,0.333333333333333,2021,2021-2022
HI,2021-09-30,intra-ui,904,107,105,46,49,32,31,28,38,720,796,2856,1700,1807,FALSE,0.632703081232493,2021,2021-2022
HI,2021-10-31,inter-total,6,3,3,3,3,3,0,1,4,38,1,65,7,10,FALSE,0.153846153846154,2021,2021-2022
HI,2021-10-31,inter-ucfe,0,1,0,1,1,0,0,0,1,2,0,6,0,1,FALSE,0.166666666666667,2021,2021-2022
HI,2021-10-31,inter-ucx,0,0,0,0,0,0,0,0,0,0,0,0,0,0,FALSE,0,2021,2021-2022
HI,2021-10-31,inter-ui,6,2,3,2,2,3,0,1,3,36,1,59,7,9,FALSE,0.152542372881356,2021,2021-2022
HI,2021-10-31,intra-total,396,236,105,115,98,52,30,28,34,672,411,2177,807,1043,FALSE,0.479099678456592,2021,2021-2022
HI,2021-10-31,intra-ucfe,0,0,1,2,0,0,2,1,1,6,0,13,0,0,FALSE,0,2021,2021-2022
HI,2021-10-31,intra-ucx,2,2,1,2,3,0,0,0,1,7,0,18,2,4,FALSE,0.222222222222222,2021,2021-2022
HI,2021-10-31,intra-ui,394,234,103,111,95,52,28,27,32,659,411,2146,805,1039,FALSE,0.484156570363467,2021,2021-2022
HI,2021-11-30,inter-total,11,5,5,5,5,8,3,2,3,47,8,102,19,24,FALSE,0.235294117647059,2021,2021-2022
HI,2021-11-30,inter-ucfe,0,0,0,1,0,1,0,0,2,2,0,6,0,0,FALSE,0,2021,2021-2022
HI,2021-11-30,inter-ucx,0,0,0,0,1,0,0,0,0,0,0,1,0,0,FALSE,0,2021,2021-2022
HI,2021-11-30,inter-ui,11,5,5,4,4,7,3,2,1,45,8,95,19,24,FALSE,0.252631578947368,2021,2021-2022
HI,2021-11-30,intra-total,445,149,93,74,65,89,52,56,35,608,322,1988,767,916,FALSE,0.460764587525151,2021,2021-2022
HI,2021-11-30,intra-ucfe,0,1,1,0,1,1,2,2,0,8,1,17,1,2,FALSE,0.117647058823529,2021,2021-2022
HI,2021-11-30,intra-ucx,2,1,0,0,0,0,0,0,0,10,2,15,4,5,FALSE,0.333333333333333,2021,2021-2022
HI,2021-11-30,intra-ui,443,147,92,74,64,88,50,54,35,590,319,1956,762,909,FALSE,0.464723926380368,2021,2021-2022
HI,2021-12-31,inter-total,4,8,2,0,0,6,3,2,3,29,4,61,8,16,FALSE,0.262295081967213,2021,2021-2022
HI,2021-12-31,inter-ucfe,0,0,0,0,0,0,0,1,0,2,0,3,0,0,FALSE,0,2021,2021-2022
HI,2021-12-31,inter-ucx,0,0,0,0,0,0,0,0,0,1,0,1,0,0,FALSE,0,2021,2021-2022
HI,2021-12-31,inter-ui,4,8,2,0,0,6,3,1,3,26,4,57,8,16,FALSE,0.280701754385965,2021,2021-2022
HI,2021-12-31,intra-total,437,98,69,50,49,48,47,30,40,672,306,1846,743,841,FALSE,0.45557963163597,2021,2021-2022
HI,2021-12-31,intra-ucfe,0,1,0,0,0,0,0,0,1,3,1,6,1,2,FALSE,0.333333333333333,2021,2021-2022
HI,2021-12-31,intra-ucx,2,1,1,1,0,0,2,1,0,6,1,15,3,4,FALSE,0.266666666666667,2021,2021-2022
HI,2021-12-31,intra-ui,435,96,68,49,49,48,45,29,39,663,304,1825,739,835,FALSE,0.457534246575342,2021,2021-2022
HI,2022-01-31,inter-total,9,3,2,2,4,3,1,1,0,28,12,65,21,24,FALSE,0.369230769230769,2021,2021-2022
HI,2022-01-31,inter-ucfe,0,0,0,0,2,0,0,0,0,1,0,3,0,0,FALSE,0,2021,2021-2022
HI,2022-01-31,inter-ucx,0,0,0,0,0,0,0,0,0,0,0,0,0,0,FALSE,0,2021,2021-2022
HI,2022-01-31,inter-ui,9,3,2,2,2,3,1,1,0,27,12,62,21,24,FALSE,0.387096774193548,2021,2021-2022
HI,2022-01-31,intra-total,628,124,82,44,30,31,31,17,19,515,428,1949,1056,1180,FALSE,0.605438686505901,2021,2021-2022
HI,2022-01-31,intra-ucfe,1,0,1,0,1,1,0,0,0,11,0,15,1,1,FALSE,0.0666666666666667,2021,2021-2022
HI,2022-01-31,intra-ucx,4,0,0,0,0,1,0,0,0,7,2,14,6,6,FALSE,0.428571428571429,2021,2021-2022
HI,2022-01-31,intra-ui,623,124,81,44,29,29,31,17,19,497,426,1920,1049,1173,FALSE,0.6109375,2021,2021-2022
HI,2022-02-28,inter-total,12,3,1,3,0,1,0,0,1,26,5,52,17,20,FALSE,0.384615384615385,2021,2021-2022
HI,2022-02-28,inter-ucfe,0,0,0,0,0,0,0,0,0,1,1,2,1,1,FALSE,0.5,2021,2021-2022
HI,2022-02-28,inter-ucx,0,0,0,0,0,0,0,0,0,0,0,0,0,0,FALSE,0,2021,2021-2022
HI,2022-02-28,inter-ui,12,3,1,3,0,1,0,0,1,25,4,50,16,19,FALSE,0.38,2021,2021-2022
HI,2022-02-28,intra-total,392,119,69,69,57,49,25,18,13,393,329,1533,721,840,FALSE,0.547945205479452,2021,2021-2022
HI,2022-02-28,intra-ucfe,1,0,0,0,0,0,1,0,0,5,1,8,2,2,FALSE,0.25,2021,2021-2022
HI,2022-02-28,intra-ucx,1,0,2,1,0,0,0,0,0,9,1,14,2,2,FALSE,0.142857142857143,2021,2021-2022
HI,2022-02-28,intra-ui,390,119,67,68,57,49,24,18,13,379,327,1511,717,836,FALSE,0.553275976174719,2021,2021-2022
HI,2022-03-31,inter-total,5,3,2,0,0,1,0,2,3,32,5,53,10,13,FALSE,0.245283018867925,2021,2021-2022
HI,2022-03-31,inter-ucfe,0,0,0,0,0,0,0,0,0,1,0,1,0,0,FALSE,0,2021,2021-2022
HI,2022-03-31,inter-ucx,0,0,0,0,0,0,0,0,0,0,0,0,0,0,FALSE,0,2021,2021-2022
HI,2022-03-31,inter-ui,5,3,2,0,0,1,0,2,3,31,5,52,10,13,FALSE,0.25,2021,2021-2022
HI,2022-03-31,intra-total,480,87,53,42,37,38,26,31,20,450,304,1568,784,871,FALSE,0.555484693877551,2021,2021-2022
HI,2022-03-31,intra-ucfe,1,1,0,1,0,0,0,1,1,12,1,18,2,3,FALSE,0.166666666666667,2021,2021-2022
HI,2022-03-31,intra-ucx,7,3,0,2,0,0,1,0,0,9,4,26,11,14,FALSE,0.538461538461538,2021,2021-2022
HI,2022-03-31,intra-ui,472,83,53,39,37,38,25,30,19,429,299,1524,771,854,FALSE,0.560367454068242,2021,2021-2022
HI,2022-04-30,inter-total,7,0,4,1,1,1,1,1,1,15,4,36,11,11,FALSE,0.305555555555556,2021,2021-2022
HI,2022-04-30,inter-ucfe,0,0,0,0,0,1,0,0,0,0,1,2,1,1,FALSE,0.5,2021,2021-2022
HI,2022-04-30,inter-ucx,0,0,0,0,0,0,0,0,0,0,0,0,0,0,FALSE,0,2021,2021-2022
HI,2022-04-30,inter-ui,7,0,4,1,1,0,1,1,1,15,3,34,10,10,FALSE,0.294117647058824,2021,2021-2022
HI,2022-04-30,intra-total,502,109,59,28,29,20,17,15,10,335,376,1500,878,987,FALSE,0.658,2021,2021-2022
HI,2022-04-30,intra-ucfe,1,2,0,0,0,0,0,0,2,4,1,10,2,4,FALSE,0.4,2021,2021-2022
HI,2022-04-30,intra-ucx,4,2,2,1,1,0,0,0,0,2,4,16,8,10,FALSE,0.625,2021,2021-2022
HI,2022-04-30,intra-ui,497,105,57,27,28,20,17,15,8,329,371,1474,868,973,FALSE,0.66010854816825,2021,2021-2022
HI,2022-05-31,inter-total,8,1,2,2,1,1,0,0,1,17,4,37,12,13,FALSE,0.351351351351351,2021,2021-2022
HI,2022-05-31,inter-ucfe,0,1,0,0,0,0,0,0,0,0,0,1,0,1,FALSE,1,2021,2021-2022
HI,2022-05-31,inter-ucx,0,0,0,0,0,0,0,0,0,0,0,0,0,0,FALSE,0,2021,2021-2022
HI,2022-05-31,inter-ui,8,0,2,2,1,1,0,0,1,17,4,36,12,12,FALSE,0.333333333333333,2021,2021-2022
HI,2022-05-31,intra-total,597,130,62,39,31,18,15,7,9,281,357,1546,954,1084,FALSE,0.701164294954722,2021,2021-2022
HI,2022-05-31,intra-ucfe,0,1,3,1,0,0,0,0,0,3,2,10,2,3,FALSE,0.3,2021,2021-2022
HI,2022-05-31,intra-ucx,9,1,1,1,0,0,1,1,0,6,3,23,12,13,FALSE,0.565217391304348,2021,2021-2022
HI,2022-05-31,intra-ui,588,128,58,37,31,18,14,6,9,272,352,1513,940,1068,FALSE,0.705882352941177,2021,2021-2022
HI,2022-06-30,inter-total,13,5,4,3,3,0,3,0,0,14,7,52,20,25,FALSE,0.480769230769231,2021,2021-2022
HI,2022-06-30,inter-ucfe,0,1,0,0,0,0,0,0,0,1,0,2,0,1,FALSE,0.5,2021,2021-2022
HI,2022-06-30,inter-ucx,0,0,0,0,0,0,0,0,0,0,0,0,0,0,FALSE,0,2021,2021-2022
HI,2022-06-30,inter-ui,13,4,4,3,3,0,3,0,0,13,7,50,20,24,FALSE,0.48,2021,2021-2022
HI,2022-06-30,intra-total,613,137,60,46,26,16,17,8,8,267,424,1622,1037,1174,FALSE,0.723797780517879,2021,2021-2022
HI,2022-06-30,intra-ucfe,0,3,0,0,0,0,2,0,0,5,1,11,1,4,FALSE,0.363636363636364,2021,2021-2022
HI,2022-06-30,intra-ucx,5,1,2,0,1,0,0,1,0,6,2,18,7,8,FALSE,0.444444444444444,2021,2021-2022
HI,2022-06-30,intra-ui,608,133,58,46,25,16,15,7,8,256,421,1593,1029,1162,FALSE,0.729441305712492,2021,2021-2022
HI,2022-07-31,inter-total,14,4,2,0,2,0,2,1,0,15,14,54,28,32,FALSE,0.592592592592593,2022,2022-2023
HI,2022-07-31,inter-ucfe,0,1,0,0,0,0,1,0,0,1,1,4,1,2,FALSE,0.5,2022,2022-2023
HI,2022-07-31,inter-ucx,0,0,0,0,0,0,0,0,0,0,0,0,0,0,FALSE,0,2022,2022-2023
HI,2022-07-31,inter-ui,14,3,2,0,2,0,1,1,0,14,13,50,27,30,FALSE,0.6,2022,2022-2023
HI,2022-07-31,intra-total,547,117,70,32,22,17,9,10,4,214,343,1385,890,1007,FALSE,0.727075812274368,2022,2022-2023
HI,2022-07-31,intra-ucfe,0,0,1,1,0,1,1,0,0,0,4,8,4,4,FALSE,0.5,2022,2022-2023
HI,2022-07-31,intra-ucx,4,3,0,1,0,0,0,0,0,1,2,11,6,9,FALSE,0.818181818181818,2022,2022-2023
HI,2022-07-31,intra-ui,543,114,69,30,22,16,8,10,4,213,337,1366,880,994,FALSE,0.727672035139092,2022,2022-2023
HI,2022-08-31,inter-total,9,4,3,2,0,2,0,1,1,17,17,56,26,30,FALSE,0.535714285714286,2022,2022-2023
HI,2022-08-31,inter-ucfe,1,1,0,0,0,0,0,0,0,0,2,4,3,4,FALSE,1,2022,2022-2023
HI,2022-08-31,inter-ucx,0,0,0,0,0,0,0,0,0,0,0,0,0,0,FALSE,0,2022,2022-2023
HI,2022-08-31,inter-ui,8,3,3,2,0,2,0,1,1,17,15,52,23,26,FALSE,0.5,2022,2022-2023
HI,2022-08-31,intra-total,658,120,55,37,28,21,21,7,12,181,408,1548,1066,1186,FALSE,0.766149870801034,2022,2022-2023
HI,2022-08-31,intra-ucfe,0,2,2,0,1,0,1,0,0,1,0,7,0,2,FALSE,0.285714285714286,2022,2022-2023
HI,2022-08-31,intra-ucx,5,0,0,0,0,1,0,0,0,2,0,8,5,5,FALSE,0.625,2022,2022-2023
HI,2022-08-31,intra-ui,653,118,53,37,27,20,20,7,12,178,408,1533,1061,1179,FALSE,0.76908023483366,2022,2022-2023
HI,2022-09-30,inter-total,8,5,3,2,3,1,0,0,0,6,10,38,18,23,FALSE,0.605263157894737,2022,2022-2023
HI,2022-09-30,inter-ucfe,1,0,1,0,0,0,0,0,0,1,0,3,1,1,FALSE,0.333333333333333,2022,2022-2023
HI,2022-09-30,inter-ucx,0,0,0,0,0,0,0,0,0,0,0,0,0,0,FALSE,0,2022,2022-2023
HI,2022-09-30,inter-ui,7,5,2,2,3,1,0,0,0,5,10,35,17,22,FALSE,0.628571428571429,2022,2022-2023
HI,2022-09-30,intra-total,465,93,55,45,26,16,19,10,15,193,337,1274,802,895,FALSE,0.702511773940345,2022,2022-2023
HI,2022-09-30,intra-ucfe,0,0,0,1,1,1,1,0,1,3,1,9,1,1,FALSE,0.111111111111111,2022,2022-2023
HI,2022-09-30,intra-ucx,2,1,0,1,0,0,0,0,0,1,4,9,6,7,FALSE,0.777777777777778,2022,2022-2023
HI,2022-09-30,intra-ui,463,92,55,43,25,15,18,10,14,189,332,1256,795,887,FALSE,0.706210191082803,2022,2022-2023
HI,2022-10-31,inter-total,16,2,2,1,1,1,1,1,2,8,8,43,24,26,FALSE,0.604651162790698,2022,2022-2023
HI,2022-10-31,inter-ucfe,0,1,0,0,0,0,0,0,0,0,1,2,1,2,FALSE,1,2022,2022-2023
HI,2022-10-31,inter-ucx,0,0,0,0,0,0,0,0,0,0,0,0,0,0,FALSE,0,2022,2022-2023
HI,2022-10-31,inter-ui,16,1,2,1,1,1,1,1,2,8,7,41,23,24,FALSE,0.585365853658537,2022,2022-2023
HI,2022-10-31,intra-total,557,91,42,27,15,10,9,7,6,173,338,1275,895,986,FALSE,0.773333333333333,2022,2022-2023
HI,2022-10-31,intra-ucfe,0,0,0,0,0,0,0,0,0,5,2,7,2,2,FALSE,0.285714285714286,2022,2022-2023
HI,2022-10-31,intra-ucx,5,1,0,1,0,0,0,0,0,3,3,13,8,9,FALSE,0.692307692307692,2022,2022-2023
HI,2022-10-31,intra-ui,552,90,42,26,15,10,9,7,6,165,333,1255,885,975,FALSE,0.776892430278885,2022,2022-2023
HI,2022-11-30,inter-total,21,5,2,1,2,0,0,0,0,13,8,52,29,34,FALSE,0.653846153846154,2022,2022-2023
HI,2022-11-30,inter-ucfe,0,0,0,0,0,0,0,0,0,1,0,1,0,0,FALSE,0,2022,2022-2023
HI,2022-11-30,inter-ucx,0,0,0,0,0,0,0,0,0,0,0,0,0,0,FALSE,0,2022,2022-2023
HI,2022-11-30,inter-ui,21,5,2,1,2,0,0,0,0,12,8,51,29,34,FALSE,0.666666666666667,2022,2022-2023
HI,2022-11-30,intra-total,450,106,48,16,18,15,7,2,2,124,350,1138,800,906,FALSE,0.796133567662566,2022,2022-2023
HI,2022-11-30,intra-ucfe,0,0,1,0,0,1,0,0,0,0,0,2,0,0,FALSE,0,2022,2022-2023
HI,2022-11-30,intra-ucx,3,0,0,0,0,0,1,0,0,0,3,7,6,6,FALSE,0.857142857142857,2022,2022-2023
HI,2022-11-30,intra-ui,447,106,47,16,18,14,6,2,2,124,347,1129,794,900,FALSE,0.797165633303809,2022,2022-2023
HI,2022-12-31,inter-total,15,3,2,1,1,3,0,1,1,10,12,49,27,30,FALSE,0.612244897959184,2022,2022-2023
HI,2022-12-31,inter-ucfe,0,0,0,0,0,2,0,1,0,0,0,3,0,0,FALSE,0,2022,2022-2023
HI,2022-12-31,inter-ucx,0,0,0,0,0,0,0,0,0,0,0,0,0,0,FALSE,0,2022,2022-2023
HI,2022-12-31,inter-ui,15,3,2,1,1,1,0,0,1,10,12,46,27,30,FALSE,0.652173913043478,2022,2022-2023
HI,2022-12-31,intra-total,473,78,34,32,11,11,8,4,5,95,303,1054,776,854,FALSE,0.810246679316888,2022,2022-2023
HI,2022-12-31,intra-ucfe,0,0,0,3,0,2,0,0,0,1,2,8,2,2,FALSE,0.25,2022,2022-2023
HI,2022-12-31,intra-ucx,2,1,0,0,1,0,0,0,0,2,3,9,5,6,FALSE,0.666666666666667,2022,2022-2023
HI,2022-12-31,intra-ui,471,77,34,29,10,9,8,4,5,92,298,1037,769,846,FALSE,0.815814850530376,2022,2022-2023
HI,2023-01-31,inter-total,8,4,6,1,2,1,1,0,1,20,4,48,12,16,FALSE,0.333333333333333,2022,2022-2023
HI,2023-01-31,inter-ucfe,2,0,2,0,0,0,0,0,0,0,0,4,2,2,FALSE,0.5,2022,2022-2023
HI,2023-01-31,inter-ucx,0,0,0,0,0,0,0,0,0,0,0,0,0,0,FALSE,0,2022,2022-2023
HI,2023-01-31,inter-ui,6,4,4,1,2,1,1,0,1,20,4,44,10,14,FALSE,0.318181818181818,2022,2022-2023
HI,2023-01-31,intra-total,730,99,54,36,14,9,9,8,5,112,507,1583,1237,1336,FALSE,0.843967150979154,2022,2022-2023
HI,2023-01-31,intra-ucfe,0,0,0,2,0,0,0,1,0,2,3,8,3,3,FALSE,0.375,2022,2022-2023
HI,2023-01-31,intra-ucx,2,0,0,0,1,0,0,0,0,0,0,3,2,2,FALSE,0.666666666666667,2022,2022-2023
HI,2023-01-31,intra-ui,728,99,54,34,13,9,9,7,5,110,504,1572,1232,1331,FALSE,0.846692111959288,2022,2022-2023
HI,2023-02-28,inter-total,8,11,2,3,3,0,1,0,1,7,12,48,20,31,FALSE,0.645833333333333,2022,2022-2023
HI,2023-02-28,inter-ucfe,0,0,0,1,0,0,0,0,0,0,1,2,1,1,FALSE,0.5,2022,2022-2023
HI,2023-02-28,inter-ucx,0,0,0,0,0,0,0,0,0,0,0,0,0,0,FALSE,0,2022,2022-2023
HI,2023-02-28,inter-ui,8,11,2,2,3,0,1,0,1,7,11,46,19,30,FALSE,0.652173913043478,2022,2022-2023
HI,2023-02-28,intra-total,512,101,46,38,25,12,8,8,6,95,372,1223,884,985,FALSE,0.80539656582175,2022,2022-2023
HI,2023-02-28,intra-ucfe,1,0,2,0,0,0,0,0,0,2,2,7,3,3,FALSE,0.428571428571429,2022,2022-2023
HI,2023-02-28,intra-ucx,6,0,0,0,0,0,0,0,0,1,3,10,9,9,FALSE,0.9,2022,2022-2023
HI,2023-02-28,intra-ui,505,101,44,38,25,12,8,8,6,92,367,1206,872,973,FALSE,0.806799336650083,2022,2022-2023
HI,2023-03-31,inter-total,8,3,3,1,2,1,1,2,1,11,8,41,16,19,FALSE,0.463414634146342,2022,2022-2023
HI,2023-03-31,inter-ucfe,0,0,0,0,0,0,1,0,0,1,2,4,2,2,FALSE,0.5,2022,2022-2023
HI,2023-03-31,inter-ucx,0,0,0,0,0,0,0,0,0,0,0,0,0,0,FALSE,0,2022,2022-2023
HI,2023-03-31,inter-ui,8,3,3,1,2,1,0,2,1,10,6,37,14,17,FALSE,0.45945945945946,2022,2022-2023
HI,2023-03-31,intra-total,504,100,51,28,15,11,16,6,13,99,380,1223,884,984,FALSE,0.804578904333606,2022,2022-2023
HI,2023-03-31,intra-ucfe,1,1,0,0,0,1,0,0,0,0,4,7,5,6,FALSE,0.857142857142857,2022,2022-2023
HI,2023-03-31,intra-ucx,6,2,0,0,0,0,0,1,0,0,1,10,7,9,FALSE,0.9,2022,2022-2023
HI,2023-03-31,intra-ui,497,97,51,28,15,10,16,5,13,99,375,1206,872,969,FALSE,0.803482587064677,2022,2022-2023
HI,2023-04-30,inter-total,6,4,3,1,2,1,1,0,0,28,16,62,22,26,FALSE,0.419354838709677,2022,2022-2023
HI,2023-04-30,inter-ucfe,0,0,0,0,0,0,0,0,0,2,0,2,0,0,FALSE,0,2022,2022-2023
HI,2023-04-30,inter-ucx,0,0,0,0,0,0,0,0,0,1,0,1,0,0,FALSE,0,2022,2022-2023
HI,2023-04-30,inter-ui,6,4,3,1,2,1,1,0,0,25,16,59,22,26,FALSE,0.440677966101695,2022,2022-2023
HI,2023-04-30,intra-total,497,90,37,16,15,12,8,7,5,123,326,1136,823,913,FALSE,0.803697183098592,2022,2022-2023
HI,2023-04-30,intra-ucfe,0,1,3,0,0,0,0,0,0,7,5,16,5,6,FALSE,0.375,2022,2022-2023
HI,2023-04-30,intra-ucx,0,0,0,0,0,0,0,1,0,0,2,3,2,2,FALSE,0.666666666666667,2022,2022-2023
HI,2023-04-30,intra-ui,497,89,34,16,15,12,8,6,5,116,319,1117,816,905,FALSE,0.810205908683975,2022,2022-2023
HI,2023-05-31,inter-total,17,2,3,0,1,1,1,1,2,6,14,48,31,33,FALSE,0.6875,2022,2022-2023
HI,2023-05-31,inter-ucfe,0,1,0,0,0,0,0,0,0,1,0,2,0,1,FALSE,0.5,2022,2022-2023
HI,2023-05-31,inter-ucx,0,0,0,0,0,0,0,0,0,0,0,0,0,0,FALSE,0,2022,2022-2023
HI,2023-05-31,inter-ui,17,1,3,0,1,1,1,1,2,5,14,46,31,32,FALSE,0.695652173913044,2022,2022-2023
HI,2023-05-31,intra-total,696,94,41,31,19,9,9,9,6,72,400,1386,1096,1190,FALSE,0.858585858585859,2022,2022-2023
HI,2023-05-31,intra-ucfe,0,2,1,1,1,1,0,0,1,2,2,11,2,4,FALSE,0.363636363636364,2022,2022-2023
HI,2023-05-31,intra-ucx,2,0,0,0,0,0,0,0,0,1,2,5,4,4,FALSE,0.8,2022,2022-2023
HI,2023-05-31,intra-ui,694,92,40,30,18,8,9,9,5,69,396,1370,1090,1182,FALSE,0.862773722627737,2022,2022-2023
HI,2023-06-30,inter-total,14,7,4,1,1,1,0,2,0,8,10,48,24,31,FALSE,0.645833333333333,2022,2022-2023
HI,2023-06-30,inter-ucfe,1,0,0,0,0,0,0,0,0,1,0,2,1,1,FALSE,0.5,2022,2022-2023
HI,2023-06-30,inter-ucx,0,0,0,0,0,0,0,0,0,0,0,0,0,0,FALSE,0,2022,2022-2023
HI,2023-06-30,inter-ui,13,7,4,1,1,1,0,2,0,7,10,46,23,30,FALSE,0.652173913043478,2022,2022-2023
HI,2023-06-30,intra-total,576,112,48,22,13,15,10,4,5,65,431,1301,1007,1119,FALSE,0.86010760953113,2022,2022-2023
HI,2023-06-30,intra-ucfe,0,1,0,0,0,0,0,0,0,0,1,2,1,2,FALSE,1,2022,2022-2023
HI,2023-06-30,intra-ucx,0,1,0,0,1,0,0,0,0,1,2,5,2,3,FALSE,0.6,2022,2022-2023
HI,2023-06-30,intra-ui,576,110,48,22,12,15,10,4,5,64,428,1294,1004,1114,FALSE,0.860896445131376,2022,2022-2023
HI,2023-07-31,inter-total,22,5,3,2,2,0,0,2,0,4,17,57,39,44,FALSE,0.771929824561403,2023,2023-2024
HI,2023-07-31,inter-ucfe,0,0,0,0,0,0,0,0,0,0,0,0,0,0,FALSE,0,2023,2023-2024
HI,2023-07-31,inter-ucx,0,0,0,0,0,0,0,0,0,0,0,0,0,0,FALSE,0,2023,2023-2024
HI,2023-07-31,inter-ui,22,5,3,2,2,0,0,2,0,4,17,57,39,44,FALSE,0.771929824561403,2023,2023-2024
HI,2023-07-31,intra-total,556,85,43,25,17,11,7,4,1,58,367,1174,923,1008,FALSE,0.858603066439523,2023,2023-2024
HI,2023-07-31,intra-ucfe,0,0,0,2,0,0,0,0,0,1,5,8,5,5,FALSE,0.625,2023,2023-2024
HI,2023-07-31,intra-ucx,4,0,1,0,0,0,0,0,0,0,1,6,5,5,FALSE,0.833333333333333,2023,2023-2024
HI,2023-07-31,intra-ui,552,85,42,23,17,11,7,4,1,57,361,1160,913,998,FALSE,0.860344827586207,2023,2023-2024
HI,2023-08-31,inter-total,30,5,1,1,2,0,1,2,2,6,25,75,55,60,FALSE,0.8,2023,2023-2024
HI,2023-08-31,inter-ucfe,0,0,1,0,0,0,0,0,0,0,0,1,0,0,FALSE,0,2023,2023-2024
HI,2023-08-31,inter-ucx,0,0,0,0,0,0,0,0,0,0,0,0,0,0,FALSE,0,2023,2023-2024
HI,2023-08-31,inter-ui,30,5,0,1,2,0,1,2,2,6,25,74,55,60,FALSE,0.810810810810811,2023,2023-2024
HI,2023-08-31,intra-total,2101,99,27,17,15,9,11,10,7,95,1185,3576,3286,3385,FALSE,0.94658836689038,2023,2023-2024
HI,2023-08-31,intra-ucfe,3,0,0,0,0,1,0,0,0,0,2,6,5,5,FALSE,0.833333333333333,2023,2023-2024
HI,2023-08-31,intra-ucx,3,0,0,0,1,0,0,0,0,0,3,7,6,6,FALSE,0.857142857142857,2023,2023-2024
HI,2023-08-31,intra-ui,2095,99,27,17,14,8,11,10,7,95,1180,3563,3275,3374,FALSE,0.946954813359529,2023,2023-2024
HI,2023-09-30,inter-total,11,10,10,9,5,0,1,1,2,6,17,72,28,38,FALSE,0.527777777777778,2023,2023-2024
HI,2023-09-30,inter-ucfe,0,1,0,1,0,0,0,0,0,1,0,3,0,1,FALSE,0.333333333333333,2023,2023-2024
HI,2023-09-30,inter-ucx,0,0,0,0,0,0,0,0,0,0,0,0,0,0,FALSE,0,2023,2023-2024
HI,2023-09-30,inter-ui,11,9,10,8,5,0,1,1,2,5,17,69,28,37,FALSE,0.536231884057971,2023,2023-2024
HI,2023-09-30,intra-total,1045,912,574,411,216,28,13,6,2,44,1649,4900,2694,3606,FALSE,0.735918367346939,2023,2023-2024
HI,2023-09-30,intra-ucfe,0,3,0,0,1,0,1,0,0,1,1,7,1,4,FALSE,0.571428571428571,2023,2023-2024
HI,2023-09-30,intra-ucx,2,1,0,1,0,0,0,0,0,0,1,5,3,4,FALSE,0.8,2023,2023-2024
HI,2023-09-30,intra-ui,1043,908,574,410,215,28,12,6,2,43,1647,4888,2690,3598,FALSE,0.736088379705401,2023,2023-2024
HI,2023-10-31,inter-total,9,3,2,3,3,4,1,1,2,2,9,39,18,21,FALSE,0.538461538461538,2023,2023-2024
HI,2023-10-31,inter-ucfe,0,0,0,0,0,0,0,0,0,1,0,1,0,0,FALSE,0,2023,2023-2024
HI,2023-10-31,inter-ucx,0,0,0,0,0,0,0,0,0,0,0,0,0,0,FALSE,0,2023,2023-2024
HI,2023-10-31,inter-ui,9,3,2,3,3,4,1,1,2,1,9,38,18,21,FALSE,0.552631578947369,2023,2023-2024
HI,2023-10-31,intra-total,533,184,159,171,196,235,186,112,75,71,403,2325,936,1120,FALSE,0.481720430107527,2023,2023-2024
HI,2023-10-31,intra-ucfe,0,3,1,0,0,0,0,0,0,0,1,5,1,4,FALSE,0.8,2023,2023-2024
HI,2023-10-31,intra-ucx,2,0,0,1,0,1,0,0,0,1,1,6,3,3,FALSE,0.5,2023,2023-2024
HI,2023-10-31,intra-ui,531,181,158,170,196,234,186,112,75,70,401,2314,932,1113,FALSE,0.480985306828003,2023,2023-2024
HI,2023-11-30,inter-total,24,3,5,0,2,0,3,0,4,15,6,62,30,33,FALSE,0.532258064516129,2023,2023-2024
HI,2023-11-30,inter-ucfe,0,0,0,0,0,0,0,0,0,0,0,0,0,0,FALSE,0,2023,2023-2024
HI,2023-11-30,inter-ucx,0,0,0,0,0,0,0,0,0,0,0,0,0,0,FALSE,0,2023,2023-2024
HI,2023-11-30,inter-ui,24,3,5,0,2,0,3,0,4,15,6,62,30,33,FALSE,0.532258064516129,2023,2023-2024
HI,2023-11-30,intra-total,416,104,69,56,53,36,35,41,57,228,299,1394,715,819,FALSE,0.587517934002869,2023,2023-2024
HI,2023-11-30,intra-ucfe,0,0,0,0,0,0,0,0,0,2,1,3,1,1,FALSE,0.333333333333333,2023,2023-2024
HI,2023-11-30,intra-ucx,2,0,0,1,2,0,0,0,0,1,1,7,3,3,FALSE,0.428571428571429,2023,2023-2024
HI,2023-11-30,intra-ui,414,104,69,55,51,36,35,41,57,225,297,1384,711,815,FALSE,0.588872832369942,2023,2023-2024
HI,2023-12-31,inter-total,8,1,4,2,2,0,0,0,2,12,10,41,18,19,FALSE,0.463414634146342,2023,2023-2024
HI,2023-12-31,inter-ucfe,0,0,0,0,0,0,0,0,0,0,1,1,1,1,FALSE,1,2023,2023-2024
HI,2023-12-31,inter-ucx,0,0,0,0,0,0,0,0,0,0,0,0,0,0,FALSE,0,2023,2023-2024
HI,2023-12-31,inter-ui,8,1,4,2,2,0,0,0,2,12,9,40,17,18,FALSE,0.45,2023,2023-2024
HI,2023-12-31,intra-total,430,100,42,31,16,19,22,18,8,155,240,1081,670,770,FALSE,0.712303422756707,2023,2023-2024
HI,2023-12-31,intra-ucfe,2,0,1,0,0,0,0,0,0,0,0,3,2,2,FALSE,0.666666666666667,2023,2023-2024
HI,2023-12-31,intra-ucx,1,1,0,1,0,0,0,0,0,1,0,4,1,2,FALSE,0.5,2023,2023-2024
HI,2023-12-31,intra-ui,427,99,41,30,16,19,22,18,8,154,240,1074,667,766,FALSE,0.713221601489758,2023,2023-2024
HI,2024-01-31,inter-total,15,2,1,2,2,2,2,0,1,11,11,49,26,28,FALSE,0.571428571428571,2023,2023-2024
HI,2024-01-31,inter-ucfe,0,0,0,0,0,0,0,0,0,0,0,0,0,0,FALSE,0,2023,2023-2024
HI,2024-01-31,inter-ucx,0,0,0,0,0,0,0,0,0,0,0,0,0,0,FALSE,0,2023,2023-2024
HI,2024-01-31,inter-ui,15,2,1,2,2,2,2,0,1,11,11,49,26,28,FALSE,0.571428571428571,2023,2023-2024
HI,2024-01-31,intra-total,619,119,62,39,31,15,15,14,6,121,362,1403,981,1100,FALSE,0.784034212401996,2023,2023-2024
HI,2024-01-31,intra-ucfe,2,0,2,0,1,0,0,0,0,1,0,6,2,2,FALSE,0.333333333333333,2023,2023-2024
HI,2024-01-31,intra-ucx,3,1,0,0,0,0,0,0,0,2,2,8,5,6,FALSE,0.75,2023,2023-2024
HI,2024-01-31,intra-ui,614,118,60,39,30,15,15,14,6,118,360,1389,974,1092,FALSE,0.786177105831533,2023,2023-2024
HI,2024-02-29,inter-total,8,5,4,1,2,0,1,0,1,8,8,38,16,21,FALSE,0.552631578947369,2023,2023-2024
HI,2024-02-29,inter-ucfe,0,0,0,1,0,0,0,0,0,1,0,2,0,0,FALSE,0,2023,2023-2024
HI,2024-02-29,inter-ucx,0,0,0,0,0,0,0,0,0,0,0,0,0,0,FALSE,0,2023,2023-2024
HI,2024-02-29,inter-ui,8,5,4,0,2,0,1,0,1,7,8,36,16,21,FALSE,0.583333333333333,2023,2023-2024
HI,2024-02-29,intra-total,484,100,55,50,19,20,18,14,10,109,304,1183,788,888,FALSE,0.750633981403212,2023,2023-2024
HI,2024-02-29,intra-ucfe,0,0,0,1,0,1,0,0,0,3,1,6,1,1,FALSE,0.166666666666667,2023,2023-2024
HI,2024-02-29,intra-ucx,2,1,0,0,0,0,1,1,1,0,0,6,2,3,FALSE,0.5,2023,2023-2024
HI,2024-02-29,intra-ui,482,99,55,49,19,19,17,13,9,106,303,1171,785,884,FALSE,0.754910333048676,2023,2023-2024
HI,2024-03-31,inter-total,13,2,5,1,0,0,3,2,2,7,3,38,16,18,FALSE,0.473684210526316,2023,2023-2024
HI,2024-03-31,inter-ucfe,0,1,0,0,0,0,0,0,0,0,0,1,0,1,FALSE,1,2023,2023-2024
HI,2024-03-31,inter-ucx,0,0,0,0,0,0,0,0,0,0,0,0,0,0,FALSE,0,2023,2023-2024
HI,2024-03-31,inter-ui,13,1,5,1,0,0,3,2,2,7,3,37,16,17,FALSE,0.45945945945946,2023,2023-2024
HI,2024-03-31,intra-total,439,69,61,37,36,21,25,11,5,89,256,1049,695,764,FALSE,0.728312678741659,2023,2023-2024
HI,2024-03-31,intra-ucfe,0,1,0,1,0,0,0,0,0,1,2,5,2,3,FALSE,0.6,2023,2023-2024
HI,2024-03-31,intra-ucx,4,1,0,0,1,1,0,0,0,2,2,11,6,7,FALSE,0.636363636363636,2023,2023-2024
HI,2024-03-31,intra-ui,435,67,61,36,35,20,25,11,5,86,252,1033,687,754,FALSE,0.729912875121007,2023,2023-2024
HI,2024-04-30,inter-total,9,1,3,2,0,2,2,1,2,11,9,42,18,19,FALSE,0.452380952380952,2023,2023-2024
HI,2024-04-30,inter-ucfe,0,0,0,1,0,0,0,0,0,0,0,1,0,0,FALSE,0,2023,2023-2024
HI,2024-04-30,inter-ucx,0,0,0,0,0,0,0,0,0,0,0,0,0,0,FALSE,0,2023,2023-2024
HI,2024-04-30,inter-ui,9,1,3,1,0,2,2,1,2,11,9,41,18,19,FALSE,0.463414634146342,2023,2023-2024
HI,2024-04-30,intra-total,533,97,38,41,34,27,27,17,12,108,312,1246,845,942,FALSE,0.756019261637239,2023,2023-2024
HI,2024-04-30,intra-ucfe,1,3,1,0,1,0,0,1,0,0,0,7,1,4,FALSE,0.571428571428571,2023,2023-2024
HI,2024-04-30,intra-ucx,2,1,1,1,0,2,0,0,0,0,0,7,2,3,FALSE,0.428571428571429,2023,2023-2024
HI,2024-04-30,intra-ui,530,93,36,40,33,25,27,16,12,108,312,1232,842,935,FALSE,0.758928571428571,2023,2023-2024
HI,2024-05-31,inter-total,8,2,5,3,2,2,6,0,0,10,2,40,10,12,FALSE,0.3,2023,2023-2024
HI,2024-05-31,inter-ucfe,0,0,0,0,0,0,1,0,0,1,0,2,0,0,FALSE,0,2023,2023-2024
HI,2024-05-31,inter-ucx,0,0,0,0,0,0,0,0,0,0,0,0,0,0,FALSE,0,2023,2023-2024
HI,2024-05-31,inter-ui,8,2,5,3,2,2,5,0,0,9,2,38,10,12,FALSE,0.315789473684211,2023,2023-2024
HI,2024-05-31,intra-total,512,89,48,40,33,21,26,24,12,139,300,1244,812,901,FALSE,0.72427652733119,2023,2023-2024
HI,2024-05-31,intra-ucfe,1,1,0,0,0,0,0,0,1,2,4,9,5,6,FALSE,0.666666666666667,2023,2023-2024
HI,2024-05-31,intra-ucx,2,0,1,1,1,0,0,1,0,2,2,10,4,4,FALSE,0.4,2023,2023-2024
HI,2024-05-31,intra-ui,509,88,47,39,32,21,26,23,11,135,294,1225,803,891,FALSE,0.72734693877551,2023,2023-2024
HI,2024-06-30,inter-total,6,1,0,2,4,2,0,2,0,8,2,27,8,9,FALSE,0.333333333333333,2023,2023-2024
HI,2024-06-30,inter-ucfe,0,0,0,0,0,0,0,0,0,1,0,1,0,0,FALSE,0,2023,2023-2024
HI,2024-06-30,inter-ucx,0,0,0,0,0,0,0,0,0,0,0,0,0,0,FALSE,0,2023,2023-2024
HI,2024-06-30,inter-ui,6,1,0,2,4,2,0,2,0,7,2,26,8,9,FALSE,0.346153846153846,2023,2023-2024
HI,2024-06-30,intra-total,515,88,49,40,24,21,14,15,13,91,300,1170,815,903,FALSE,0.771794871794872,2023,2023-2024
HI,2024-06-30,intra-ucfe,0,1,0,1,0,1,0,0,0,1,1,5,1,2,FALSE,0.4,2023,2023-2024
HI,2024-06-30,intra-ucx,0,0,1,0,1,1,0,0,0,2,0,5,0,0,FALSE,0,2023,2023-2024
HI,2024-06-30,intra-ui,515,87,48,39,23,19,14,15,13,88,299,1160,814,901,FALSE,0.776724137931034,2023,2023-2024
HI,2024-07-31,inter-total,11,7,1,2,3,1,1,2,1,7,3,39,14,21,FALSE,0.538461538461538,2024,2024-2025
HI,2024-07-31,inter-ucfe,0,0,0,0,1,0,0,1,1,0,0,3,0,0,FALSE,0,2024,2024-2025
HI,2024-07-31,inter-ucx,0,0,0,0,0,0,0,0,0,0,0,0,0,0,FALSE,0,2024,2024-2025
HI,2024-07-31,inter-ui,11,7,1,2,2,1,1,1,0,7,3,36,14,21,FALSE,0.583333333333333,2024,2024-2025
HI,2024-07-31,intra-total,481,115,64,33,32,29,29,21,8,137,288,1237,769,884,FALSE,0.714632174616007,2024,2024-2025
HI,2024-07-31,intra-ucfe,0,3,1,0,0,0,0,0,0,1,1,6,1,4,FALSE,0.666666666666667,2024,2024-2025
HI,2024-07-31,intra-ucx,2,0,1,0,0,0,2,0,0,1,1,7,3,3,FALSE,0.428571428571429,2024,2024-2025
HI,2024-07-31,intra-ui,479,112,62,33,32,29,27,21,8,135,286,1224,765,877,FALSE,0.716503267973856,2024,2024-2025
HI,2024-08-31,inter-total,16,3,4,1,1,4,1,2,0,21,8,61,24,27,FALSE,0.442622950819672,2024,2024-2025
HI,2024-08-31,inter-ucfe,1,0,0,0,0,0,0,0,0,2,0,3,1,1,FALSE,0.333333333333333,2024,2024-2025
HI,2024-08-31,inter-ucx,0,0,0,0,0,1,0,0,0,0,0,1,0,0,FALSE,0,2024,2024-2025
HI,2024-08-31,inter-ui,15,3,4,1,1,3,1,2,0,19,8,57,23,26,FALSE,0.456140350877193,2024,2024-2025
HI,2024-08-31,intra-total,491,97,49,42,33,30,28,16,16,168,326,1296,817,914,FALSE,0.705246913580247,2024,2024-2025
HI,2024-08-31,intra-ucfe,0,1,0,1,2,0,1,0,0,3,1,9,1,2,FALSE,0.222222222222222,2024,2024-2025
HI,2024-08-31,intra-ucx,2,2,0,1,1,1,1,1,0,6,3,18,5,7,FALSE,0.388888888888889,2024,2024-2025
HI,2024-08-31,intra-ui,489,94,49,40,30,29,26,15,16,159,322,1269,811,905,FALSE,0.713159968479117,2024,2024-2025
HI,2024-09-30,inter-total,13,3,2,1,1,1,2,3,2,13,5,46,18,21,FALSE,0.456521739130435,2024,2024-2025
HI,2024-09-30,inter-ucfe,0,0,0,0,0,0,1,0,1,0,0,2,0,0,FALSE,0,2024,2024-2025
HI,2024-09-30,inter-ucx,0,0,0,0,0,0,0,0,0,0,0,0,0,0,FALSE,0,2024,2024-2025
HI,2024-09-30,inter-ui,13,3,2,1,1,1,1,3,1,13,5,44,18,21,FALSE,0.477272727272727,2024,2024-2025
HI,2024-09-30,intra-total,550,114,52,28,33,26,14,20,18,215,310,1380,860,974,FALSE,0.705797101449275,2024,2024-2025
HI,2024-09-30,intra-ucfe,1,2,1,0,1,0,0,1,0,4,1,11,2,4,FALSE,0.363636363636364,2024,2024-2025
HI,2024-09-30,intra-ucx,1,1,0,0,0,1,0,0,0,5,1,9,2,3,FALSE,0.333333333333333,2024,2024-2025
HI,2024-09-30,intra-ui,548,111,51,28,32,25,14,19,18,206,308,1360,856,967,FALSE,0.711029411764706,2024,2024-2025
HI,2024-10-31,inter-total,16,3,5,3,6,5,6,3,1,20,10,78,26,29,FALSE,0.371794871794872,2024,2024-2025
HI,2024-10-31,inter-ucfe,0,0,0,0,1,0,0,0,0,1,0,2,0,0,FALSE,0,2024,2024-2025
HI,2024-10-31,inter-ucx,0,0,1,0,0,0,1,0,0,0,0,2,0,0,FALSE,0,2024,2024-2025
HI,2024-10-31,inter-ui,16,3,4,3,5,5,5,3,1,19,10,74,26,29,FALSE,0.391891891891892,2024,2024-2025
HI,2024-10-31,intra-total,500,95,48,50,33,24,31,19,14,159,344,1317,844,939,FALSE,0.712984054669704,2024,2024-2025
HI,2024-10-31,intra-ucfe,3,1,0,1,0,1,2,0,1,3,1,13,4,5,FALSE,0.384615384615385,2024,2024-2025
HI,2024-10-31,intra-ucx,5,1,0,1,1,1,0,1,0,1,1,12,6,7,FALSE,0.583333333333333,2024,2024-2025
HI,2024-10-31,intra-ui,492,93,48,48,32,22,29,18,13,155,342,1292,834,927,FALSE,0.71749226006192,2024,2024-2025
HI,2024-11-30,inter-total,19,5,1,5,1,1,3,0,1,6,17,59,36,41,FALSE,0.694915254237288,2024,2024-2025
HI,2024-11-30,inter-ucfe,0,0,0,0,0,0,0,0,0,0,2,2,2,2,FALSE,1,2024,2024-2025
HI,2024-11-30,inter-ucx,0,0,0,0,0,0,0,0,0,0,0,0,0,0,FALSE,0,2024,2024-2025
HI,2024-11-30,inter-ui,19,5,1,5,1,1,3,0,1,6,15,57,34,39,FALSE,0.68421052631579,2024,2024-2025
HI,2024-11-30,intra-total,411,92,32,23,21,14,70,218,15,125,301,1322,712,804,FALSE,0.608169440242057,2024,2024-2025
HI,2024-11-30,intra-ucfe,1,0,0,0,0,0,0,0,0,2,1,4,2,2,FALSE,0.5,2024,2024-2025
HI,2024-11-30,intra-ucx,3,6,0,0,0,0,1,0,1,1,2,14,5,11,FALSE,0.785714285714286,2024,2024-2025
HI,2024-11-30,intra-ui,407,86,32,23,21,14,69,218,14,122,298,1304,705,791,FALSE,0.60659509202454,2024,2024-2025
HI,2024-12-31,inter-total,21,1,4,4,2,1,2,0,1,21,7,64,28,29,FALSE,0.453125,2024,2024-2025
HI,2024-12-31,inter-ucfe,0,0,0,0,0,0,0,0,0,1,0,1,0,0,FALSE,0,2024,2024-2025
HI,2024-12-31,inter-ucx,0,0,0,0,0,0,0,0,0,0,0,0,0,0,FALSE,0,2024,2024-2025
HI,2024-12-31,inter-ui,21,1,4,4,2,1,2,0,1,20,7,63,28,29,FALSE,0.46031746031746,2024,2024-2025
HI,2024-12-31,intra-total,442,88,60,42,24,21,17,14,13,109,277,1107,719,807,FALSE,0.7289972899729,2024,2024-2025
HI,2024-12-31,intra-ucfe,0,0,0,0,0,1,1,0,0,1,1,4,1,1,FALSE,0.25,2024,2024-2025
HI,2024-12-31,intra-ucx,1,0,0,1,1,0,1,0,1,3,1,9,2,2,FALSE,0.222222222222222,2024,2024-2025
HI,2024-12-31,intra-ui,441,88,60,41,23,20,15,14,12,105,275,1094,716,804,FALSE,0.73491773308958,2024,2024-2025
IA,2019-01-31,inter-total,31,145,19,7,5,0,0,2,0,3,320,532,351,496,TRUE,0.659774436090226,2018,2018-2019
IA,2019-01-31,inter-ucfe,0,0,0,0,0,0,0,0,0,0,0,0,0,0,TRUE,0,2018,2018-2019
IA,2019-01-31,inter-ucx,0,0,0,0,0,0,0,0,0,0,0,0,0,0,TRUE,0,2018,2018-2019
IA,2019-01-31,inter-ui,31,145,19,7,5,0,0,2,0,3,320,532,351,496,TRUE,0.659774436090226,2018,2018-2019
IA,2019-01-31,intra-total,1471,2576,362,141,33,29,17,12,1,15,12617,17274,14088,16664,TRUE,0.815560958666204,2018,2018-2019
IA,2019-01-31,intra-ucfe,9,106,1,0,0,0,0,0,0,1,184,301,193,299,TRUE,0.641196013289037,2018,2018-2019
IA,2019-01-31,intra-ucx,3,1,0,0,0,0,0,0,0,1,3,8,6,7,TRUE,0.75,2018,2018-2019
IA,2019-01-31,intra-ui,1459,2469,361,141,33,29,17,12,1,13,12430,16965,13889,16358,TRUE,0.818685529030357,2018,2018-2019
IA,2019-02-28,inter-total,30,89,20,14,5,5,3,1,0,0,172,339,202,291,TRUE,0.595870206489676,2018,2018-2019
IA,2019-02-28,inter-ucfe,0,0,0,0,0,0,0,0,0,0,0,0,0,0,TRUE,0,2018,2018-2019
IA,2019-02-28,inter-ucx,0,0,0,0,0,0,0,0,0,0,0,0,0,0,TRUE,0,2018,2018-2019
IA,2019-02-28,inter-ui,30,89,20,14,5,5,3,1,0,0,172,339,202,291,TRUE,0.595870206489676,2018,2018-2019
IA,2019-02-28,intra-total,763,1548,347,107,49,37,27,10,12,12,5272,8184,6035,7583,TRUE,0.737414467253177,2018,2018-2019
IA,2019-02-28,intra-ucfe,2,8,1,1,0,0,1,0,0,0,3,16,5,13,TRUE,0.3125,2018,2018-2019
IA,2019-02-28,intra-ucx,2,1,0,0,0,0,0,0,0,0,5,8,7,8,TRUE,0.875,2018,2018-2019
IA,2019-02-28,intra-ui,759,1539,346,106,49,37,26,10,12,12,5264,8160,6023,7562,TRUE,0.738112745098039,2018,2018-2019
IA,2019-03-31,inter-total,23,42,8,5,5,3,1,2,1,3,85,178,108,150,TRUE,0.606741573033708,2018,2018-2019
IA,2019-03-31,inter-ucfe,0,0,0,0,0,0,0,0,0,0,0,0,0,0,TRUE,0,2018,2018-2019
IA,2019-03-31,inter-ucx,0,0,0,0,0,0,0,0,0,0,0,0,0,0,TRUE,0,2018,2018-2019
IA,2019-03-31,inter-ui,23,42,8,5,5,3,1,2,1,3,85,178,108,150,TRUE,0.606741573033708,2018,2018-2019
IA,2019-03-31,intra-total,538,823,114,28,23,22,18,8,6,7,2735,4322,3273,4096,TRUE,0.757288292457196,2018,2018-2019
IA,2019-03-31,intra-ucfe,0,3,1,0,0,0,0,0,0,0,2,6,2,5,TRUE,0.333333333333333,2018,2018-2019
IA,2019-03-31,intra-ucx,1,0,1,0,0,0,0,0,0,0,6,8,7,7,TRUE,0.875,2018,2018-2019
IA,2019-03-31,intra-ui,537,820,112,28,23,22,18,8,6,7,2727,4308,3264,4084,TRUE,0.757660167130919,2018,2018-2019
IA,2019-04-30,inter-total,14,46,7,5,2,1,1,2,2,1,88,169,102,148,TRUE,0.603550295857988,2018,2018-2019
IA,2019-04-30,inter-ucfe,0,0,0,0,0,0,0,0,0,0,0,0,0,0,TRUE,0,2018,2018-2019
IA,2019-04-30,inter-ucx,0,0,0,0,0,0,0,0,0,0,0,0,0,0,TRUE,0,2018,2018-2019
IA,2019-04-30,inter-ui,14,46,7,5,2,1,1,2,2,1,88,169,102,148,TRUE,0.603550295857988,2018,2018-2019
IA,2019-04-30,intra-total,413,786,125,35,25,18,13,6,1,13,2042,3477,2455,3241,TRUE,0.706068449813057,2018,2018-2019
IA,2019-04-30,intra-ucfe,1,5,0,1,0,0,0,0,0,0,1,8,2,7,TRUE,0.25,2018,2018-2019
IA,2019-04-30,intra-ucx,0,2,0,0,0,0,0,0,0,0,3,5,3,5,TRUE,0.6,2018,2018-2019
IA,2019-04-30,intra-ui,412,779,125,34,25,18,13,6,1,13,2038,3464,2450,3229,TRUE,0.707274826789838,2018,2018-2019
IA,2019-05-31,inter-total,10,39,8,6,5,2,1,1,0,1,86,159,96,135,TRUE,0.60377358490566,2018,2018-2019
IA,2019-05-31,inter-ucfe,0,0,0,0,0,0,0,0,0,0,0,0,0,0,TRUE,0,2018,2018-2019
IA,2019-05-31,inter-ucx,0,0,0,0,0,0,0,0,0,0,0,0,0,0,TRUE,0,2018,2018-2019
IA,2019-05-31,inter-ui,10,39,8,6,5,2,1,1,0,1,86,159,96,135,TRUE,0.60377358490566,2018,2018-2019
IA,2019-05-31,intra-total,513,703,121,25,13,20,18,11,5,11,2551,3991,3064,3767,TRUE,0.767727386619895,2018,2018-2019
IA,2019-05-31,intra-ucfe,2,5,0,0,0,0,0,0,0,0,3,10,5,10,TRUE,0.5,2018,2018-2019
IA,2019-05-31,intra-ucx,1,2,0,0,0,0,0,0,0,0,4,7,5,7,TRUE,0.714285714285714,2018,2018-2019
IA,2019-05-31,intra-ui,510,696,121,25,13,20,18,11,5,11,2544,3974,3054,3750,TRUE,0.768495218923,2018,2018-2019
IA,2019-06-30,inter-total,14,41,12,5,4,2,0,1,0,1,70,150,84,125,TRUE,0.56,2018,2018-2019
IA,2019-06-30,inter-ucfe,0,0,0,0,0,0,0,0,0,0,0,0,0,0,TRUE,0,2018,2018-2019
IA,2019-06-30,inter-ucx,0,0,0,0,0,0,0,0,0,0,0,0,0,0,TRUE,0,2018,2018-2019
IA,2019-06-30,inter-ui,14,41,12,5,4,2,0,1,0,1,70,150,84,125,TRUE,0.56,2018,2018-2019
IA,2019-06-30,intra-total,461,695,139,46,16,13,24,7,7,8,2315,3731,2776,3471,TRUE,0.744036451353525,2018,2018-2019
IA,2019-06-30,intra-ucfe,0,2,0,0,0,0,0,0,0,0,0,2,0,2,TRUE,0,2018,2018-2019
IA,2019-06-30,intra-ucx,0,0,0,0,0,0,0,0,0,0,3,3,3,3,TRUE,1,2018,2018-2019
IA,2019-06-30,intra-ui,461,693,139,46,16,13,24,7,7,8,2312,3726,2773,3466,TRUE,0.74422973698336,2018,2018-2019
IA,2019-07-31,inter-total,13,40,11,4,2,1,1,0,1,2,68,143,81,121,TRUE,0.566433566433567,2019,2019-2020
IA,2019-07-31,inter-ucfe,0,0,0,0,0,0,0,0,0,0,0,0,0,0,TRUE,0,2019,2019-2020
IA,2019-07-31,inter-ucx,0,0,0,0,0,0,0,0,0,0,0,0,0,0,TRUE,0,2019,2019-2020
IA,2019-07-31,inter-ui,13,40,11,4,2,1,1,0,1,2,68,143,81,121,TRUE,0.566433566433567,2019,2019-2020
IA,2019-07-31,intra-total,498,930,215,54,18,14,28,15,4,14,3083,4873,3581,4511,TRUE,0.734865585881387,2019,2019-2020
IA,2019-07-31,intra-ucfe,1,1,2,0,0,0,0,0,0,0,3,7,4,5,TRUE,0.571428571428571,2019,2019-2020
IA,2019-07-31,intra-ucx,0,1,0,0,0,0,0,0,0,0,2,3,2,3,TRUE,0.666666666666667,2019,2019-2020
IA,2019-07-31,intra-ui,497,928,213,54,18,14,28,15,4,14,3078,4863,3575,4503,TRUE,0.735142915895538,2019,2019-2020
IA,2019-08-31,inter-total,13,32,6,5,3,0,2,1,0,1,87,150,100,132,TRUE,0.666666666666667,2019,2019-2020
IA,2019-08-31,inter-ucfe,0,0,0,0,0,0,0,0,0,0,0,0,0,0,TRUE,0,2019,2019-2020
IA,2019-08-31,inter-ucx,0,0,0,0,0,0,0,0,0,0,0,0,0,0,TRUE,0,2019,2019-2020
IA,2019-08-31,inter-ui,13,32,6,5,3,0,2,1,0,1,87,150,100,132,TRUE,0.666666666666667,2019,2019-2020
IA,2019-08-31,intra-total,379,767,196,66,23,13,25,9,7,13,2504,4002,2883,3650,TRUE,0.720389805097451,2019,2019-2020
IA,2019-08-31,intra-ucfe,0,6,0,1,0,0,0,0,0,0,2,9,2,8,TRUE,0.222222222222222,2019,2019-2020
IA,2019-08-31,intra-ucx,1,1,0,0,0,0,0,0,0,0,7,9,8,9,TRUE,0.888888888888889,2019,2019-2020
IA,2019-08-31,intra-ui,378,760,196,65,23,13,25,9,7,13,2495,3984,2873,3633,TRUE,0.721134538152611,2019,2019-2020
IA,2019-09-30,inter-total,5,26,6,3,3,1,0,0,0,1,53,98,58,84,TRUE,0.591836734693878,2019,2019-2020
IA,2019-09-30,inter-ucfe,0,0,0,0,1,0,0,0,0,0,0,1,0,0,TRUE,0,2019,2019-2020
IA,2019-09-30,inter-ucx,0,0,0,0,0,0,0,0,0,0,1,1,1,1,TRUE,1,2019,2019-2020
IA,2019-09-30,inter-ui,5,26,6,3,2,1,0,0,0,1,52,96,57,83,TRUE,0.59375,2019,2019-2020
IA,2019-09-30,intra-total,426,616,197,50,14,11,16,17,7,11,1974,3339,2400,3016,TRUE,0.718778077268643,2019,2019-2020
IA,2019-09-30,intra-ucfe,0,5,0,0,0,0,0,0,0,0,0,5,0,5,TRUE,0,2019,2019-2020
IA,2019-09-30,intra-ucx,3,0,0,0,0,0,0,0,0,0,1,4,4,4,TRUE,1,2019,2019-2020
IA,2019-09-30,intra-ui,423,611,197,50,14,11,16,17,7,11,1973,3330,2396,3007,TRUE,0.71951951951952,2019,2019-2020
IA,2019-10-31,inter-total,14,47,7,4,5,0,2,1,0,1,89,170,103,150,TRUE,0.605882352941176,2019,2019-2020
IA,2019-10-31,inter-ucfe,0,1,0,0,0,0,0,0,0,0,0,1,0,1,TRUE,0,2019,2019-2020
IA,2019-10-31,inter-ucx,0,0,0,0,0,0,0,0,0,0,0,0,0,0,TRUE,0,2019,2019-2020
IA,2019-10-31,inter-ui,14,46,7,4,5,0,2,1,0,1,89,169,103,149,TRUE,0.609467455621302,2019,2019-2020
IA,2019-10-31,intra-total,513,628,120,39,15,10,28,4,6,22,2612,3997,3125,3753,TRUE,0.781836377282962,2019,2019-2020
IA,2019-10-31,intra-ucfe,2,3,0,1,0,0,0,0,0,0,2,8,4,7,TRUE,0.5,2019,2019-2020
IA,2019-10-31,intra-ucx,0,0,1,0,0,0,0,0,0,0,2,3,2,2,TRUE,0.666666666666667,2019,2019-2020
IA,2019-10-31,intra-ui,511,625,119,38,15,10,28,4,6,22,2608,3986,3119,3744,TRUE,0.782488710486704,2019,2019-2020
IA,2019-11-30,inter-total,19,60,8,9,4,0,1,1,0,1,129,232,148,208,TRUE,0.637931034482759,2019,2019-2020
IA,2019-11-30,inter-ucfe,0,1,0,0,0,0,0,0,0,0,0,1,0,1,TRUE,0,2019,2019-2020
IA,2019-11-30,inter-ucx,0,0,0,0,0,0,0,0,0,0,0,0,0,0,TRUE,0,2019,2019-2020
IA,2019-11-30,inter-ui,19,59,8,9,4,0,1,1,0,1,129,231,148,207,TRUE,0.640692640692641,2019,2019-2020
IA,2019-11-30,intra-total,499,764,141,36,14,12,13,13,7,17,3113,4629,3612,4376,TRUE,0.780298120544394,2019,2019-2020
IA,2019-11-30,intra-ucfe,1,3,2,0,0,0,0,0,0,0,8,14,9,12,TRUE,0.642857142857143,2019,2019-2020
IA,2019-11-30,intra-ucx,2,0,1,0,0,0,0,0,0,1,2,6,4,4,TRUE,0.666666666666667,2019,2019-2020
IA,2019-11-30,intra-ui,496,761,138,36,14,12,13,13,7,16,3103,4609,3599,4360,TRUE,0.780863527880234,2019,2019-2020
IA,2019-12-31,inter-total,33,95,10,6,5,1,4,2,1,1,215,373,248,343,TRUE,0.664879356568365,2019,2019-2020
IA,2019-12-31,inter-ucfe,0,0,0,0,0,0,0,0,0,0,2,2,2,2,TRUE,1,2019,2019-2020
IA,2019-12-31,inter-ucx,0,0,0,0,0,0,0,0,0,0,0,0,0,0,TRUE,0,2019,2019-2020
IA,2019-12-31,inter-ui,33,95,10,6,5,1,4,2,1,1,213,371,246,341,TRUE,0.663072776280323,2019,2019-2020
IA,2019-12-31,intra-total,882,1883,245,79,28,16,25,15,6,21,6973,10173,7855,9738,TRUE,0.772141944362528,2019,2019-2020
IA,2019-12-31,intra-ucfe,3,5,2,0,0,0,0,0,0,0,4,14,7,12,TRUE,0.5,2019,2019-2020
IA,2019-12-31,intra-ucx,6,1,0,0,0,0,0,0,0,0,2,9,8,9,TRUE,0.888888888888889,2019,2019-2020
IA,2019-12-31,intra-ui,873,1877,243,79,28,16,25,15,6,21,6967,10150,7840,9717,TRUE,0.772413793103448,2019,2019-2020
IA,2020-01-31,inter-total,33,121,24,6,6,4,0,1,1,2,388,586,421,542,TRUE,0.718430034129693,2019,2019-2020
IA,2020-01-31,inter-ucfe,0,0,0,0,0,0,0,0,0,0,1,1,1,1,TRUE,1,2019,2019-2020
IA,2020-01-31,inter-ucx,0,0,0,0,0,0,0,0,0,0,0,0,0,0,TRUE,0,2019,2019-2020
IA,2020-01-31,inter-ui,33,121,24,6,6,4,0,1,1,2,387,585,420,541,TRUE,0.717948717948718,2019,2019-2020
IA,2020-01-31,intra-total,1485,2551,574,206,60,28,23,25,15,30,12826,17823,14311,16862,TRUE,0.802951242776188,2019,2019-2020
IA,2020-01-31,intra-ucfe,2,3,0,0,0,0,1,0,1,0,3,10,5,8,TRUE,0.5,2019,2019-2020
IA,2020-01-31,intra-ucx,6,1,0,0,1,0,0,0,0,0,0,8,6,7,TRUE,0.75,2019,2019-2020
IA,2020-01-31,intra-ui,1477,2547,574,206,59,28,22,25,14,30,12823,17805,14300,16847,TRUE,0.803145183937096,2019,2019-2020
IA,2020-02-29,inter-total,22,90,25,14,17,5,9,4,0,1,168,355,190,280,TRUE,0.535211267605634,2019,2019-2020
IA,2020-02-29,inter-ucfe,0,0,0,0,0,0,0,0,0,0,1,1,1,1,TRUE,1,2019,2019-2020
IA,2020-02-29,inter-ucx,0,0,0,0,0,0,0,0,0,0,0,0,0,0,TRUE,0,2019,2019-2020
IA,2020-02-29,inter-ui,22,90,25,14,17,5,9,4,0,1,167,354,189,279,TRUE,0.533898305084746,2019,2019-2020
IA,2020-02-29,intra-total,688,1303,289,114,61,48,32,23,16,27,4642,7243,5330,6633,TRUE,0.735882921441392,2019,2019-2020
IA,2020-02-29,intra-ucfe,2,4,0,1,1,0,0,0,0,0,5,13,7,11,TRUE,0.538461538461538,2019,2019-2020
IA,2020-02-29,intra-ucx,5,0,0,0,0,0,0,0,0,0,1,6,6,6,TRUE,1,2019,2019-2020
IA,2020-02-29,intra-ui,681,1299,289,113,60,48,32,23,16,27,4636,7224,5317,6616,TRUE,0.736018826135105,2019,2019-2020
IA,2020-03-31,inter-total,136,53,9,2,4,4,4,2,4,1,143,362,279,332,TRUE,0.770718232044199,2019,2019-2020
IA,2020-03-31,inter-ucfe,0,0,0,0,0,0,0,0,0,0,0,0,0,0,TRUE,0,2019,2019-2020
IA,2020-03-31,inter-ucx,0,0,0,0,0,0,0,0,0,0,0,0,0,0,TRUE,0,2019,2019-2020
IA,2020-03-31,inter-ui,136,53,9,2,4,4,4,2,4,1,143,362,279,332,TRUE,0.770718232044199,2019,2019-2020
IA,2020-03-31,intra-total,8897,888,106,44,19,22,17,24,2,30,5252,15301,14149,15037,TRUE,0.924710803215476,2019,2019-2020
IA,2020-03-31,intra-ucfe,2,2,1,0,0,0,0,0,0,0,2,7,4,6,TRUE,0.571428571428571,2019,2019-2020
IA,2020-03-31,intra-ucx,5,0,0,0,0,0,0,0,0,0,3,8,8,8,TRUE,1,2019,2019-2020
IA,2020-03-31,intra-ui,8890,886,105,44,19,22,17,24,2,30,5247,15286,14137,15023,TRUE,0.924833180688211,2019,2019-2020
IA,2020-04-30,inter-total,959,371,98,41,13,3,2,5,1,10,664,2167,1623,1994,TRUE,0.748961698200277,2019,2019-2020
IA,2020-04-30,inter-ucfe,0,0,0,1,0,0,0,0,0,0,0,1,0,0,TRUE,0,2019,2019-2020
IA,2020-04-30,inter-ucx,0,0,0,0,0,0,0,0,0,0,0,0,0,0,TRUE,0,2019,2019-2020
IA,2020-04-30,inter-ui,959,371,98,40,13,3,2,5,1,10,664,2166,1623,1994,TRUE,0.749307479224377,2019,2019-2020
IA,2020-04-30,intra-total,37393,21181,5395,1868,501,73,34,13,16,61,58058,124593,95451,116632,TRUE,0.766102429510486,2019,2019-2020
IA,2020-04-30,intra-ucfe,4,15,4,4,2,0,0,0,0,0,15,44,19,34,TRUE,0.431818181818182,2019,2019-2020
IA,2020-04-30,intra-ucx,4,5,0,2,0,0,0,0,0,0,13,24,17,22,TRUE,0.708333333333333,2019,2019-2020
IA,2020-04-30,intra-ui,37385,21161,5391,1862,499,73,34,13,16,61,58030,124525,95415,116576,TRUE,0.766231680385465,2019,2019-2020
IA,2020-05-31,inter-total,452,163,62,80,60,66,37,19,7,10,258,1214,710,873,TRUE,0.584843492586491,2019,2019-2020
IA,2020-05-31,inter-ucfe,0,0,0,0,0,0,1,0,0,0,0,1,0,0,TRUE,0,2019,2019-2020
IA,2020-05-31,inter-ucx,0,0,0,0,0,0,0,0,0,0,0,0,0,0,TRUE,0,2019,2019-2020
IA,2020-05-31,inter-ui,452,163,62,80,60,66,36,19,7,10,258,1213,710,873,TRUE,0.585325638911789,2019,2019-2020
IA,2020-05-31,intra-total,11079,5899,2972,3392,2772,2181,1348,667,312,242,18231,49095,29310,35209,TRUE,0.5970058050718,2019,2019-2020
IA,2020-05-31,intra-ucfe,5,4,4,4,2,2,5,3,0,0,7,36,12,16,TRUE,0.333333333333333,2019,2019-2020
IA,2020-05-31,intra-ucx,0,7,2,2,1,1,1,0,0,0,2,16,2,9,TRUE,0.125,2019,2019-2020
IA,2020-05-31,intra-ui,11074,5888,2966,3386,2769,2178,1342,664,312,242,18222,49043,29296,35184,TRUE,0.597353342984728,2019,2019-2020
IA,2020-06-30,inter-total,79,146,35,44,30,24,34,33,23,125,156,729,235,381,TRUE,0.322359396433471,2019,2019-2020
IA,2020-06-30,inter-ucfe,0,0,0,0,0,0,0,0,0,0,0,0,0,0,TRUE,0,2019,2019-2020
IA,2020-06-30,inter-ucx,0,0,0,0,0,0,0,0,0,0,0,0,0,0,TRUE,0,2019,2019-2020
IA,2020-06-30,inter-ui,79,146,35,44,30,24,34,33,23,125,156,729,235,381,TRUE,0.322359396433471,2019,2019-2020
IA,2020-06-30,intra-total,2508,2565,990,964,868,746,938,1040,1001,3584,7161,22365,9669,12234,TRUE,0.43232729711603,2019,2019-2020
IA,2020-06-30,intra-ucfe,2,3,1,2,1,2,1,2,2,10,0,26,2,5,TRUE,0.0769230769230769,2019,2019-2020
IA,2020-06-30,intra-ucx,0,2,2,2,0,0,0,0,0,1,2,9,2,4,TRUE,0.222222222222222,2019,2019-2020
IA,2020-06-30,intra-ui,2506,2560,987,960,867,744,937,1038,999,3573,7159,22330,9665,12225,TRUE,0.43282579489476,2019,2019-2020
IA,2020-07-31,inter-total,12,120,19,18,14,13,7,8,13,93,127,444,139,259,TRUE,0.313063063063063,2020,2020-2021
IA,2020-07-31,inter-ucfe,0,0,0,0,0,0,0,0,0,2,0,2,0,0,TRUE,0,2020,2020-2021
IA,2020-07-31,inter-ucx,0,0,0,0,0,0,0,0,0,0,0,0,0,0,TRUE,0,2020,2020-2021
IA,2020-07-31,inter-ui,12,120,19,18,14,13,7,8,13,91,127,442,139,259,TRUE,0.31447963800905,2020,2020-2021
IA,2020-07-31,intra-total,817,2357,712,467,337,244,242,240,250,1770,8194,15630,9011,11368,TRUE,0.576519513755598,2020,2020-2021
IA,2020-07-31,intra-ucfe,1,1,1,1,0,1,0,0,0,3,1,9,2,3,TRUE,0.222222222222222,2020,2020-2021
IA,2020-07-31,intra-ucx,0,4,0,1,2,2,0,0,0,1,3,13,3,7,TRUE,0.230769230769231,2020,2020-2021
IA,2020-07-31,intra-ui,816,2352,711,465,335,241,242,240,250,1766,8190,15608,9006,11358,TRUE,0.577011788826243,2020,2020-2021
IA,2020-08-31,inter-total,4,87,17,14,16,10,4,9,10,86,74,331,78,165,TRUE,0.235649546827795,2020,2020-2021
IA,2020-08-31,inter-ucfe,0,0,0,0,0,0,0,0,0,0,0,0,0,0,TRUE,0,2020,2020-2021
IA,2020-08-31,inter-ucx,0,0,0,0,0,0,0,0,0,0,0,0,0,0,TRUE,0,2020,2020-2021
IA,2020-08-31,inter-ui,4,87,17,14,16,10,4,9,10,86,74,331,78,165,TRUE,0.235649546827795,2020,2020-2021
IA,2020-08-31,intra-total,256,1592,528,487,354,235,210,246,214,1188,3014,8324,3270,4862,TRUE,0.392839980778472,2020,2020-2021
IA,2020-08-31,intra-ucfe,2,2,3,2,1,1,0,3,3,8,2,27,4,6,TRUE,0.148148148148148,2020,2020-2021
IA,2020-08-31,intra-ucx,8,4,1,2,1,1,0,0,0,1,5,23,13,17,TRUE,0.565217391304348,2020,2020-2021
IA,2020-08-31,intra-ui,246,1586,524,483,352,233,210,243,211,1179,3007,8274,3253,4839,TRUE,0.393159294174523,2020,2020-2021
IA,2020-09-30,inter-total,4,68,8,6,8,6,14,11,5,71,100,301,104,172,TRUE,0.345514950166113,2020,2020-2021
IA,2020-09-30,inter-ucfe,0,0,0,0,0,0,0,0,0,0,0,0,0,0,TRUE,0,2020,2020-2021
IA,2020-09-30,inter-ucx,0,0,0,0,0,0,0,0,0,0,0,0,0,0,TRUE,0,2020,2020-2021
IA,2020-09-30,inter-ui,4,68,8,6,8,6,14,11,5,71,100,301,104,172,TRUE,0.345514950166113,2020,2020-2021
IA,2020-09-30,intra-total,248,1353,354,310,227,261,209,172,154,996,2865,7149,3113,4466,TRUE,0.435445516855504,2020,2020-2021
IA,2020-09-30,intra-ucfe,1,1,1,0,2,1,2,2,0,2,2,14,3,4,TRUE,0.214285714285714,2020,2020-2021
IA,2020-09-30,intra-ucx,1,2,0,0,0,0,0,0,0,1,4,8,5,7,TRUE,0.625,2020,2020-2021
IA,2020-09-30,intra-ui,246,1350,353,310,225,260,207,170,154,993,2859,7127,3105,4455,TRUE,0.435667181142136,2020,2020-2021
IA,2020-10-31,inter-total,7,43,7,11,5,1,4,3,4,57,75,217,82,125,TRUE,0.377880184331797,2020,2020-2021
IA,2020-10-31,inter-ucfe,0,1,0,0,0,0,0,0,0,0,0,1,0,1,TRUE,0,2020,2020-2021
IA,2020-10-31,inter-ucx,0,0,0,0,0,0,0,0,0,0,0,0,0,0,TRUE,0,2020,2020-2021
IA,2020-10-31,inter-ui,7,42,7,11,5,1,4,3,4,57,75,216,82,124,TRUE,0.37962962962963,2020,2020-2021
IA,2020-10-31,intra-total,173,695,233,138,150,138,107,113,128,1234,1786,4895,1959,2654,TRUE,0.400204290091931,2020,2020-2021
IA,2020-10-31,intra-ucfe,0,2,0,0,0,2,0,0,0,3,1,8,1,3,TRUE,0.125,2020,2020-2021
IA,2020-10-31,intra-ucx,5,0,5,0,0,0,0,0,0,0,2,12,7,7,TRUE,0.583333333333333,2020,2020-2021
IA,2020-10-31,intra-ui,168,693,228,138,150,136,107,113,128,1231,1783,4875,1951,2644,TRUE,0.400205128205128,2020,2020-2021
IA,2020-11-30,inter-total,6,76,17,8,12,7,6,7,5,48,86,278,92,168,TRUE,0.330935251798561,2020,2020-2021
IA,2020-11-30,inter-ucfe,0,0,0,0,0,0,0,0,0,0,0,0,0,0,TRUE,0,2020,2020-2021
IA,2020-11-30,inter-ucx,0,0,0,0,0,0,0,0,0,0,0,0,0,0,TRUE,0,2020,2020-2021
IA,2020-11-30,inter-ui,6,76,17,8,12,7,6,7,5,48,86,278,92,168,TRUE,0.330935251798561,2020,2020-2021
IA,2020-11-30,intra-total,176,839,247,194,179,136,140,134,117,1144,2455,5761,2631,3470,TRUE,0.456691546606492,2020,2020-2021
IA,2020-11-30,intra-ucfe,0,3,2,3,1,3,0,1,1,8,3,25,3,6,TRUE,0.12,2020,2020-2021
IA,2020-11-30,intra-ucx,0,0,1,0,0,0,0,0,0,0,0,1,0,0,TRUE,0,2020,2020-2021
IA,2020-11-30,intra-ui,176,836,244,191,178,133,140,133,116,1136,2452,5735,2628,3464,TRUE,0.458238884045336,2020,2020-2021
IA,2020-12-31,inter-total,7,140,34,22,10,6,9,8,6,45,151,438,158,298,TRUE,0.360730593607306,2020,2020-2021
IA,2020-12-31,inter-ucfe,0,0,0,0,0,0,0,0,0,0,0,0,0,0,TRUE,0,2020,2020-2021
IA,2020-12-31,inter-ucx,0,0,0,0,0,0,0,0,0,0,0,0,0,0,TRUE,0,2020,2020-2021
IA,2020-12-31,inter-ui,7,140,34,22,10,6,9,8,6,45,151,438,158,298,TRUE,0.360730593607306,2020,2020-2021
IA,2020-12-31,intra-total,486,2378,683,479,252,143,214,209,142,796,5503,11285,5989,8367,TRUE,0.53070447496677,2020,2020-2021
IA,2020-12-31,intra-ucfe,2,3,5,0,2,3,0,0,0,2,5,22,7,10,TRUE,0.318181818181818,2020,2020-2021
IA,2020-12-31,intra-ucx,3,5,0,1,0,0,1,1,0,0,3,14,6,11,TRUE,0.428571428571429,2020,2020-2021
IA,2020-12-31,intra-ui,481,2370,678,478,250,140,213,208,142,794,5495,11249,5976,8346,TRUE,0.531247221975287,2020,2020-2021
IA,2021-01-31,inter-total,7,120,36,20,14,8,9,7,5,46,120,392,127,247,TRUE,0.323979591836735,2020,2020-2021
IA,2021-01-31,inter-ucfe,0,0,0,0,0,0,0,0,1,0,0,1,0,0,TRUE,0,2020,2020-2021
IA,2021-01-31,inter-ucx,0,0,0,0,0,0,0,0,0,0,0,0,0,0,TRUE,0,2020,2020-2021
IA,2021-01-31,inter-ui,7,120,36,20,14,8,9,7,4,46,120,391,127,247,TRUE,0.324808184143223,2020,2020-2021
IA,2021-01-31,intra-total,394,3132,976,559,305,230,243,253,183,738,6934,13947,7328,10460,TRUE,0.525417652541765,2020,2020-2021
IA,2021-01-31,intra-ucfe,3,3,1,3,1,1,0,1,3,3,4,23,7,10,TRUE,0.304347826086957,2020,2020-2021
IA,2021-01-31,intra-ucx,0,3,3,0,1,0,0,0,0,0,3,10,3,6,TRUE,0.3,2020,2020-2021
IA,2021-01-31,intra-ui,391,3126,972,556,303,229,243,252,180,735,6927,13914,7318,10444,TRUE,0.525945091274975,2020,2020-2021
IA,2021-02-28,inter-total,4,123,38,19,21,11,10,8,7,37,105,383,109,232,TRUE,0.284595300261097,2020,2020-2021
IA,2021-02-28,inter-ucfe,0,0,0,0,0,0,0,0,0,0,0,0,0,0,TRUE,0,2020,2020-2021
IA,2021-02-28,inter-ucx,0,0,0,0,0,0,0,0,0,0,0,0,0,0,TRUE,0,2020,2020-2021
IA,2021-02-28,inter-ui,4,123,38,19,21,11,10,8,7,37,105,383,109,232,TRUE,0.284595300261097,2020,2020-2021
IA,2021-02-28,intra-total,320,1770,749,572,498,390,240,187,124,665,4072,9587,4392,6162,TRUE,0.458120371336185,2020,2020-2021
IA,2021-02-28,intra-ucfe,3,2,3,3,3,2,1,2,3,7,2,31,5,7,TRUE,0.161290322580645,2020,2020-2021
IA,2021-02-28,intra-ucx,2,0,0,0,0,0,0,0,0,0,0,2,2,2,TRUE,1,2020,2020-2021
IA,2021-02-28,intra-ui,315,1768,746,569,495,388,239,185,121,658,4070,9554,4385,6153,TRUE,0.458970064894285,2020,2020-2021
IA,2021-03-31,inter-total,4,122,28,12,19,16,13,10,10,30,68,332,72,194,TRUE,0.216867469879518,2020,2020-2021
IA,2021-03-31,inter-ucfe,0,0,0,0,0,0,0,0,0,0,0,0,0,0,TRUE,0,2020,2020-2021
IA,2021-03-31,inter-ucx,0,0,0,0,0,0,0,0,0,0,0,0,0,0,TRUE,0,2020,2020-2021
IA,2021-03-31,inter-ui,4,122,28,12,19,16,13,10,10,30,68,332,72,194,TRUE,0.216867469879518,2020,2020-2021
IA,2021-03-31,intra-total,201,1525,495,361,328,223,209,169,114,746,3449,7820,3650,5175,TRUE,0.466751918158568,2020,2020-2021
IA,2021-03-31,intra-ucfe,1,3,1,1,1,1,1,2,0,2,2,15,3,6,TRUE,0.2,2020,2020-2021
IA,2021-03-31,intra-ucx,2,0,0,0,0,0,0,0,0,1,2,5,4,4,TRUE,0.8,2020,2020-2021
IA,2021-03-31,intra-ui,198,1522,494,360,327,222,208,167,114,743,3445,7800,3643,5165,TRUE,0.467051282051282,2020,2020-2021
IA,2021-04-30,inter-total,4,105,31,20,11,5,8,3,1,26,79,293,83,188,TRUE,0.283276450511945,2020,2020-2021
IA,2021-04-30,inter-ucfe,0,0,0,0,0,0,0,0,0,0,0,0,0,0,TRUE,0,2020,2020-2021
IA,2021-04-30,inter-ucx,0,0,0,0,0,0,0,0,0,1,0,1,0,0,TRUE,0,2020,2020-2021
IA,2021-04-30,inter-ui,4,105,31,20,11,5,8,3,1,25,79,292,83,188,TRUE,0.284246575342466,2020,2020-2021
IA,2021-04-30,intra-total,265,1833,621,429,218,99,68,41,30,376,3423,7403,3688,5521,TRUE,0.498176414966905,2020,2020-2021
IA,2021-04-30,intra-ucfe,1,1,2,1,1,0,1,0,0,0,1,8,2,3,TRUE,0.25,2020,2020-2021
IA,2021-04-30,intra-ucx,3,1,0,0,0,0,0,0,0,0,3,7,6,7,TRUE,0.857142857142857,2020,2020-2021
IA,2021-04-30,intra-ui,261,1831,619,428,217,99,67,41,30,376,3419,7388,3680,5511,TRUE,0.498105035192204,2020,2020-2021
IA,2021-05-31,inter-total,6,103,34,17,16,10,7,5,6,21,140,365,146,249,TRUE,0.4,2020,2020-2021
IA,2021-05-31,inter-ucfe,0,0,0,0,0,0,0,0,0,1,0,1,0,0,TRUE,0,2020,2020-2021
IA,2021-05-31,inter-ucx,0,0,0,0,0,0,0,0,0,0,0,0,0,0,TRUE,0,2020,2020-2021
IA,2021-05-31,inter-ui,6,103,34,17,16,10,7,5,6,20,140,364,146,249,TRUE,0.401098901098901,2020,2020-2021
IA,2021-05-31,intra-total,147,848,418,334,377,257,208,142,104,283,1599,4717,1746,2594,TRUE,0.370150519397922,2020,2020-2021
IA,2021-05-31,intra-ucfe,1,1,4,0,0,2,0,0,2,2,3,15,4,5,TRUE,0.266666666666667,2020,2020-2021
IA,2021-05-31,intra-ucx,0,0,0,0,0,0,1,0,0,0,2,3,2,2,TRUE,0.666666666666667,2020,2020-2021
IA,2021-05-31,intra-ui,146,847,414,334,377,255,207,142,102,281,1594,4699,1740,2587,TRUE,0.370291551393914,2020,2020-2021
IA,2021-06-30,inter-total,3,69,18,23,5,9,7,6,7,36,105,288,108,177,TRUE,0.375,2020,2020-2021
IA,2021-06-30,inter-ucfe,0,0,0,0,0,0,0,1,0,0,0,1,0,0,TRUE,0,2020,2020-2021
IA,2021-06-30,inter-ucx,0,0,0,0,0,0,0,0,0,0,0,0,0,0,TRUE,0,2020,2020-2021
IA,2021-06-30,inter-ui,3,69,18,23,5,9,7,5,7,36,105,287,108,177,TRUE,0.376306620209059,2020,2020-2021
IA,2021-06-30,intra-total,178,790,335,179,178,156,128,142,158,595,1781,4620,1959,2749,TRUE,0.424025974025974,2020,2020-2021
IA,2021-06-30,intra-ucfe,0,2,0,0,0,1,0,0,0,3,1,7,1,3,TRUE,0.142857142857143,2020,2020-2021
IA,2021-06-30,intra-ucx,3,2,0,0,0,0,0,0,0,0,4,9,7,9,TRUE,0.777777777777778,2020,2020-2021
IA,2021-06-30,intra-ui,175,786,335,179,178,155,128,142,158,592,1776,4604,1951,2737,TRUE,0.423761946133797,2020,2020-2021
IA,2021-07-31,inter-total,5,33,9,5,4,5,3,3,4,45,38,154,43,76,TRUE,0.279220779220779,2021,2021-2022
IA,2021-07-31,inter-ucfe,0,0,0,0,0,0,0,0,0,0,0,0,0,0,TRUE,0,2021,2021-2022
IA,2021-07-31,inter-ucx,0,0,0,0,0,0,0,0,0,0,0,0,0,0,TRUE,0,2021,2021-2022
IA,2021-07-31,inter-ui,5,33,9,5,4,5,3,3,4,45,38,154,43,76,TRUE,0.279220779220779,2021,2021-2022
IA,2021-07-31,intra-total,104,460,175,147,105,75,69,78,178,799,1170,3360,1274,1734,TRUE,0.379166666666667,2021,2021-2022
IA,2021-07-31,intra-ucfe,0,0,0,0,0,0,0,0,0,4,0,4,0,0,TRUE,0,2021,2021-2022
IA,2021-07-31,intra-ucx,1,0,1,0,0,0,0,0,0,0,2,4,3,3,TRUE,0.75,2021,2021-2022
IA,2021-07-31,intra-ui,103,460,174,147,105,75,69,78,178,795,1168,3352,1271,1731,TRUE,0.37917661097852,2021,2021-2022
IA,2021-08-31,inter-total,2,50,9,8,6,6,4,9,9,34,35,172,37,87,TRUE,0.215116279069767,2021,2021-2022
IA,2021-08-31,inter-ucfe,0,0,0,0,0,0,0,0,0,0,0,0,0,0,TRUE,0,2021,2021-2022
IA,2021-08-31,inter-ucx,0,0,0,0,0,0,0,0,0,0,0,0,0,0,TRUE,0,2021,2021-2022
IA,2021-08-31,inter-ui,2,50,9,8,6,6,4,9,9,34,35,172,37,87,TRUE,0.215116279069767,2021,2021-2022
IA,2021-08-31,intra-total,78,534,153,125,117,109,154,176,154,607,1162,3369,1240,1774,TRUE,0.368061739388543,2021,2021-2022
IA,2021-08-31,intra-ucfe,0,0,0,0,0,0,0,1,1,5,0,7,0,0,TRUE,0,2021,2021-2022
IA,2021-08-31,intra-ucx,0,1,0,0,2,0,1,0,1,0,1,6,1,2,TRUE,0.166666666666667,2021,2021-2022
IA,2021-08-31,intra-ui,78,533,153,125,115,109,153,175,152,602,1161,3356,1239,1772,TRUE,0.369189511323004,2021,2021-2022
IA,2021-09-30,inter-total,3,27,13,10,14,9,0,6,2,19,27,130,30,57,TRUE,0.230769230769231,2021,2021-2022
IA,2021-09-30,inter-ucfe,0,0,0,0,0,0,0,0,0,0,1,1,1,1,TRUE,1,2021,2021-2022
IA,2021-09-30,inter-ucx,0,0,0,0,0,0,0,0,0,0,0,0,0,0,TRUE,0,2021,2021-2022
IA,2021-09-30,inter-ui,3,27,13,10,14,9,0,6,2,19,26,129,29,56,TRUE,0.224806201550388,2021,2021-2022
IA,2021-09-30,intra-total,83,396,179,189,183,126,75,53,44,433,1006,2767,1089,1485,TRUE,0.393567040115649,2021,2021-2022
IA,2021-09-30,intra-ucfe,0,0,1,0,0,0,0,1,1,2,1,6,1,1,TRUE,0.166666666666667,2021,2021-2022
IA,2021-09-30,intra-ucx,1,5,2,0,0,0,0,0,0,0,7,15,8,13,TRUE,0.533333333333333,2021,2021-2022
IA,2021-09-30,intra-ui,82,391,176,189,183,126,75,52,43,431,998,2746,1080,1471,TRUE,0.393299344501092,2021,2021-2022
IA,2021-10-31,inter-total,1,28,9,3,3,5,4,1,0,22,42,118,43,71,TRUE,0.364406779661017,2021,2021-2022
IA,2021-10-31,inter-ucfe,0,0,0,0,0,0,0,0,0,1,0,1,0,0,TRUE,0,2021,2021-2022
IA,2021-10-31,inter-ucx,0,0,0,0,0,0,0,0,0,0,0,0,0,0,TRUE,0,2021,2021-2022
IA,2021-10-31,inter-ui,1,28,9,3,3,5,4,1,0,21,42,117,43,71,TRUE,0.367521367521368,2021,2021-2022
IA,2021-10-31,intra-total,89,441,183,155,106,47,25,29,8,234,951,2268,1040,1481,TRUE,0.458553791887125,2021,2021-2022
IA,2021-10-31,intra-ucfe,0,2,1,3,0,0,0,0,0,3,4,13,4,6,TRUE,0.307692307692308,2021,2021-2022
IA,2021-10-31,intra-ucx,4,3,0,1,1,0,0,0,0,0,3,12,7,10,TRUE,0.583333333333333,2021,2021-2022
IA,2021-10-31,intra-ui,85,436,182,151,105,47,25,29,8,231,944,2243,1029,1465,TRUE,0.458760588497548,2021,2021-2022
IA,2021-11-30,inter-total,4,37,13,12,14,1,0,2,0,10,59,152,63,100,TRUE,0.414473684210526,2021,2021-2022
IA,2021-11-30,inter-ucfe,0,1,0,0,0,0,0,0,0,0,0,1,0,1,TRUE,0,2021,2021-2022
IA,2021-11-30,inter-ucx,0,0,0,0,0,0,0,0,0,0,0,0,0,0,TRUE,0,2021,2021-2022
IA,2021-11-30,inter-ui,4,36,13,12,14,1,0,2,0,10,59,151,63,99,TRUE,0.417218543046358,2021,2021-2022
IA,2021-11-30,intra-total,96,489,209,130,100,42,23,22,8,175,1095,2389,1191,1680,TRUE,0.498534951862704,2021,2021-2022
IA,2021-11-30,intra-ucfe,0,0,3,2,0,0,0,0,0,1,0,6,0,0,TRUE,0,2021,2021-2022
IA,2021-11-30,intra-ucx,2,1,0,0,0,0,0,0,0,0,1,4,3,4,TRUE,0.75,2021,2021-2022
IA,2021-11-30,intra-ui,94,488,206,128,100,42,23,22,8,174,1094,2379,1188,1676,TRUE,0.49936948297604,2021,2021-2022
IA,2021-12-31,inter-total,5,73,24,15,15,7,6,3,3,15,111,277,116,189,TRUE,0.418772563176895,2021,2021-2022
IA,2021-12-31,inter-ucfe,0,0,0,0,0,0,0,0,0,0,2,2,2,2,TRUE,1,2021,2021-2022
IA,2021-12-31,inter-ucx,0,0,0,0,0,0,0,0,0,0,0,0,0,0,TRUE,0,2021,2021-2022
IA,2021-12-31,inter-ui,5,73,24,15,15,7,6,3,3,15,109,275,114,187,TRUE,0.414545454545455,2021,2021-2022
IA,2021-12-31,intra-total,376,1362,452,233,108,73,46,19,15,260,4017,6961,4393,5755,TRUE,0.631087487429967,2021,2021-2022
IA,2021-12-31,intra-ucfe,1,2,0,1,0,1,0,1,0,1,3,10,4,6,TRUE,0.4,2021,2021-2022
IA,2021-12-31,intra-ucx,0,2,1,0,0,0,0,0,0,0,1,4,1,3,TRUE,0.25,2021,2021-2022
IA,2021-12-31,intra-ui,375,1358,451,232,108,72,46,18,15,259,4013,6947,4388,5746,TRUE,0.631639556643155,2021,2021-2022
IA,2022-01-31,inter-total,6,106,32,8,7,4,0,2,2,11,154,332,160,266,TRUE,0.481927710843373,2021,2021-2022
IA,2022-01-31,inter-ucfe,0,0,0,0,0,0,0,0,0,0,0,0,0,0,TRUE,0,2021,2021-2022
IA,2022-01-31,inter-ucx,0,0,0,0,0,0,0,0,0,0,0,0,0,0,TRUE,0,2021,2021-2022
IA,2022-01-31,inter-ui,6,106,32,8,7,4,0,2,2,11,154,332,160,266,TRUE,0.481927710843373,2021,2021-2022
IA,2022-01-31,intra-total,559,2451,773,401,153,81,39,24,13,341,7244,12079,7803,10254,TRUE,0.64599718519745,2021,2021-2022
IA,2022-01-31,intra-ucfe,0,6,2,1,0,0,0,0,0,1,2,12,2,8,TRUE,0.166666666666667,2021,2021-2022
IA,2022-01-31,intra-ucx,0,2,2,0,0,1,0,0,0,1,2,8,2,4,TRUE,0.25,2021,2021-2022
IA,2022-01-31,intra-ui,559,2443,769,400,153,80,39,24,13,339,7240,12059,7799,10242,TRUE,0.646736877021312,2021,2021-2022
IA,2022-02-28,inter-total,16,67,35,15,9,7,5,2,1,16,74,247,90,157,TRUE,0.364372469635628,2021,2021-2022
IA,2022-02-28,inter-ucfe,0,0,0,0,0,0,0,0,0,0,0,0,0,0,TRUE,0,2021,2021-2022
IA,2022-02-28,inter-ucx,0,0,0,0,0,0,0,0,0,0,0,0,0,0,TRUE,0,2021,2021-2022
IA,2022-02-28,inter-ui,16,67,35,15,9,7,5,2,1,16,74,247,90,157,TRUE,0.364372469635628,2021,2021-2022
IA,2022-02-28,intra-total,470,1414,547,319,226,123,69,44,13,243,3354,6822,3824,5238,TRUE,0.560539431251832,2021,2021-2022
IA,2022-02-28,intra-ucfe,2,0,1,0,1,1,0,0,0,0,1,6,3,3,TRUE,0.5,2021,2021-2022
IA,2022-02-28,intra-ucx,3,1,3,0,1,0,0,0,0,0,2,10,5,6,TRUE,0.5,2021,2021-2022
IA,2022-02-28,intra-ui,465,1413,543,319,224,122,69,44,13,243,3351,6806,3816,5229,TRUE,0.560681751395827,2021,2021-2022
IA,2022-03-31,inter-total,8,33,12,2,3,3,1,1,3,8,52,126,60,93,TRUE,0.476190476190476,2021,2021-2022
IA,2022-03-31,inter-ucfe,1,0,0,0,0,0,0,0,0,0,0,1,1,1,TRUE,1,2021,2021-2022
IA,2022-03-31,inter-ucx,0,0,0,0,0,0,0,0,0,0,0,0,0,0,TRUE,0,2021,2021-2022
IA,2022-03-31,inter-ui,7,33,12,2,3,3,1,1,3,8,52,125,59,92,TRUE,0.472,2021,2021-2022
IA,2022-03-31,intra-total,368,538,160,96,72,56,31,31,35,196,1886,3469,2254,2792,TRUE,0.649754972614586,2021,2021-2022
IA,2022-03-31,intra-ucfe,2,4,0,1,0,0,0,0,0,0,2,9,4,8,TRUE,0.444444444444444,2021,2021-2022
IA,2022-03-31,intra-ucx,1,1,0,0,0,0,0,0,0,0,1,3,2,3,TRUE,0.666666666666667,2021,2021-2022
IA,2022-03-31,intra-ui,365,533,160,95,72,56,31,31,35,196,1883,3457,2248,2781,TRUE,0.650274804743998,2021,2021-2022
IA,2022-04-30,inter-total,6,22,7,3,0,0,1,1,1,9,48,98,54,76,TRUE,0.551020408163265,2021,2021-2022
IA,2022-04-30,inter-ucfe,0,0,0,0,0,0,0,0,0,0,0,0,0,0,TRUE,0,2021,2021-2022
IA,2022-04-30,inter-ucx,0,0,0,0,0,0,0,0,0,0,0,0,0,0,TRUE,0,2021,2021-2022
IA,2022-04-30,inter-ui,6,22,7,3,0,0,1,1,1,9,48,98,54,76,TRUE,0.551020408163265,2021,2021-2022
IA,2022-04-30,intra-total,198,479,119,39,21,13,15,8,15,134,1177,2218,1375,1854,TRUE,0.619927862939585,2021,2021-2022
IA,2022-04-30,intra-ucfe,3,1,0,0,0,0,0,0,0,0,1,5,4,5,TRUE,0.8,2021,2021-2022
IA,2022-04-30,intra-ucx,0,0,0,0,0,0,0,0,0,0,2,2,2,2,TRUE,1,2021,2021-2022
IA,2022-04-30,intra-ui,195,478,119,39,21,13,15,8,15,134,1174,2211,1369,1847,TRUE,0.61917684305744,2021,2021-2022
IA,2022-05-31,inter-total,3,29,5,1,4,1,1,0,0,2,35,81,38,67,TRUE,0.469135802469136,2021,2021-2022
IA,2022-05-31,inter-ucfe,0,0,0,0,0,0,0,0,0,0,0,0,0,0,TRUE,0,2021,2021-2022
IA,2022-05-31,inter-ucx,0,0,0,0,0,0,0,0,0,0,0,0,0,0,TRUE,0,2021,2021-2022
IA,2022-05-31,inter-ui,3,29,5,1,4,1,1,0,0,2,35,81,38,67,TRUE,0.469135802469136,2021,2021-2022
IA,2022-05-31,intra-total,202,426,104,39,26,16,8,5,13,81,1072,1992,1274,1700,TRUE,0.639558232931727,2021,2021-2022
IA,2022-05-31,intra-ucfe,1,2,0,0,0,0,0,0,0,0,0,3,1,3,TRUE,0.333333333333333,2021,2021-2022
IA,2022-05-31,intra-ucx,0,1,0,0,0,0,0,0,0,0,0,1,0,1,TRUE,0,2021,2021-2022
IA,2022-05-31,intra-ui,201,423,104,39,26,16,8,5,13,81,1072,1988,1273,1696,TRUE,0.640342052313883,2021,2021-2022
IA,2022-06-30,inter-total,5,23,5,1,2,0,2,1,0,6,49,94,54,77,TRUE,0.574468085106383,2021,2021-2022
IA,2022-06-30,inter-ucfe,0,0,0,0,0,0,0,0,0,0,0,0,0,0,TRUE,0,2021,2021-2022
IA,2022-06-30,inter-ucx,0,0,0,0,0,0,0,0,0,0,0,0,0,0,TRUE,0,2021,2021-2022
IA,2022-06-30,inter-ui,5,23,5,1,2,0,2,1,0,6,49,94,54,77,TRUE,0.574468085106383,2021,2021-2022
IA,2022-06-30,intra-total,310,580,125,48,22,4,7,9,3,70,1713,2891,2023,2603,TRUE,0.699757869249395,2021,2021-2022
IA,2022-06-30,intra-ucfe,1,1,0,0,1,0,0,0,0,0,2,5,3,4,TRUE,0.6,2021,2021-2022
IA,2022-06-30,intra-ucx,0,1,0,0,0,0,0,0,0,0,0,1,0,1,TRUE,0,2021,2021-2022
IA,2022-06-30,intra-ui,309,578,125,48,21,4,7,9,3,70,1711,2885,2020,2598,TRUE,0.700173310225303,2021,2021-2022
IA,2022-07-31,inter-total,11,22,6,3,1,2,0,1,0,2,45,93,56,78,TRUE,0.602150537634409,2022,2022-2023
IA,2022-07-31,inter-ucfe,0,0,0,0,0,0,0,0,0,0,0,0,0,0,TRUE,0,2022,2022-2023
IA,2022-07-31,inter-ucx,0,0,0,0,0,0,0,0,0,0,0,0,0,0,TRUE,0,2022,2022-2023
IA,2022-07-31,inter-ui,11,22,6,3,1,2,0,1,0,2,45,93,56,78,TRUE,0.602150537634409,2022,2022-2023
IA,2022-07-31,intra-total,256,571,128,63,33,22,4,6,3,48,1262,2396,1518,2089,TRUE,0.63355592654424,2022,2022-2023
IA,2022-07-31,intra-ucfe,0,2,1,0,1,0,0,0,1,0,2,7,2,4,TRUE,0.285714285714286,2022,2022-2023
IA,2022-07-31,intra-ucx,0,1,0,0,0,0,0,0,0,0,0,1,0,1,TRUE,0,2022,2022-2023
IA,2022-07-31,intra-ui,256,568,127,63,32,22,4,6,2,48,1260,2388,1516,2084,TRUE,0.634840871021776,2022,2022-2023
IA,2022-08-31,inter-total,9,41,7,4,1,0,0,0,0,4,60,126,69,110,TRUE,0.547619047619048,2022,2022-2023
IA,2022-08-31,inter-ucfe,0,0,0,0,0,0,0,0,0,0,0,0,0,0,TRUE,0,2022,2022-2023
IA,2022-08-31,inter-ucx,0,1,0,0,0,0,0,0,0,0,0,1,0,1,TRUE,0,2022,2022-2023
IA,2022-08-31,inter-ui,9,40,7,4,1,0,0,0,0,4,60,125,69,109,TRUE,0.552,2022,2022-2023
IA,2022-08-31,intra-total,259,570,131,84,38,17,8,5,4,57,1440,2613,1699,2269,TRUE,0.650210486031382,2022,2022-2023
IA,2022-08-31,intra-ucfe,2,1,1,1,1,1,0,0,0,0,3,10,5,6,TRUE,0.5,2022,2022-2023
IA,2022-08-31,intra-ucx,0,0,0,0,0,0,0,0,0,0,0,0,0,0,TRUE,0,2022,2022-2023
IA,2022-08-31,intra-ui,257,569,130,83,37,16,8,5,4,57,1437,2603,1694,2263,TRUE,0.650787552823665,2022,2022-2023
IA,2022-09-30,inter-total,7,23,9,3,1,0,0,0,0,2,39,84,46,69,TRUE,0.547619047619048,2022,2022-2023
IA,2022-09-30,inter-ucfe,0,1,0,0,0,0,0,0,0,0,0,1,0,1,TRUE,0,2022,2022-2023
IA,2022-09-30,inter-ucx,0,0,0,0,0,0,0,0,0,0,0,0,0,0,TRUE,0,2022,2022-2023
IA,2022-09-30,inter-ui,7,22,9,3,1,0,0,0,0,2,39,83,46,68,TRUE,0.55421686746988,2022,2022-2023
IA,2022-09-30,intra-total,217,455,111,60,40,14,16,10,4,66,892,1885,1109,1564,TRUE,0.588328912466844,2022,2022-2023
IA,2022-09-30,intra-ucfe,0,2,0,0,1,0,0,0,0,0,0,3,0,2,TRUE,0,2022,2022-2023
IA,2022-09-30,intra-ucx,0,0,0,0,1,0,0,0,0,0,0,1,0,0,TRUE,0,2022,2022-2023
IA,2022-09-30,intra-ui,217,453,111,60,38,14,16,10,4,66,892,1881,1109,1562,TRUE,0.589580010632642,2022,2022-2023
IA,2022-10-31,inter-total,8,31,4,1,0,0,0,0,0,8,40,92,48,79,TRUE,0.521739130434783,2022,2022-2023
IA,2022-10-31,inter-ucfe,0,0,0,0,0,0,0,0,0,0,0,0,0,0,TRUE,0,2022,2022-2023
IA,2022-10-31,inter-ucx,0,0,0,0,0,0,0,0,0,0,0,0,0,0,TRUE,0,2022,2022-2023
IA,2022-10-31,inter-ui,8,31,4,1,0,0,0,0,0,8,40,92,48,79,TRUE,0.521739130434783,2022,2022-2023
IA,2022-10-31,intra-total,252,481,107,50,21,17,6,10,14,110,958,2026,1210,1691,TRUE,0.597235932872656,2022,2022-2023
IA,2022-10-31,intra-ucfe,1,1,0,0,0,0,0,0,0,0,1,3,2,3,TRUE,0.666666666666667,2022,2022-2023
IA,2022-10-31,intra-ucx,0,1,0,0,1,0,0,0,0,0,0,2,0,1,TRUE,0,2022,2022-2023
IA,2022-10-31,intra-ui,251,479,107,50,20,17,6,10,14,110,957,2021,1208,1687,TRUE,0.597723899059871,2022,2022-2023
IA,2022-11-30,inter-total,8,45,7,7,2,2,0,0,2,2,48,123,56,101,TRUE,0.455284552845528,2022,2022-2023
IA,2022-11-30,inter-ucfe,0,2,0,0,0,0,0,0,0,0,0,2,0,2,TRUE,0,2022,2022-2023
IA,2022-11-30,inter-ucx,0,0,0,0,0,0,0,0,0,0,0,0,0,0,TRUE,0,2022,2022-2023
IA,2022-11-30,inter-ui,8,43,7,7,2,2,0,0,2,2,48,121,56,99,TRUE,0.462809917355372,2022,2022-2023
IA,2022-11-30,intra-total,234,511,135,69,25,18,9,15,9,37,1170,2232,1404,1915,TRUE,0.629032258064516,2022,2022-2023
IA,2022-11-30,intra-ucfe,0,1,0,0,0,0,0,0,0,0,0,1,0,1,TRUE,0,2022,2022-2023
IA,2022-11-30,intra-ucx,1,1,0,0,0,0,0,0,0,0,0,2,1,2,TRUE,0.5,2022,2022-2023
IA,2022-11-30,intra-ui,233,509,135,69,25,18,9,15,9,37,1170,2229,1403,1912,TRUE,0.629430237774787,2022,2022-2023
IA,2022-12-31,inter-total,25,77,24,11,0,4,2,0,0,4,129,276,154,231,TRUE,0.557971014492754,2022,2022-2023
IA,2022-12-31,inter-ucfe,0,0,1,0,0,0,0,0,0,0,3,4,3,3,TRUE,0.75,2022,2022-2023
IA,2022-12-31,inter-ucx,0,1,0,0,0,0,0,0,0,0,0,1,0,1,TRUE,0,2022,2022-2023
IA,2022-12-31,inter-ui,25,76,23,11,0,4,2,0,0,4,126,271,151,227,TRUE,0.55719557195572,2022,2022-2023
IA,2022-12-31,intra-total,667,1354,404,123,63,25,26,20,15,83,4256,7036,4923,6277,TRUE,0.69968732234224,2022,2022-2023
IA,2022-12-31,intra-ucfe,2,3,0,0,0,0,1,0,0,0,2,8,4,7,TRUE,0.5,2022,2022-2023
IA,2022-12-31,intra-ucx,0,0,1,0,0,0,0,0,0,0,2,3,2,2,TRUE,0.666666666666667,2022,2022-2023
IA,2022-12-31,intra-ui,665,1351,403,123,63,25,25,20,15,83,4252,7025,4917,6268,TRUE,0.699928825622776,2022,2022-2023
IA,2023-01-31,inter-total,19,118,41,17,11,3,2,2,1,6,104,324,123,241,TRUE,0.37962962962963,2022,2022-2023
IA,2023-01-31,inter-ucfe,0,0,0,0,0,0,0,0,0,0,0,0,0,0,TRUE,0,2022,2022-2023
IA,2023-01-31,inter-ucx,0,0,0,0,0,0,0,0,0,0,0,0,0,0,TRUE,0,2022,2022-2023
IA,2023-01-31,inter-ui,19,118,41,17,11,3,2,2,1,6,104,324,123,241,TRUE,0.37962962962963,2022,2022-2023
IA,2023-01-31,intra-total,709,2734,869,356,208,82,36,25,13,88,7166,12286,7875,10609,TRUE,0.640973465733355,2022,2022-2023
IA,2023-01-31,intra-ucfe,0,2,2,0,0,0,0,0,0,0,5,9,5,7,TRUE,0.555555555555556,2022,2022-2023
IA,2023-01-31,intra-ucx,0,0,2,1,0,0,0,0,0,0,1,4,1,1,TRUE,0.25,2022,2022-2023
IA,2023-01-31,intra-ui,709,2732,865,355,208,82,36,25,13,88,7160,12273,7869,10601,TRUE,0.64116352969934,2022,2022-2023
IA,2023-02-28,inter-total,16,78,18,14,10,8,5,1,0,2,89,241,105,183,TRUE,0.435684647302905,2022,2022-2023
IA,2023-02-28,inter-ucfe,0,1,0,1,0,0,0,0,0,0,0,2,0,1,TRUE,0,2022,2022-2023
IA,2023-02-28,inter-ucx,0,0,0,0,0,0,0,0,0,0,1,1,1,1,TRUE,1,2022,2022-2023
IA,2023-02-28,inter-ui,16,77,18,13,10,8,5,1,0,2,88,238,104,181,TRUE,0.436974789915966,2022,2022-2023
IA,2023-02-28,intra-total,554,1368,402,337,227,151,79,41,29,86,3559,6833,4113,5481,TRUE,0.601931801551295,2022,2022-2023
IA,2023-02-28,intra-ucfe,0,1,0,0,1,0,0,0,0,0,0,2,0,1,TRUE,0,2022,2022-2023
IA,2023-02-28,intra-ucx,0,2,1,0,0,0,0,0,0,0,0,3,0,2,TRUE,0,2022,2022-2023
IA,2023-02-28,intra-ui,554,1365,401,337,226,151,79,41,29,86,3559,6828,4113,5478,TRUE,0.602372583479789,2022,2022-2023
IA,2023-03-31,inter-total,12,60,9,4,2,6,2,1,0,6,67,169,79,139,TRUE,0.467455621301775,2022,2022-2023
IA,2023-03-31,inter-ucfe,0,1,0,0,0,0,0,0,0,0,0,1,0,1,TRUE,0,2022,2022-2023
IA,2023-03-31,inter-ucx,0,0,0,0,0,0,0,0,0,0,0,0,0,0,TRUE,0,2022,2022-2023
IA,2023-03-31,inter-ui,12,59,9,4,2,6,2,1,0,6,67,168,79,138,TRUE,0.470238095238095,2022,2022-2023
IA,2023-03-31,intra-total,478,571,230,78,39,44,45,31,26,69,1988,3599,2466,3037,TRUE,0.685190330647402,2022,2022-2023
IA,2023-03-31,intra-ucfe,1,0,1,1,0,0,0,0,0,0,0,3,1,1,TRUE,0.333333333333333,2022,2022-2023
IA,2023-03-31,intra-ucx,0,1,0,1,0,0,0,0,0,0,0,2,0,1,TRUE,0,2022,2022-2023
IA,2023-03-31,intra-ui,477,570,229,76,39,44,45,31,26,69,1988,3594,2465,3035,TRUE,0.685865331107401,2022,2022-2023
IA,2023-04-30,inter-total,10,37,4,3,2,1,0,1,0,4,36,98,46,83,TRUE,0.469387755102041,2022,2022-2023
IA,2023-04-30,inter-ucfe,0,0,0,0,0,0,0,0,0,0,0,0,0,0,TRUE,0,2022,2022-2023
IA,2023-04-30,inter-ucx,0,0,0,0,0,0,0,0,0,0,0,0,0,0,TRUE,0,2022,2022-2023
IA,2023-04-30,inter-ui,10,37,4,3,2,1,0,1,0,4,36,98,46,83,TRUE,0.469387755102041,2022,2022-2023
IA,2023-04-30,intra-total,291,502,143,73,26,23,23,8,16,38,1031,2174,1322,1824,TRUE,0.608095676172953,2022,2022-2023
IA,2023-04-30,intra-ucfe,0,4,0,0,0,0,0,0,0,0,1,5,1,5,TRUE,0.2,2022,2022-2023
IA,2023-04-30,intra-ucx,0,0,1,0,0,0,0,0,0,0,1,2,1,1,TRUE,0.5,2022,2022-2023
IA,2023-04-30,intra-ui,291,498,142,73,26,23,23,8,16,38,1029,2167,1320,1818,TRUE,0.609137055837564,2022,2022-2023
IA,2023-05-31,inter-total,12,29,7,5,3,1,1,1,1,2,28,90,40,69,TRUE,0.444444444444444,2022,2022-2023
IA,2023-05-31,inter-ucfe,0,1,0,0,0,0,0,0,0,0,0,1,0,1,TRUE,0,2022,2022-2023
IA,2023-05-31,inter-ucx,0,0,0,0,0,0,0,0,0,0,0,0,0,0,TRUE,0,2022,2022-2023
IA,2023-05-31,inter-ui,12,28,7,5,3,1,1,1,1,2,28,89,40,68,TRUE,0.449438202247191,2022,2022-2023
IA,2023-05-31,intra-total,313,550,151,66,38,23,17,14,4,46,1355,2577,1668,2218,TRUE,0.647264260768335,2022,2022-2023
IA,2023-05-31,intra-ucfe,1,2,0,2,1,0,0,0,0,0,1,7,2,4,TRUE,0.285714285714286,2022,2022-2023
IA,2023-05-31,intra-ucx,0,1,1,0,0,0,0,0,0,0,0,2,0,1,TRUE,0,2022,2022-2023
IA,2023-05-31,intra-ui,312,547,150,64,37,23,17,14,4,46,1354,2568,1666,2213,TRUE,0.648753894080997,2022,2022-2023
IA,2023-06-30,inter-total,17,48,8,5,5,2,0,0,1,1,70,157,87,135,TRUE,0.554140127388535,2022,2022-2023
IA,2023-06-30,inter-ucfe,0,0,0,0,0,0,0,0,0,0,0,0,0,0,TRUE,0,2022,2022-2023
IA,2023-06-30,inter-ucx,0,0,0,0,0,0,0,0,0,0,0,0,0,0,TRUE,0,2022,2022-2023
IA,2023-06-30,inter-ui,17,48,8,5,5,2,0,0,1,1,70,157,87,135,TRUE,0.554140127388535,2022,2022-2023
IA,2023-06-30,intra-total,508,749,211,99,44,25,16,8,10,43,1976,3689,2484,3233,TRUE,0.673353212252643,2022,2022-2023
IA,2023-06-30,intra-ucfe,2,2,0,0,0,0,0,0,0,0,4,8,6,8,TRUE,0.75,2022,2022-2023
IA,2023-06-30,intra-ucx,0,0,0,0,0,0,0,0,0,0,0,0,0,0,TRUE,0,2022,2022-2023
IA,2023-06-30,intra-ui,506,747,211,99,44,25,16,8,10,43,1972,3681,2478,3225,TRUE,0.67318663406683,2022,2022-2023
IA,2023-07-31,inter-total,7,42,5,2,7,4,3,0,0,1,28,99,35,77,TRUE,0.353535353535354,2023,2023-2024
IA,2023-07-31,inter-ucfe,0,0,0,0,0,0,0,0,0,0,0,0,0,0,TRUE,0,2023,2023-2024
IA,2023-07-31,inter-ucx,0,0,0,0,0,0,0,0,0,0,0,0,0,0,TRUE,0,2023,2023-2024
IA,2023-07-31,inter-ui,7,42,5,2,7,4,3,0,0,1,28,99,35,77,TRUE,0.353535353535354,2023,2023-2024
IA,2023-07-31,intra-total,370,843,178,96,61,43,27,15,9,74,1931,3647,2301,3144,TRUE,0.63092953112147,2023,2023-2024
IA,2023-07-31,intra-ucfe,0,1,0,0,0,1,0,0,0,0,2,4,2,3,TRUE,0.5,2023,2023-2024
IA,2023-07-31,intra-ucx,0,1,0,0,0,0,0,0,0,0,4,5,4,5,TRUE,0.8,2023,2023-2024
IA,2023-07-31,intra-ui,370,841,178,96,61,42,27,15,9,74,1925,3638,2295,3136,TRUE,0.630841121495327,2023,2023-2024
IA,2023-08-31,inter-total,11,40,13,5,0,1,1,1,0,3,103,178,114,154,TRUE,0.640449438202247,2023,2023-2024
IA,2023-08-31,inter-ucfe,0,0,0,0,0,0,0,0,0,0,0,0,0,0,TRUE,0,2023,2023-2024
IA,2023-08-31,inter-ucx,0,0,0,0,0,0,0,0,0,0,0,0,0,0,TRUE,0,2023,2023-2024
IA,2023-08-31,inter-ui,11,40,13,5,0,1,1,1,0,3,103,178,114,154,TRUE,0.640449438202247,2023,2023-2024
IA,2023-08-31,intra-total,419,618,217,118,53,67,31,14,10,44,1800,3391,2219,2837,TRUE,0.654379239162489,2023,2023-2024
IA,2023-08-31,intra-ucfe,0,1,0,0,0,0,0,0,0,0,0,1,0,1,TRUE,0,2023,2023-2024
IA,2023-08-31,intra-ucx,2,1,0,0,0,0,0,0,0,0,1,4,3,4,TRUE,0.75,2023,2023-2024
IA,2023-08-31,intra-ui,417,616,217,118,53,67,31,14,10,44,1799,3386,2216,2832,TRUE,0.654459539279386,2023,2023-2024
IA,2023-09-30,inter-total,8,18,6,5,1,2,0,0,0,1,20,61,28,46,TRUE,0.459016393442623,2023,2023-2024
IA,2023-09-30,inter-ucfe,0,0,0,0,0,0,0,0,0,0,0,0,0,0,TRUE,0,2023,2023-2024
IA,2023-09-30,inter-ucx,0,0,0,0,0,0,0,0,0,0,0,0,0,0,TRUE,0,2023,2023-2024
IA,2023-09-30,inter-ui,8,18,6,5,1,2,0,0,0,1,20,61,28,46,TRUE,0.459016393442623,2023,2023-2024
IA,2023-09-30,intra-total,300,511,152,92,59,28,24,12,9,41,1088,2316,1388,1899,TRUE,0.599309153713299,2023,2023-2024
IA,2023-09-30,intra-ucfe,0,0,0,1,0,0,0,0,0,0,1,2,1,1,TRUE,0.5,2023,2023-2024
IA,2023-09-30,intra-ucx,1,1,0,0,0,0,0,0,0,0,3,5,4,5,TRUE,0.8,2023,2023-2024
IA,2023-09-30,intra-ui,299,510,152,91,59,28,24,12,9,41,1084,2309,1383,1893,TRUE,0.598960588999567,2023,2023-2024
IA,2023-10-31,inter-total,10,21,7,1,4,2,1,0,1,0,38,85,48,69,TRUE,0.564705882352941,2023,2023-2024
IA,2023-10-31,inter-ucfe,0,0,0,0,0,0,0,0,0,0,0,0,0,0,TRUE,0,2023,2023-2024
IA,2023-10-31,inter-ucx,0,0,0,0,0,0,0,0,0,0,0,0,0,0,TRUE,0,2023,2023-2024
IA,2023-10-31,inter-ui,10,21,7,1,4,2,1,0,1,0,38,85,48,69,TRUE,0.564705882352941,2023,2023-2024
IA,2023-10-31,intra-total,317,560,153,63,26,33,15,9,8,40,1395,2619,1712,2272,TRUE,0.653684612447499,2023,2023-2024
IA,2023-10-31,intra-ucfe,0,0,0,0,0,0,0,0,1,1,0,2,0,0,TRUE,0,2023,2023-2024
IA,2023-10-31,intra-ucx,1,0,0,0,0,0,0,0,0,0,1,2,2,2,TRUE,1,2023,2023-2024
IA,2023-10-31,intra-ui,316,560,153,63,26,33,15,9,7,39,1394,2615,1710,2270,TRUE,0.653919694072658,2023,2023-2024
IA,2023-11-30,inter-total,9,41,11,4,1,2,2,1,0,3,69,143,78,119,TRUE,0.545454545454545,2023,2023-2024
IA,2023-11-30,inter-ucfe,0,0,0,0,0,0,0,0,0,0,0,0,0,0,TRUE,0,2023,2023-2024
IA,2023-11-30,inter-ucx,0,0,0,0,0,0,0,0,0,0,0,0,0,0,TRUE,0,2023,2023-2024
IA,2023-11-30,inter-ui,9,41,11,4,1,2,2,1,0,3,69,143,78,119,TRUE,0.545454545454545,2023,2023-2024
IA,2023-11-30,intra-total,364,572,185,83,32,22,15,5,3,27,1782,3090,2146,2718,TRUE,0.694498381877023,2023,2023-2024
IA,2023-11-30,intra-ucfe,2,1,2,0,0,0,0,0,0,0,1,6,3,4,TRUE,0.5,2023,2023-2024
IA,2023-11-30,intra-ucx,1,0,1,0,0,0,0,0,0,0,0,2,1,1,TRUE,0.5,2023,2023-2024
IA,2023-11-30,intra-ui,361,571,182,83,32,22,15,5,3,27,1781,3082,2142,2713,TRUE,0.695003244646334,2023,2023-2024
IA,2023-12-31,inter-total,13,51,15,4,1,1,0,1,1,0,70,157,83,134,TRUE,0.528662420382166,2023,2023-2024
IA,2023-12-31,inter-ucfe,0,0,0,0,0,0,0,0,0,0,0,0,0,0,TRUE,0,2023,2023-2024
IA,2023-12-31,inter-ucx,0,0,0,0,0,0,0,0,0,0,0,0,0,0,TRUE,0,2023,2023-2024
IA,2023-12-31,inter-ui,13,51,15,4,1,1,0,1,1,0,70,157,83,134,TRUE,0.528662420382166,2023,2023-2024
IA,2023-12-31,intra-total,479,1101,425,130,64,41,31,12,11,34,2506,4834,2985,4086,TRUE,0.617501034340091,2023,2023-2024
IA,2023-12-31,intra-ucfe,3,0,0,0,0,0,0,0,0,0,1,4,4,4,TRUE,1,2023,2023-2024
IA,2023-12-31,intra-ucx,1,0,0,0,0,0,0,0,0,0,1,2,2,2,TRUE,1,2023,2023-2024
IA,2023-12-31,intra-ui,475,1101,425,130,64,41,31,12,11,34,2504,4828,2979,4080,TRUE,0.617025683512842,2023,2023-2024
IA,2024-01-31,inter-total,17,132,49,31,12,8,3,2,1,3,77,335,94,226,TRUE,0.280597014925373,2023,2023-2024
IA,2024-01-31,inter-ucfe,0,0,0,0,0,0,0,0,0,0,0,0,0,0,TRUE,0,2023,2023-2024
IA,2024-01-31,inter-ucx,0,0,0,0,0,0,0,0,0,0,0,0,0,0,TRUE,0,2023,2023-2024
IA,2024-01-31,inter-ui,17,132,49,31,12,8,3,2,1,3,77,335,94,226,TRUE,0.280597014925373,2023,2023-2024
IA,2024-01-31,intra-total,858,2802,1560,920,383,154,62,29,16,92,6737,13613,7595,10397,TRUE,0.557922574010137,2023,2023-2024
IA,2024-01-31,intra-ucfe,1,2,4,0,0,0,1,0,0,0,2,10,3,5,TRUE,0.3,2023,2023-2024
IA,2024-01-31,intra-ucx,1,2,0,0,0,0,0,0,0,0,1,4,2,4,TRUE,0.5,2023,2023-2024
IA,2024-01-31,intra-ui,856,2798,1556,920,383,154,61,29,16,92,6734,13599,7590,10388,TRUE,0.558129274211339,2023,2023-2024
IA,2024-02-29,inter-total,16,61,34,21,11,7,3,2,1,5,69,230,85,146,TRUE,0.369565217391304,2023,2023-2024
IA,2024-02-29,inter-ucfe,0,0,0,0,0,0,0,0,0,0,0,0,0,0,TRUE,0,2023,2023-2024
IA,2024-02-29,inter-ucx,0,0,0,0,0,0,0,0,0,0,0,0,0,0,TRUE,0,2023,2023-2024
IA,2024-02-29,inter-ui,16,61,34,21,11,7,3,2,1,5,69,230,85,146,TRUE,0.369565217391304,2023,2023-2024
IA,2024-02-29,intra-total,555,1619,825,501,374,184,90,65,47,119,3113,7492,3668,5287,TRUE,0.489588894821143,2023,2023-2024
IA,2024-02-29,intra-ucfe,0,3,1,0,1,0,0,0,0,0,0,5,0,3,TRUE,0,2023,2023-2024
IA,2024-02-29,intra-ucx,0,1,0,0,0,0,0,0,0,1,1,3,1,2,TRUE,0.333333333333333,2023,2023-2024
IA,2024-02-29,intra-ui,555,1615,824,501,373,184,90,65,47,118,3112,7484,3667,5282,TRUE,0.489978621058258,2023,2023-2024
IA,2024-03-31,inter-total,8,15,7,10,8,1,2,1,0,5,40,97,48,63,TRUE,0.494845360824742,2023,2023-2024
IA,2024-03-31,inter-ucfe,0,0,0,0,0,0,0,0,0,0,0,0,0,0,TRUE,0,2023,2023-2024
IA,2024-03-31,inter-ucx,0,0,0,0,0,0,0,0,0,0,0,0,0,0,TRUE,0,2023,2023-2024
IA,2024-03-31,inter-ui,8,15,7,10,8,1,2,1,0,5,40,97,48,63,TRUE,0.494845360824742,2023,2023-2024
IA,2024-03-31,intra-total,356,535,158,108,79,73,58,41,31,98,1556,3093,1912,2447,TRUE,0.618170061429033,2023,2023-2024
IA,2024-03-31,intra-ucfe,0,1,0,1,0,1,0,0,0,0,1,4,1,2,TRUE,0.25,2023,2023-2024
IA,2024-03-31,intra-ucx,1,1,1,0,0,0,0,0,0,0,0,3,1,2,TRUE,0.333333333333333,2023,2023-2024
IA,2024-03-31,intra-ui,355,533,157,107,79,72,58,41,31,98,1555,3086,1910,2443,TRUE,0.618924173687622,2023,2023-2024
IA,2024-04-30,inter-total,2,15,7,5,1,1,0,1,0,3,47,82,49,64,TRUE,0.597560975609756,2023,2023-2024
IA,2024-04-30,inter-ucfe,0,0,0,0,0,0,0,0,0,0,0,0,0,0,TRUE,0,2023,2023-2024
IA,2024-04-30,inter-ucx,0,0,0,0,0,0,0,0,0,0,0,0,0,0,TRUE,0,2023,2023-2024
IA,2024-04-30,inter-ui,2,15,7,5,1,1,0,1,0,3,47,82,49,64,TRUE,0.597560975609756,2023,2023-2024
IA,2024-04-30,intra-total,330,511,147,61,36,45,60,33,17,163,1670,3073,2000,2511,TRUE,0.650829808005207,2023,2023-2024
IA,2024-04-30,intra-ucfe,0,1,0,1,0,0,0,0,0,0,1,3,1,2,TRUE,0.333333333333333,2023,2023-2024
IA,2024-04-30,intra-ucx,0,1,1,0,0,0,0,0,0,0,1,3,1,2,TRUE,0.333333333333333,2023,2023-2024
IA,2024-04-30,intra-ui,330,509,146,60,36,45,60,33,17,163,1668,3067,1998,2507,TRUE,0.651450929246821,2023,2023-2024
IA,2024-05-31,inter-total,7,16,8,0,0,2,0,0,1,5,54,93,61,77,TRUE,0.655913978494624,2023,2023-2024
IA,2024-05-31,inter-ucfe,0,0,0,0,0,0,0,0,0,0,0,0,0,0,TRUE,0,2023,2023-2024
IA,2024-05-31,inter-ucx,0,0,0,0,0,0,0,0,0,0,0,0,0,0,TRUE,0,2023,2023-2024
IA,2024-05-31,inter-ui,7,16,8,0,0,2,0,0,1,5,54,93,61,77,TRUE,0.655913978494624,2023,2023-2024
IA,2024-05-31,intra-total,434,473,160,58,53,20,15,8,9,83,2432,3745,2866,3339,TRUE,0.765287049399199,2023,2023-2024
IA,2024-05-31,intra-ucfe,0,2,2,0,0,0,0,0,0,0,1,5,1,3,TRUE,0.2,2023,2023-2024
IA,2024-05-31,intra-ucx,1,0,0,0,0,0,0,0,0,0,0,1,1,1,TRUE,1,2023,2023-2024
IA,2024-05-31,intra-ui,433,471,158,58,53,20,15,8,9,83,2431,3739,2864,3335,TRUE,0.765980208611928,2023,2023-2024
IA,2024-06-30,inter-total,7,19,4,1,3,1,0,1,0,3,48,87,55,74,TRUE,0.632183908045977,2023,2023-2024
IA,2024-06-30,inter-ucfe,0,0,0,0,0,0,0,0,0,0,0,0,0,0,TRUE,0,2023,2023-2024
IA,2024-06-30,inter-ucx,0,0,0,0,0,0,0,0,0,0,0,0,0,0,TRUE,0,2023,2023-2024
IA,2024-06-30,inter-ui,7,19,4,1,3,1,0,1,0,3,48,87,55,74,TRUE,0.632183908045977,2023,2023-2024
IA,2024-06-30,intra-total,449,567,124,50,24,21,21,13,4,65,2347,3685,2796,3363,TRUE,0.758751696065129,2023,2023-2024
IA,2024-06-30,intra-ucfe,0,0,2,0,1,0,0,0,0,1,0,4,0,0,TRUE,0,2023,2023-2024
IA,2024-06-30,intra-ucx,2,0,0,0,0,0,0,0,0,0,1,3,3,3,TRUE,1,2023,2023-2024
IA,2024-06-30,intra-ui,447,567,122,50,23,21,21,13,4,64,2346,3678,2793,3360,TRUE,0.759380097879282,2023,2023-2024
IA,2024-07-31,inter-total,4,38,3,1,0,1,3,0,1,2,67,120,71,109,TRUE,0.591666666666667,2024,2024-2025
IA,2024-07-31,inter-ucfe,0,0,0,0,0,0,0,0,0,0,0,0,0,0,TRUE,0,2024,2024-2025
IA,2024-07-31,inter-ucx,0,0,0,0,0,0,0,0,0,0,0,0,0,0,TRUE,0,2024,2024-2025
IA,2024-07-31,inter-ui,4,38,3,1,0,1,3,0,1,2,67,120,71,109,TRUE,0.591666666666667,2024,2024-2025
IA,2024-07-31,intra-total,562,898,167,61,29,19,16,9,4,88,3299,5152,3861,4759,TRUE,0.749417701863354,2024,2024-2025
IA,2024-07-31,intra-ucfe,1,0,3,1,0,0,1,0,0,0,1,7,2,2,TRUE,0.285714285714286,2024,2024-2025
IA,2024-07-31,intra-ucx,0,1,0,0,0,0,0,0,0,0,1,2,1,2,TRUE,0.5,2024,2024-2025
IA,2024-07-31,intra-ui,561,897,164,60,29,19,15,9,4,88,3297,5143,3858,4755,TRUE,0.75014582928252,2024,2024-2025
IA,2024-08-31,inter-total,10,23,4,5,0,3,1,0,0,1,108,155,118,141,TRUE,0.761290322580645,2024,2024-2025
IA,2024-08-31,inter-ucfe,0,0,0,0,0,0,0,0,0,0,0,0,0,0,TRUE,0,2024,2024-2025
IA,2024-08-31,inter-ucx,0,0,0,0,0,0,0,0,0,0,0,0,0,0,TRUE,0,2024,2024-2025
IA,2024-08-31,inter-ui,10,23,4,5,0,3,1,0,0,1,108,155,118,141,TRUE,0.761290322580645,2024,2024-2025
IA,2024-08-31,intra-total,489,617,166,55,32,19,10,10,3,47,2819,4267,3308,3925,TRUE,0.7752519334427,2024,2024-2025
IA,2024-08-31,intra-ucfe,0,2,1,1,0,0,0,0,0,0,1,5,1,3,TRUE,0.2,2024,2024-2025
IA,2024-08-31,intra-ucx,0,0,0,0,0,0,0,0,0,0,1,1,1,1,TRUE,1,2024,2024-2025
IA,2024-08-31,intra-ui,489,615,165,54,32,19,10,10,3,47,2817,4261,3306,3921,TRUE,0.77587420793241,2024,2024-2025
IA,2024-09-30,inter-total,3,17,5,2,2,2,2,2,0,2,43,80,46,63,TRUE,0.575,2024,2024-2025
IA,2024-09-30,inter-ucfe,0,0,0,0,0,0,0,0,0,0,0,0,0,0,TRUE,0,2024,2024-2025
IA,2024-09-30,inter-ucx,0,0,0,0,0,0,0,0,0,0,0,0,0,0,TRUE,0,2024,2024-2025
IA,2024-09-30,inter-ui,3,17,5,2,2,2,2,2,0,2,43,80,46,63,TRUE,0.575,2024,2024-2025
IA,2024-09-30,intra-total,410,640,144,37,29,31,14,5,4,33,1825,3172,2235,2875,TRUE,0.704602774274906,2024,2024-2025
IA,2024-09-30,intra-ucfe,2,0,0,0,0,0,2,0,0,0,0,4,2,2,TRUE,0.5,2024,2024-2025
IA,2024-09-30,intra-ucx,0,0,0,0,1,0,0,0,0,0,1,2,1,1,TRUE,0.5,2024,2024-2025
IA,2024-09-30,intra-ui,408,640,144,37,28,31,12,5,4,33,1824,3166,2232,2872,TRUE,0.70499052432091,2024,2024-2025
IA,2024-10-31,inter-total,7,28,3,1,0,0,0,0,0,0,41,80,48,76,TRUE,0.6,2024,2024-2025
IA,2024-10-31,inter-ucfe,0,0,0,0,0,0,0,0,0,0,0,0,0,0,TRUE,0,2024,2024-2025
IA,2024-10-31,inter-ucx,0,0,0,0,0,0,0,0,0,0,0,0,0,0,TRUE,0,2024,2024-2025
IA,2024-10-31,inter-ui,7,28,3,1,0,0,0,0,0,0,41,80,48,76,TRUE,0.6,2024,2024-2025
IA,2024-10-31,intra-total,519,589,108,36,23,26,12,3,3,48,2608,3975,3127,3716,TRUE,0.786666666666667,2024,2024-2025
IA,2024-10-31,intra-ucfe,0,1,0,0,0,0,0,1,0,1,1,4,1,2,TRUE,0.25,2024,2024-2025
IA,2024-10-31,intra-ucx,0,0,0,0,0,0,0,0,0,0,1,1,1,1,TRUE,1,2024,2024-2025
IA,2024-10-31,intra-ui,519,588,108,36,23,26,12,2,3,47,2606,3970,3125,3713,TRUE,0.787153652392947,2024,2024-2025
IA,2024-11-30,inter-total,6,31,5,2,1,0,0,0,0,1,82,128,88,119,TRUE,0.6875,2024,2024-2025
IA,2024-11-30,inter-ucfe,0,0,0,0,0,0,0,0,0,0,0,0,0,0,TRUE,0,2024,2024-2025
IA,2024-11-30,inter-ucx,0,0,0,0,0,0,0,0,0,0,0,0,0,0,TRUE,0,2024,2024-2025
IA,2024-11-30,inter-ui,6,31,5,2,1,0,0,0,0,1,82,128,88,119,TRUE,0.6875,2024,2024-2025
IA,2024-11-30,intra-total,418,659,131,46,23,17,8,9,3,31,2127,3472,2545,3204,TRUE,0.733006912442396,2024,2024-2025
IA,2024-11-30,intra-ucfe,2,1,0,0,0,0,0,0,0,0,0,3,2,3,TRUE,0.666666666666667,2024,2024-2025
IA,2024-11-30,intra-ucx,0,0,0,0,0,0,0,0,0,0,0,0,0,0,TRUE,0,2024,2024-2025
IA,2024-11-30,intra-ui,416,658,131,46,23,17,8,9,3,31,2127,3469,2543,3201,TRUE,0.733064283655232,2024,2024-2025
IA,2024-12-31,inter-total,10,59,12,5,2,0,1,0,0,4,133,226,143,202,TRUE,0.632743362831858,2024,2024-2025
IA,2024-12-31,inter-ucfe,0,0,1,0,0,0,0,0,0,0,0,1,0,0,TRUE,0,2024,2024-2025
IA,2024-12-31,inter-ucx,0,0,0,0,0,0,0,0,0,0,0,0,0,0,TRUE,0,2024,2024-2025
IA,2024-12-31,inter-ui,10,59,11,5,2,0,1,0,0,4,133,225,143,202,TRUE,0.635555555555556,2024,2024-2025
IA,2024-12-31,intra-total,723,1149,197,79,22,15,15,10,6,57,5485,7758,6208,7357,TRUE,0.80020623872132,2024,2024-2025
IA,2024-12-31,intra-ucfe,3,1,1,0,0,0,0,0,0,0,0,5,3,4,TRUE,0.6,2024,2024-2025
IA,2024-12-31,intra-ucx,1,2,2,0,0,0,0,0,0,0,0,5,1,3,TRUE,0.2,2024,2024-2025
IA,2024-12-31,intra-ui,719,1146,194,79,22,15,15,10,6,57,5485,7748,6204,7350,TRUE,0.80072276716572,2024,2024-2025
ID,2019-01-31,inter-total,80,11,7,2,4,0,0,0,0,0,12,116,92,103,FALSE,0.887931034482759,2018,2018-2019
ID,2019-01-31,inter-ucfe,13,1,4,2,0,0,0,0,0,0,2,22,15,16,FALSE,0.727272727272727,2018,2018-2019
ID,2019-01-31,inter-ucx,0,0,0,0,0,0,0,0,0,0,0,0,0,0,FALSE,0,2018,2018-2019
ID,2019-01-31,inter-ui,67,10,3,0,4,0,0,0,0,0,10,94,77,87,FALSE,0.925531914893617,2018,2018-2019
ID,2019-01-31,intra-total,4090,249,102,41,20,15,10,3,0,3,597,5130,4687,4936,FALSE,0.962183235867446,2018,2018-2019
ID,2019-01-31,intra-ucfe,254,26,27,13,5,0,0,1,0,0,52,378,306,332,FALSE,0.878306878306878,2018,2018-2019
ID,2019-01-31,intra-ucx,1,0,1,0,0,0,0,0,0,0,0,2,1,1,FALSE,0.5,2018,2018-2019
ID,2019-01-31,intra-ui,3835,223,74,28,15,15,10,2,0,3,545,4750,4380,4603,FALSE,0.969052631578947,2018,2018-2019
ID,2019-02-28,inter-total,53,8,5,2,1,1,2,0,1,1,15,89,68,76,FALSE,0.853932584269663,2018,2018-2019
ID,2019-02-28,inter-ucfe,10,1,3,1,0,0,1,0,1,0,3,20,13,14,FALSE,0.7,2018,2018-2019
ID,2019-02-28,inter-ucx,0,0,0,0,0,0,0,0,0,0,0,0,0,0,FALSE,0,2018,2018-2019
ID,2019-02-28,inter-ui,43,7,2,1,1,1,1,0,0,1,12,69,55,62,FALSE,0.898550724637681,2018,2018-2019
ID,2019-02-28,intra-total,2086,214,86,34,25,17,3,4,6,3,372,2850,2458,2672,FALSE,0.937543859649123,2018,2018-2019
ID,2019-02-28,intra-ucfe,36,17,8,6,3,2,0,0,1,0,14,87,50,67,FALSE,0.770114942528736,2018,2018-2019
ID,2019-02-28,intra-ucx,4,0,0,1,0,0,0,0,0,0,0,5,4,4,FALSE,0.8,2018,2018-2019
ID,2019-02-28,intra-ui,2046,197,78,27,22,15,3,4,5,3,358,2758,2404,2601,FALSE,0.943074691805656,2018,2018-2019
ID,2019-03-31,inter-total,42,3,3,2,0,2,0,1,0,2,3,58,45,48,FALSE,0.827586206896552,2018,2018-2019
ID,2019-03-31,inter-ucfe,5,1,2,0,0,0,0,1,0,2,0,11,5,6,FALSE,0.545454545454545,2018,2018-2019
ID,2019-03-31,inter-ucx,0,0,0,0,0,0,0,0,0,0,0,0,0,0,FALSE,0,2018,2018-2019
ID,2019-03-31,inter-ui,37,2,1,2,0,2,0,0,0,0,3,47,40,42,FALSE,0.893617021276596,2018,2018-2019
ID,2019-03-31,intra-total,1759,125,38,13,15,8,12,5,4,5,371,2355,2130,2255,FALSE,0.957537154989384,2018,2018-2019
ID,2019-03-31,intra-ucfe,20,5,3,2,5,0,5,0,2,1,4,47,24,29,FALSE,0.617021276595745,2018,2018-2019
ID,2019-03-31,intra-ucx,1,0,0,0,0,0,0,0,0,0,4,5,5,5,FALSE,1,2018,2018-2019
ID,2019-03-31,intra-ui,1738,120,35,11,10,8,7,5,2,4,363,2303,2101,2221,FALSE,0.964394268345636,2018,2018-2019
ID,2019-04-30,inter-total,23,4,0,0,0,1,0,0,0,2,5,35,28,32,FALSE,0.914285714285714,2018,2018-2019
ID,2019-04-30,inter-ucfe,2,1,0,0,0,0,0,0,0,1,1,5,3,4,FALSE,0.8,2018,2018-2019
ID,2019-04-30,inter-ucx,0,0,0,0,0,0,0,0,0,0,0,0,0,0,FALSE,0,2018,2018-2019
ID,2019-04-30,inter-ui,21,3,0,0,0,1,0,0,0,1,4,30,25,28,FALSE,0.933333333333333,2018,2018-2019
ID,2019-04-30,intra-total,1251,38,12,11,12,8,7,7,1,8,238,1593,1489,1527,FALSE,0.958568738229755,2018,2018-2019
ID,2019-04-30,intra-ucfe,9,2,1,2,0,0,0,1,0,4,1,20,10,12,FALSE,0.6,2018,2018-2019
ID,2019-04-30,intra-ucx,4,0,0,0,0,0,0,0,0,0,1,5,5,5,FALSE,1,2018,2018-2019
ID,2019-04-30,intra-ui,1238,36,11,9,12,8,7,6,1,4,236,1568,1474,1510,FALSE,0.963010204081633,2018,2018-2019
ID,2019-05-31,inter-total,11,3,1,1,0,0,0,0,0,0,1,17,12,15,FALSE,0.882352941176471,2018,2018-2019
ID,2019-05-31,inter-ucfe,0,0,0,0,0,0,0,0,0,0,0,0,0,0,FALSE,0,2018,2018-2019
ID,2019-05-31,inter-ucx,0,0,0,0,0,0,0,0,0,0,0,0,0,0,FALSE,0,2018,2018-2019
ID,2019-05-31,inter-ui,11,3,1,1,0,0,0,0,0,0,1,17,12,15,FALSE,0.882352941176471,2018,2018-2019
ID,2019-05-31,intra-total,858,16,4,3,6,4,2,1,0,5,159,1058,1017,1033,FALSE,0.976370510396975,2018,2018-2019
ID,2019-05-31,intra-ucfe,0,1,0,0,0,0,0,0,0,0,1,2,1,2,FALSE,1,2018,2018-2019
ID,2019-05-31,intra-ucx,2,0,0,0,0,0,0,0,0,0,0,2,2,2,FALSE,1,2018,2018-2019
ID,2019-05-31,intra-ui,856,15,4,3,6,4,2,1,0,5,158,1054,1014,1029,FALSE,0.976280834914611,2018,2018-2019
ID,2019-06-30,inter-total,21,1,0,0,0,0,0,0,0,1,5,28,26,27,FALSE,0.964285714285714,2018,2018-2019
ID,2019-06-30,inter-ucfe,0,0,0,0,0,0,0,0,0,0,0,0,0,0,FALSE,0,2018,2018-2019
ID,2019-06-30,inter-ucx,0,0,0,0,0,0,0,0,0,0,0,0,0,0,FALSE,0,2018,2018-2019
ID,2019-06-30,inter-ui,21,1,0,0,0,0,0,0,0,1,5,28,26,27,FALSE,0.964285714285714,2018,2018-2019
ID,2019-06-30,intra-total,1266,22,9,6,8,0,3,0,0,2,160,1476,1426,1448,FALSE,0.981029810298103,2018,2018-2019
ID,2019-06-30,intra-ucfe,1,0,0,0,0,0,0,0,0,1,2,4,3,3,FALSE,0.75,2018,2018-2019
ID,2019-06-30,intra-ucx,2,0,0,0,0,0,0,0,0,0,1,3,3,3,FALSE,1,2018,2018-2019
ID,2019-06-30,intra-ui,1263,22,9,6,8,0,3,0,0,1,157,1469,1420,1442,FALSE,0.981620149761743,2018,2018-2019
ID,2019-07-31,inter-total,25,0,0,0,0,0,0,0,0,0,4,29,29,29,FALSE,1,2019,2019-2020
ID,2019-07-31,inter-ucfe,0,0,0,0,0,0,0,0,0,0,0,0,0,0,FALSE,0,2019,2019-2020
ID,2019-07-31,inter-ucx,0,0,0,0,0,0,0,0,0,0,0,0,0,0,FALSE,0,2019,2019-2020
ID,2019-07-31,inter-ui,25,0,0,0,0,0,0,0,0,0,4,29,29,29,FALSE,1,2019,2019-2020
ID,2019-07-31,intra-total,1150,20,3,0,0,0,0,0,0,0,130,1303,1280,1300,FALSE,0.997697620874904,2019,2019-2020
ID,2019-07-31,intra-ucfe,1,0,0,0,0,0,0,0,0,0,2,3,3,3,FALSE,1,2019,2019-2020
ID,2019-07-31,intra-ucx,3,0,0,0,0,0,0,0,0,0,0,3,3,3,FALSE,1,2019,2019-2020
ID,2019-07-31,intra-ui,1146,20,3,0,0,0,0,0,0,0,128,1297,1274,1294,FALSE,0.997686969930609,2019,2019-2020
ID,2019-08-31,inter-total,20,1,0,0,0,0,0,0,0,0,3,24,23,24,FALSE,1,2019,2019-2020
ID,2019-08-31,inter-ucfe,0,0,0,0,0,0,0,0,0,0,0,0,0,0,FALSE,0,2019,2019-2020
ID,2019-08-31,inter-ucx,0,0,0,0,0,0,0,0,0,0,0,0,0,0,FALSE,0,2019,2019-2020
ID,2019-08-31,inter-ui,20,1,0,0,0,0,0,0,0,0,3,24,23,24,FALSE,1,2019,2019-2020
ID,2019-08-31,intra-total,734,4,5,1,0,0,0,0,0,0,110,854,844,848,FALSE,0.992974238875878,2019,2019-2020
ID,2019-08-31,intra-ucfe,1,1,0,0,0,0,0,0,0,0,1,3,2,3,FALSE,1,2019,2019-2020
ID,2019-08-31,intra-ucx,2,0,0,0,0,0,0,0,0,0,2,4,4,4,FALSE,1,2019,2019-2020
ID,2019-08-31,intra-ui,731,3,5,1,0,0,0,0,0,0,107,847,838,841,FALSE,0.992916174734357,2019,2019-2020
ID,2019-09-30,inter-total,20,0,1,0,0,0,0,0,0,0,2,23,22,22,FALSE,0.956521739130435,2019,2019-2020
ID,2019-09-30,inter-ucfe,0,0,0,0,0,0,0,0,0,0,0,0,0,0,FALSE,0,2019,2019-2020
ID,2019-09-30,inter-ucx,0,0,0,0,0,0,0,0,0,0,0,0,0,0,FALSE,0,2019,2019-2020
ID,2019-09-30,inter-ui,20,0,1,0,0,0,0,0,0,0,2,23,22,22,FALSE,0.956521739130435,2019,2019-2020
ID,2019-09-30,intra-total,709,12,2,1,0,0,0,0,0,0,113,837,822,834,FALSE,0.996415770609319,2019,2019-2020
ID,2019-09-30,intra-ucfe,2,0,0,0,0,0,0,0,0,0,0,2,2,2,FALSE,1,2019,2019-2020
ID,2019-09-30,intra-ucx,2,0,0,0,0,0,0,0,0,0,1,3,3,3,FALSE,1,2019,2019-2020
ID,2019-09-30,intra-ui,705,12,2,1,0,0,0,0,0,0,112,832,817,829,FALSE,0.996394230769231,2019,2019-2020
ID,2019-10-31,inter-total,30,2,0,1,0,0,0,0,0,0,2,35,32,34,FALSE,0.971428571428571,2019,2019-2020
ID,2019-10-31,inter-ucfe,6,0,0,0,0,0,0,0,0,0,0,6,6,6,FALSE,1,2019,2019-2020
ID,2019-10-31,inter-ucx,0,0,0,0,0,0,0,0,0,0,0,0,0,0,FALSE,0,2019,2019-2020
ID,2019-10-31,inter-ui,24,2,0,1,0,0,0,0,0,0,2,29,26,28,FALSE,0.96551724137931,2019,2019-2020
ID,2019-10-31,intra-total,779,41,13,5,6,1,1,1,0,4,217,1068,996,1037,FALSE,0.970973782771536,2019,2019-2020
ID,2019-10-31,intra-ucfe,17,2,0,0,1,0,0,0,0,0,1,21,18,20,FALSE,0.952380952380952,2019,2019-2020
ID,2019-10-31,intra-ucx,5,0,0,0,0,0,0,0,0,0,1,6,6,6,FALSE,1,2019,2019-2020
ID,2019-10-31,intra-ui,757,39,13,5,5,1,1,1,0,4,215,1041,972,1011,FALSE,0.971181556195966,2019,2019-2020
ID,2019-11-30,inter-total,70,4,1,1,0,0,0,0,0,0,10,86,80,84,FALSE,0.976744186046512,2019,2019-2020
ID,2019-11-30,inter-ucfe,12,1,0,0,0,0,0,0,0,0,3,16,15,16,FALSE,1,2019,2019-2020
ID,2019-11-30,inter-ucx,0,0,0,0,0,0,0,0,0,0,0,0,0,0,FALSE,0,2019,2019-2020
ID,2019-11-30,inter-ui,58,3,1,1,0,0,0,0,0,0,7,70,65,68,FALSE,0.971428571428571,2019,2019-2020
ID,2019-11-30,intra-total,1198,31,9,5,8,2,1,1,0,4,223,1482,1421,1452,FALSE,0.979757085020243,2019,2019-2020
ID,2019-11-30,intra-ucfe,36,0,1,0,0,0,0,0,0,0,8,45,44,44,FALSE,0.977777777777778,2019,2019-2020
ID,2019-11-30,intra-ucx,2,0,0,0,0,0,0,0,0,0,0,2,2,2,FALSE,1,2019,2019-2020
ID,2019-11-30,intra-ui,1160,31,8,5,8,2,1,1,0,4,215,1435,1375,1406,FALSE,0.979790940766551,2019,2019-2020
ID,2019-12-31,inter-total,72,5,1,1,0,0,0,0,0,0,11,90,83,88,FALSE,0.977777777777778,2019,2019-2020
ID,2019-12-31,inter-ucfe,9,0,0,0,0,0,0,0,0,0,3,12,12,12,FALSE,1,2019,2019-2020
ID,2019-12-31,inter-ucx,0,0,0,0,0,0,0,0,0,0,0,0,0,0,FALSE,0,2019,2019-2020
ID,2019-12-31,inter-ui,63,5,1,1,0,0,0,0,0,0,8,78,71,76,FALSE,0.974358974358974,2019,2019-2020
ID,2019-12-31,intra-total,3623,83,17,13,5,5,1,1,1,2,350,4101,3973,4056,FALSE,0.98902706656913,2019,2019-2020
ID,2019-12-31,intra-ucfe,92,1,0,1,0,0,0,0,0,0,14,108,106,107,FALSE,0.990740740740741,2019,2019-2020
ID,2019-12-31,intra-ucx,2,0,0,0,0,0,0,0,0,0,0,2,2,2,FALSE,1,2019,2019-2020
ID,2019-12-31,intra-ui,3529,82,17,12,5,5,1,1,1,2,336,3991,3865,3947,FALSE,0.988975194186921,2019,2019-2020
ID,2020-01-31,inter-total,71,5,3,1,0,1,0,1,0,0,11,93,82,87,FALSE,0.935483870967742,2019,2019-2020
ID,2020-01-31,inter-ucfe,12,1,0,0,0,0,0,1,0,0,0,14,12,13,FALSE,0.928571428571429,2019,2019-2020
ID,2020-01-31,inter-ucx,0,0,0,0,0,0,0,0,0,0,0,0,0,0,FALSE,0,2019,2019-2020
ID,2020-01-31,inter-ui,59,4,3,1,0,1,0,0,0,0,11,79,70,74,FALSE,0.936708860759494,2019,2019-2020
ID,2020-01-31,intra-total,3804,185,50,13,10,5,3,0,0,5,537,4612,4341,4526,FALSE,0.981352992194276,2019,2019-2020
ID,2020-01-31,intra-ucfe,94,4,1,1,0,0,0,0,0,1,19,120,113,117,FALSE,0.975,2019,2019-2020
ID,2020-01-31,intra-ucx,1,0,0,0,0,0,0,0,0,0,1,2,2,2,FALSE,1,2019,2019-2020
ID,2020-01-31,intra-ui,3709,181,49,12,10,5,3,0,0,4,517,4490,4226,4407,FALSE,0.981514476614699,2019,2019-2020
ID,2020-02-29,inter-total,49,8,4,0,1,1,0,0,0,0,9,72,58,66,FALSE,0.916666666666667,2019,2019-2020
ID,2020-02-29,inter-ucfe,10,4,3,0,0,0,0,0,0,0,2,19,12,16,FALSE,0.842105263157895,2019,2019-2020
ID,2020-02-29,inter-ucx,0,0,0,0,0,0,0,0,0,0,0,0,0,0,FALSE,0,2019,2019-2020
ID,2020-02-29,inter-ui,39,4,1,0,1,1,0,0,0,0,7,53,46,50,FALSE,0.943396226415094,2019,2019-2020
ID,2020-02-29,intra-total,1938,192,50,14,4,5,8,2,1,3,396,2613,2334,2526,FALSE,0.96670493685419,2019,2019-2020
ID,2020-02-29,intra-ucfe,53,18,15,1,1,0,0,0,0,0,10,98,63,81,FALSE,0.826530612244898,2019,2019-2020
ID,2020-02-29,intra-ucx,3,0,1,0,0,0,0,0,0,0,1,5,4,4,FALSE,0.8,2019,2019-2020
ID,2020-02-29,intra-ui,1882,174,34,13,3,5,8,2,1,3,385,2510,2267,2441,FALSE,0.972509960159362,2019,2019-2020
ID,2020-03-31,inter-total,90,5,1,0,0,0,1,0,0,0,21,118,111,116,FALSE,0.983050847457627,2019,2019-2020
ID,2020-03-31,inter-ucfe,2,0,0,0,0,0,0,0,0,0,0,2,2,2,FALSE,1,2019,2019-2020
ID,2020-03-31,inter-ucx,0,0,0,0,0,0,0,0,0,0,0,0,0,0,FALSE,0,2019,2019-2020
ID,2020-03-31,inter-ui,88,5,1,0,0,0,1,0,0,0,21,116,109,114,FALSE,0.982758620689655,2019,2019-2020
ID,2020-03-31,intra-total,8429,170,48,13,13,7,7,1,1,3,1138,9830,9567,9737,FALSE,0.990539165818922,2019,2019-2020
ID,2020-03-31,intra-ucfe,20,0,0,1,1,1,0,0,0,0,7,30,27,27,FALSE,0.9,2019,2019-2020
ID,2020-03-31,intra-ucx,0,0,0,0,0,0,0,0,0,0,1,1,1,1,FALSE,1,2019,2019-2020
ID,2020-03-31,intra-ui,8409,170,48,12,12,6,7,1,1,3,1130,9799,9539,9709,FALSE,0.990815389325441,2019,2019-2020
ID,2020-04-30,inter-total,207,76,34,21,7,0,0,0,0,0,92,437,299,375,FALSE,0.85812356979405,2019,2019-2020
ID,2020-04-30,inter-ucfe,1,0,0,1,0,0,0,0,0,0,1,3,2,2,FALSE,0.666666666666667,2019,2019-2020
ID,2020-04-30,inter-ucx,0,0,0,0,0,0,0,0,0,0,0,0,0,0,FALSE,0,2019,2019-2020
ID,2020-04-30,inter-ui,206,76,34,20,7,0,0,0,0,0,91,434,297,373,FALSE,0.859447004608295,2019,2019-2020
ID,2020-04-30,intra-total,17097,4757,2855,1137,230,9,7,1,2,6,6997,33098,24094,28851,FALSE,0.871684089673092,2019,2019-2020
ID,2020-04-30,intra-ucfe,12,2,3,0,0,0,0,0,0,0,2,19,14,16,FALSE,0.842105263157895,2019,2019-2020
ID,2020-04-30,intra-ucx,4,3,4,3,0,0,0,0,0,0,4,18,8,11,FALSE,0.611111111111111,2019,2019-2020
ID,2020-04-30,intra-ui,17081,4752,2848,1134,230,9,7,1,2,6,6991,33061,24072,28824,FALSE,0.87184295695835,2019,2019-2020
ID,2020-05-31,inter-total,75,31,28,29,23,14,13,7,1,0,29,250,104,135,FALSE,0.54,2019,2019-2020
ID,2020-05-31,inter-ucfe,0,0,0,0,0,0,0,0,1,0,0,1,0,0,FALSE,0,2019,2019-2020
ID,2020-05-31,inter-ucx,0,0,0,0,0,0,0,0,0,0,0,0,0,0,FALSE,0,2019,2019-2020
ID,2020-05-31,inter-ui,75,31,28,29,23,14,13,7,0,0,29,249,104,135,FALSE,0.542168674698795,2019,2019-2020
ID,2020-05-31,intra-total,3411,993,1333,1922,1647,1309,744,287,28,4,1219,12897,4630,5623,FALSE,0.435992866558114,2019,2019-2020
ID,2020-05-31,intra-ucfe,1,0,0,0,2,1,1,0,0,0,0,5,1,1,FALSE,0.2,2019,2019-2020
ID,2020-05-31,intra-ucx,4,0,2,0,0,0,0,0,0,0,2,8,6,6,FALSE,0.75,2019,2019-2020
ID,2020-05-31,intra-ui,3406,993,1331,1922,1645,1308,743,287,28,4,1217,12884,4623,5616,FALSE,0.435889475318224,2019,2019-2020
ID,2020-06-30,inter-total,31,9,16,14,29,31,33,28,27,59,14,291,45,54,FALSE,0.185567010309278,2019,2019-2020
ID,2020-06-30,inter-ucfe,0,0,0,0,0,0,0,0,0,0,0,0,0,0,FALSE,0,2019,2019-2020
ID,2020-06-30,inter-ucx,0,0,0,0,0,0,0,0,0,0,0,0,0,0,FALSE,0,2019,2019-2020
ID,2020-06-30,inter-ui,31,9,16,14,29,31,33,28,27,59,14,291,45,54,FALSE,0.185567010309278,2019,2019-2020
ID,2020-06-30,intra-total,1966,449,394,495,694,950,1095,1563,1910,2244,532,12292,2498,2947,FALSE,0.239749430523918,2019,2019-2020
ID,2020-06-30,intra-ucfe,0,0,0,0,0,0,1,1,0,1,1,4,1,1,FALSE,0.25,2019,2019-2020
ID,2020-06-30,intra-ucx,2,2,0,3,0,0,1,0,0,0,0,8,2,4,FALSE,0.5,2019,2019-2020
ID,2020-06-30,intra-ui,1964,447,394,492,694,950,1093,1562,1910,2243,531,12280,2495,2942,FALSE,0.23957654723127,2019,2019-2020
ID,2020-07-31,inter-total,17,16,14,13,9,9,8,10,8,41,13,158,30,46,FALSE,0.291139240506329,2020,2020-2021
ID,2020-07-31,inter-ucfe,0,0,0,0,0,0,0,0,0,0,0,0,0,0,FALSE,0,2020,2020-2021
ID,2020-07-31,inter-ucx,0,0,0,0,0,0,0,0,0,0,0,0,0,0,FALSE,0,2020,2020-2021
ID,2020-07-31,inter-ui,17,16,14,13,9,9,8,10,8,41,13,158,30,46,FALSE,0.291139240506329,2020,2020-2021
ID,2020-07-31,intra-total,1613,197,172,174,101,78,89,95,98,722,395,3734,2008,2205,FALSE,0.590519550080343,2020,2020-2021
ID,2020-07-31,intra-ucfe,0,0,0,0,0,0,0,0,0,1,0,1,0,0,FALSE,0,2020,2020-2021
ID,2020-07-31,intra-ucx,0,1,1,0,0,0,0,0,0,0,1,3,1,2,FALSE,0.666666666666667,2020,2020-2021
ID,2020-07-31,intra-ui,1613,196,171,174,101,78,89,95,98,721,394,3730,2007,2203,FALSE,0.590616621983914,2020,2020-2021
ID,2020-08-31,inter-total,18,15,13,6,4,0,3,0,0,24,22,105,40,55,FALSE,0.523809523809524,2020,2020-2021
ID,2020-08-31,inter-ucfe,0,0,0,0,0,0,0,0,0,0,0,0,0,0,FALSE,0,2020,2020-2021
ID,2020-08-31,inter-ucx,0,0,0,0,0,0,0,0,0,0,0,0,0,0,FALSE,0,2020,2020-2021
ID,2020-08-31,inter-ui,18,15,13,6,4,0,3,0,0,24,22,105,40,55,FALSE,0.523809523809524,2020,2020-2021
ID,2020-08-31,intra-total,907,375,343,124,73,52,30,30,29,430,502,2895,1409,1784,FALSE,0.616234887737478,2020,2020-2021
ID,2020-08-31,intra-ucfe,0,0,1,1,0,0,0,0,0,1,0,3,0,0,FALSE,0,2020,2020-2021
ID,2020-08-31,intra-ucx,1,0,0,1,1,1,0,0,0,1,1,6,2,2,FALSE,0.333333333333333,2020,2020-2021
ID,2020-08-31,intra-ui,906,375,342,122,72,51,30,30,29,428,501,2886,1407,1782,FALSE,0.617463617463617,2020,2020-2021
ID,2020-09-30,inter-total,12,7,6,3,1,1,1,1,0,13,13,58,25,32,FALSE,0.551724137931035,2020,2020-2021
ID,2020-09-30,inter-ucfe,0,0,0,0,0,0,0,0,0,0,0,0,0,0,FALSE,0,2020,2020-2021
ID,2020-09-30,inter-ucx,0,0,0,0,0,0,0,0,0,0,0,0,0,0,FALSE,0,2020,2020-2021
ID,2020-09-30,inter-ui,12,7,6,3,1,1,1,1,0,13,13,58,25,32,FALSE,0.551724137931035,2020,2020-2021
ID,2020-09-30,intra-total,1087,84,30,20,24,12,13,11,11,142,332,1766,1419,1503,FALSE,0.851075877689694,2020,2020-2021
ID,2020-09-30,intra-ucfe,1,0,0,0,0,0,0,0,0,0,2,3,3,3,FALSE,1,2020,2020-2021
ID,2020-09-30,intra-ucx,1,0,0,0,0,0,0,0,0,0,0,1,1,1,FALSE,1,2020,2020-2021
ID,2020-09-30,intra-ui,1085,84,30,20,24,12,13,11,11,142,330,1762,1415,1499,FALSE,0.850737797956867,2020,2020-2021
ID,2020-10-31,inter-total,29,4,5,2,0,0,2,0,2,11,18,73,47,51,FALSE,0.698630136986301,2020,2020-2021
ID,2020-10-31,inter-ucfe,0,0,0,0,0,0,0,0,0,1,0,1,0,0,FALSE,0,2020,2020-2021
ID,2020-10-31,inter-ucx,1,0,0,0,0,0,0,0,0,0,0,1,1,1,FALSE,1,2020,2020-2021
ID,2020-10-31,inter-ui,28,4,5,2,0,0,2,0,2,10,18,71,46,50,FALSE,0.704225352112676,2020,2020-2021
ID,2020-10-31,intra-total,1043,74,38,13,13,7,13,6,9,123,318,1657,1361,1435,FALSE,0.866022933011467,2020,2020-2021
ID,2020-10-31,intra-ucfe,6,1,0,0,0,0,0,0,0,2,3,12,9,10,FALSE,0.833333333333333,2020,2020-2021
ID,2020-10-31,intra-ucx,2,1,1,0,0,1,0,0,0,0,1,6,3,4,FALSE,0.666666666666667,2020,2020-2021
ID,2020-10-31,intra-ui,1035,72,37,13,13,6,13,6,9,121,314,1639,1349,1421,FALSE,0.86699206833435,2020,2020-2021
ID,2020-11-30,inter-total,28,14,1,0,2,0,2,0,0,2,21,70,49,63,FALSE,0.9,2020,2020-2021
ID,2020-11-30,inter-ucfe,1,0,1,0,1,0,0,0,0,0,0,3,1,1,FALSE,0.333333333333333,2020,2020-2021
ID,2020-11-30,inter-ucx,0,0,0,0,0,0,0,0,0,0,0,0,0,0,FALSE,0,2020,2020-2021
ID,2020-11-30,inter-ui,27,14,0,0,1,0,2,0,0,2,21,67,48,62,FALSE,0.925373134328358,2020,2020-2021
ID,2020-11-30,intra-total,1475,127,39,26,7,9,2,1,5,75,494,2260,1969,2096,FALSE,0.927433628318584,2020,2020-2021
ID,2020-11-30,intra-ucfe,14,3,2,1,1,1,0,0,0,1,9,32,23,26,FALSE,0.8125,2020,2020-2021
ID,2020-11-30,intra-ucx,3,0,0,0,0,0,0,0,0,0,1,4,4,4,FALSE,1,2020,2020-2021
ID,2020-11-30,intra-ui,1458,124,37,25,6,8,2,1,5,74,484,2224,1942,2066,FALSE,0.928956834532374,2020,2020-2021
ID,2020-12-31,inter-total,22,9,10,13,4,0,2,4,1,7,14,86,36,45,FALSE,0.523255813953488,2020,2020-2021
ID,2020-12-31,inter-ucfe,0,3,3,4,2,0,2,1,0,1,3,19,3,6,FALSE,0.315789473684211,2020,2020-2021
ID,2020-12-31,inter-ucx,0,0,0,0,0,0,0,0,0,0,0,0,0,0,FALSE,0,2020,2020-2021
ID,2020-12-31,inter-ui,22,6,7,9,2,0,0,3,1,6,11,67,33,39,FALSE,0.582089552238806,2020,2020-2021
ID,2020-12-31,intra-total,2757,447,184,119,82,37,16,7,5,137,911,4702,3668,4115,FALSE,0.875159506592939,2020,2020-2021
ID,2020-12-31,intra-ucfe,48,9,7,13,4,6,2,1,0,4,39,133,87,96,FALSE,0.721804511278195,2020,2020-2021
ID,2020-12-31,intra-ucx,0,0,1,0,0,0,0,0,0,0,0,1,0,0,FALSE,0,2020,2020-2021
ID,2020-12-31,intra-ui,2709,438,176,106,78,31,14,6,5,133,872,4568,3581,4019,FALSE,0.879816112084063,2020,2020-2021
ID,2021-01-31,inter-total,28,10,7,5,4,1,3,3,2,10,18,91,46,56,FALSE,0.615384615384615,2020,2020-2021
ID,2021-01-31,inter-ucfe,12,1,0,0,0,0,1,3,1,2,4,24,16,17,FALSE,0.708333333333333,2020,2020-2021
ID,2021-01-31,inter-ucx,0,0,0,0,0,0,0,0,0,0,0,0,0,0,FALSE,0,2020,2020-2021
ID,2021-01-31,inter-ui,16,9,7,5,4,1,2,0,1,8,14,67,30,39,FALSE,0.582089552238806,2020,2020-2021
ID,2021-01-31,intra-total,2445,343,264,192,127,66,43,35,19,97,671,4302,3116,3459,FALSE,0.804044630404463,2020,2020-2021
ID,2021-01-31,intra-ucfe,67,3,8,13,10,7,5,2,2,4,23,144,90,93,FALSE,0.645833333333333,2020,2020-2021
ID,2021-01-31,intra-ucx,0,2,0,0,0,0,1,0,0,0,0,3,0,2,FALSE,0.666666666666667,2020,2020-2021
ID,2021-01-31,intra-ui,2378,338,256,179,117,59,37,33,17,93,648,4155,3026,3364,FALSE,0.809626955475331,2020,2020-2021
ID,2021-02-28,inter-total,15,14,6,3,2,2,1,2,2,15,11,73,26,40,FALSE,0.547945205479452,2020,2020-2021
ID,2021-02-28,inter-ucfe,3,3,1,1,0,0,0,0,0,1,3,12,6,9,FALSE,0.75,2020,2020-2021
ID,2021-02-28,inter-ucx,0,0,0,0,0,0,0,0,0,0,0,0,0,0,FALSE,0,2020,2020-2021
ID,2021-02-28,inter-ui,12,11,5,2,2,2,1,2,2,14,8,61,20,31,FALSE,0.508196721311475,2020,2020-2021
ID,2021-02-28,intra-total,1773,222,109,58,42,36,35,25,20,141,407,2868,2180,2402,FALSE,0.837517433751743,2020,2020-2021
ID,2021-02-28,intra-ucfe,39,8,9,3,0,1,4,5,2,8,17,96,56,64,FALSE,0.666666666666667,2020,2020-2021
ID,2021-02-28,intra-ucx,4,2,0,1,1,0,0,1,0,0,0,9,4,6,FALSE,0.666666666666667,2020,2020-2021
ID,2021-02-28,intra-ui,1730,212,100,54,41,35,31,19,18,133,390,2763,2120,2332,FALSE,0.844010133912414,2020,2020-2021
ID,2021-03-31,inter-total,10,6,7,4,6,3,3,1,1,13,14,68,24,30,FALSE,0.441176470588235,2020,2020-2021
ID,2021-03-31,inter-ucfe,2,2,0,2,3,0,1,0,0,1,1,12,3,5,FALSE,0.416666666666667,2020,2020-2021
ID,2021-03-31,inter-ucx,0,0,0,0,0,0,0,0,0,0,0,0,0,0,FALSE,0,2020,2020-2021
ID,2021-03-31,inter-ui,8,4,7,2,3,3,2,1,1,12,13,56,21,25,FALSE,0.446428571428571,2020,2020-2021
ID,2021-03-31,intra-total,1122,200,125,73,65,41,31,38,23,213,274,2205,1396,1596,FALSE,0.723809523809524,2020,2020-2021
ID,2021-03-31,intra-ucfe,13,3,4,2,2,3,2,2,1,8,6,46,19,22,FALSE,0.478260869565217,2020,2020-2021
ID,2021-03-31,intra-ucx,2,0,1,0,0,0,1,0,0,1,1,6,3,3,FALSE,0.5,2020,2020-2021
ID,2021-03-31,intra-ui,1107,197,120,71,63,38,28,36,22,204,267,2153,1374,1571,FALSE,0.729679516953089,2020,2020-2021
ID,2021-04-30,inter-total,20,13,5,4,7,0,2,2,2,17,11,83,31,44,FALSE,0.530120481927711,2020,2020-2021
ID,2021-04-30,inter-ucfe,0,1,0,0,0,0,1,0,0,4,0,6,0,1,FALSE,0.166666666666667,2020,2020-2021
ID,2021-04-30,inter-ucx,0,0,0,0,0,0,0,0,0,0,0,0,0,0,FALSE,0,2020,2020-2021
ID,2021-04-30,inter-ui,20,12,5,4,7,0,1,2,2,13,11,77,31,43,FALSE,0.558441558441558,2020,2020-2021
ID,2021-04-30,intra-total,1152,303,203,79,31,29,24,19,20,160,518,2538,1670,1973,FALSE,0.777383766745469,2020,2020-2021
ID,2021-04-30,intra-ucfe,5,1,1,1,1,0,0,0,2,3,4,18,9,10,FALSE,0.555555555555556,2020,2020-2021
ID,2021-04-30,intra-ucx,2,2,0,0,0,0,0,0,0,0,0,4,2,4,FALSE,1,2020,2020-2021
ID,2021-04-30,intra-ui,1145,300,202,78,30,29,24,19,18,157,514,2516,1659,1959,FALSE,0.778616852146264,2020,2020-2021
ID,2021-05-31,inter-total,12,9,6,3,1,0,1,1,2,6,9,50,21,30,FALSE,0.6,2020,2020-2021
ID,2021-05-31,inter-ucfe,1,0,0,0,0,0,0,0,0,1,0,2,1,1,FALSE,0.5,2020,2020-2021
ID,2021-05-31,inter-ucx,0,0,0,0,0,0,0,0,0,0,0,0,0,0,FALSE,0,2020,2020-2021
ID,2021-05-31,inter-ui,11,9,6,3,1,0,1,1,2,5,9,48,20,29,FALSE,0.604166666666667,2020,2020-2021
ID,2021-05-31,intra-total,512,268,236,148,90,44,33,19,14,109,245,1718,757,1025,FALSE,0.59662398137369,2020,2020-2021
ID,2021-05-31,intra-ucfe,2,1,1,2,1,1,2,0,0,0,4,14,6,7,FALSE,0.5,2020,2020-2021
ID,2021-05-31,intra-ucx,2,0,0,1,0,0,0,0,0,0,0,3,2,2,FALSE,0.666666666666667,2020,2020-2021
ID,2021-05-31,intra-ui,508,267,235,145,89,43,31,19,14,109,241,1701,749,1016,FALSE,0.59729570840682,2020,2020-2021
ID,2021-06-30,inter-total,4,2,7,1,1,1,1,1,0,7,7,32,11,13,FALSE,0.40625,2020,2020-2021
ID,2021-06-30,inter-ucfe,0,0,0,0,0,0,0,0,0,2,0,2,0,0,FALSE,0,2020,2020-2021
ID,2021-06-30,inter-ucx,0,0,0,0,0,0,0,0,0,0,0,0,0,0,FALSE,0,2020,2020-2021
ID,2021-06-30,inter-ui,4,2,7,1,1,1,1,1,0,5,7,30,11,13,FALSE,0.433333333333333,2020,2020-2021
ID,2021-06-30,intra-total,545,168,188,113,53,27,20,21,17,108,200,1460,745,913,FALSE,0.625342465753425,2020,2020-2021
ID,2021-06-30,intra-ucfe,0,0,1,0,0,0,0,0,0,1,0,2,0,0,FALSE,0,2020,2020-2021
ID,2021-06-30,intra-ucx,1,0,0,0,0,0,0,0,0,0,0,1,1,1,FALSE,1,2020,2020-2021
ID,2021-06-30,intra-ui,544,168,187,113,53,27,20,21,17,107,200,1457,744,912,FALSE,0.625943719972546,2020,2020-2021
ID,2021-07-31,inter-total,14,2,4,2,1,1,1,0,0,6,3,34,17,19,FALSE,0.558823529411765,2021,2021-2022
ID,2021-07-31,inter-ucfe,0,0,0,0,0,0,0,0,0,0,0,0,0,0,FALSE,0,2021,2021-2022
ID,2021-07-31,inter-ucx,0,0,0,0,0,0,0,0,0,0,0,0,0,0,FALSE,0,2021,2021-2022
ID,2021-07-31,inter-ui,14,2,4,2,1,1,1,0,0,6,3,34,17,19,FALSE,0.558823529411765,2021,2021-2022
ID,2021-07-31,intra-total,839,191,127,55,26,18,12,9,13,101,269,1660,1108,1299,FALSE,0.782530120481928,2021,2021-2022
ID,2021-07-31,intra-ucfe,0,0,0,1,2,0,0,0,0,4,0,7,0,0,FALSE,0,2021,2021-2022
ID,2021-07-31,intra-ucx,0,0,0,0,0,0,0,0,0,0,0,0,0,0,FALSE,0,2021,2021-2022
ID,2021-07-31,intra-ui,839,191,127,54,24,18,12,9,13,97,269,1653,1108,1299,FALSE,0.785843920145191,2021,2021-2022
ID,2021-08-31,inter-total,11,0,1,0,0,0,0,0,1,5,3,21,14,14,FALSE,0.666666666666667,2021,2021-2022
ID,2021-08-31,inter-ucfe,0,0,0,0,0,0,0,0,0,0,0,0,0,0,FALSE,0,2021,2021-2022
ID,2021-08-31,inter-ucx,0,0,0,0,0,0,0,0,0,0,0,0,0,0,FALSE,0,2021,2021-2022
ID,2021-08-31,inter-ui,11,0,1,0,0,0,0,0,1,5,3,21,14,14,FALSE,0.666666666666667,2021,2021-2022
ID,2021-08-31,intra-total,698,29,26,18,17,8,13,11,12,85,92,1009,790,819,FALSE,0.811694747274529,2021,2021-2022
ID,2021-08-31,intra-ucfe,2,0,1,0,0,0,0,0,0,1,0,4,2,2,FALSE,0.5,2021,2021-2022
ID,2021-08-31,intra-ucx,1,0,0,0,0,1,0,0,0,0,0,2,1,1,FALSE,0.5,2021,2021-2022
ID,2021-08-31,intra-ui,695,29,25,18,17,7,13,11,12,84,92,1003,787,816,FALSE,0.813559322033898,2021,2021-2022
ID,2021-09-30,inter-total,10,3,1,2,0,0,0,0,0,0,4,20,14,17,FALSE,0.85,2021,2021-2022
ID,2021-09-30,inter-ucfe,0,0,0,0,0,0,0,0,0,0,0,0,0,0,FALSE,0,2021,2021-2022
ID,2021-09-30,inter-ucx,0,0,0,0,0,0,0,0,0,0,0,0,0,0,FALSE,0,2021,2021-2022
ID,2021-09-30,inter-ui,10,3,1,2,0,0,0,0,0,0,4,20,14,17,FALSE,0.85,2021,2021-2022
ID,2021-09-30,intra-total,364,69,21,7,6,10,6,5,7,45,150,690,514,583,FALSE,0.844927536231884,2021,2021-2022
ID,2021-09-30,intra-ucfe,1,0,0,0,0,0,0,0,0,0,0,1,1,1,FALSE,1,2021,2021-2022
ID,2021-09-30,intra-ucx,2,0,0,0,0,0,0,0,0,0,1,3,3,3,FALSE,1,2021,2021-2022
ID,2021-09-30,intra-ui,361,69,21,7,6,10,6,5,7,45,149,686,510,579,FALSE,0.84402332361516,2021,2021-2022
ID,2021-10-31,inter-total,24,0,1,1,0,0,0,0,0,0,1,27,25,25,FALSE,0.925925925925926,2021,2021-2022
ID,2021-10-31,inter-ucfe,1,0,0,0,0,0,0,0,0,0,0,1,1,1,FALSE,1,2021,2021-2022
ID,2021-10-31,inter-ucx,0,0,0,0,0,0,0,0,0,0,0,0,0,0,FALSE,0,2021,2021-2022
ID,2021-10-31,inter-ui,23,0,1,1,0,0,0,0,0,0,1,26,24,24,FALSE,0.923076923076923,2021,2021-2022
ID,2021-10-31,intra-total,463,57,19,12,8,3,7,4,0,25,154,752,617,674,FALSE,0.896276595744681,2021,2021-2022
ID,2021-10-31,intra-ucfe,4,1,0,0,0,0,0,0,0,1,1,7,5,6,FALSE,0.857142857142857,2021,2021-2022
ID,2021-10-31,intra-ucx,0,0,0,0,0,0,0,0,0,0,1,1,1,1,FALSE,1,2021,2021-2022
ID,2021-10-31,intra-ui,459,56,19,12,8,3,7,4,0,24,152,744,611,667,FALSE,0.896505376344086,2021,2021-2022
ID,2021-11-30,inter-total,66,6,1,1,0,1,0,0,0,1,10,86,76,82,FALSE,0.953488372093023,2021,2021-2022
ID,2021-11-30,inter-ucfe,10,3,1,0,0,0,0,0,0,0,3,17,13,16,FALSE,0.941176470588235,2021,2021-2022
ID,2021-11-30,inter-ucx,0,0,0,0,0,0,0,0,0,0,0,0,0,0,FALSE,0,2021,2021-2022
ID,2021-11-30,inter-ui,56,3,0,1,0,1,0,0,0,1,7,69,63,66,FALSE,0.956521739130435,2021,2021-2022
ID,2021-11-30,intra-total,1228,32,15,10,8,2,3,3,0,41,132,1474,1360,1392,FALSE,0.944369063772049,2021,2021-2022
ID,2021-11-30,intra-ucfe,45,1,0,1,1,1,0,0,0,2,1,52,46,47,FALSE,0.903846153846154,2021,2021-2022
ID,2021-11-30,intra-ucx,1,0,0,0,0,0,0,0,0,0,0,1,1,1,FALSE,1,2021,2021-2022
ID,2021-11-30,intra-ui,1182,31,15,9,7,1,3,3,0,39,131,1421,1313,1344,FALSE,0.945812807881773,2021,2021-2022
ID,2021-12-31,inter-total,55,3,3,1,2,1,0,0,0,2,8,75,63,66,FALSE,0.88,2021,2021-2022
ID,2021-12-31,inter-ucfe,8,0,1,0,0,0,0,0,0,0,1,10,9,9,FALSE,0.9,2021,2021-2022
ID,2021-12-31,inter-ucx,0,0,0,0,0,0,0,0,0,0,0,0,0,0,FALSE,0,2021,2021-2022
ID,2021-12-31,inter-ui,47,3,2,1,2,1,0,0,0,2,7,65,54,57,FALSE,0.876923076923077,2021,2021-2022
ID,2021-12-31,intra-total,2266,37,9,12,9,3,3,0,0,43,185,2567,2451,2488,FALSE,0.969224776003117,2021,2021-2022
ID,2021-12-31,intra-ucfe,105,2,1,0,0,0,1,0,0,1,12,122,117,119,FALSE,0.975409836065574,2021,2021-2022
ID,2021-12-31,intra-ucx,2,0,0,0,1,0,0,0,0,0,0,3,2,2,FALSE,0.666666666666667,2021,2021-2022
ID,2021-12-31,intra-ui,2159,35,8,12,8,3,2,0,0,42,173,2442,2332,2367,FALSE,0.969287469287469,2021,2021-2022
ID,2022-01-31,inter-total,71,3,2,1,0,1,1,1,0,1,13,94,84,87,FALSE,0.925531914893617,2021,2021-2022
ID,2022-01-31,inter-ucfe,15,1,0,0,0,0,1,0,0,1,3,21,18,19,FALSE,0.904761904761905,2021,2021-2022
ID,2022-01-31,inter-ucx,0,0,0,0,0,0,0,0,0,0,0,0,0,0,FALSE,0,2021,2021-2022
ID,2022-01-31,inter-ui,56,2,2,1,0,1,0,1,0,0,10,73,66,68,FALSE,0.931506849315068,2021,2021-2022
ID,2022-01-31,intra-total,3766,86,27,14,10,6,3,6,2,55,427,4402,4193,4279,FALSE,0.972058155383916,2021,2021-2022
ID,2022-01-31,intra-ucfe,83,4,0,2,0,0,0,1,0,2,14,106,97,101,FALSE,0.952830188679245,2021,2021-2022
ID,2022-01-31,intra-ucx,2,0,0,0,0,0,0,0,0,1,0,3,2,2,FALSE,0.666666666666667,2021,2021-2022
ID,2022-01-31,intra-ui,3681,82,27,12,10,6,3,5,2,52,413,4293,4094,4176,FALSE,0.972746331236897,2021,2021-2022
ID,2022-02-28,inter-total,50,2,0,2,0,0,0,0,0,0,9,63,59,61,FALSE,0.968253968253968,2021,2021-2022
ID,2022-02-28,inter-ucfe,10,2,0,0,0,0,0,0,0,0,3,15,13,15,FALSE,1,2021,2021-2022
ID,2022-02-28,inter-ucx,0,0,0,0,0,0,0,0,0,0,0,0,0,0,FALSE,0,2021,2021-2022
ID,2022-02-28,inter-ui,40,0,0,2,0,0,0,0,0,0,6,48,46,46,FALSE,0.958333333333333,2021,2021-2022
ID,2022-02-28,intra-total,1912,61,14,15,8,3,2,0,2,35,236,2288,2148,2209,FALSE,0.965472027972028,2021,2021-2022
ID,2022-02-28,intra-ucfe,64,7,1,1,0,0,0,0,0,2,14,89,78,85,FALSE,0.955056179775281,2021,2021-2022
ID,2022-02-28,intra-ucx,0,0,0,0,0,0,0,0,0,0,0,0,0,0,FALSE,0,2021,2021-2022
ID,2022-02-28,intra-ui,1848,54,13,14,8,3,2,0,2,33,222,2199,2070,2124,FALSE,0.965893587994543,2021,2021-2022
ID,2022-03-31,inter-total,37,2,0,0,0,0,0,0,0,0,5,44,42,44,FALSE,1,2021,2021-2022
ID,2022-03-31,inter-ucfe,2,0,0,0,0,0,0,0,0,0,0,2,2,2,FALSE,1,2021,2021-2022
ID,2022-03-31,inter-ucx,0,0,0,0,0,0,0,0,0,0,0,0,0,0,FALSE,0,2021,2021-2022
ID,2022-03-31,inter-ui,35,2,0,0,0,0,0,0,0,0,5,42,40,42,FALSE,1,2021,2021-2022
ID,2022-03-31,intra-total,1130,27,26,13,11,4,4,1,2,14,124,1356,1254,1281,FALSE,0.944690265486726,2021,2021-2022
ID,2022-03-31,intra-ucfe,15,2,6,0,1,2,1,0,0,0,2,29,17,19,FALSE,0.655172413793103,2021,2021-2022
ID,2022-03-31,intra-ucx,1,0,0,0,0,0,0,0,0,0,0,1,1,1,FALSE,1,2021,2021-2022
ID,2022-03-31,intra-ui,1114,25,20,13,10,2,3,1,2,14,122,1326,1236,1261,FALSE,0.950980392156863,2021,2021-2022
ID,2022-04-30,inter-total,16,1,0,0,0,0,2,0,0,1,6,26,22,23,FALSE,0.884615384615385,2021,2021-2022
ID,2022-04-30,inter-ucfe,1,0,0,0,0,0,1,0,0,0,0,2,1,1,FALSE,0.5,2021,2021-2022
ID,2022-04-30,inter-ucx,0,0,0,0,0,0,0,0,0,0,0,0,0,0,FALSE,0,2021,2021-2022
ID,2022-04-30,inter-ui,15,1,0,0,0,0,1,0,0,1,6,24,21,22,FALSE,0.916666666666667,2021,2021-2022
ID,2022-04-30,intra-total,888,21,11,6,3,2,1,0,2,22,100,1056,988,1009,FALSE,0.955492424242424,2021,2021-2022
ID,2022-04-30,intra-ucfe,6,1,0,0,0,0,0,0,1,1,0,9,6,7,FALSE,0.777777777777778,2021,2021-2022
ID,2022-04-30,intra-ucx,1,0,0,0,0,0,0,0,0,0,1,2,2,2,FALSE,1,2021,2021-2022
ID,2022-04-30,intra-ui,881,20,11,6,3,2,1,0,1,21,99,1045,980,1000,FALSE,0.956937799043062,2021,2021-2022
ID,2022-05-31,inter-total,24,0,0,0,0,0,0,0,0,0,4,28,28,28,FALSE,1,2021,2021-2022
ID,2022-05-31,inter-ucfe,1,0,0,0,0,0,0,0,0,0,0,1,1,1,FALSE,1,2021,2021-2022
ID,2022-05-31,inter-ucx,0,0,0,0,0,0,0,0,0,0,0,0,0,0,FALSE,0,2021,2021-2022
ID,2022-05-31,inter-ui,23,0,0,0,0,0,0,0,0,0,4,27,27,27,FALSE,1,2021,2021-2022
ID,2022-05-31,intra-total,729,19,8,4,3,0,2,0,0,9,72,846,801,820,FALSE,0.969267139479905,2021,2021-2022
ID,2022-05-31,intra-ucfe,0,0,0,0,0,0,0,0,0,0,0,0,0,0,FALSE,0,2021,2021-2022
ID,2022-05-31,intra-ucx,0,0,0,0,0,0,0,0,0,0,0,0,0,0,FALSE,0,2021,2021-2022
ID,2022-05-31,intra-ui,729,19,8,4,3,0,2,0,0,9,72,846,801,820,FALSE,0.969267139479905,2021,2021-2022
ID,2022-06-30,inter-total,12,0,0,0,0,0,0,1,0,1,4,18,16,16,FALSE,0.888888888888889,2021,2021-2022
ID,2022-06-30,inter-ucfe,0,0,0,0,0,0,0,0,0,0,0,0,0,0,FALSE,0,2021,2021-2022
ID,2022-06-30,inter-ucx,0,0,0,0,0,0,0,0,0,0,0,0,0,0,FALSE,0,2021,2021-2022
ID,2022-06-30,inter-ui,12,0,0,0,0,0,0,1,0,1,4,18,16,16,FALSE,0.888888888888889,2021,2021-2022
ID,2022-06-30,intra-total,1073,23,8,7,7,1,2,1,0,12,108,1242,1181,1204,FALSE,0.969404186795491,2021,2021-2022
ID,2022-06-30,intra-ucfe,1,0,0,1,0,0,0,0,0,0,1,3,2,2,FALSE,0.666666666666667,2021,2021-2022
ID,2022-06-30,intra-ucx,2,1,0,0,0,0,0,0,0,0,1,4,3,4,FALSE,1,2021,2021-2022
ID,2022-06-30,intra-ui,1070,22,8,6,7,1,2,1,0,12,106,1235,1176,1198,FALSE,0.97004048582996,2021,2021-2022
ID,2022-07-31,inter-total,17,0,0,0,0,0,0,0,0,0,2,19,19,19,FALSE,1,2022,2022-2023
ID,2022-07-31,inter-ucfe,0,0,0,0,0,0,0,0,0,0,0,0,0,0,FALSE,0,2022,2022-2023
ID,2022-07-31,inter-ucx,0,0,0,0,0,0,0,0,0,0,0,0,0,0,FALSE,0,2022,2022-2023
ID,2022-07-31,inter-ui,17,0,0,0,0,0,0,0,0,0,2,19,19,19,FALSE,1,2022,2022-2023
ID,2022-07-31,intra-total,928,15,11,5,4,0,1,0,0,11,130,1105,1058,1073,FALSE,0.9710407239819,2022,2022-2023
ID,2022-07-31,intra-ucfe,0,0,0,0,0,0,0,0,0,0,0,0,0,0,FALSE,0,2022,2022-2023
ID,2022-07-31,intra-ucx,0,0,0,0,0,0,0,0,0,0,0,0,0,0,FALSE,0,2022,2022-2023
ID,2022-07-31,intra-ui,928,15,11,5,4,0,1,0,0,11,130,1105,1058,1073,FALSE,0.9710407239819,2022,2022-2023
ID,2022-08-31,inter-total,27,0,0,0,0,0,0,0,0,0,5,32,32,32,FALSE,1,2022,2022-2023
ID,2022-08-31,inter-ucfe,0,0,0,0,0,0,0,0,0,0,0,0,0,0,FALSE,0,2022,2022-2023
ID,2022-08-31,inter-ucx,0,0,0,0,0,0,0,0,0,0,0,0,0,0,FALSE,0,2022,2022-2023
ID,2022-08-31,inter-ui,27,0,0,0,0,0,0,0,0,0,5,32,32,32,FALSE,1,2022,2022-2023
ID,2022-08-31,intra-total,933,25,11,7,5,1,2,3,0,14,141,1142,1074,1099,FALSE,0.962346760070053,2022,2022-2023
ID,2022-08-31,intra-ucfe,1,0,0,1,0,0,0,0,0,0,0,2,1,1,FALSE,0.5,2022,2022-2023
ID,2022-08-31,intra-ucx,3,0,0,0,0,0,0,0,0,0,0,3,3,3,FALSE,1,2022,2022-2023
ID,2022-08-31,intra-ui,929,25,11,6,5,1,2,3,0,14,141,1137,1070,1095,FALSE,0.963060686015831,2022,2022-2023
ID,2022-09-30,inter-total,19,0,1,0,0,0,0,0,0,0,2,22,21,21,FALSE,0.954545454545455,2022,2022-2023
ID,2022-09-30,inter-ucfe,1,0,0,0,0,0,0,0,0,0,0,1,1,1,FALSE,1,2022,2022-2023
ID,2022-09-30,inter-ucx,0,0,0,0,0,0,0,0,0,0,0,0,0,0,FALSE,0,2022,2022-2023
ID,2022-09-30,inter-ui,18,0,1,0,0,0,0,0,0,0,2,21,20,20,FALSE,0.952380952380952,2022,2022-2023
ID,2022-09-30,intra-total,603,21,11,11,3,8,1,2,0,10,102,772,705,726,FALSE,0.940414507772021,2022,2022-2023
ID,2022-09-30,intra-ucfe,0,0,2,1,0,0,0,0,0,0,0,3,0,0,FALSE,0,2022,2022-2023
ID,2022-09-30,intra-ucx,1,0,0,0,0,0,0,0,0,0,0,1,1,1,FALSE,1,2022,2022-2023
ID,2022-09-30,intra-ui,602,21,9,10,3,8,1,2,0,10,102,768,704,725,FALSE,0.944010416666667,2022,2022-2023
ID,2022-10-31,inter-total,28,0,0,0,0,0,0,0,0,0,4,32,32,32,FALSE,1,2022,2022-2023
ID,2022-10-31,inter-ucfe,1,0,0,0,0,0,0,0,0,0,1,2,2,2,FALSE,1,2022,2022-2023
ID,2022-10-31,inter-ucx,0,0,0,0,0,0,0,0,0,0,0,0,0,0,FALSE,0,2022,2022-2023
ID,2022-10-31,inter-ui,27,0,0,0,0,0,0,0,0,0,3,30,30,30,FALSE,1,2022,2022-2023
ID,2022-10-31,intra-total,770,26,10,5,3,2,7,2,1,8,144,978,914,940,FALSE,0.961145194274029,2022,2022-2023
ID,2022-10-31,intra-ucfe,4,1,0,0,1,0,0,0,0,0,0,6,4,5,FALSE,0.833333333333333,2022,2022-2023
ID,2022-10-31,intra-ucx,6,0,0,0,0,0,0,0,0,0,0,6,6,6,FALSE,1,2022,2022-2023
ID,2022-10-31,intra-ui,760,25,10,5,2,2,7,2,1,8,144,966,904,929,FALSE,0.961697722567288,2022,2022-2023
ID,2022-11-30,inter-total,63,3,2,1,0,0,0,0,0,0,16,85,79,82,FALSE,0.964705882352941,2022,2022-2023
ID,2022-11-30,inter-ucfe,11,0,0,0,0,0,0,0,0,0,1,12,12,12,FALSE,1,2022,2022-2023
ID,2022-11-30,inter-ucx,0,0,0,0,0,0,0,0,0,0,0,0,0,0,FALSE,0,2022,2022-2023
ID,2022-11-30,inter-ui,52,3,2,1,0,0,0,0,0,0,15,73,67,70,FALSE,0.958904109589041,2022,2022-2023
ID,2022-11-30,intra-total,1690,30,11,7,5,2,0,0,1,14,181,1941,1871,1901,FALSE,0.979392065945389,2022,2022-2023
ID,2022-11-30,intra-ucfe,28,2,0,0,0,0,0,0,0,0,2,32,30,32,FALSE,1,2022,2022-2023
ID,2022-11-30,intra-ucx,6,0,0,0,0,0,0,0,0,0,0,6,6,6,FALSE,1,2022,2022-2023
ID,2022-11-30,intra-ui,1656,28,11,7,5,2,0,0,1,14,179,1903,1835,1863,FALSE,0.978980557015239,2022,2022-2023
ID,2022-12-31,inter-total,85,6,4,1,1,1,0,0,0,1,13,112,98,104,FALSE,0.928571428571429,2022,2022-2023
ID,2022-12-31,inter-ucfe,12,3,2,0,1,0,0,0,0,0,4,22,16,19,FALSE,0.863636363636364,2022,2022-2023
ID,2022-12-31,inter-ucx,0,0,0,0,0,0,0,0,0,0,0,0,0,0,FALSE,0,2022,2022-2023
ID,2022-12-31,inter-ui,73,3,2,1,0,1,0,0,0,1,9,90,82,85,FALSE,0.944444444444444,2022,2022-2023
ID,2022-12-31,intra-total,3102,72,19,11,2,4,0,1,1,16,354,3582,3456,3528,FALSE,0.984924623115578,2022,2022-2023
ID,2022-12-31,intra-ucfe,54,2,0,0,0,0,0,0,0,0,6,62,60,62,FALSE,1,2022,2022-2023
ID,2022-12-31,intra-ucx,2,0,0,0,0,0,0,0,0,0,0,2,2,2,FALSE,1,2022,2022-2023
ID,2022-12-31,intra-ui,3046,70,19,11,2,4,0,1,1,16,348,3518,3394,3464,FALSE,0.984650369528141,2022,2022-2023
ID,2023-01-31,inter-total,83,6,1,2,1,0,1,0,0,2,14,110,97,103,FALSE,0.936363636363636,2022,2022-2023
ID,2023-01-31,inter-ucfe,10,0,0,1,0,0,0,0,0,0,2,13,12,12,FALSE,0.923076923076923,2022,2022-2023
ID,2023-01-31,inter-ucx,0,0,0,0,0,0,0,0,0,0,0,0,0,0,FALSE,0,2022,2022-2023
ID,2023-01-31,inter-ui,73,6,1,1,1,0,1,0,0,2,12,97,85,91,FALSE,0.938144329896907,2022,2022-2023
ID,2023-01-31,intra-total,4133,134,34,16,14,11,2,3,1,11,527,4886,4660,4794,FALSE,0.981170691772411,2022,2022-2023
ID,2023-01-31,intra-ucfe,66,3,2,2,1,0,0,0,1,0,7,82,73,76,FALSE,0.926829268292683,2022,2022-2023
ID,2023-01-31,intra-ucx,2,0,0,0,0,0,0,0,0,0,5,7,7,7,FALSE,1,2022,2022-2023
ID,2023-01-31,intra-ui,4065,131,32,14,13,11,2,3,0,11,515,4797,4580,4711,FALSE,0.982072128413592,2022,2022-2023
ID,2023-02-28,inter-total,40,5,2,1,0,0,0,0,0,0,15,63,55,60,FALSE,0.952380952380952,2022,2022-2023
ID,2023-02-28,inter-ucfe,5,2,0,1,0,0,0,0,0,0,3,11,8,10,FALSE,0.909090909090909,2022,2022-2023
ID,2023-02-28,inter-ucx,0,0,0,0,0,0,0,0,0,0,0,0,0,0,FALSE,0,2022,2022-2023
ID,2023-02-28,inter-ui,35,3,2,0,0,0,0,0,0,0,12,52,47,50,FALSE,0.961538461538461,2022,2022-2023
ID,2023-02-28,intra-total,2048,117,31,13,4,5,5,1,1,12,411,2648,2459,2576,FALSE,0.972809667673716,2022,2022-2023
ID,2023-02-28,intra-ucfe,36,4,2,0,0,1,0,0,0,0,11,54,47,51,FALSE,0.944444444444444,2022,2022-2023
ID,2023-02-28,intra-ucx,2,0,0,0,0,0,0,0,0,0,1,3,3,3,FALSE,1,2022,2022-2023
ID,2023-02-28,intra-ui,2010,113,29,13,4,4,5,1,1,12,399,2591,2409,2522,FALSE,0.973369355461212,2022,2022-2023
ID,2023-03-31,inter-total,32,6,1,1,0,0,0,0,0,0,12,52,44,50,FALSE,0.961538461538461,2022,2022-2023
ID,2023-03-31,inter-ucfe,2,0,0,1,0,0,0,0,0,0,1,4,3,3,FALSE,0.75,2022,2022-2023
ID,2023-03-31,inter-ucx,0,0,0,0,0,0,0,0,0,0,0,0,0,0,FALSE,0,2022,2022-2023
ID,2023-03-31,inter-ui,30,6,1,0,0,0,0,0,0,0,11,48,41,47,FALSE,0.979166666666667,2022,2022-2023
ID,2023-03-31,intra-total,1448,136,33,16,18,7,2,0,0,10,398,2068,1846,1982,FALSE,0.958413926499033,2022,2022-2023
ID,2023-03-31,intra-ucfe,12,2,0,1,3,0,0,0,0,0,3,21,15,17,FALSE,0.80952380952381,2022,2022-2023
ID,2023-03-31,intra-ucx,2,1,0,0,0,0,0,0,0,0,1,4,3,4,FALSE,1,2022,2022-2023
ID,2023-03-31,intra-ui,1434,133,33,15,15,7,2,0,0,10,394,2043,1828,1961,FALSE,0.959862946647088,2022,2022-2023
ID,2023-04-30,inter-total,31,5,1,0,0,0,0,0,0,0,7,44,38,43,FALSE,0.977272727272727,2022,2022-2023
ID,2023-04-30,inter-ucfe,0,0,0,0,0,0,0,0,0,0,0,0,0,0,FALSE,0,2022,2022-2023
ID,2023-04-30,inter-ucx,0,0,0,0,0,0,0,0,0,0,0,0,0,0,FALSE,0,2022,2022-2023
ID,2023-04-30,inter-ui,31,5,1,0,0,0,0,0,0,0,7,44,38,43,FALSE,0.977272727272727,2022,2022-2023
ID,2023-04-30,intra-total,1288,98,25,9,3,6,0,3,1,8,315,1756,1603,1701,FALSE,0.968678815489749,2022,2022-2023
ID,2023-04-30,intra-ucfe,0,1,0,0,0,0,0,0,0,0,1,2,1,2,FALSE,1,2022,2022-2023
ID,2023-04-30,intra-ucx,2,0,0,0,0,0,0,0,0,0,1,3,3,3,FALSE,1,2022,2022-2023
ID,2023-04-30,intra-ui,1286,97,25,9,3,6,0,3,1,8,313,1751,1599,1696,FALSE,0.968589377498572,2022,2022-2023
ID,2023-05-31,inter-total,32,6,0,1,0,0,0,0,1,0,11,51,43,49,FALSE,0.96078431372549,2022,2022-2023
ID,2023-05-31,inter-ucfe,0,0,0,0,0,0,0,0,0,0,0,0,0,0,FALSE,0,2022,2022-2023
ID,2023-05-31,inter-ucx,0,0,0,0,0,0,0,0,0,0,0,0,0,0,FALSE,0,2022,2022-2023
ID,2023-05-31,inter-ui,32,6,0,1,0,0,0,0,1,0,11,51,43,49,FALSE,0.96078431372549,2022,2022-2023
ID,2023-05-31,intra-total,1018,123,47,10,15,9,3,1,0,4,335,1565,1353,1476,FALSE,0.943130990415335,2022,2022-2023
ID,2023-05-31,intra-ucfe,1,0,0,0,0,0,0,0,0,0,1,2,2,2,FALSE,1,2022,2022-2023
ID,2023-05-31,intra-ucx,0,0,0,0,0,0,0,0,0,0,1,1,1,1,FALSE,1,2022,2022-2023
ID,2023-05-31,intra-ui,1017,123,47,10,15,9,3,1,0,4,333,1562,1350,1473,FALSE,0.943021766965429,2022,2022-2023
ID,2023-06-30,inter-total,25,2,0,1,1,0,0,0,1,0,7,37,32,34,FALSE,0.918918918918919,2022,2022-2023
ID,2023-06-30,inter-ucfe,0,0,0,0,0,0,0,0,0,0,0,0,0,0,FALSE,0,2022,2022-2023
ID,2023-06-30,inter-ucx,0,0,0,0,0,0,0,0,0,0,0,0,0,0,FALSE,0,2022,2022-2023
ID,2023-06-30,inter-ui,25,2,0,1,1,0,0,0,1,0,7,37,32,34,FALSE,0.918918918918919,2022,2022-2023
ID,2023-06-30,intra-total,1174,70,20,7,5,4,4,4,0,5,275,1568,1449,1519,FALSE,0.96875,2022,2022-2023
ID,2023-06-30,intra-ucfe,1,0,0,0,0,0,0,0,0,0,0,1,1,1,FALSE,1,2022,2022-2023
ID,2023-06-30,intra-ucx,0,0,0,0,0,0,0,0,0,0,1,1,1,1,FALSE,1,2022,2022-2023
ID,2023-06-30,intra-ui,1173,70,20,7,5,4,4,4,0,5,274,1566,1447,1517,FALSE,0.968710089399745,2022,2022-2023
ID,2023-07-31,inter-total,26,3,0,1,0,0,0,0,0,0,10,40,36,39,FALSE,0.975,2023,2023-2024
ID,2023-07-31,inter-ucfe,0,0,0,0,0,0,0,0,0,0,0,0,0,0,FALSE,0,2023,2023-2024
ID,2023-07-31,inter-ucx,0,0,0,0,0,0,0,0,0,0,0,0,0,0,FALSE,0,2023,2023-2024
ID,2023-07-31,inter-ui,26,3,0,1,0,0,0,0,0,0,10,40,36,39,FALSE,0.975,2023,2023-2024
ID,2023-07-31,intra-total,1272,73,24,11,6,7,3,2,1,5,288,1692,1560,1633,FALSE,0.965130023640662,2023,2023-2024
ID,2023-07-31,intra-ucfe,0,0,0,0,0,0,0,0,0,0,0,0,0,0,FALSE,0,2023,2023-2024
ID,2023-07-31,intra-ucx,2,0,0,0,0,0,0,0,0,0,1,3,3,3,FALSE,1,2023,2023-2024
ID,2023-07-31,intra-ui,1270,73,24,11,6,7,3,2,1,5,287,1689,1557,1630,FALSE,0.965068087625814,2023,2023-2024
ID,2023-08-31,inter-total,24,3,3,0,0,0,0,0,0,0,7,37,31,34,FALSE,0.918918918918919,2023,2023-2024
ID,2023-08-31,inter-ucfe,0,0,0,0,0,0,0,0,0,0,0,0,0,0,FALSE,0,2023,2023-2024
ID,2023-08-31,inter-ucx,0,0,0,0,0,0,0,0,0,0,0,0,0,0,FALSE,0,2023,2023-2024
ID,2023-08-31,inter-ui,24,3,3,0,0,0,0,0,0,0,7,37,31,34,FALSE,0.918918918918919,2023,2023-2024
ID,2023-08-31,intra-total,924,62,17,9,8,5,5,3,1,4,257,1295,1181,1243,FALSE,0.95984555984556,2023,2023-2024
ID,2023-08-31,intra-ucfe,0,1,0,0,0,0,0,0,0,0,0,1,0,1,FALSE,1,2023,2023-2024
ID,2023-08-31,intra-ucx,2,0,0,0,0,0,0,0,0,0,2,4,4,4,FALSE,1,2023,2023-2024
ID,2023-08-31,intra-ui,922,61,17,9,8,5,5,3,1,4,255,1290,1177,1238,FALSE,0.95968992248062,2023,2023-2024
ID,2023-09-30,inter-total,13,2,0,1,0,0,0,0,0,0,6,22,19,21,FALSE,0.954545454545455,2023,2023-2024
ID,2023-09-30,inter-ucfe,0,0,0,0,0,0,0,0,0,0,0,0,0,0,FALSE,0,2023,2023-2024
ID,2023-09-30,inter-ucx,0,0,0,0,0,0,0,0,0,0,0,0,0,0,FALSE,0,2023,2023-2024
ID,2023-09-30,inter-ui,13,2,0,1,0,0,0,0,0,0,6,22,19,21,FALSE,0.954545454545455,2023,2023-2024
ID,2023-09-30,intra-total,582,129,38,12,6,8,1,1,0,4,205,986,787,916,FALSE,0.929006085192698,2023,2023-2024
ID,2023-09-30,intra-ucfe,1,0,0,0,0,0,0,0,0,0,0,1,1,1,FALSE,1,2023,2023-2024
ID,2023-09-30,intra-ucx,2,0,0,0,0,0,0,0,0,0,0,2,2,2,FALSE,1,2023,2023-2024
ID,2023-09-30,intra-ui,579,129,38,12,6,8,1,1,0,4,205,983,784,913,FALSE,0.928789420142421,2023,2023-2024
ID,2023-10-31,inter-total,481,12,4,2,1,0,0,0,0,0,40,540,521,533,FALSE,0.987037037037037,2023,2023-2024
ID,2023-10-31,inter-ucfe,10,0,0,0,0,0,0,0,0,0,0,10,10,10,FALSE,1,2023,2023-2024
ID,2023-10-31,inter-ucx,0,0,0,0,0,0,0,0,0,0,0,0,0,0,FALSE,0,2023,2023-2024
ID,2023-10-31,inter-ui,471,12,4,2,1,0,0,0,0,0,40,530,511,523,FALSE,0.986792452830189,2023,2023-2024
ID,2023-10-31,intra-total,10859,212,83,36,17,10,9,8,7,182,1163,12586,12022,12234,FALSE,0.972032416971238,2023,2023-2024
ID,2023-10-31,intra-ucfe,34,0,0,0,0,0,0,0,0,0,2,36,36,36,FALSE,1,2023,2023-2024
ID,2023-10-31,intra-ucx,23,2,0,0,0,0,0,0,0,0,1,26,24,26,FALSE,1,2023,2023-2024
ID,2023-10-31,intra-ui,10802,210,83,36,17,10,9,8,7,182,1160,12524,11962,12172,FALSE,0.971893963589907,2023,2023-2024
ID,2023-11-30,inter-total,63,4,3,1,0,0,1,0,0,1,19,92,82,86,FALSE,0.934782608695652,2023,2023-2024
ID,2023-11-30,inter-ucfe,4,2,0,0,0,0,0,0,0,0,5,11,9,11,FALSE,1,2023,2023-2024
ID,2023-11-30,inter-ucx,0,0,0,0,0,0,0,0,0,0,0,0,0,0,FALSE,0,2023,2023-2024
ID,2023-11-30,inter-ui,59,2,3,1,0,0,1,0,0,1,14,81,73,75,FALSE,0.925925925925926,2023,2023-2024
ID,2023-11-30,intra-total,1262,89,38,11,7,6,1,1,0,2,347,1764,1609,1698,FALSE,0.962585034013605,2023,2023-2024
ID,2023-11-30,intra-ucfe,18,0,0,0,0,1,0,0,0,0,1,20,19,19,FALSE,0.95,2023,2023-2024
ID,2023-11-30,intra-ucx,1,0,0,0,0,0,0,0,0,0,0,1,1,1,FALSE,1,2023,2023-2024
ID,2023-11-30,intra-ui,1243,89,38,11,7,5,1,1,0,2,346,1743,1589,1678,FALSE,0.962707974756167,2023,2023-2024
ID,2023-12-31,inter-total,89,6,2,1,1,0,1,0,0,1,12,113,101,107,FALSE,0.946902654867257,2023,2023-2024
ID,2023-12-31,inter-ucfe,15,0,1,0,1,0,0,0,0,0,1,18,16,16,FALSE,0.888888888888889,2023,2023-2024
ID,2023-12-31,inter-ucx,0,0,0,0,0,0,0,0,0,0,0,0,0,0,FALSE,0,2023,2023-2024
ID,2023-12-31,inter-ui,74,6,1,1,0,0,1,0,0,1,11,95,85,91,FALSE,0.957894736842105,2023,2023-2024
ID,2023-12-31,intra-total,2484,123,38,6,9,8,4,0,1,5,437,3115,2921,3044,FALSE,0.977207062600321,2023,2023-2024
ID,2023-12-31,intra-ucfe,42,2,4,0,0,0,0,0,0,0,9,57,51,53,FALSE,0.929824561403509,2023,2023-2024
ID,2023-12-31,intra-ucx,1,0,0,0,0,0,0,0,0,0,0,1,1,1,FALSE,1,2023,2023-2024
ID,2023-12-31,intra-ui,2441,121,34,6,9,8,4,0,1,5,428,3057,2869,2990,FALSE,0.978083087994766,2023,2023-2024
ID,2024-01-31,inter-total,172,10,3,3,1,1,2,0,0,0,16,208,188,198,FALSE,0.951923076923077,2023,2023-2024
ID,2024-01-31,inter-ucfe,17,0,1,0,0,0,1,0,0,0,3,22,20,20,FALSE,0.909090909090909,2023,2023-2024
ID,2024-01-31,inter-ucx,0,0,0,0,0,0,0,0,0,0,0,0,0,0,FALSE,0,2023,2023-2024
ID,2024-01-31,inter-ui,155,10,2,3,1,1,1,0,0,0,13,186,168,178,FALSE,0.956989247311828,2023,2023-2024
ID,2024-01-31,intra-total,4459,218,99,30,10,8,2,1,1,5,643,5476,5102,5320,FALSE,0.971512052593134,2023,2023-2024
ID,2024-01-31,intra-ucfe,61,2,1,1,1,1,0,0,0,0,19,86,80,82,FALSE,0.953488372093023,2023,2023-2024
ID,2024-01-31,intra-ucx,1,0,2,0,0,0,0,0,0,0,0,3,1,1,FALSE,0.333333333333333,2023,2023-2024
ID,2024-01-31,intra-ui,4397,216,96,29,9,7,2,1,1,5,624,5387,5021,5237,FALSE,0.972155188416558,2023,2023-2024
ID,2024-02-29,inter-total,112,10,1,2,1,0,0,0,0,1,22,149,134,144,FALSE,0.966442953020134,2023,2023-2024
ID,2024-02-29,inter-ucfe,5,2,1,1,0,0,0,0,0,0,2,11,7,9,FALSE,0.818181818181818,2023,2023-2024
ID,2024-02-29,inter-ucx,0,0,0,0,0,0,0,0,0,0,0,0,0,0,FALSE,0,2023,2023-2024
ID,2024-02-29,inter-ui,107,8,0,1,1,0,0,0,0,1,20,138,127,135,FALSE,0.978260869565217,2023,2023-2024
ID,2024-02-29,intra-total,2073,184,49,15,6,7,7,2,2,10,507,2862,2580,2764,FALSE,0.96575821104123,2023,2023-2024
ID,2024-02-29,intra-ucfe,36,3,1,0,0,2,0,0,0,0,2,44,38,41,FALSE,0.931818181818182,2023,2023-2024
ID,2024-02-29,intra-ucx,1,0,0,0,0,0,0,0,0,0,1,2,2,2,FALSE,1,2023,2023-2024
ID,2024-02-29,intra-ui,2036,181,48,15,6,5,7,2,2,10,504,2816,2540,2721,FALSE,0.966264204545455,2023,2023-2024
ID,2024-03-31,inter-total,55,8,1,0,2,0,0,0,0,2,19,87,74,82,FALSE,0.942528735632184,2023,2023-2024
ID,2024-03-31,inter-ucfe,3,0,0,0,0,0,0,0,0,0,1,4,4,4,FALSE,1,2023,2023-2024
ID,2024-03-31,inter-ucx,0,0,0,0,0,0,0,0,0,0,0,0,0,0,FALSE,0,2023,2023-2024
ID,2024-03-31,inter-ui,52,8,1,0,2,0,0,0,0,2,18,83,70,78,FALSE,0.939759036144578,2023,2023-2024
ID,2024-03-31,intra-total,1392,135,32,12,8,9,2,1,1,4,392,1988,1784,1919,FALSE,0.965291750503018,2023,2023-2024
ID,2024-03-31,intra-ucfe,10,2,2,0,0,0,0,0,0,1,3,18,13,15,FALSE,0.833333333333333,2023,2023-2024
ID,2024-03-31,intra-ucx,2,0,0,0,0,1,0,0,0,0,0,3,2,2,FALSE,0.666666666666667,2023,2023-2024
ID,2024-03-31,intra-ui,1380,133,30,12,8,8,2,1,1,3,389,1967,1769,1902,FALSE,0.966954753431622,2023,2023-2024
ID,2024-04-30,inter-total,46,3,1,0,1,0,0,0,1,0,14,66,60,63,FALSE,0.954545454545455,2023,2023-2024
ID,2024-04-30,inter-ucfe,0,0,0,0,0,0,0,0,0,0,0,0,0,0,FALSE,0,2023,2023-2024
ID,2024-04-30,inter-ucx,0,0,0,0,0,0,0,0,0,0,0,0,0,0,FALSE,0,2023,2023-2024
ID,2024-04-30,inter-ui,46,3,1,0,1,0,0,0,1,0,14,66,60,63,FALSE,0.954545454545455,2023,2023-2024
ID,2024-04-30,intra-total,1140,86,24,10,10,8,5,3,1,7,304,1598,1444,1530,FALSE,0.957446808510638,2023,2023-2024
ID,2024-04-30,intra-ucfe,3,1,0,0,0,0,0,0,0,0,2,6,5,6,FALSE,1,2023,2023-2024
ID,2024-04-30,intra-ucx,0,0,0,0,0,0,0,0,0,0,0,0,0,0,FALSE,0,2023,2023-2024
ID,2024-04-30,intra-ui,1137,85,24,10,10,8,5,3,1,7,302,1592,1439,1524,FALSE,0.957286432160804,2023,2023-2024
ID,2024-05-31,inter-total,39,3,0,1,0,0,0,0,0,0,12,55,51,54,FALSE,0.981818181818182,2023,2023-2024
ID,2024-05-31,inter-ucfe,0,1,0,1,0,0,0,0,0,0,0,2,0,1,FALSE,0.5,2023,2023-2024
ID,2024-05-31,inter-ucx,0,0,0,0,0,0,0,0,0,0,0,0,0,0,FALSE,0,2023,2023-2024
ID,2024-05-31,inter-ui,39,2,0,0,0,0,0,0,0,0,12,53,51,53,FALSE,1,2023,2023-2024
ID,2024-05-31,intra-total,861,106,23,9,12,2,1,0,2,2,288,1306,1149,1255,FALSE,0.960949464012251,2023,2023-2024
ID,2024-05-31,intra-ucfe,2,0,1,0,1,0,0,0,0,0,1,5,3,3,FALSE,0.6,2023,2023-2024
ID,2024-05-31,intra-ucx,1,0,0,0,0,0,0,0,0,0,1,2,2,2,FALSE,1,2023,2023-2024
ID,2024-05-31,intra-ui,858,106,22,9,11,2,1,0,2,2,286,1299,1144,1250,FALSE,0.962278675904542,2023,2023-2024
ID,2024-06-30,inter-total,40,7,2,1,2,0,1,0,1,0,11,65,51,58,FALSE,0.892307692307692,2023,2023-2024
ID,2024-06-30,inter-ucfe,0,0,0,1,0,0,0,0,0,0,0,1,0,0,FALSE,0,2023,2023-2024
ID,2024-06-30,inter-ucx,0,0,0,0,0,0,0,0,0,0,0,0,0,0,FALSE,0,2023,2023-2024
ID,2024-06-30,inter-ui,40,7,2,0,2,0,1,0,1,0,11,64,51,58,FALSE,0.90625,2023,2023-2024
ID,2024-06-30,intra-total,1130,127,40,3,9,3,3,1,0,2,324,1642,1454,1581,FALSE,0.962850182704019,2023,2023-2024
ID,2024-06-30,intra-ucfe,0,0,0,0,0,0,0,0,0,0,0,0,0,0,FALSE,0,2023,2023-2024
ID,2024-06-30,intra-ucx,2,0,0,0,0,0,0,0,0,0,0,2,2,2,FALSE,1,2023,2023-2024
ID,2024-06-30,intra-ui,1128,127,40,3,9,3,3,1,0,2,324,1640,1452,1579,FALSE,0.96280487804878,2023,2023-2024
ID,2024-07-31,inter-total,32,3,0,1,0,0,0,0,1,2,10,49,42,45,FALSE,0.918367346938776,2024,2024-2025
ID,2024-07-31,inter-ucfe,0,0,0,0,0,0,0,0,0,0,0,0,0,0,FALSE,0,2024,2024-2025
ID,2024-07-31,inter-ucx,0,0,0,0,0,0,0,0,0,0,0,0,0,0,FALSE,0,2024,2024-2025
ID,2024-07-31,inter-ui,32,3,0,1,0,0,0,0,1,2,10,49,42,45,FALSE,0.918367346938776,2024,2024-2025
ID,2024-07-31,intra-total,936,90,31,11,3,7,4,1,0,4,243,1330,1179,1269,FALSE,0.954135338345865,2024,2024-2025
ID,2024-07-31,intra-ucfe,1,0,0,0,0,0,0,0,0,0,1,2,2,2,FALSE,1,2024,2024-2025
ID,2024-07-31,intra-ucx,1,0,0,0,0,0,0,0,0,0,0,1,1,1,FALSE,1,2024,2024-2025
ID,2024-07-31,intra-ui,934,90,31,11,3,7,4,1,0,4,242,1327,1176,1266,FALSE,0.954031650339111,2024,2024-2025
ID,2024-08-31,inter-total,34,1,1,0,1,0,0,0,0,2,5,44,39,40,FALSE,0.909090909090909,2024,2024-2025
ID,2024-08-31,inter-ucfe,0,0,0,0,0,0,0,0,0,0,0,0,0,0,FALSE,0,2024,2024-2025
ID,2024-08-31,inter-ucx,0,0,0,0,0,0,0,0,0,0,0,0,0,0,FALSE,0,2024,2024-2025
ID,2024-08-31,inter-ui,34,1,1,0,1,0,0,0,0,2,5,44,39,40,FALSE,0.909090909090909,2024,2024-2025
ID,2024-08-31,intra-total,801,21,9,8,8,3,1,0,1,3,107,962,908,929,FALSE,0.965696465696466,2024,2024-2025
ID,2024-08-31,intra-ucfe,1,0,0,0,0,0,0,0,0,0,1,2,2,2,FALSE,1,2024,2024-2025
ID,2024-08-31,intra-ucx,1,0,0,0,0,0,0,0,0,0,0,1,1,1,FALSE,1,2024,2024-2025
ID,2024-08-31,intra-ui,799,21,9,8,8,3,1,0,1,3,106,959,905,926,FALSE,0.965589155370177,2024,2024-2025
ID,2024-09-30,inter-total,38,0,0,0,0,0,0,0,0,0,6,44,44,44,FALSE,1,2024,2024-2025
ID,2024-09-30,inter-ucfe,0,0,0,0,0,0,0,0,0,0,0,0,0,0,FALSE,0,2024,2024-2025
ID,2024-09-30,inter-ucx,0,0,0,0,0,0,0,0,0,0,0,0,0,0,FALSE,0,2024,2024-2025
ID,2024-09-30,inter-ui,38,0,0,0,0,0,0,0,0,0,6,44,44,44,FALSE,1,2024,2024-2025
ID,2024-09-30,intra-total,830,18,14,4,0,0,1,1,1,3,125,997,955,973,FALSE,0.97592778335005,2024,2024-2025
ID,2024-09-30,intra-ucfe,0,0,1,0,0,0,0,0,0,0,2,3,2,2,FALSE,0.666666666666667,2024,2024-2025
ID,2024-09-30,intra-ucx,1,1,0,0,0,0,0,0,0,0,0,2,1,2,FALSE,1,2024,2024-2025
ID,2024-09-30,intra-ui,829,17,13,4,0,0,1,1,1,3,123,992,952,969,FALSE,0.976814516129032,2024,2024-2025
ID,2024-10-31,inter-total,37,3,1,0,0,0,0,0,0,0,8,49,45,48,FALSE,0.979591836734694,2024,2024-2025
ID,2024-10-31,inter-ucfe,2,0,0,0,0,0,0,0,0,0,0,2,2,2,FALSE,1,2024,2024-2025
ID,2024-10-31,inter-ucx,0,0,0,0,0,0,0,0,0,0,0,0,0,0,FALSE,0,2024,2024-2025
ID,2024-10-31,inter-ui,35,3,1,0,0,0,0,0,0,0,8,47,43,46,FALSE,0.978723404255319,2024,2024-2025
ID,2024-10-31,intra-total,910,38,3,7,4,6,1,0,2,5,204,1180,1114,1152,FALSE,0.976271186440678,2024,2024-2025
ID,2024-10-31,intra-ucfe,5,0,0,0,0,0,0,0,0,0,1,6,6,6,FALSE,1,2024,2024-2025
ID,2024-10-31,intra-ucx,1,0,0,0,0,0,0,0,0,0,1,2,2,2,FALSE,1,2024,2024-2025
ID,2024-10-31,intra-ui,904,38,3,7,4,6,1,0,2,5,202,1172,1106,1144,FALSE,0.976109215017065,2024,2024-2025
ID,2024-11-30,inter-total,83,1,1,1,1,0,0,0,0,0,14,101,97,98,FALSE,0.97029702970297,2024,2024-2025
ID,2024-11-30,inter-ucfe,5,0,0,0,0,0,0,0,0,0,3,8,8,8,FALSE,1,2024,2024-2025
ID,2024-11-30,inter-ucx,0,0,0,0,0,0,0,0,0,0,0,0,0,0,FALSE,0,2024,2024-2025
ID,2024-11-30,inter-ui,78,1,1,1,1,0,0,0,0,0,11,93,89,90,FALSE,0.967741935483871,2024,2024-2025
ID,2024-11-30,intra-total,1413,22,8,5,3,2,0,0,0,6,177,1636,1590,1612,FALSE,0.985330073349633,2024,2024-2025
ID,2024-11-30,intra-ucfe,17,0,0,0,0,0,0,0,0,0,4,21,21,21,FALSE,1,2024,2024-2025
ID,2024-11-30,intra-ucx,1,0,0,0,0,0,0,0,0,0,0,1,1,1,FALSE,1,2024,2024-2025
ID,2024-11-30,intra-ui,1395,22,8,5,3,2,0,0,0,6,173,1614,1568,1590,FALSE,0.985130111524164,2024,2024-2025
ID,2024-12-31,inter-total,143,3,1,1,0,1,0,0,0,0,20,169,163,166,FALSE,0.982248520710059,2024,2024-2025
ID,2024-12-31,inter-ucfe,12,0,0,0,0,0,0,0,0,0,3,15,15,15,FALSE,1,2024,2024-2025
ID,2024-12-31,inter-ucx,0,0,0,0,0,0,0,0,0,0,0,0,0,0,FALSE,0,2024,2024-2025
ID,2024-12-31,inter-ui,131,3,1,1,0,1,0,0,0,0,17,154,148,151,FALSE,0.980519480519481,2024,2024-2025
ID,2024-12-31,intra-total,3486,58,20,10,5,3,0,1,0,3,365,3951,3851,3909,FALSE,0.989369779802582,2024,2024-2025
ID,2024-12-31,intra-ucfe,89,3,0,0,0,0,0,0,0,0,16,108,105,108,FALSE,1,2024,2024-2025
ID,2024-12-31,intra-ucx,3,0,0,0,0,0,0,0,0,0,0,3,3,3,FALSE,1,2024,2024-2025
ID,2024-12-31,intra-ui,3394,55,20,10,5,3,0,1,0,3,349,3840,3743,3798,FALSE,0.9890625,2024,2024-2025
IL,2019-01-31,inter-total,453,54,33,10,6,9,3,0,3,9,142,722,595,649,FALSE,0.898891966759003,2018,2018-2019
IL,2019-01-31,inter-ucfe,1,1,0,0,0,0,0,0,0,0,4,6,5,6,FALSE,1,2018,2018-2019
IL,2019-01-31,inter-ucx,1,0,0,0,0,0,0,0,0,0,0,1,1,1,FALSE,1,2018,2018-2019
IL,2019-01-31,inter-ui,451,53,33,10,6,9,3,0,3,9,138,715,589,642,FALSE,0.897902097902098,2018,2018-2019
IL,2019-01-31,intra-total,37388,980,366,235,171,108,66,57,39,105,5324,44839,42712,43692,FALSE,0.974419590088985,2018,2018-2019
IL,2019-01-31,intra-ucfe,618,27,7,0,1,0,1,0,0,1,83,738,701,728,FALSE,0.986449864498645,2018,2018-2019
IL,2019-01-31,intra-ucx,16,3,4,0,0,2,0,0,0,1,8,34,24,27,FALSE,0.794117647058824,2018,2018-2019
IL,2019-01-31,intra-ui,36754,950,355,235,170,106,65,57,39,103,5233,44067,41987,42937,FALSE,0.974357228765289,2018,2018-2019
IL,2019-02-28,inter-total,287,32,26,8,7,1,2,3,2,10,93,471,380,412,FALSE,0.874734607218684,2018,2018-2019
IL,2019-02-28,inter-ucfe,0,0,0,0,0,0,0,0,0,0,0,0,0,0,FALSE,0,2018,2018-2019
IL,2019-02-28,inter-ucx,0,0,0,0,0,0,0,0,0,0,0,0,0,0,FALSE,0,2018,2018-2019
IL,2019-02-28,inter-ui,287,32,26,8,7,1,2,3,2,10,93,471,380,412,FALSE,0.874734607218684,2018,2018-2019
IL,2019-02-28,intra-total,18362,702,337,207,178,119,79,51,32,76,3827,23970,22189,22891,FALSE,0.954985398414685,2018,2018-2019
IL,2019-02-28,intra-ucfe,23,14,9,0,2,0,1,0,0,1,17,67,40,54,FALSE,0.805970149253731,2018,2018-2019
IL,2019-02-28,intra-ucx,10,1,1,2,2,1,0,0,0,0,5,22,15,16,FALSE,0.727272727272727,2018,2018-2019
IL,2019-02-28,intra-ui,18329,687,327,205,174,118,78,51,32,75,3805,23881,22134,22821,FALSE,0.955613249026423,2018,2018-2019
IL,2019-03-31,inter-total,315,30,14,10,8,3,4,6,2,17,115,524,430,460,FALSE,0.877862595419847,2018,2018-2019
IL,2019-03-31,inter-ucfe,1,0,1,1,0,0,0,0,0,0,1,4,2,2,FALSE,0.5,2018,2018-2019
IL,2019-03-31,inter-ucx,1,0,0,0,0,0,0,0,0,0,0,1,1,1,FALSE,1,2018,2018-2019
IL,2019-03-31,inter-ui,313,30,13,9,8,3,4,6,2,17,114,519,427,457,FALSE,0.880539499036609,2018,2018-2019
IL,2019-03-31,intra-total,13585,576,199,232,158,114,85,49,40,112,2904,18054,16489,17065,FALSE,0.945219895867952,2018,2018-2019
IL,2019-03-31,intra-ucfe,30,7,6,0,2,0,2,0,0,0,7,54,37,44,FALSE,0.814814814814815,2018,2018-2019
IL,2019-03-31,intra-ucx,19,4,1,0,0,1,0,0,1,1,8,35,27,31,FALSE,0.885714285714286,2018,2018-2019
IL,2019-03-31,intra-ui,13536,565,192,232,156,113,83,49,39,111,2889,17965,16425,16990,FALSE,0.945727804063457,2018,2018-2019
IL,2019-04-30,inter-total,240,33,16,8,8,3,6,3,0,5,66,388,306,339,FALSE,0.873711340206186,2018,2018-2019
IL,2019-04-30,inter-ucfe,1,0,1,0,0,0,0,0,0,0,0,2,1,1,FALSE,0.5,2018,2018-2019
IL,2019-04-30,inter-ucx,0,0,0,0,0,0,0,0,0,0,0,0,0,0,FALSE,0,2018,2018-2019
IL,2019-04-30,inter-ui,239,33,15,8,8,3,6,3,0,5,66,386,305,338,FALSE,0.875647668393782,2018,2018-2019
IL,2019-04-30,intra-total,11216,639,244,203,155,96,61,28,28,78,2695,15443,13911,14550,FALSE,0.942174447969954,2018,2018-2019
IL,2019-04-30,intra-ucfe,25,3,3,2,0,2,0,0,0,0,10,45,35,38,FALSE,0.844444444444445,2018,2018-2019
IL,2019-04-30,intra-ucx,26,2,0,0,0,0,0,0,0,0,7,35,33,35,FALSE,1,2018,2018-2019
IL,2019-04-30,intra-ui,11165,634,241,201,155,94,61,28,28,78,2678,15363,13843,14477,FALSE,0.942328972205949,2018,2018-2019
IL,2019-05-31,inter-total,213,25,10,5,10,3,3,1,0,6,93,369,306,331,FALSE,0.897018970189702,2018,2018-2019
IL,2019-05-31,inter-ucfe,1,0,0,1,0,0,0,0,0,0,1,3,2,2,FALSE,0.666666666666667,2018,2018-2019
IL,2019-05-31,inter-ucx,0,0,0,0,0,0,0,0,0,0,0,0,0,0,FALSE,0,2018,2018-2019
IL,2019-05-31,inter-ui,212,25,10,4,10,3,3,1,0,6,92,366,304,329,FALSE,0.898907103825137,2018,2018-2019
IL,2019-05-31,intra-total,10141,504,219,202,142,88,60,47,22,96,2241,13762,12382,12886,FALSE,0.936346461270164,2018,2018-2019
IL,2019-05-31,intra-ucfe,34,3,4,1,0,1,0,0,0,1,6,50,40,43,FALSE,0.86,2018,2018-2019
IL,2019-05-31,intra-ucx,24,2,1,0,0,1,0,0,0,1,6,35,30,32,FALSE,0.914285714285714,2018,2018-2019
IL,2019-05-31,intra-ui,10083,499,214,201,142,86,60,47,22,94,2229,13677,12312,12811,FALSE,0.936682020911018,2018,2018-2019
IL,2019-06-30,inter-total,226,26,14,5,7,3,2,2,1,5,85,376,311,337,FALSE,0.896276595744681,2018,2018-2019
IL,2019-06-30,inter-ucfe,0,1,0,0,0,0,0,0,0,0,0,1,0,1,FALSE,1,2018,2018-2019
IL,2019-06-30,inter-ucx,0,0,0,0,0,0,0,0,0,0,0,0,0,0,FALSE,0,2018,2018-2019
IL,2019-06-30,inter-ui,226,25,14,5,7,3,2,2,1,5,85,375,311,336,FALSE,0.896,2018,2018-2019
IL,2019-06-30,intra-total,12652,457,194,149,122,82,68,33,15,84,2437,16293,15089,15546,FALSE,0.954152089854539,2018,2018-2019
IL,2019-06-30,intra-ucfe,21,6,1,0,1,0,2,2,0,0,10,43,31,37,FALSE,0.86046511627907,2018,2018-2019
IL,2019-06-30,intra-ucx,18,2,0,0,0,0,0,0,0,0,4,24,22,24,FALSE,1,2018,2018-2019
IL,2019-06-30,intra-ui,12613,449,193,149,121,82,66,31,15,84,2423,16226,15036,15485,FALSE,0.954332552693208,2018,2018-2019
IL,2019-07-31,inter-total,231,42,16,7,6,6,4,3,1,2,146,464,377,419,FALSE,0.90301724137931,2019,2019-2020
IL,2019-07-31,inter-ucfe,1,0,1,1,0,0,0,0,0,0,1,4,2,2,FALSE,0.5,2019,2019-2020
IL,2019-07-31,inter-ucx,0,0,0,0,0,0,0,0,0,0,0,0,0,0,FALSE,0,2019,2019-2020
IL,2019-07-31,inter-ui,230,42,15,6,6,6,4,3,1,2,145,460,375,417,FALSE,0.906521739130435,2019,2019-2020
IL,2019-07-31,intra-total,14012,832,360,242,154,105,68,43,36,82,3488,19422,17500,18332,FALSE,0.943878076408197,2019,2019-2020
IL,2019-07-31,intra-ucfe,25,7,4,4,0,0,0,0,0,2,7,49,32,39,FALSE,0.795918367346939,2019,2019-2020
IL,2019-07-31,intra-ucx,22,2,4,2,0,1,0,0,0,0,3,34,25,27,FALSE,0.794117647058824,2019,2019-2020
IL,2019-07-31,intra-ui,13965,823,352,236,154,104,68,43,36,80,3478,19339,17443,18266,FALSE,0.944516262474792,2019,2019-2020
IL,2019-08-31,inter-total,239,35,16,11,12,4,1,5,4,4,88,419,327,362,FALSE,0.863961813842482,2019,2019-2020
IL,2019-08-31,inter-ucfe,0,0,1,0,1,0,0,0,0,0,0,2,0,0,FALSE,0,2019,2019-2020
IL,2019-08-31,inter-ucx,0,1,0,0,0,0,0,0,0,0,0,1,0,1,FALSE,1,2019,2019-2020
IL,2019-08-31,inter-ui,239,34,15,11,11,4,1,5,4,4,88,416,327,361,FALSE,0.867788461538462,2019,2019-2020
IL,2019-08-31,intra-total,10173,535,251,221,182,118,83,55,23,92,2495,14228,12668,13203,FALSE,0.927958954174867,2019,2019-2020
IL,2019-08-31,intra-ucfe,18,1,4,0,1,2,0,0,2,1,9,38,27,28,FALSE,0.736842105263158,2019,2019-2020
IL,2019-08-31,intra-ucx,20,4,1,0,0,0,0,0,0,1,7,33,27,31,FALSE,0.939393939393939,2019,2019-2020
IL,2019-08-31,intra-ui,10135,530,246,221,181,116,83,55,21,90,2479,14157,12614,13144,FALSE,0.928445292081656,2019,2019-2020
IL,2019-09-30,inter-total,191,29,11,7,9,6,5,4,0,5,89,356,280,309,FALSE,0.867977528089888,2019,2019-2020
IL,2019-09-30,inter-ucfe,0,0,0,0,0,0,0,0,0,0,1,1,1,1,FALSE,1,2019,2019-2020
IL,2019-09-30,inter-ucx,1,0,0,0,0,0,0,0,0,0,0,1,1,1,FALSE,1,2019,2019-2020
IL,2019-09-30,inter-ui,190,29,11,7,9,6,5,4,0,5,88,354,278,307,FALSE,0.867231638418079,2019,2019-2020
IL,2019-09-30,intra-total,9051,502,192,179,136,79,74,51,29,103,2421,12817,11472,11974,FALSE,0.9342279784661,2019,2019-2020
IL,2019-09-30,intra-ucfe,29,11,3,3,2,0,0,1,0,2,8,59,37,48,FALSE,0.813559322033898,2019,2019-2020
IL,2019-09-30,intra-ucx,20,5,3,1,0,0,0,1,0,0,7,37,27,32,FALSE,0.864864864864865,2019,2019-2020
IL,2019-09-30,intra-ui,9002,486,186,175,134,79,74,49,29,101,2406,12721,11408,11894,FALSE,0.934989387626759,2019,2019-2020
IL,2019-10-31,inter-total,213,27,12,5,6,1,2,0,3,7,77,353,290,317,FALSE,0.898016997167139,2019,2019-2020
IL,2019-10-31,inter-ucfe,0,1,0,0,0,0,0,0,0,0,0,1,0,1,FALSE,1,2019,2019-2020
IL,2019-10-31,inter-ucx,0,0,0,0,0,0,0,0,0,0,0,0,0,0,FALSE,0,2019,2019-2020
IL,2019-10-31,inter-ui,213,26,12,5,6,1,2,0,3,7,77,352,290,316,FALSE,0.897727272727273,2019,2019-2020
IL,2019-10-31,intra-total,11064,527,224,192,123,77,53,33,17,76,2380,14766,13444,13971,FALSE,0.946160097521333,2019,2019-2020
IL,2019-10-31,intra-ucfe,32,8,2,5,3,0,0,0,0,1,11,62,43,51,FALSE,0.82258064516129,2019,2019-2020
IL,2019-10-31,intra-ucx,24,2,2,2,0,0,0,0,0,1,6,37,30,32,FALSE,0.864864864864865,2019,2019-2020
IL,2019-10-31,intra-ui,11008,517,220,185,120,77,53,33,17,74,2363,14667,13371,13888,FALSE,0.946887570737029,2019,2019-2020
IL,2019-11-30,inter-total,272,31,22,10,2,3,0,2,0,5,95,442,367,398,FALSE,0.900452488687783,2019,2019-2020
IL,2019-11-30,inter-ucfe,0,0,1,0,0,1,0,0,0,0,1,3,1,1,FALSE,0.333333333333333,2019,2019-2020
IL,2019-11-30,inter-ucx,0,0,1,0,0,0,0,0,0,0,0,1,0,0,FALSE,0,2019,2019-2020
IL,2019-11-30,inter-ui,272,31,20,10,2,2,0,2,0,5,94,438,366,397,FALSE,0.906392694063927,2019,2019-2020
IL,2019-11-30,intra-total,13773,487,233,169,118,70,43,22,13,81,2394,17403,16167,16654,FALSE,0.956961443429294,2019,2019-2020
IL,2019-11-30,intra-ucfe,31,6,6,0,1,1,1,0,0,1,10,57,41,47,FALSE,0.824561403508772,2019,2019-2020
IL,2019-11-30,intra-ucx,17,2,3,1,0,1,0,0,0,1,7,32,24,26,FALSE,0.8125,2019,2019-2020
IL,2019-11-30,intra-ui,13725,479,224,168,117,68,42,22,13,79,2377,17314,16102,16581,FALSE,0.957664317893035,2019,2019-2020
IL,2019-12-31,inter-total,386,57,23,10,6,3,2,2,0,7,159,655,545,602,FALSE,0.919083969465649,2019,2019-2020
IL,2019-12-31,inter-ucfe,0,0,0,0,0,0,0,0,0,0,0,0,0,0,FALSE,0,2019,2019-2020
IL,2019-12-31,inter-ucx,0,0,0,0,0,0,0,0,0,0,0,0,0,0,FALSE,0,2019,2019-2020
IL,2019-12-31,inter-ui,386,57,23,10,6,3,2,2,0,7,159,655,545,602,FALSE,0.919083969465649,2019,2019-2020
IL,2019-12-31,intra-total,25829,773,299,199,148,96,69,41,23,97,4198,31772,30027,30800,FALSE,0.969407025053506,2019,2019-2020
IL,2019-12-31,intra-ucfe,37,4,3,2,1,0,1,0,1,2,12,63,49,53,FALSE,0.841269841269841,2019,2019-2020
IL,2019-12-31,intra-ucx,21,2,2,2,0,0,0,0,0,0,4,31,25,27,FALSE,0.870967741935484,2019,2019-2020
IL,2019-12-31,intra-ui,25771,767,294,195,147,96,68,41,22,95,4182,31678,29953,30720,FALSE,0.969758191805038,2019,2019-2020
IL,2020-01-31,inter-total,545,53,15,21,9,7,4,2,1,11,177,845,722,775,FALSE,0.917159763313609,2019,2019-2020
IL,2020-01-31,inter-ucfe,2,1,0,0,0,0,0,0,0,0,1,4,3,4,FALSE,1,2019,2019-2020
IL,2020-01-31,inter-ucx,0,0,0,0,0,0,0,0,0,0,0,0,0,0,FALSE,0,2019,2019-2020
IL,2020-01-31,inter-ui,543,52,15,21,9,7,4,2,1,11,176,841,719,771,FALSE,0.916765755053508,2019,2019-2020
IL,2020-01-31,intra-total,38052,993,434,206,154,99,75,68,32,120,5465,45698,43517,44510,FALSE,0.97400323865377,2019,2019-2020
IL,2020-01-31,intra-ucfe,17,8,2,1,3,0,1,0,0,1,7,40,24,32,FALSE,0.8,2019,2019-2020
IL,2020-01-31,intra-ucx,11,3,2,0,0,0,0,0,0,0,7,23,18,21,FALSE,0.91304347826087,2019,2019-2020
IL,2020-01-31,intra-ui,38024,982,430,205,151,99,74,68,32,119,5451,45635,43475,44457,FALSE,0.974186479675688,2019,2019-2020
IL,2020-02-29,inter-total,263,43,23,13,8,1,4,2,2,6,121,486,384,427,FALSE,0.878600823045268,2019,2019-2020
IL,2020-02-29,inter-ucfe,0,1,1,0,0,0,0,0,0,0,0,2,0,1,FALSE,0.5,2019,2019-2020
IL,2020-02-29,inter-ucx,0,0,0,0,0,0,0,0,0,0,0,0,0,0,FALSE,0,2019,2019-2020
IL,2020-02-29,inter-ui,263,42,22,13,8,1,4,2,2,6,121,484,384,426,FALSE,0.880165289256198,2019,2019-2020
IL,2020-02-29,intra-total,18011,789,334,195,159,118,103,52,28,90,3985,23864,21996,22785,FALSE,0.954785450888367,2019,2019-2020
IL,2020-02-29,intra-ucfe,9,6,2,2,2,1,2,2,0,2,4,32,13,19,FALSE,0.59375,2019,2019-2020
IL,2020-02-29,intra-ucx,16,3,2,0,1,1,0,0,0,0,6,29,22,25,FALSE,0.862068965517241,2019,2019-2020
IL,2020-02-29,intra-ui,17986,780,330,193,156,116,101,50,28,88,3975,23803,21961,22741,FALSE,0.955383775154392,2019,2019-2020
IL,2020-03-31,inter-total,161,34,5,11,5,7,2,3,0,7,251,486,412,446,FALSE,0.917695473251029,2019,2019-2020
IL,2020-03-31,inter-ucfe,0,0,0,0,0,0,0,0,0,0,0,0,0,0,FALSE,0,2019,2019-2020
IL,2020-03-31,inter-ucx,0,0,0,0,0,0,0,0,0,0,0,0,0,0,FALSE,0,2019,2019-2020
IL,2020-03-31,inter-ui,161,34,5,11,5,7,2,3,0,7,251,486,412,446,FALSE,0.917695473251029,2019,2019-2020
IL,2020-03-31,intra-total,10524,962,292,214,179,124,79,36,31,109,33720,46270,44244,45206,FALSE,0.977004538577912,2019,2019-2020
IL,2020-03-31,intra-ucfe,10,5,2,4,4,3,1,2,2,1,11,45,21,26,FALSE,0.577777777777778,2019,2019-2020
IL,2020-03-31,intra-ucx,15,2,0,0,0,0,0,0,0,0,4,21,19,21,FALSE,1,2019,2019-2020
IL,2020-03-31,intra-ui,10499,955,290,210,175,121,78,34,29,108,33705,46204,44204,45159,FALSE,0.977382910570513,2019,2019-2020
IL,2020-04-30,inter-total,101,595,136,49,15,5,5,5,1,8,3838,4758,3939,4534,FALSE,0.952921395544346,2019,2019-2020
IL,2020-04-30,inter-ucfe,0,1,1,0,0,1,0,0,0,0,0,3,0,1,FALSE,0.333333333333333,2019,2019-2020
IL,2020-04-30,inter-ucx,0,0,0,0,0,0,0,0,0,0,0,0,0,0,FALSE,0,2019,2019-2020
IL,2020-04-30,inter-ui,101,594,135,49,15,4,5,5,1,8,3838,4755,3939,4533,FALSE,0.953312302839117,2019,2019-2020
IL,2020-04-30,intra-total,9192,46031,8331,2950,678,90,55,38,34,121,346477,413997,355669,401700,FALSE,0.97029688620932,2019,2019-2020
IL,2020-04-30,intra-ucfe,3,24,14,4,3,3,0,0,0,2,36,89,39,63,FALSE,0.707865168539326,2019,2019-2020
IL,2020-04-30,intra-ucx,1,15,5,2,0,0,0,0,0,0,30,53,31,46,FALSE,0.867924528301887,2019,2019-2020
IL,2020-04-30,intra-ui,9188,45992,8312,2944,675,87,55,38,34,119,346411,413855,355599,401591,FALSE,0.970366432687777,2019,2019-2020
IL,2020-05-31,inter-total,54,356,212,122,119,100,69,31,8,7,2277,3355,2331,2687,FALSE,0.800894187779434,2019,2019-2020
IL,2020-05-31,inter-ucfe,0,0,0,0,0,1,0,0,0,0,2,3,2,2,FALSE,0.666666666666667,2019,2019-2020
IL,2020-05-31,inter-ucx,0,0,0,0,0,0,0,0,0,0,1,1,1,1,FALSE,1,2019,2019-2020
IL,2020-05-31,inter-ui,54,356,212,122,119,99,69,31,8,7,2274,3351,2328,2684,FALSE,0.800954938824232,2019,2019-2020
IL,2020-05-31,intra-total,3133,16674,8690,9093,8650,7432,4517,1856,559,163,140709,201476,143842,160516,FALSE,0.796700351406619,2019,2019-2020
IL,2020-05-31,intra-ucfe,4,14,7,17,12,9,9,7,5,7,30,121,34,48,FALSE,0.396694214876033,2019,2019-2020
IL,2020-05-31,intra-ucx,0,8,9,1,5,4,2,0,0,0,25,54,25,33,FALSE,0.611111111111111,2019,2019-2020
IL,2020-05-31,intra-ui,3129,16652,8674,9075,8633,7419,4506,1849,554,156,140654,201301,143783,160435,FALSE,0.796990576301161,2019,2019-2020
IL,2020-06-30,inter-total,22,228,114,68,58,40,85,94,85,210,1176,2180,1198,1426,FALSE,0.654128440366972,2019,2019-2020
IL,2020-06-30,inter-ucfe,0,0,0,0,0,0,0,0,1,0,0,1,0,0,FALSE,0,2019,2019-2020
IL,2020-06-30,inter-ucx,0,0,0,0,0,0,0,0,0,1,0,1,0,0,FALSE,0,2019,2019-2020
IL,2020-06-30,inter-ui,22,228,114,68,58,40,85,94,84,209,1176,2178,1198,1426,FALSE,0.654729109274564,2019,2019-2020
IL,2020-06-30,intra-total,1568,9196,2818,2050,1657,1813,2622,3928,4047,9563,79301,118563,80869,90065,FALSE,0.759638335737119,2019,2019-2020
IL,2020-06-30,intra-ucfe,1,8,9,13,3,7,2,10,5,12,29,99,30,38,FALSE,0.383838383838384,2019,2019-2020
IL,2020-06-30,intra-ucx,0,8,5,7,1,2,2,2,0,5,26,58,26,34,FALSE,0.586206896551724,2019,2019-2020
IL,2020-06-30,intra-ui,1567,9180,2804,2030,1653,1804,2618,3916,4042,9546,79246,118406,80813,89993,FALSE,0.760037498099759,2019,2019-2020
IL,2020-07-31,inter-total,16,177,43,38,26,29,28,24,23,264,927,1595,943,1120,FALSE,0.702194357366771,2020,2020-2021
IL,2020-07-31,inter-ucfe,0,0,0,1,0,0,1,0,0,0,0,2,0,0,FALSE,0,2020,2020-2021
IL,2020-07-31,inter-ucx,0,0,0,0,0,0,0,0,0,1,2,3,2,2,FALSE,0.666666666666667,2020,2020-2021
IL,2020-07-31,inter-ui,16,177,43,37,26,29,27,24,23,263,925,1590,941,1118,FALSE,0.70314465408805,2020,2020-2021
IL,2020-07-31,intra-total,865,7566,2901,2067,1353,1127,913,864,806,11149,54886,84497,55751,63317,FALSE,0.749340213262009,2020,2020-2021
IL,2020-07-31,intra-ucfe,0,10,9,8,7,4,7,1,3,29,26,104,26,36,FALSE,0.346153846153846,2020,2020-2021
IL,2020-07-31,intra-ucx,0,16,5,3,1,3,3,3,1,10,17,62,17,33,FALSE,0.532258064516129,2020,2020-2021
IL,2020-07-31,intra-ui,865,7540,2887,2056,1345,1120,903,860,802,11110,54843,84331,55708,63248,FALSE,0.749997035491101,2020,2020-2021
IL,2020-08-31,inter-total,2,110,29,19,16,26,14,13,12,281,620,1142,622,732,FALSE,0.640980735551664,2020,2020-2021
IL,2020-08-31,inter-ucfe,0,0,0,1,1,0,0,0,0,1,0,3,0,0,FALSE,0,2020,2020-2021
IL,2020-08-31,inter-ucx,0,0,0,0,0,0,0,0,0,0,1,1,1,1,FALSE,1,2020,2020-2021
IL,2020-08-31,inter-ui,2,110,29,18,15,26,14,13,12,280,619,1138,621,731,FALSE,0.642355008787346,2020,2020-2021
IL,2020-08-31,intra-total,382,4130,1535,1348,1228,1077,964,835,940,13352,29143,54934,29525,33655,FALSE,0.612644264025922,2020,2020-2021
IL,2020-08-31,intra-ucfe,2,13,6,7,3,3,6,3,2,36,19,100,21,34,FALSE,0.34,2020,2020-2021
IL,2020-08-31,intra-ucx,0,7,3,4,0,7,1,3,1,18,24,68,24,31,FALSE,0.455882352941176,2020,2020-2021
IL,2020-08-31,intra-ui,380,4110,1526,1337,1225,1067,957,829,937,13298,29100,54766,29480,33590,FALSE,0.613336741774093,2020,2020-2021
IL,2020-09-30,inter-total,5,165,23,22,21,21,15,14,18,258,574,1136,579,744,FALSE,0.654929577464789,2020,2020-2021
IL,2020-09-30,inter-ucfe,0,0,0,1,0,0,1,0,1,1,1,5,1,1,FALSE,0.2,2020,2020-2021
IL,2020-09-30,inter-ucx,0,0,0,0,0,0,0,0,0,0,1,1,1,1,FALSE,1,2020,2020-2021
IL,2020-09-30,inter-ui,5,165,23,21,21,21,14,14,17,257,572,1130,577,742,FALSE,0.656637168141593,2020,2020-2021
IL,2020-09-30,intra-total,340,3398,1035,713,636,661,714,675,644,10254,24097,43167,24437,27835,FALSE,0.644821275511386,2020,2020-2021
IL,2020-09-30,intra-ucfe,0,7,7,5,9,8,5,4,4,31,16,96,16,23,FALSE,0.239583333333333,2020,2020-2021
IL,2020-09-30,intra-ucx,0,7,2,2,2,0,1,2,0,10,15,41,15,22,FALSE,0.536585365853659,2020,2020-2021
IL,2020-09-30,intra-ui,340,3384,1026,706,625,653,708,669,640,10213,24066,43030,24406,27790,FALSE,0.645828491749942,2020,2020-2021
IL,2020-10-31,inter-total,12,229,41,26,14,19,17,9,16,217,1724,2324,1736,1965,FALSE,0.84552495697074,2020,2020-2021
IL,2020-10-31,inter-ucfe,0,0,0,0,0,1,0,0,1,0,0,2,0,0,FALSE,0,2020,2020-2021
IL,2020-10-31,inter-ucx,0,0,0,0,0,0,0,0,0,0,0,0,0,0,FALSE,0,2020,2020-2021
IL,2020-10-31,inter-ui,12,229,41,26,14,18,17,9,15,217,1724,2322,1736,1965,FALSE,0.84625322997416,2020,2020-2021
IL,2020-10-31,intra-total,293,4797,827,623,578,472,395,312,300,7112,36568,52277,36861,41658,FALSE,0.796870516670811,2020,2020-2021
IL,2020-10-31,intra-ucfe,1,13,10,4,5,2,5,4,4,32,22,102,23,36,FALSE,0.352941176470588,2020,2020-2021
IL,2020-10-31,intra-ucx,0,7,0,1,2,2,4,2,2,13,22,55,22,29,FALSE,0.527272727272727,2020,2020-2021
IL,2020-10-31,intra-ui,292,4777,817,618,571,468,386,306,294,7067,36524,52120,36816,41593,FALSE,0.798023791250959,2020,2020-2021
IL,2020-11-30,inter-total,5,601,138,25,21,16,9,14,9,106,4372,5316,4377,4978,FALSE,0.936418359668924,2020,2020-2021
IL,2020-11-30,inter-ucfe,0,2,0,0,1,0,0,0,0,1,0,4,0,2,FALSE,0.5,2020,2020-2021
IL,2020-11-30,inter-ucx,0,0,0,0,0,0,0,0,0,0,0,0,0,0,FALSE,0,2020,2020-2021
IL,2020-11-30,inter-ui,5,599,138,25,20,16,9,14,9,105,4372,5312,4377,4976,FALSE,0.936746987951807,2020,2020-2021
IL,2020-11-30,intra-total,332,8769,1580,466,332,252,180,148,137,3345,58424,73965,58756,67525,FALSE,0.912931792063814,2020,2020-2021
IL,2020-11-30,intra-ucfe,1,18,13,4,5,2,3,4,2,20,24,96,25,43,FALSE,0.447916666666667,2020,2020-2021
IL,2020-11-30,intra-ucx,1,1,3,2,1,1,0,1,0,9,11,30,12,13,FALSE,0.433333333333333,2020,2020-2021
IL,2020-11-30,intra-ui,330,8750,1564,460,326,249,177,143,135,3316,58389,73839,58719,67469,FALSE,0.913731226045856,2020,2020-2021
IL,2020-12-31,inter-total,6,497,64,26,16,16,10,8,12,94,3848,4597,3854,4351,FALSE,0.946486839242985,2020,2020-2021
IL,2020-12-31,inter-ucfe,0,0,0,0,0,0,0,0,0,0,2,2,2,2,FALSE,1,2020,2020-2021
IL,2020-12-31,inter-ucx,0,1,0,0,0,0,0,0,0,0,0,1,0,1,FALSE,1,2020,2020-2021
IL,2020-12-31,inter-ui,6,496,64,26,16,16,10,8,12,94,3846,4594,3852,4348,FALSE,0.946451893774488,2020,2020-2021
IL,2020-12-31,intra-total,599,8567,1698,871,498,361,242,173,149,2453,56261,71872,56860,65427,FALSE,0.910326691896705,2020,2020-2021
IL,2020-12-31,intra-ucfe,0,23,11,20,17,12,8,3,1,30,36,161,36,59,FALSE,0.366459627329193,2020,2020-2021
IL,2020-12-31,intra-ucx,0,3,4,4,2,1,0,1,0,12,13,40,13,16,FALSE,0.4,2020,2020-2021
IL,2020-12-31,intra-ui,599,8541,1683,847,479,348,234,169,148,2411,56212,71671,56811,65352,FALSE,0.911833237990261,2020,2020-2021
IL,2021-01-31,inter-total,2,204,51,22,22,15,11,4,6,48,906,1291,908,1112,FALSE,0.861347792408985,2020,2020-2021
IL,2021-01-31,inter-ucfe,0,0,0,0,0,0,0,0,0,0,0,0,0,0,FALSE,0,2020,2020-2021
IL,2021-01-31,inter-ucx,0,0,0,0,0,0,0,0,0,0,0,0,0,0,FALSE,0,2020,2020-2021
IL,2021-01-31,inter-ui,2,204,51,22,22,15,11,4,6,48,906,1291,908,1112,FALSE,0.861347792408985,2020,2020-2021
IL,2021-01-31,intra-total,520,7049,1391,886,548,401,288,200,173,1525,41896,54877,42416,49465,FALSE,0.901379448585017,2020,2020-2021
IL,2021-01-31,intra-ucfe,2,30,23,14,4,9,9,7,6,17,71,192,73,103,FALSE,0.536458333333333,2020,2020-2021
IL,2021-01-31,intra-ucx,1,6,2,2,3,2,2,1,1,7,13,40,14,20,FALSE,0.5,2020,2020-2021
IL,2021-01-31,intra-ui,517,7013,1366,870,541,390,277,192,166,1501,41812,54645,42329,49342,FALSE,0.902955439655961,2020,2020-2021
IL,2021-02-28,inter-total,6,90,84,44,38,34,12,10,6,78,244,646,250,340,FALSE,0.526315789473684,2020,2020-2021
IL,2021-02-28,inter-ucfe,0,0,0,1,1,0,1,0,0,1,0,4,0,0,FALSE,0,2020,2020-2021
IL,2021-02-28,inter-ucx,0,0,1,0,0,0,0,0,0,0,0,1,0,0,FALSE,0,2020,2020-2021
IL,2021-02-28,inter-ui,6,90,83,43,37,34,11,10,6,77,244,641,250,340,FALSE,0.530421216848674,2020,2020-2021
IL,2021-02-28,intra-total,293,4583,1210,731,617,489,305,233,212,1161,23293,33127,23586,28169,FALSE,0.850333564765901,2020,2020-2021
IL,2021-02-28,intra-ucfe,0,17,22,13,15,9,9,0,2,28,15,130,15,32,FALSE,0.246153846153846,2020,2020-2021
IL,2021-02-28,intra-ucx,0,4,3,2,1,0,0,1,1,8,18,38,18,22,FALSE,0.578947368421053,2020,2020-2021
IL,2021-02-28,intra-ui,293,4562,1185,716,601,480,296,232,209,1125,23260,32959,23553,28115,FALSE,0.853029521526745,2020,2020-2021
IL,2021-03-31,inter-total,5,86,49,44,28,21,19,32,15,96,239,634,244,330,FALSE,0.520504731861199,2020,2020-2021
IL,2021-03-31,inter-ucfe,0,0,1,0,0,0,0,0,0,1,0,2,0,0,FALSE,0,2020,2020-2021
IL,2021-03-31,inter-ucx,0,0,0,0,0,0,0,0,0,0,0,0,0,0,FALSE,0,2020,2020-2021
IL,2021-03-31,inter-ui,5,86,48,44,28,21,19,32,15,95,239,632,244,330,FALSE,0.522151898734177,2020,2020-2021
IL,2021-03-31,intra-total,334,3402,982,675,539,477,417,335,315,1641,28920,38037,29254,32656,FALSE,0.858532481531141,2020,2020-2021
IL,2021-03-31,intra-ucfe,1,3,12,7,6,5,10,7,6,43,23,123,24,27,FALSE,0.219512195121951,2020,2020-2021
IL,2021-03-31,intra-ucx,0,5,1,4,2,2,2,0,0,4,15,35,15,20,FALSE,0.571428571428571,2020,2020-2021
IL,2021-03-31,intra-ui,333,3394,969,664,531,470,405,328,309,1594,28882,37879,29215,32609,FALSE,0.860872779112437,2020,2020-2021
IL,2021-04-30,inter-total,13,133,41,24,23,13,15,11,13,100,482,868,495,628,FALSE,0.723502304147465,2020,2020-2021
IL,2021-04-30,inter-ucfe,0,0,0,0,0,1,0,0,1,0,0,2,0,0,FALSE,0,2020,2020-2021
IL,2021-04-30,inter-ucx,0,0,0,0,0,0,0,0,0,0,0,0,0,0,FALSE,0,2020,2020-2021
IL,2021-04-30,inter-ui,13,133,41,24,23,12,15,11,12,100,482,866,495,628,FALSE,0.725173210161663,2020,2020-2021
IL,2021-04-30,intra-total,582,11757,1278,668,367,277,247,226,195,1485,53183,70265,53765,65522,FALSE,0.93249839891838,2020,2020-2021
IL,2021-04-30,intra-ucfe,0,9,8,8,4,1,1,4,4,41,23,103,23,32,FALSE,0.310679611650485,2020,2020-2021
IL,2021-04-30,intra-ucx,0,6,1,2,1,1,0,1,1,4,12,29,12,18,FALSE,0.620689655172414,2020,2020-2021
IL,2021-04-30,intra-ui,582,11742,1269,658,362,275,246,221,190,1440,53148,70133,53730,65472,FALSE,0.933540558652845,2020,2020-2021
IL,2021-05-31,inter-total,4,239,72,52,39,9,13,16,5,78,376,903,380,619,FALSE,0.685492801771872,2020,2020-2021
IL,2021-05-31,inter-ucfe,0,1,0,0,0,0,0,0,0,0,0,1,0,1,FALSE,1,2020,2020-2021
IL,2021-05-31,inter-ucx,0,0,0,0,1,0,0,0,0,0,0,1,0,0,FALSE,0,2020,2020-2021
IL,2021-05-31,inter-ui,4,238,72,52,38,9,13,16,5,78,376,901,380,618,FALSE,0.685904550499445,2020,2020-2021
IL,2021-05-31,intra-total,316,6101,1307,867,673,553,365,240,182,1396,24397,36397,24713,30814,FALSE,0.846608236942605,2020,2020-2021
IL,2021-05-31,intra-ucfe,0,5,6,9,3,4,3,2,1,40,19,92,19,24,FALSE,0.260869565217391,2020,2020-2021
IL,2021-05-31,intra-ucx,0,3,3,2,1,1,1,0,0,4,11,26,11,14,FALSE,0.538461538461538,2020,2020-2021
IL,2021-05-31,intra-ui,316,6093,1298,856,669,548,361,238,181,1352,24367,36279,24683,30776,FALSE,0.848314451886767,2020,2020-2021
IL,2021-06-30,inter-total,5,84,50,31,34,14,18,10,7,69,425,747,430,514,FALSE,0.688085676037483,2020,2020-2021
IL,2021-06-30,inter-ucfe,0,0,1,0,0,0,0,0,0,0,2,3,2,2,FALSE,0.666666666666667,2020,2020-2021
IL,2021-06-30,inter-ucx,0,0,0,0,0,0,0,0,0,0,0,0,0,0,FALSE,0,2020,2020-2021
IL,2021-06-30,inter-ui,5,84,49,31,34,14,18,10,7,69,423,744,428,512,FALSE,0.688172043010753,2020,2020-2021
IL,2021-06-30,intra-total,467,4957,1211,594,433,353,270,265,231,1403,36252,46436,36719,41676,FALSE,0.89749332414506,2020,2020-2021
IL,2021-06-30,intra-ucfe,0,12,6,6,5,4,6,2,1,20,18,80,18,30,FALSE,0.375,2020,2020-2021
IL,2021-06-30,intra-ucx,1,4,5,1,1,1,2,1,1,10,12,39,13,17,FALSE,0.435897435897436,2020,2020-2021
IL,2021-06-30,intra-ui,466,4941,1200,587,427,348,262,262,229,1373,36222,46317,36688,41629,FALSE,0.898784463587884,2020,2020-2021
IL,2021-07-31,inter-total,3,74,33,29,10,14,9,6,5,44,397,624,400,474,FALSE,0.759615384615385,2021,2021-2022
IL,2021-07-31,inter-ucfe,0,0,0,1,1,0,0,0,0,0,0,2,0,0,FALSE,0,2021,2021-2022
IL,2021-07-31,inter-ucx,0,0,0,0,0,0,0,0,0,0,0,0,0,0,FALSE,0,2021,2021-2022
IL,2021-07-31,inter-ui,3,74,33,28,9,14,9,6,5,44,397,622,400,474,FALSE,0.762057877813505,2021,2021-2022
IL,2021-07-31,intra-total,394,6703,2465,1232,756,556,411,240,162,1219,29648,43786,30042,36745,FALSE,0.839195176540447,2021,2021-2022
IL,2021-07-31,intra-ucfe,0,7,12,7,3,5,3,3,3,14,28,85,28,35,FALSE,0.411764705882353,2021,2021-2022
IL,2021-07-31,intra-ucx,1,5,4,1,3,6,3,1,0,4,9,37,10,15,FALSE,0.405405405405405,2021,2021-2022
IL,2021-07-31,intra-ui,393,6691,2449,1224,750,545,405,236,159,1201,29611,43664,30004,36695,FALSE,0.840394833272261,2021,2021-2022
IL,2021-08-31,inter-total,3,80,32,33,18,12,6,4,7,44,606,845,609,689,FALSE,0.815384615384615,2021,2021-2022
IL,2021-08-31,inter-ucfe,0,0,0,0,1,0,0,0,0,0,0,1,0,0,FALSE,0,2021,2021-2022
IL,2021-08-31,inter-ucx,0,0,0,0,0,0,0,0,0,0,0,0,0,0,FALSE,0,2021,2021-2022
IL,2021-08-31,inter-ui,3,80,32,33,17,12,6,4,7,44,606,844,609,689,FALSE,0.816350710900474,2021,2021-2022
IL,2021-08-31,intra-total,217,3808,1203,1334,760,543,503,413,348,1557,16138,26824,16355,20163,FALSE,0.751677602147331,2021,2021-2022
IL,2021-08-31,intra-ucfe,0,13,9,3,5,2,1,3,1,11,12,60,12,25,FALSE,0.416666666666667,2021,2021-2022
IL,2021-08-31,intra-ucx,0,4,4,2,2,0,0,0,2,12,12,38,12,16,FALSE,0.421052631578947,2021,2021-2022
IL,2021-08-31,intra-ui,217,3791,1190,1329,753,541,502,410,345,1534,16114,26726,16331,20122,FALSE,0.752899797949562,2021,2021-2022
IL,2021-09-30,inter-total,0,146,30,13,11,14,13,10,12,54,684,987,684,830,FALSE,0.840932117527862,2021,2021-2022
IL,2021-09-30,inter-ucfe,0,0,0,0,1,0,2,2,0,2,0,7,0,0,FALSE,0,2021,2021-2022
IL,2021-09-30,inter-ucx,0,0,0,0,0,0,0,0,0,0,0,0,0,0,FALSE,0,2021,2021-2022
IL,2021-09-30,inter-ui,0,146,30,13,10,14,11,8,12,52,684,980,684,830,FALSE,0.846938775510204,2021,2021-2022
IL,2021-09-30,intra-total,90,1950,613,424,273,207,206,169,191,1538,9054,14715,9144,11094,FALSE,0.753924566768603,2021,2021-2022
IL,2021-09-30,intra-ucfe,0,4,4,2,2,1,1,1,4,20,19,58,19,23,FALSE,0.396551724137931,2021,2021-2022
IL,2021-09-30,intra-ucx,0,6,3,5,0,0,1,0,0,6,13,34,13,19,FALSE,0.558823529411765,2021,2021-2022
IL,2021-09-30,intra-ui,90,1940,606,417,271,206,204,168,187,1512,9022,14623,9112,11052,FALSE,0.755795664364358,2021,2021-2022
IL,2021-10-31,inter-total,1,69,19,8,7,7,1,2,4,34,422,574,423,492,FALSE,0.857142857142857,2021,2021-2022
IL,2021-10-31,inter-ucfe,0,0,1,0,0,0,0,0,0,0,1,2,1,1,FALSE,0.5,2021,2021-2022
IL,2021-10-31,inter-ucx,0,0,0,0,0,0,0,0,0,0,0,0,0,0,FALSE,0,2021,2021-2022
IL,2021-10-31,inter-ui,1,69,18,8,7,7,1,2,4,34,421,572,422,491,FALSE,0.858391608391609,2021,2021-2022
IL,2021-10-31,intra-total,79,1175,492,272,213,161,124,135,112,1168,4894,8825,4973,6148,FALSE,0.696657223796034,2021,2021-2022
IL,2021-10-31,intra-ucfe,0,7,6,6,3,0,2,1,3,17,15,60,15,22,FALSE,0.366666666666667,2021,2021-2022
IL,2021-10-31,intra-ucx,0,4,4,1,1,0,1,0,1,4,12,28,12,16,FALSE,0.571428571428571,2021,2021-2022
IL,2021-10-31,intra-ui,79,1164,482,265,209,161,121,134,108,1147,4867,8737,4946,6110,FALSE,0.699324710999199,2021,2021-2022
IL,2021-11-30,inter-total,4,81,25,15,7,6,4,5,7,34,434,622,438,519,FALSE,0.834405144694534,2021,2021-2022
IL,2021-11-30,inter-ucfe,1,0,1,2,1,0,0,0,0,0,0,5,1,1,FALSE,0.2,2021,2021-2022
IL,2021-11-30,inter-ucx,0,0,0,0,0,0,0,0,0,0,0,0,0,0,FALSE,0,2021,2021-2022
IL,2021-11-30,inter-ui,3,81,24,13,6,6,4,5,7,34,434,617,437,518,FALSE,0.839546191247974,2021,2021-2022
IL,2021-11-30,intra-total,120,1437,534,309,209,166,128,109,103,1036,7712,11863,7832,9269,FALSE,0.781336929950266,2021,2021-2022
IL,2021-11-30,intra-ucfe,0,12,17,26,6,7,5,4,3,18,13,111,13,25,FALSE,0.225225225225225,2021,2021-2022
IL,2021-11-30,intra-ucx,0,2,5,3,2,1,1,1,0,2,8,25,8,10,FALSE,0.4,2021,2021-2022
IL,2021-11-30,intra-ui,120,1423,512,280,201,158,122,104,100,1016,7691,11727,7811,9234,FALSE,0.787413660782809,2021,2021-2022
IL,2021-12-31,inter-total,5,74,51,21,14,7,6,1,3,27,275,484,280,354,FALSE,0.731404958677686,2021,2021-2022
IL,2021-12-31,inter-ucfe,0,0,0,1,0,0,0,0,1,0,0,2,0,0,FALSE,0,2021,2021-2022
IL,2021-12-31,inter-ucx,0,0,0,0,0,0,0,0,0,0,1,1,1,1,FALSE,1,2021,2021-2022
IL,2021-12-31,inter-ui,5,74,51,20,14,7,6,1,2,27,274,481,279,353,FALSE,0.733887733887734,2021,2021-2022
IL,2021-12-31,intra-total,270,2545,708,446,245,156,130,115,98,948,15816,21477,16086,18631,FALSE,0.86748614797225,2021,2021-2022
IL,2021-12-31,intra-ucfe,0,10,4,5,3,4,7,1,1,14,23,72,23,33,FALSE,0.458333333333333,2021,2021-2022
IL,2021-12-31,intra-ucx,0,5,3,4,1,0,3,0,0,2,6,24,6,11,FALSE,0.458333333333333,2021,2021-2022
IL,2021-12-31,intra-ui,270,2530,701,437,241,152,120,114,97,932,15787,21381,16057,18587,FALSE,0.869323230905945,2021,2021-2022
IL,2022-01-31,inter-total,4,102,39,31,14,9,8,6,3,25,394,635,398,500,FALSE,0.78740157480315,2021,2021-2022
IL,2022-01-31,inter-ucfe,0,0,0,0,0,0,0,0,0,2,0,2,0,0,FALSE,0,2021,2021-2022
IL,2022-01-31,inter-ucx,0,0,0,0,0,0,0,0,0,0,0,0,0,0,FALSE,0,2021,2021-2022
IL,2022-01-31,inter-ui,4,102,39,31,14,9,8,6,3,23,394,633,398,500,FALSE,0.789889415481833,2021,2021-2022
IL,2022-01-31,intra-total,487,5127,1167,655,347,257,147,129,92,837,26236,35481,26723,31850,FALSE,0.89766353823173,2021,2021-2022
IL,2022-01-31,intra-ucfe,1,5,8,5,3,4,1,0,0,16,20,63,21,26,FALSE,0.412698412698413,2021,2021-2022
IL,2022-01-31,intra-ucx,0,4,1,1,1,1,0,0,0,5,11,24,11,15,FALSE,0.625,2021,2021-2022
IL,2022-01-31,intra-ui,486,5118,1158,649,343,252,146,129,92,816,26205,35394,26691,31809,FALSE,0.898711646041702,2021,2021-2022
IL,2022-02-28,inter-total,1,67,33,13,17,9,6,4,0,29,262,441,263,330,FALSE,0.748299319727891,2021,2021-2022
IL,2022-02-28,inter-ucfe,0,0,0,0,0,0,0,0,0,1,0,1,0,0,FALSE,0,2021,2021-2022
IL,2022-02-28,inter-ucx,0,0,0,0,0,0,0,0,0,0,0,0,0,0,FALSE,0,2021,2021-2022
IL,2022-02-28,inter-ui,1,67,33,13,17,9,6,4,0,28,262,440,263,330,FALSE,0.75,2021,2021-2022
IL,2022-02-28,intra-total,293,3403,1019,602,402,299,216,132,112,722,13009,20209,13302,16705,FALSE,0.82661190558662,2021,2021-2022
IL,2022-02-28,intra-ucfe,0,8,3,7,5,5,1,1,1,13,13,57,13,21,FALSE,0.368421052631579,2021,2021-2022
IL,2022-02-28,intra-ucx,0,4,2,2,1,2,0,0,2,2,13,28,13,17,FALSE,0.607142857142857,2021,2021-2022
IL,2022-02-28,intra-ui,293,3391,1014,593,396,292,215,131,109,707,12983,20124,13276,16667,FALSE,0.82821506658716,2021,2021-2022
IL,2022-03-31,inter-total,5,59,24,13,13,13,12,13,5,39,251,447,256,315,FALSE,0.704697986577181,2021,2021-2022
IL,2022-03-31,inter-ucfe,0,0,0,0,0,0,0,0,0,0,1,1,1,1,FALSE,1,2021,2021-2022
IL,2022-03-31,inter-ucx,0,0,0,0,0,1,0,0,0,0,0,1,0,0,FALSE,0,2021,2021-2022
IL,2022-03-31,inter-ui,5,59,24,13,13,12,12,13,5,39,250,445,255,314,FALSE,0.70561797752809,2021,2021-2022
IL,2022-03-31,intra-total,221,2177,797,412,281,225,218,200,161,1004,9855,15551,10076,12253,FALSE,0.787923606198958,2021,2021-2022
IL,2022-03-31,intra-ucfe,1,8,8,6,2,0,1,0,2,12,20,60,21,29,FALSE,0.483333333333333,2021,2021-2022
IL,2022-03-31,intra-ucx,2,4,1,2,1,1,1,1,0,4,7,24,9,13,FALSE,0.541666666666667,2021,2021-2022
IL,2022-03-31,intra-ui,218,2165,788,404,278,224,216,199,159,988,9828,15467,10046,12211,FALSE,0.789487295532424,2021,2021-2022
IL,2022-04-30,inter-total,1,40,17,5,4,2,1,3,0,19,283,375,284,324,FALSE,0.864,2021,2021-2022
IL,2022-04-30,inter-ucfe,0,1,0,0,0,1,0,0,0,0,0,2,0,1,FALSE,0.5,2021,2021-2022
IL,2022-04-30,inter-ucx,0,0,0,0,0,0,0,0,0,0,0,0,0,0,FALSE,0,2021,2021-2022
IL,2022-04-30,inter-ui,1,39,17,5,4,1,1,3,0,19,283,373,284,323,FALSE,0.865951742627346,2021,2021-2022
IL,2022-04-30,intra-total,153,1706,609,264,167,108,80,66,63,782,8055,12053,8208,9914,FALSE,0.822533809010205,2021,2021-2022
IL,2022-04-30,intra-ucfe,0,11,8,3,4,0,2,0,1,9,28,66,28,39,FALSE,0.590909090909091,2021,2021-2022
IL,2022-04-30,intra-ucx,0,3,2,2,1,0,2,1,0,2,14,27,14,17,FALSE,0.62962962962963,2021,2021-2022
IL,2022-04-30,intra-ui,153,1692,599,259,162,108,76,65,62,771,8013,11960,8166,9858,FALSE,0.824247491638796,2021,2021-2022
IL,2022-05-31,inter-total,8,72,24,8,7,1,3,1,2,23,394,543,402,474,FALSE,0.87292817679558,2021,2021-2022
IL,2022-05-31,inter-ucfe,0,0,1,0,1,0,0,0,1,0,0,3,0,0,FALSE,0,2021,2021-2022
IL,2022-05-31,inter-ucx,0,0,0,0,0,0,0,0,0,0,1,1,1,1,FALSE,1,2021,2021-2022
IL,2022-05-31,inter-ui,8,72,23,8,6,1,3,1,1,23,393,539,401,473,FALSE,0.877551020408163,2021,2021-2022
IL,2022-05-31,intra-total,142,1693,695,383,199,121,106,74,45,615,10253,14326,10395,12088,FALSE,0.843780538880358,2021,2021-2022
IL,2022-05-31,intra-ucfe,0,7,6,5,5,2,0,2,2,3,40,72,40,47,FALSE,0.652777777777778,2021,2021-2022
IL,2022-05-31,intra-ucx,0,3,3,0,1,1,1,0,0,0,11,20,11,14,FALSE,0.7,2021,2021-2022
IL,2022-05-31,intra-ui,142,1683,686,378,193,118,105,72,43,612,10202,14234,10344,12027,FALSE,0.844948714345932,2021,2021-2022
IL,2022-06-30,inter-total,2,68,31,18,10,8,4,2,1,17,412,573,414,482,FALSE,0.841186736474695,2021,2021-2022
IL,2022-06-30,inter-ucfe,0,0,0,0,0,0,0,0,0,0,1,1,1,1,FALSE,1,2021,2021-2022
IL,2022-06-30,inter-ucx,0,0,0,0,0,0,0,0,0,0,0,0,0,0,FALSE,0,2021,2021-2022
IL,2022-06-30,inter-ui,2,68,31,18,10,8,4,2,1,17,411,572,413,481,FALSE,0.840909090909091,2021,2021-2022
IL,2022-06-30,intra-total,229,2276,868,455,234,152,106,107,75,488,11330,16320,11559,13835,FALSE,0.847732843137255,2021,2021-2022
IL,2022-06-30,intra-ucfe,0,30,8,5,5,3,1,5,2,6,49,114,49,79,FALSE,0.692982456140351,2021,2021-2022
IL,2022-06-30,intra-ucx,0,3,2,0,0,0,0,1,0,1,11,18,11,14,FALSE,0.777777777777778,2021,2021-2022
IL,2022-06-30,intra-ui,229,2243,858,450,229,149,105,101,73,481,11270,16188,11499,13742,FALSE,0.848900420064245,2021,2021-2022
IL,2022-07-31,inter-total,3,65,26,18,12,6,1,2,6,24,223,386,226,291,FALSE,0.753886010362694,2022,2022-2023
IL,2022-07-31,inter-ucfe,0,0,0,0,0,0,0,0,0,0,1,1,1,1,FALSE,1,2022,2022-2023
IL,2022-07-31,inter-ucx,0,0,0,0,0,0,0,0,0,0,0,0,0,0,FALSE,0,2022,2022-2023
IL,2022-07-31,inter-ui,3,65,26,18,12,6,1,2,6,24,222,385,225,290,FALSE,0.753246753246753,2022,2022-2023
IL,2022-07-31,intra-total,138,2118,983,532,294,176,139,64,54,567,8709,13774,8847,10965,FALSE,0.796065050094381,2022,2022-2023
IL,2022-07-31,intra-ucfe,2,12,10,6,3,4,2,2,4,7,28,80,30,42,FALSE,0.525,2022,2022-2023
IL,2022-07-31,intra-ucx,0,7,1,5,0,1,0,0,0,0,8,22,8,15,FALSE,0.681818181818182,2022,2022-2023
IL,2022-07-31,intra-ui,136,2099,972,521,291,171,137,62,50,560,8673,13672,8809,10908,FALSE,0.797834991222937,2022,2022-2023
IL,2022-08-31,inter-total,4,50,28,16,7,5,4,2,1,11,218,346,222,272,FALSE,0.786127167630058,2022,2022-2023
IL,2022-08-31,inter-ucfe,0,0,0,1,0,0,0,0,0,0,0,1,0,0,FALSE,0,2022,2022-2023
IL,2022-08-31,inter-ucx,0,0,0,0,0,0,0,0,0,0,0,0,0,0,FALSE,0,2022,2022-2023
IL,2022-08-31,inter-ui,4,50,28,15,7,5,4,2,1,11,218,345,222,272,FALSE,0.788405797101449,2022,2022-2023
IL,2022-08-31,intra-total,86,1889,751,391,228,149,114,101,70,723,9893,14395,9979,11868,FALSE,0.824452935046891,2022,2022-2023
IL,2022-08-31,intra-ucfe,0,10,10,3,6,0,4,3,0,15,30,81,30,40,FALSE,0.493827160493827,2022,2022-2023
IL,2022-08-31,intra-ucx,0,5,0,3,2,0,2,0,0,3,13,28,13,18,FALSE,0.642857142857143,2022,2022-2023
IL,2022-08-31,intra-ui,86,1874,741,385,220,149,108,98,70,705,9850,14286,9936,11810,FALSE,0.826683466330673,2022,2022-2023
IL,2022-09-30,inter-total,2,48,24,9,8,2,3,2,0,22,182,302,184,232,FALSE,0.768211920529801,2022,2022-2023
IL,2022-09-30,inter-ucfe,0,1,1,0,0,0,0,0,0,1,1,4,1,2,FALSE,0.5,2022,2022-2023
IL,2022-09-30,inter-ucx,0,0,0,0,0,0,0,0,0,0,0,0,0,0,FALSE,0,2022,2022-2023
IL,2022-09-30,inter-ui,2,47,23,9,8,2,3,2,0,21,181,298,183,230,FALSE,0.771812080536913,2022,2022-2023
IL,2022-09-30,intra-total,70,1778,644,258,141,83,68,67,66,725,7560,11460,7630,9408,FALSE,0.820942408376963,2022,2022-2023
IL,2022-09-30,intra-ucfe,1,9,7,5,2,3,1,1,1,15,25,70,26,35,FALSE,0.5,2022,2022-2023
IL,2022-09-30,intra-ucx,0,3,2,3,1,0,2,1,0,1,12,25,12,15,FALSE,0.6,2022,2022-2023
IL,2022-09-30,intra-ui,69,1766,635,250,138,80,65,65,65,709,7523,11365,7592,9358,FALSE,0.823405191377035,2022,2022-2023
IL,2022-10-31,inter-total,4,54,20,7,9,8,2,2,2,9,200,317,204,258,FALSE,0.813880126182965,2022,2022-2023
IL,2022-10-31,inter-ucfe,0,0,1,0,0,0,0,0,0,0,0,1,0,0,FALSE,0,2022,2022-2023
IL,2022-10-31,inter-ucx,0,0,0,0,0,0,0,0,0,0,0,0,0,0,FALSE,0,2022,2022-2023
IL,2022-10-31,inter-ui,4,54,19,7,9,8,2,2,2,9,200,316,204,258,FALSE,0.816455696202532,2022,2022-2023
IL,2022-10-31,intra-total,101,1452,595,220,95,79,63,51,53,541,8328,11578,8429,9881,FALSE,0.853428916911384,2022,2022-2023
IL,2022-10-31,intra-ucfe,0,6,4,3,1,4,2,0,1,4,23,48,23,29,FALSE,0.604166666666667,2022,2022-2023
IL,2022-10-31,intra-ucx,0,7,1,1,0,1,1,0,0,2,8,21,8,15,FALSE,0.714285714285714,2022,2022-2023
IL,2022-10-31,intra-ui,101,1439,590,216,94,74,60,51,52,535,8297,11509,8398,9837,FALSE,0.854722391172126,2022,2022-2023
IL,2022-11-30,inter-total,6,109,40,11,6,4,1,2,1,12,210,402,216,325,FALSE,0.808457711442786,2022,2022-2023
IL,2022-11-30,inter-ucfe,0,0,0,0,0,0,0,0,0,0,0,0,0,0,FALSE,0,2022,2022-2023
IL,2022-11-30,inter-ucx,0,0,0,0,0,0,0,0,0,0,0,0,0,0,FALSE,0,2022,2022-2023
IL,2022-11-30,inter-ui,6,109,40,11,6,4,1,2,1,12,210,402,216,325,FALSE,0.808457711442786,2022,2022-2023
IL,2022-11-30,intra-total,110,2415,846,293,142,84,53,45,41,449,11514,15992,11624,14039,FALSE,0.87787643821911,2022,2022-2023
IL,2022-11-30,intra-ucfe,0,12,5,5,2,1,0,1,1,4,18,49,18,30,FALSE,0.612244897959184,2022,2022-2023
IL,2022-11-30,intra-ucx,0,4,6,1,0,0,1,0,0,2,9,23,9,13,FALSE,0.565217391304348,2022,2022-2023
IL,2022-11-30,intra-ui,110,2399,835,287,140,83,52,44,40,443,11487,15920,11597,13996,FALSE,0.879145728643216,2022,2022-2023
IL,2022-12-31,inter-total,3,113,44,15,12,7,3,3,3,26,366,595,369,482,FALSE,0.810084033613445,2022,2022-2023
IL,2022-12-31,inter-ucfe,0,0,0,0,1,0,0,0,0,0,0,1,0,0,FALSE,0,2022,2022-2023
IL,2022-12-31,inter-ucx,0,0,0,0,0,0,0,0,0,0,0,0,0,0,FALSE,0,2022,2022-2023
IL,2022-12-31,inter-ui,3,113,44,15,11,7,3,3,3,26,366,594,369,482,FALSE,0.811447811447811,2022,2022-2023
IL,2022-12-31,intra-total,214,3584,983,444,190,93,62,36,53,525,19696,25880,19910,23494,FALSE,0.907805255023184,2022,2022-2023
IL,2022-12-31,intra-ucfe,0,4,3,5,4,1,1,0,1,5,8,32,8,12,FALSE,0.375,2022,2022-2023
IL,2022-12-31,intra-ucx,0,6,3,0,1,0,1,0,0,4,12,27,12,18,FALSE,0.666666666666667,2022,2022-2023
IL,2022-12-31,intra-ui,214,3574,977,439,185,92,60,36,52,516,19676,25821,19890,23464,FALSE,0.908717710390767,2022,2022-2023
IL,2023-01-31,inter-total,4,116,48,18,12,4,6,1,3,19,453,684,457,573,FALSE,0.837719298245614,2022,2022-2023
IL,2023-01-31,inter-ucfe,0,0,0,0,0,0,0,0,0,0,0,0,0,0,FALSE,0,2022,2022-2023
IL,2023-01-31,inter-ucx,0,0,0,0,0,0,0,0,0,0,0,0,0,0,FALSE,0,2022,2022-2023
IL,2023-01-31,inter-ui,4,116,48,18,12,4,6,1,3,19,453,684,457,573,FALSE,0.837719298245614,2022,2022-2023
IL,2023-01-31,intra-total,354,5832,1326,588,313,179,104,67,54,628,29482,38927,29836,35668,FALSE,0.916279189251676,2022,2022-2023
IL,2023-01-31,intra-ucfe,0,7,5,2,1,2,0,3,1,7,9,37,9,16,FALSE,0.432432432432432,2022,2022-2023
IL,2023-01-31,intra-ucx,0,2,4,1,1,1,1,0,0,3,8,21,8,10,FALSE,0.476190476190476,2022,2022-2023
IL,2023-01-31,intra-ui,354,5823,1317,585,311,176,103,64,53,618,29465,38869,29819,35642,FALSE,0.916977539941856,2022,2022-2023
IL,2023-02-28,inter-total,2,101,33,26,4,18,5,7,6,26,257,485,259,360,FALSE,0.742268041237113,2022,2022-2023
IL,2023-02-28,inter-ucfe,0,0,0,0,0,1,0,0,0,1,0,2,0,0,FALSE,0,2022,2022-2023
IL,2023-02-28,inter-ucx,0,0,0,0,0,0,0,0,0,0,0,0,0,0,FALSE,0,2022,2022-2023
IL,2023-02-28,inter-ui,2,101,33,26,4,17,5,7,6,25,257,483,259,360,FALSE,0.745341614906832,2022,2022-2023
IL,2023-02-28,intra-total,193,3276,1094,469,284,166,100,84,79,662,17934,24341,18127,21403,FALSE,0.879298303274311,2022,2022-2023
IL,2023-02-28,intra-ucfe,0,7,3,2,2,1,1,0,0,6,9,31,9,16,FALSE,0.516129032258065,2022,2022-2023
IL,2023-02-28,intra-ucx,0,2,3,0,0,1,0,1,0,1,8,16,8,10,FALSE,0.625,2022,2022-2023
IL,2023-02-28,intra-ui,193,3267,1088,467,282,164,99,83,79,655,17917,24294,18110,21377,FALSE,0.879929200625669,2022,2022-2023
IL,2023-03-31,inter-total,0,75,39,27,11,11,14,2,1,16,221,417,221,296,FALSE,0.709832134292566,2022,2022-2023
IL,2023-03-31,inter-ucfe,0,1,0,0,0,0,0,0,0,0,0,1,0,1,FALSE,1,2022,2022-2023
IL,2023-03-31,inter-ucx,0,0,0,0,0,0,0,0,0,0,0,0,0,0,FALSE,0,2022,2022-2023
IL,2023-03-31,inter-ui,0,74,39,27,11,11,14,2,1,16,221,416,221,295,FALSE,0.709134615384615,2022,2022-2023
IL,2023-03-31,intra-total,114,2485,886,377,222,140,115,127,96,806,14239,19607,14353,16838,FALSE,0.858774927321875,2022,2022-2023
IL,2023-03-31,intra-ucfe,0,10,4,2,2,1,2,3,1,9,18,52,18,28,FALSE,0.538461538461538,2022,2022-2023
IL,2023-03-31,intra-ucx,0,6,2,1,0,1,2,0,0,3,12,27,12,18,FALSE,0.666666666666667,2022,2022-2023
IL,2023-03-31,intra-ui,114,2469,880,374,220,138,111,124,95,794,14209,19528,14323,16792,FALSE,0.859893486276116,2022,2022-2023
IL,2023-04-30,inter-total,0,66,27,15,5,5,3,3,1,14,188,327,188,254,FALSE,0.776758409785933,2022,2022-2023
IL,2023-04-30,inter-ucfe,0,1,0,0,0,0,0,0,0,0,0,1,0,1,FALSE,1,2022,2022-2023
IL,2023-04-30,inter-ucx,0,0,0,0,0,0,0,0,0,0,0,0,0,0,FALSE,0,2022,2022-2023
IL,2023-04-30,inter-ui,0,65,27,15,5,5,3,3,1,14,188,326,188,253,FALSE,0.776073619631902,2022,2022-2023
IL,2023-04-30,intra-total,107,1939,608,253,162,127,141,110,114,483,11117,15161,11224,13163,FALSE,0.868214497724425,2022,2022-2023
IL,2023-04-30,intra-ucfe,0,9,5,3,2,1,2,2,0,5,19,48,19,28,FALSE,0.583333333333333,2022,2022-2023
IL,2023-04-30,intra-ucx,0,5,0,0,0,1,1,2,0,0,12,21,12,17,FALSE,0.80952380952381,2022,2022-2023
IL,2023-04-30,intra-ui,107,1925,603,250,160,125,138,106,114,478,11086,15092,11193,13118,FALSE,0.869202226345083,2022,2022-2023
IL,2023-05-31,inter-total,114,58,29,13,6,5,0,4,3,20,165,417,279,337,FALSE,0.808153477218225,2022,2022-2023
IL,2023-05-31,inter-ucfe,0,0,0,0,0,0,0,0,0,0,0,0,0,0,FALSE,0,2022,2022-2023
IL,2023-05-31,inter-ucx,0,0,0,0,0,0,0,0,0,0,0,0,0,0,FALSE,0,2022,2022-2023
IL,2023-05-31,inter-ui,114,58,29,13,6,5,0,4,3,20,165,417,279,337,FALSE,0.808153477218225,2022,2022-2023
IL,2023-05-31,intra-total,3040,1987,840,359,225,182,118,114,94,311,10444,17714,13484,15471,FALSE,0.873376989951451,2022,2022-2023
IL,2023-05-31,intra-ucfe,4,7,3,3,3,3,1,1,1,3,15,44,19,26,FALSE,0.590909090909091,2022,2022-2023
IL,2023-05-31,intra-ucx,3,2,2,2,0,0,1,1,0,1,11,23,14,16,FALSE,0.695652173913044,2022,2022-2023
IL,2023-05-31,intra-ui,3033,1978,835,354,222,179,116,112,93,307,10418,17647,13451,15429,FALSE,0.874312914376381,2022,2022-2023
IL,2023-06-30,inter-total,212,37,24,12,5,2,5,6,5,12,94,414,306,343,FALSE,0.828502415458937,2022,2022-2023
IL,2023-06-30,inter-ucfe,0,0,0,0,0,0,0,0,0,0,0,0,0,0,FALSE,0,2022,2022-2023
IL,2023-06-30,inter-ucx,0,0,0,0,0,0,0,0,0,0,0,0,0,0,FALSE,0,2022,2022-2023
IL,2023-06-30,inter-ui,212,37,24,12,5,2,5,6,5,12,94,414,306,343,FALSE,0.828502415458937,2022,2022-2023
IL,2023-06-30,intra-total,11812,1125,367,210,170,164,133,87,84,230,4455,18837,16267,17392,FALSE,0.923289271115358,2022,2022-2023
IL,2023-06-30,intra-ucfe,13,6,2,2,0,1,0,0,0,7,17,48,30,36,FALSE,0.75,2022,2022-2023
IL,2023-06-30,intra-ucx,12,5,1,1,0,2,0,0,0,1,4,26,16,21,FALSE,0.807692307692308,2022,2022-2023
IL,2023-06-30,intra-ui,11787,1114,364,207,170,161,133,87,84,222,4434,18763,16221,17335,FALSE,0.923892767681074,2022,2022-2023
IL,2023-07-31,inter-total,254,39,31,14,8,8,2,4,1,11,92,464,346,385,FALSE,0.829741379310345,2023,2023-2024
IL,2023-07-31,inter-ucfe,0,0,0,1,0,0,0,0,0,0,0,1,0,0,FALSE,0,2023,2023-2024
IL,2023-07-31,inter-ucx,0,0,0,0,0,0,0,0,0,0,0,0,0,0,FALSE,0,2023,2023-2024
IL,2023-07-31,inter-ui,254,39,31,13,8,8,2,4,1,11,92,463,346,385,FALSE,0.831533477321814,2023,2023-2024
IL,2023-07-31,intra-total,10007,1498,596,320,230,179,151,99,62,249,5017,18408,15024,16522,FALSE,0.897544545849631,2023,2023-2024
IL,2023-07-31,intra-ucfe,8,7,4,3,2,0,3,0,1,5,8,41,16,23,FALSE,0.560975609756098,2023,2023-2024
IL,2023-07-31,intra-ucx,11,4,2,0,0,0,0,0,0,0,2,19,13,17,FALSE,0.894736842105263,2023,2023-2024
IL,2023-07-31,intra-ui,9988,1487,590,317,228,179,148,99,61,244,5007,18348,14995,16482,FALSE,0.898299542184434,2023,2023-2024
IL,2023-08-31,inter-total,226,43,22,13,9,6,6,4,1,10,98,438,324,367,FALSE,0.837899543378996,2023,2023-2024
IL,2023-08-31,inter-ucfe,0,0,0,0,0,0,0,0,0,1,0,1,0,0,FALSE,0,2023,2023-2024
IL,2023-08-31,inter-ucx,0,0,0,0,0,0,0,0,0,0,0,0,0,0,FALSE,0,2023,2023-2024
IL,2023-08-31,inter-ui,226,43,22,13,9,6,6,4,1,9,98,437,324,367,FALSE,0.839816933638444,2023,2023-2024
IL,2023-08-31,intra-total,10298,1186,544,299,255,224,176,130,90,280,4020,17502,14318,15504,FALSE,0.885841618100788,2023,2023-2024
IL,2023-08-31,intra-ucfe,11,3,2,1,0,1,2,3,1,6,3,33,14,17,FALSE,0.515151515151515,2023,2023-2024
IL,2023-08-31,intra-ucx,15,2,2,1,1,0,2,0,0,1,3,27,18,20,FALSE,0.740740740740741,2023,2023-2024
IL,2023-08-31,intra-ui,10272,1181,540,297,254,223,172,127,89,273,4014,17442,14286,15467,FALSE,0.886767572526087,2023,2023-2024
IL,2023-09-30,inter-total,178,32,11,14,8,1,5,3,6,8,70,336,248,280,FALSE,0.833333333333333,2023,2023-2024
IL,2023-09-30,inter-ucfe,0,0,0,0,0,0,0,0,0,0,0,0,0,0,FALSE,0,2023,2023-2024
IL,2023-09-30,inter-ucx,0,0,0,0,0,0,0,0,0,0,0,0,0,0,FALSE,0,2023,2023-2024
IL,2023-09-30,inter-ui,178,32,11,14,8,1,5,3,6,8,70,336,248,280,FALSE,0.833333333333333,2023,2023-2024
IL,2023-09-30,intra-total,7893,926,420,214,179,144,137,109,80,261,3040,13403,10933,11859,FALSE,0.884801910020145,2023,2023-2024
IL,2023-09-30,intra-ucfe,17,4,5,1,2,1,0,1,2,5,7,45,24,28,FALSE,0.622222222222222,2023,2023-2024
IL,2023-09-30,intra-ucx,15,0,1,0,0,0,0,0,1,1,7,25,22,22,FALSE,0.88,2023,2023-2024
IL,2023-09-30,intra-ui,7861,922,414,213,177,143,137,108,77,255,3026,13333,10887,11809,FALSE,0.885697142428561,2023,2023-2024
IL,2023-10-31,inter-total,213,23,15,9,8,4,6,2,6,11,79,376,292,315,FALSE,0.837765957446809,2023,2023-2024
IL,2023-10-31,inter-ucfe,1,0,0,0,0,1,0,0,0,0,0,2,1,1,FALSE,0.5,2023,2023-2024
IL,2023-10-31,inter-ucx,0,0,0,0,0,0,0,0,0,0,0,0,0,0,FALSE,0,2023,2023-2024
IL,2023-10-31,inter-ui,212,23,15,9,8,3,6,2,6,11,79,374,291,314,FALSE,0.839572192513369,2023,2023-2024
IL,2023-10-31,intra-total,9309,961,399,246,204,186,136,115,84,277,3369,15286,12678,13639,FALSE,0.892254350385974,2023,2023-2024
IL,2023-10-31,intra-ucfe,22,5,2,1,1,2,2,2,1,7,14,59,36,41,FALSE,0.694915254237288,2023,2023-2024
IL,2023-10-31,intra-ucx,11,2,0,0,2,0,2,0,0,0,5,22,16,18,FALSE,0.818181818181818,2023,2023-2024
IL,2023-10-31,intra-ui,9276,954,397,245,201,184,132,113,83,270,3350,15205,12626,13580,FALSE,0.893127260769484,2023,2023-2024
IL,2023-11-30,inter-total,253,34,19,4,5,6,1,4,1,15,84,426,337,371,FALSE,0.870892018779343,2023,2023-2024
IL,2023-11-30,inter-ucfe,1,0,0,0,0,0,0,0,0,0,0,1,1,1,FALSE,1,2023,2023-2024
IL,2023-11-30,inter-ucx,0,0,0,0,0,0,0,0,0,0,0,0,0,0,FALSE,0,2023,2023-2024
IL,2023-11-30,inter-ui,252,34,19,4,5,6,1,4,1,15,84,425,336,370,FALSE,0.870588235294118,2023,2023-2024
IL,2023-11-30,intra-total,10229,1199,435,248,199,147,106,72,43,212,4284,17174,14513,15712,FALSE,0.914871317107255,2023,2023-2024
IL,2023-11-30,intra-ucfe,12,9,2,2,2,1,2,1,0,2,7,40,19,28,FALSE,0.7,2023,2023-2024
IL,2023-11-30,intra-ucx,8,3,1,1,1,0,0,0,0,0,2,16,10,13,FALSE,0.8125,2023,2023-2024
IL,2023-11-30,intra-ui,10209,1187,432,245,196,146,104,71,43,210,4275,17118,14484,15671,FALSE,0.915469096857109,2023,2023-2024
IL,2023-12-31,inter-total,332,28,20,11,8,3,3,6,3,9,107,530,439,467,FALSE,0.881132075471698,2023,2023-2024
IL,2023-12-31,inter-ucfe,1,0,0,0,0,0,0,0,0,0,1,2,2,2,FALSE,1,2023,2023-2024
IL,2023-12-31,inter-ucx,0,0,0,0,0,0,0,0,0,0,1,1,1,1,FALSE,1,2023,2023-2024
IL,2023-12-31,inter-ui,331,28,20,11,8,3,3,6,3,9,105,527,436,464,FALSE,0.88045540796964,2023,2023-2024
IL,2023-12-31,intra-total,14685,1550,470,278,195,186,114,92,59,220,7601,25450,22286,23836,FALSE,0.936581532416503,2023,2023-2024
IL,2023-12-31,intra-ucfe,18,4,4,1,2,0,2,3,3,2,5,44,23,27,FALSE,0.613636363636364,2023,2023-2024
IL,2023-12-31,intra-ucx,12,2,0,1,1,0,0,0,0,1,5,22,17,19,FALSE,0.863636363636364,2023,2023-2024
IL,2023-12-31,intra-ui,14655,1544,466,276,192,186,112,89,56,217,7591,25384,22246,23790,FALSE,0.937204538291837,2023,2023-2024
IL,2024-01-31,inter-total,434,52,15,19,7,6,2,5,1,8,140,689,574,626,FALSE,0.908563134978229,2023,2023-2024
IL,2024-01-31,inter-ucfe,0,0,0,1,0,0,0,1,0,0,0,2,0,0,FALSE,0,2023,2023-2024
IL,2024-01-31,inter-ucx,0,0,0,0,0,0,0,0,0,0,0,0,0,0,FALSE,0,2023,2023-2024
IL,2024-01-31,inter-ui,434,52,15,18,7,6,2,4,1,8,140,687,574,626,FALSE,0.911208151382824,2023,2023-2024
IL,2024-01-31,intra-total,22566,3177,876,435,287,228,178,120,81,312,15934,44194,38500,41677,FALSE,0.94304656740734,2023,2023-2024
IL,2024-01-31,intra-ucfe,12,5,2,0,2,2,2,2,1,1,17,46,29,34,FALSE,0.739130434782609,2023,2023-2024
IL,2024-01-31,intra-ucx,10,1,1,1,1,0,2,0,0,1,3,20,13,14,FALSE,0.7,2023,2023-2024
IL,2024-01-31,intra-ui,22544,3171,873,434,284,226,174,118,80,310,15914,44128,38458,41629,FALSE,0.943369289340102,2023,2023-2024
IL,2024-02-29,inter-total,234,48,19,12,8,6,4,5,4,9,74,423,308,356,FALSE,0.84160756501182,2023,2023-2024
IL,2024-02-29,inter-ucfe,1,0,1,0,0,0,0,0,0,0,0,2,1,1,FALSE,0.5,2023,2023-2024
IL,2024-02-29,inter-ucx,0,0,0,0,0,0,0,0,0,0,0,0,0,0,FALSE,0,2023,2023-2024
IL,2024-02-29,inter-ui,233,48,18,12,8,6,4,5,4,9,74,421,307,355,FALSE,0.843230403800475,2023,2023-2024
IL,2024-02-29,intra-total,15215,1576,687,393,364,274,190,159,111,308,5518,24795,20733,22309,FALSE,0.899737850373059,2023,2023-2024
IL,2024-02-29,intra-ucfe,15,4,1,2,3,1,4,2,0,5,5,42,20,24,FALSE,0.571428571428571,2023,2023-2024
IL,2024-02-29,intra-ucx,12,2,1,1,0,1,1,0,0,0,4,22,16,18,FALSE,0.818181818181818,2023,2023-2024
IL,2024-02-29,intra-ui,15188,1570,685,390,361,272,185,157,111,303,5509,24731,20697,22267,FALSE,0.900367959241438,2023,2023-2024
IL,2024-03-31,inter-total,152,43,10,7,6,4,4,5,4,12,72,319,224,267,FALSE,0.836990595611285,2023,2023-2024
IL,2024-03-31,inter-ucfe,1,1,0,0,0,0,0,0,0,0,0,2,1,2,FALSE,1,2023,2023-2024
IL,2024-03-31,inter-ucx,0,0,0,0,0,0,0,0,0,0,0,0,0,0,FALSE,0,2023,2023-2024
IL,2024-03-31,inter-ui,151,42,10,7,6,4,4,5,4,12,72,317,223,265,FALSE,0.83596214511041,2023,2023-2024
IL,2024-03-31,intra-total,10480,958,516,347,308,241,206,171,117,438,2991,16773,13471,14429,FALSE,0.860251594825016,2023,2023-2024
IL,2024-03-31,intra-ucfe,16,8,2,2,2,1,1,0,0,2,5,39,21,29,FALSE,0.743589743589744,2023,2023-2024
IL,2024-03-31,intra-ucx,10,3,3,0,0,1,0,1,0,0,3,21,13,16,FALSE,0.761904761904762,2023,2023-2024
IL,2024-03-31,intra-ui,10454,947,511,345,306,239,205,170,117,436,2983,16713,13437,14384,FALSE,0.860647400227368,2023,2023-2024
IL,2024-04-30,inter-total,144,30,16,7,6,6,6,3,2,5,69,294,213,243,FALSE,0.826530612244898,2023,2023-2024
IL,2024-04-30,inter-ucfe,0,0,0,0,0,0,0,0,0,0,1,1,1,1,FALSE,1,2023,2023-2024
IL,2024-04-30,inter-ucx,0,0,0,0,0,0,0,0,0,0,0,0,0,0,FALSE,0,2023,2023-2024
IL,2024-04-30,inter-ui,144,30,16,7,6,6,6,3,2,5,68,293,212,242,FALSE,0.825938566552901,2023,2023-2024
IL,2024-04-30,intra-total,10378,950,451,270,206,175,144,95,77,267,3007,16020,13385,14335,FALSE,0.89481897627965,2023,2023-2024
IL,2024-04-30,intra-ucfe,20,5,5,1,0,1,1,1,1,5,11,51,31,36,FALSE,0.705882352941177,2023,2023-2024
IL,2024-04-30,intra-ucx,18,0,0,1,2,0,0,0,1,2,3,27,21,21,FALSE,0.777777777777778,2023,2023-2024
IL,2024-04-30,intra-ui,10340,945,446,268,204,174,143,94,75,260,2993,15942,13333,14278,FALSE,0.895621628402961,2023,2023-2024
IL,2024-05-31,inter-total,194,37,19,6,11,7,2,4,2,9,79,370,273,310,FALSE,0.837837837837838,2023,2023-2024
IL,2024-05-31,inter-ucfe,1,0,0,0,0,0,0,0,0,1,1,3,2,2,FALSE,0.666666666666667,2023,2023-2024
IL,2024-05-31,inter-ucx,0,0,0,0,0,0,0,0,0,0,0,0,0,0,FALSE,0,2023,2023-2024
IL,2024-05-31,inter-ui,193,37,19,6,11,7,2,4,2,8,78,367,271,308,FALSE,0.839237057220709,2023,2023-2024
IL,2024-05-31,intra-total,11462,908,412,255,172,148,100,83,68,209,2914,16731,14376,15284,FALSE,0.91351383659076,2023,2023-2024
IL,2024-05-31,intra-ucfe,19,6,4,0,0,1,1,1,1,3,4,40,23,29,FALSE,0.725,2023,2023-2024
IL,2024-05-31,intra-ucx,14,1,4,1,2,0,0,1,0,2,3,28,17,18,FALSE,0.642857142857143,2023,2023-2024
IL,2024-05-31,intra-ui,11429,901,404,254,170,147,99,81,67,204,2907,16663,14336,15237,FALSE,0.914421172657985,2023,2023-2024
IL,2024-06-30,inter-total,126,25,20,11,6,5,4,5,4,9,65,280,191,216,FALSE,0.771428571428571,2023,2023-2024
IL,2024-06-30,inter-ucfe,0,1,0,0,0,1,0,0,0,0,0,2,0,1,FALSE,0.5,2023,2023-2024
IL,2024-06-30,inter-ucx,1,0,0,0,0,0,0,0,0,0,0,1,1,1,FALSE,1,2023,2023-2024
IL,2024-06-30,inter-ui,125,24,20,11,6,4,4,5,4,9,65,277,190,214,FALSE,0.772563176895307,2023,2023-2024
IL,2024-06-30,intra-total,12648,809,423,197,181,165,156,117,87,225,3237,18245,15885,16694,FALSE,0.91499040833105,2023,2023-2024
IL,2024-06-30,intra-ucfe,19,4,3,3,1,2,0,1,0,1,7,41,26,30,FALSE,0.731707317073171,2023,2023-2024
IL,2024-06-30,intra-ucx,9,3,1,0,1,0,1,0,0,5,3,23,12,15,FALSE,0.652173913043478,2023,2023-2024
IL,2024-06-30,intra-ui,12620,802,419,194,179,163,155,116,87,219,3227,18181,15847,16649,FALSE,0.915736208129366,2023,2023-2024
IL,2024-07-31,inter-total,156,39,25,21,12,10,7,5,2,16,84,377,240,279,FALSE,0.740053050397878,2024,2024-2025
IL,2024-07-31,inter-ucfe,0,0,1,0,0,0,0,0,0,0,0,1,0,0,FALSE,0,2024,2024-2025
IL,2024-07-31,inter-ucx,0,0,0,0,0,0,0,0,0,0,0,0,0,0,FALSE,0,2024,2024-2025
IL,2024-07-31,inter-ui,156,39,24,21,12,10,7,5,2,16,84,376,240,279,FALSE,0.742021276595745,2024,2024-2025
IL,2024-07-31,intra-total,12742,1517,669,378,320,214,162,126,85,307,4374,20894,17116,18633,FALSE,0.891787115918446,2024,2024-2025
IL,2024-07-31,intra-ucfe,24,8,4,3,4,3,0,0,0,6,7,59,31,39,FALSE,0.661016949152542,2024,2024-2025
IL,2024-07-31,intra-ucx,7,6,1,1,1,0,0,0,0,1,5,22,12,18,FALSE,0.818181818181818,2024,2024-2025
IL,2024-07-31,intra-ui,12711,1503,664,374,315,211,162,126,85,300,4362,20813,17073,18576,FALSE,0.892519098640273,2024,2024-2025
IL,2024-08-31,inter-total,168,44,32,18,10,7,6,4,3,12,89,393,257,301,FALSE,0.765903307888041,2024,2024-2025
IL,2024-08-31,inter-ucfe,0,0,0,0,0,0,0,0,0,1,0,1,0,0,FALSE,0,2024,2024-2025
IL,2024-08-31,inter-ucx,0,0,0,0,0,0,0,0,0,0,1,1,1,1,FALSE,1,2024,2024-2025
IL,2024-08-31,inter-ui,168,44,32,18,10,7,6,4,3,11,88,391,256,300,FALSE,0.767263427109974,2024,2024-2025
IL,2024-08-31,intra-total,10113,982,501,284,247,243,170,123,83,234,2914,15894,13027,14009,FALSE,0.8814017868378,2024,2024-2025
IL,2024-08-31,intra-ucfe,11,3,2,3,2,2,3,0,1,2,6,35,17,20,FALSE,0.571428571428571,2024,2024-2025
IL,2024-08-31,intra-ucx,8,1,0,2,1,1,0,0,0,1,4,18,12,13,FALSE,0.722222222222222,2024,2024-2025
IL,2024-08-31,intra-ui,10094,978,499,279,244,240,167,123,82,231,2904,15841,12998,13976,FALSE,0.882267533615302,2024,2024-2025
IL,2024-09-30,inter-total,136,30,19,11,10,7,10,5,1,10,58,297,194,224,FALSE,0.754208754208754,2024,2024-2025
IL,2024-09-30,inter-ucfe,0,1,0,0,0,0,0,1,0,0,0,2,0,1,FALSE,0.5,2024,2024-2025
IL,2024-09-30,inter-ucx,0,0,0,0,0,0,0,0,0,0,0,0,0,0,FALSE,0,2024,2024-2025
IL,2024-09-30,inter-ui,136,29,19,11,10,7,10,4,1,10,58,295,194,223,FALSE,0.75593220338983,2024,2024-2025
IL,2024-09-30,intra-total,9236,970,461,273,239,181,135,99,87,298,2569,14548,11805,12775,FALSE,0.878127577673907,2024,2024-2025
IL,2024-09-30,intra-ucfe,17,6,2,2,0,2,0,1,0,3,9,42,26,32,FALSE,0.761904761904762,2024,2024-2025
IL,2024-09-30,intra-ucx,12,3,2,0,0,0,0,0,0,0,2,19,14,17,FALSE,0.894736842105263,2024,2024-2025
IL,2024-09-30,intra-ui,9207,961,457,271,239,179,135,98,87,295,2558,14487,11765,12726,FALSE,0.878442741768482,2024,2024-2025
IL,2024-10-31,inter-total,134,31,23,12,7,8,10,3,5,17,62,312,196,227,FALSE,0.727564102564103,2024,2024-2025
IL,2024-10-31,inter-ucfe,0,0,0,0,0,0,0,0,0,0,0,0,0,0,FALSE,0,2024,2024-2025
IL,2024-10-31,inter-ucx,0,0,0,0,0,0,0,0,0,1,0,1,0,0,FALSE,0,2024,2024-2025
IL,2024-10-31,inter-ui,134,31,23,12,7,8,10,3,5,16,62,311,196,227,FALSE,0.729903536977492,2024,2024-2025
IL,2024-10-31,intra-total,10623,883,408,268,233,144,116,83,62,245,2747,15812,13370,14253,FALSE,0.901403996964331,2024,2024-2025
IL,2024-10-31,intra-ucfe,15,5,3,2,2,1,0,1,0,4,12,45,27,32,FALSE,0.711111111111111,2024,2024-2025
IL,2024-10-31,intra-ucx,16,3,2,0,1,0,0,0,0,0,6,28,22,25,FALSE,0.892857142857143,2024,2024-2025
IL,2024-10-31,intra-ui,10592,875,403,266,230,143,116,82,62,241,2729,15739,13321,14196,FALSE,0.901963275938751,2024,2024-2025
IL,2024-11-30,inter-total,153,27,17,12,9,3,2,4,3,10,54,294,207,234,FALSE,0.795918367346939,2024,2024-2025
IL,2024-11-30,inter-ucfe,0,0,0,0,0,1,0,0,0,0,1,2,1,1,FALSE,0.5,2024,2024-2025
IL,2024-11-30,inter-ucx,0,0,0,0,0,0,0,0,0,0,0,0,0,0,FALSE,0,2024,2024-2025
IL,2024-11-30,inter-ui,153,27,17,12,9,2,2,4,3,10,53,292,206,233,FALSE,0.797945205479452,2024,2024-2025
IL,2024-11-30,intra-total,10004,817,389,214,204,168,124,88,80,198,2506,14792,12510,13327,FALSE,0.900959978366685,2024,2024-2025
IL,2024-11-30,intra-ucfe,13,7,3,2,1,0,0,0,1,0,6,33,19,26,FALSE,0.787878787878788,2024,2024-2025
IL,2024-11-30,intra-ucx,7,2,0,0,0,0,1,0,0,1,3,14,10,12,FALSE,0.857142857142857,2024,2024-2025
IL,2024-11-30,intra-ui,9984,808,386,212,203,168,123,88,79,197,2497,14745,12481,13289,FALSE,0.901254662597491,2024,2024-2025
IL,2024-12-31,inter-total,223,59,36,18,8,8,6,6,5,19,102,490,325,384,FALSE,0.783673469387755,2024,2024-2025
IL,2024-12-31,inter-ucfe,0,0,1,0,0,0,0,0,0,2,0,3,0,0,FALSE,0,2024,2024-2025
IL,2024-12-31,inter-ucx,0,1,0,0,0,0,0,0,0,0,0,1,0,1,FALSE,1,2024,2024-2025
IL,2024-12-31,inter-ui,223,58,35,18,8,8,6,6,5,17,102,486,325,383,FALSE,0.788065843621399,2024,2024-2025
IL,2024-12-31,intra-total,22760,1158,544,268,235,196,150,121,79,254,4561,30326,27321,28479,FALSE,0.939095165864275,2024,2024-2025
IL,2024-12-31,intra-ucfe,18,5,3,3,0,3,2,0,0,0,12,46,30,35,FALSE,0.760869565217391,2024,2024-2025
IL,2024-12-31,intra-ucx,5,2,1,0,2,1,0,0,0,1,9,21,14,16,FALSE,0.761904761904762,2024,2024-2025
IL,2024-12-31,intra-ui,22737,1151,540,265,233,192,148,121,79,253,4540,30259,27277,28428,FALSE,0.939489077629796,2024,2024-2025
IN,2019-01-31,inter-total,122,13,7,5,3,2,0,1,0,3,38,194,160,173,FALSE,0.891752577319588,2018,2018-2019
IN,2019-01-31,inter-ucfe,1,0,0,0,0,0,0,0,0,0,2,3,3,3,FALSE,1,2018,2018-2019
IN,2019-01-31,inter-ucx,0,0,0,0,0,0,0,0,0,0,0,0,0,0,FALSE,0,2018,2018-2019
IN,2019-01-31,inter-ui,121,13,7,5,3,2,0,1,0,3,36,191,157,170,FALSE,0.890052356020943,2018,2018-2019
IN,2019-01-31,intra-total,6856,709,342,113,104,64,42,30,19,32,1699,10010,8555,9264,FALSE,0.925474525474525,2018,2018-2019
IN,2019-01-31,intra-ucfe,13,1,0,0,1,1,0,1,1,0,8,26,21,22,FALSE,0.846153846153846,2018,2018-2019
IN,2019-01-31,intra-ucx,6,2,1,0,0,0,0,0,0,0,2,11,8,10,FALSE,0.909090909090909,2018,2018-2019
IN,2019-01-31,intra-ui,6837,706,341,113,103,63,42,29,18,32,1689,9973,8526,9232,FALSE,0.925699388348541,2018,2018-2019
IN,2019-02-28,inter-total,128,14,5,3,4,2,1,1,0,4,43,205,171,185,FALSE,0.902439024390244,2018,2018-2019
IN,2019-02-28,inter-ucfe,0,0,0,0,0,0,0,0,0,0,0,0,0,0,FALSE,0,2018,2018-2019
IN,2019-02-28,inter-ucx,0,0,0,0,0,0,0,0,0,0,0,0,0,0,FALSE,0,2018,2018-2019
IN,2019-02-28,inter-ui,128,14,5,3,4,2,1,1,0,4,43,205,171,185,FALSE,0.902439024390244,2018,2018-2019
IN,2019-02-28,intra-total,4587,566,234,119,91,86,54,47,19,55,1583,7441,6170,6736,FALSE,0.905254670071227,2018,2018-2019
IN,2019-02-28,intra-ucfe,3,2,1,1,0,0,0,0,0,0,4,11,7,9,FALSE,0.818181818181818,2018,2018-2019
IN,2019-02-28,intra-ucx,6,0,2,0,2,1,0,0,0,1,1,13,7,7,FALSE,0.538461538461538,2018,2018-2019
IN,2019-02-28,intra-ui,4578,564,231,118,89,85,54,47,19,54,1578,7417,6156,6720,FALSE,0.906026695429419,2018,2018-2019
IN,2019-03-31,inter-total,71,8,2,3,3,4,2,0,1,1,28,123,99,107,FALSE,0.869918699186992,2018,2018-2019
IN,2019-03-31,inter-ucfe,0,0,0,0,0,0,0,0,0,0,0,0,0,0,FALSE,0,2018,2018-2019
IN,2019-03-31,inter-ucx,0,0,0,0,0,0,0,0,0,0,0,0,0,0,FALSE,0,2018,2018-2019
IN,2019-03-31,inter-ui,71,8,2,3,3,4,2,0,1,1,28,123,99,107,FALSE,0.869918699186992,2018,2018-2019
IN,2019-03-31,intra-total,3344,306,168,134,96,85,61,45,31,87,941,5298,4285,4591,FALSE,0.866553416383541,2018,2018-2019
IN,2019-03-31,intra-ucfe,4,1,0,0,0,0,0,0,0,1,1,7,5,6,FALSE,0.857142857142857,2018,2018-2019
IN,2019-03-31,intra-ucx,4,1,0,0,0,0,0,0,0,0,1,6,5,6,FALSE,1,2018,2018-2019
IN,2019-03-31,intra-ui,3336,304,168,134,96,85,61,45,31,86,939,5285,4275,4579,FALSE,0.866414380321665,2018,2018-2019
IN,2019-04-30,inter-total,75,5,5,2,1,0,1,0,2,1,14,106,89,94,FALSE,0.886792452830189,2018,2018-2019
IN,2019-04-30,inter-ucfe,0,0,0,0,0,0,0,0,0,0,0,0,0,0,FALSE,0,2018,2018-2019
IN,2019-04-30,inter-ucx,0,0,0,0,0,0,0,0,0,0,0,0,0,0,FALSE,0,2018,2018-2019
IN,2019-04-30,inter-ui,75,5,5,2,1,0,1,0,2,1,14,106,89,94,FALSE,0.886792452830189,2018,2018-2019
IN,2019-04-30,intra-total,2723,245,120,100,72,57,45,40,39,82,785,4308,3508,3753,FALSE,0.87116991643454,2018,2018-2019
IN,2019-04-30,intra-ucfe,2,0,1,0,3,1,0,0,1,1,3,12,5,5,FALSE,0.416666666666667,2018,2018-2019
IN,2019-04-30,intra-ucx,8,0,0,0,0,0,0,0,1,0,2,11,10,10,FALSE,0.909090909090909,2018,2018-2019
IN,2019-04-30,intra-ui,2713,245,119,100,69,56,45,40,37,81,780,4285,3493,3738,FALSE,0.872345390898483,2018,2018-2019
IN,2019-05-31,inter-total,76,10,1,1,2,1,1,1,2,0,19,114,95,105,FALSE,0.921052631578947,2018,2018-2019
IN,2019-05-31,inter-ucfe,0,0,0,0,0,0,0,0,0,0,1,1,1,1,FALSE,1,2018,2018-2019
IN,2019-05-31,inter-ucx,0,0,0,0,0,0,0,0,0,0,0,0,0,0,FALSE,0,2018,2018-2019
IN,2019-05-31,inter-ui,76,10,1,1,2,1,1,1,2,0,18,113,94,104,FALSE,0.920353982300885,2018,2018-2019
IN,2019-05-31,intra-total,2448,226,87,105,58,28,26,10,15,59,775,3837,3223,3449,FALSE,0.898879332812093,2018,2018-2019
IN,2019-05-31,intra-ucfe,2,1,0,1,0,1,0,0,0,0,1,6,3,4,FALSE,0.666666666666667,2018,2018-2019
IN,2019-05-31,intra-ucx,8,0,0,0,0,0,0,0,0,0,1,9,9,9,FALSE,1,2018,2018-2019
IN,2019-05-31,intra-ui,2438,225,87,104,58,27,26,10,15,59,773,3822,3211,3436,FALSE,0.899005756148613,2018,2018-2019
IN,2019-06-30,inter-total,79,3,3,1,2,1,0,0,0,2,11,102,90,93,FALSE,0.911764705882353,2018,2018-2019
IN,2019-06-30,inter-ucfe,0,0,0,0,0,0,0,0,0,0,0,0,0,0,FALSE,0,2018,2018-2019
IN,2019-06-30,inter-ucx,0,0,0,0,0,0,0,0,0,0,0,0,0,0,FALSE,0,2018,2018-2019
IN,2019-06-30,inter-ui,79,3,3,1,2,1,0,0,0,2,11,102,90,93,FALSE,0.911764705882353,2018,2018-2019
IN,2019-06-30,intra-total,2496,181,81,49,46,41,23,8,8,35,760,3728,3256,3437,FALSE,0.921942060085837,2018,2018-2019
IN,2019-06-30,intra-ucfe,3,1,1,0,1,0,0,0,0,0,2,8,5,6,FALSE,0.75,2018,2018-2019
IN,2019-06-30,intra-ucx,7,0,0,0,0,0,0,0,0,0,3,10,10,10,FALSE,1,2018,2018-2019
IN,2019-06-30,intra-ui,2486,180,80,49,45,41,23,8,8,35,755,3710,3241,3421,FALSE,0.922102425876011,2018,2018-2019
IN,2019-07-31,inter-total,55,4,2,0,1,1,0,3,0,2,14,82,69,73,FALSE,0.890243902439024,2019,2019-2020
IN,2019-07-31,inter-ucfe,1,0,0,0,0,0,0,0,0,0,0,1,1,1,FALSE,1,2019,2019-2020
IN,2019-07-31,inter-ucx,0,0,0,0,0,0,0,0,0,0,0,0,0,0,FALSE,0,2019,2019-2020
IN,2019-07-31,inter-ui,54,4,2,0,1,1,0,3,0,2,14,81,68,72,FALSE,0.888888888888889,2019,2019-2020
IN,2019-07-31,intra-total,1875,162,44,37,30,22,15,9,7,18,729,2948,2604,2766,FALSE,0.938263229308005,2019,2019-2020
IN,2019-07-31,intra-ucfe,2,1,0,0,0,0,0,0,0,0,1,4,3,4,FALSE,1,2019,2019-2020
IN,2019-07-31,intra-ucx,11,0,0,0,0,0,0,0,0,0,0,11,11,11,FALSE,1,2019,2019-2020
IN,2019-07-31,intra-ui,1862,161,44,37,30,22,15,9,7,18,728,2933,2590,2751,FALSE,0.937947494033413,2019,2019-2020
IN,2019-08-31,inter-total,60,3,1,3,1,5,0,1,0,1,13,88,73,76,FALSE,0.863636363636364,2019,2019-2020
IN,2019-08-31,inter-ucfe,0,0,0,0,0,0,0,0,0,0,0,0,0,0,FALSE,0,2019,2019-2020
IN,2019-08-31,inter-ucx,0,0,0,0,0,0,0,0,0,0,0,0,0,0,FALSE,0,2019,2019-2020
IN,2019-08-31,inter-ui,60,3,1,3,1,5,0,1,0,1,13,88,73,76,FALSE,0.863636363636364,2019,2019-2020
IN,2019-08-31,intra-total,2054,106,38,29,31,30,11,5,6,16,523,2849,2577,2683,FALSE,0.941733941733942,2019,2019-2020
IN,2019-08-31,intra-ucfe,1,0,1,0,1,0,0,0,0,0,6,9,7,7,FALSE,0.777777777777778,2019,2019-2020
IN,2019-08-31,intra-ucx,8,0,0,0,1,0,0,0,0,0,1,10,9,9,FALSE,0.9,2019,2019-2020
IN,2019-08-31,intra-ui,2045,106,37,29,29,30,11,5,6,16,516,2830,2561,2667,FALSE,0.942402826855124,2019,2019-2020
IN,2019-09-30,inter-total,45,2,2,3,1,0,2,0,0,0,8,63,53,55,FALSE,0.873015873015873,2019,2019-2020
IN,2019-09-30,inter-ucfe,0,0,0,0,0,0,0,0,0,0,0,0,0,0,FALSE,0,2019,2019-2020
IN,2019-09-30,inter-ucx,0,0,0,0,0,0,0,0,0,0,0,0,0,0,FALSE,0,2019,2019-2020
IN,2019-09-30,inter-ui,45,2,2,3,1,0,2,0,0,0,8,63,53,55,FALSE,0.873015873015873,2019,2019-2020
IN,2019-09-30,intra-total,2034,78,34,24,28,25,14,12,6,18,525,2798,2559,2637,FALSE,0.942458899213724,2019,2019-2020
IN,2019-09-30,intra-ucfe,3,0,1,0,0,0,0,0,0,0,2,6,5,5,FALSE,0.833333333333333,2019,2019-2020
IN,2019-09-30,intra-ucx,2,0,0,0,0,0,0,0,0,1,1,4,3,3,FALSE,0.75,2019,2019-2020
IN,2019-09-30,intra-ui,2029,78,33,24,28,25,14,12,6,17,522,2788,2551,2629,FALSE,0.942969870875179,2019,2019-2020
IN,2019-10-31,inter-total,61,2,0,0,0,0,0,0,0,2,20,85,81,83,FALSE,0.976470588235294,2019,2019-2020
IN,2019-10-31,inter-ucfe,2,0,0,0,0,0,0,0,0,0,0,2,2,2,FALSE,1,2019,2019-2020
IN,2019-10-31,inter-ucx,0,0,0,0,0,0,0,0,0,0,0,0,0,0,FALSE,0,2019,2019-2020
IN,2019-10-31,inter-ui,59,2,0,0,0,0,0,0,0,2,20,83,79,81,FALSE,0.975903614457831,2019,2019-2020
IN,2019-10-31,intra-total,2672,119,41,32,24,21,11,4,1,22,709,3656,3381,3500,FALSE,0.957330415754923,2019,2019-2020
IN,2019-10-31,intra-ucfe,5,0,0,0,0,0,0,0,0,1,1,7,6,6,FALSE,0.857142857142857,2019,2019-2020
IN,2019-10-31,intra-ucx,5,0,0,0,0,0,0,0,0,0,0,5,5,5,FALSE,1,2019,2019-2020
IN,2019-10-31,intra-ui,2662,119,41,32,24,21,11,4,1,21,708,3644,3370,3489,FALSE,0.957464324917673,2019,2019-2020
IN,2019-11-30,inter-total,58,2,3,0,0,0,0,0,0,0,15,78,73,75,FALSE,0.961538461538461,2019,2019-2020
IN,2019-11-30,inter-ucfe,0,0,0,0,0,0,0,0,0,0,0,0,0,0,FALSE,0,2019,2019-2020
IN,2019-11-30,inter-ucx,0,0,0,0,0,0,0,0,0,0,0,0,0,0,FALSE,0,2019,2019-2020
IN,2019-11-30,inter-ui,58,2,3,0,0,0,0,0,0,0,15,78,73,75,FALSE,0.961538461538461,2019,2019-2020
IN,2019-11-30,intra-total,2318,103,69,28,24,17,6,8,8,18,587,3186,2905,3008,FALSE,0.944130571249215,2019,2019-2020
IN,2019-11-30,intra-ucfe,3,0,2,0,0,0,0,0,0,0,2,7,5,5,FALSE,0.714285714285714,2019,2019-2020
IN,2019-11-30,intra-ucx,5,0,0,0,0,1,0,0,0,0,1,7,6,6,FALSE,0.857142857142857,2019,2019-2020
IN,2019-11-30,intra-ui,2310,103,67,28,24,16,6,8,8,18,584,3172,2894,2997,FALSE,0.944829760403531,2019,2019-2020
IN,2019-12-31,inter-total,154,6,0,2,1,2,0,0,2,1,24,192,178,184,FALSE,0.958333333333333,2019,2019-2020
IN,2019-12-31,inter-ucfe,0,0,0,0,0,0,0,0,0,0,0,0,0,0,FALSE,0,2019,2019-2020
IN,2019-12-31,inter-ucx,0,0,0,0,0,0,0,0,0,0,0,0,0,0,FALSE,0,2019,2019-2020
IN,2019-12-31,inter-ui,154,6,0,2,1,2,0,0,2,1,24,192,178,184,FALSE,0.958333333333333,2019,2019-2020
IN,2019-12-31,intra-total,4156,164,54,30,25,17,13,6,2,28,853,5348,5009,5173,FALSE,0.967277486910995,2019,2019-2020
IN,2019-12-31,intra-ucfe,4,1,0,0,0,0,0,0,0,0,3,8,7,8,FALSE,1,2019,2019-2020
IN,2019-12-31,intra-ucx,7,0,0,0,0,0,0,0,0,0,3,10,10,10,FALSE,1,2019,2019-2020
IN,2019-12-31,intra-ui,4145,163,54,30,25,17,13,6,2,28,847,5330,4992,5155,FALSE,0.967166979362101,2019,2019-2020
IN,2020-01-31,inter-total,174,9,7,3,1,0,0,0,0,0,56,250,230,239,FALSE,0.956,2019,2019-2020
IN,2020-01-31,inter-ucfe,0,0,0,0,0,0,0,0,0,0,1,1,1,1,FALSE,1,2019,2019-2020
IN,2020-01-31,inter-ucx,0,0,0,0,0,0,0,0,0,0,0,0,0,0,FALSE,0,2019,2019-2020
IN,2020-01-31,inter-ui,174,9,7,3,1,0,0,0,0,0,55,249,229,238,FALSE,0.955823293172691,2019,2019-2020
IN,2020-01-31,intra-total,6701,317,113,56,29,41,12,9,9,36,1279,8602,7980,8297,FALSE,0.964543129504766,2019,2019-2020
IN,2020-01-31,intra-ucfe,5,2,0,0,0,0,0,0,0,0,5,12,10,12,FALSE,1,2019,2019-2020
IN,2020-01-31,intra-ucx,3,0,0,0,0,0,0,0,0,0,1,4,4,4,FALSE,1,2019,2019-2020
IN,2020-01-31,intra-ui,6693,315,113,56,29,41,12,9,9,36,1273,8586,7966,8281,FALSE,0.964477055672024,2019,2019-2020
IN,2020-02-29,inter-total,115,5,3,2,3,3,1,1,0,1,33,167,148,153,FALSE,0.916167664670659,2019,2019-2020
IN,2020-02-29,inter-ucfe,0,0,0,0,0,0,0,0,0,0,0,0,0,0,FALSE,0,2019,2019-2020
IN,2020-02-29,inter-ucx,0,0,0,0,0,0,0,0,0,0,0,0,0,0,FALSE,0,2019,2019-2020
IN,2020-02-29,inter-ui,115,5,3,2,3,3,1,1,0,1,33,167,148,153,FALSE,0.916167664670659,2019,2019-2020
IN,2020-02-29,intra-total,4345,209,112,80,79,54,26,12,7,28,929,5881,5274,5483,FALSE,0.932324434619963,2019,2019-2020
IN,2020-02-29,intra-ucfe,1,0,0,0,0,0,0,0,0,0,4,5,5,5,FALSE,1,2019,2019-2020
IN,2020-02-29,intra-ucx,4,1,0,0,0,0,0,0,0,0,2,7,6,7,FALSE,1,2019,2019-2020
IN,2020-02-29,intra-ui,4340,208,112,80,79,54,26,12,7,28,923,5869,5263,5471,FALSE,0.932186062361561,2019,2019-2020
IN,2020-03-31,inter-total,103,8,2,3,2,0,2,0,1,5,40,166,143,151,FALSE,0.909638554216867,2019,2019-2020
IN,2020-03-31,inter-ucfe,1,1,0,0,0,0,0,0,0,0,0,2,1,2,FALSE,1,2019,2019-2020
IN,2020-03-31,inter-ucx,0,0,0,0,0,0,0,0,0,0,0,0,0,0,FALSE,0,2019,2019-2020
IN,2020-03-31,inter-ui,102,7,2,3,2,0,2,0,1,5,40,164,142,149,FALSE,0.908536585365854,2019,2019-2020
IN,2020-03-31,intra-total,15251,269,67,55,32,25,6,7,6,39,5283,21040,20534,20803,FALSE,0.988735741444867,2019,2019-2020
IN,2020-03-31,intra-ucfe,5,0,0,0,0,0,0,0,0,1,2,8,7,7,FALSE,0.875,2019,2019-2020
IN,2020-03-31,intra-ucx,10,0,0,0,0,0,0,0,0,0,3,13,13,13,FALSE,1,2019,2019-2020
IN,2020-03-31,intra-ui,15236,269,67,55,32,25,6,7,6,38,5278,21019,20514,20783,FALSE,0.988772063371236,2019,2019-2020
IN,2020-04-30,inter-total,332,190,44,25,6,1,0,0,0,0,992,1590,1324,1514,FALSE,0.952201257861635,2019,2019-2020
IN,2020-04-30,inter-ucfe,0,1,0,0,0,0,0,0,0,0,0,1,0,1,FALSE,1,2019,2019-2020
IN,2020-04-30,inter-ucx,0,0,0,0,0,0,0,0,0,0,0,0,0,0,FALSE,0,2019,2019-2020
IN,2020-04-30,inter-ui,332,189,44,25,6,1,0,0,0,0,992,1589,1324,1513,FALSE,0.95217117684078,2019,2019-2020
IN,2020-04-30,intra-total,56276,25411,8197,4664,741,36,10,5,1,19,137846,233206,194122,219533,FALSE,0.941369433033455,2019,2019-2020
IN,2020-04-30,intra-ucfe,10,10,3,1,1,0,0,0,0,0,12,37,22,32,FALSE,0.864864864864865,2019,2019-2020
IN,2020-04-30,intra-ucx,20,7,3,3,0,0,0,0,0,0,30,63,50,57,FALSE,0.904761904761905,2019,2019-2020
IN,2020-04-30,intra-ui,56246,25394,8191,4660,740,36,10,5,1,19,137804,233106,194050,219444,FALSE,0.941391469975033,2019,2019-2020
IN,2020-05-31,inter-total,132,131,90,185,129,61,26,11,1,1,403,1170,535,666,FALSE,0.569230769230769,2019,2019-2020
IN,2020-05-31,inter-ucfe,0,0,0,0,0,0,0,0,0,0,0,0,0,0,FALSE,0,2019,2019-2020
IN,2020-05-31,inter-ucx,0,0,0,0,0,0,0,0,0,0,1,1,1,1,FALSE,1,2019,2019-2020
IN,2020-05-31,inter-ui,132,131,90,185,129,61,26,11,1,1,402,1169,534,665,FALSE,0.568862275449102,2019,2019-2020
IN,2020-05-31,intra-total,14854,9369,9103,17634,14262,6535,2441,557,86,51,28496,103388,43350,52719,FALSE,0.509914109954734,2019,2019-2020
IN,2020-05-31,intra-ucfe,5,2,4,5,11,4,5,2,0,1,8,47,13,15,FALSE,0.319148936170213,2019,2019-2020
IN,2020-05-31,intra-ucx,7,7,4,7,3,0,1,1,0,0,12,42,19,26,FALSE,0.619047619047619,2019,2019-2020
IN,2020-05-31,intra-ui,14842,9360,9095,17622,14248,6531,2435,554,86,50,28476,103299,43318,52678,FALSE,0.50995653394515,2019,2019-2020
IN,2020-06-30,inter-total,82,113,49,66,75,85,74,55,38,54,251,942,333,446,FALSE,0.473460721868365,2019,2019-2020
IN,2020-06-30,inter-ucfe,0,0,0,0,0,0,0,1,0,0,1,2,1,1,FALSE,0.5,2019,2019-2020
IN,2020-06-30,inter-ucx,0,0,0,0,0,0,1,0,0,0,0,1,0,0,FALSE,0,2019,2019-2020
IN,2020-06-30,inter-ui,82,113,49,66,75,85,73,54,38,54,250,939,332,445,FALSE,0.473908413205538,2019,2019-2020
IN,2020-06-30,intra-total,7934,5551,3639,3327,3964,5341,5772,4544,3316,7743,11999,63130,19933,25484,FALSE,0.403674956439094,2019,2019-2020
IN,2020-06-30,intra-ucfe,3,3,1,2,4,2,3,4,4,5,4,35,7,10,FALSE,0.285714285714286,2019,2019-2020
IN,2020-06-30,intra-ucx,14,12,10,6,4,4,3,1,2,1,14,71,28,40,FALSE,0.563380281690141,2019,2019-2020
IN,2020-06-30,intra-ui,7917,5536,3628,3319,3956,5335,5766,4539,3310,7737,11981,63024,19898,25434,FALSE,0.403560548362529,2019,2019-2020
IN,2020-07-31,inter-total,61,76,13,18,20,11,6,11,15,128,193,552,254,330,FALSE,0.597826086956522,2020,2020-2021
IN,2020-07-31,inter-ucfe,0,1,0,0,0,0,0,0,0,0,2,3,2,3,FALSE,1,2020,2020-2021
IN,2020-07-31,inter-ucx,1,0,0,0,0,0,0,0,0,0,0,1,1,1,FALSE,1,2020,2020-2021
IN,2020-07-31,inter-ui,60,75,13,18,20,11,6,11,15,128,191,548,251,326,FALSE,0.594890510948905,2020,2020-2021
IN,2020-07-31,intra-total,6856,3481,733,742,733,614,691,793,1076,11134,10849,37702,17705,21186,FALSE,0.561933053949393,2020,2020-2021
IN,2020-07-31,intra-ucfe,5,2,0,1,1,2,3,1,0,11,6,32,11,13,FALSE,0.40625,2020,2020-2021
IN,2020-07-31,intra-ucx,15,3,1,7,1,3,0,0,1,12,8,51,23,26,FALSE,0.509803921568627,2020,2020-2021
IN,2020-07-31,intra-ui,6836,3476,732,734,731,609,688,792,1075,11111,10835,37619,17671,21147,FALSE,0.562136154602727,2020,2020-2021
IN,2020-08-31,inter-total,35,62,14,8,8,12,9,11,13,120,91,383,126,188,FALSE,0.490861618798956,2020,2020-2021
IN,2020-08-31,inter-ucfe,0,0,0,1,0,0,0,0,0,1,1,3,1,1,FALSE,0.333333333333333,2020,2020-2021
IN,2020-08-31,inter-ucx,0,0,0,0,0,0,0,0,0,1,0,1,0,0,FALSE,0,2020,2020-2021
IN,2020-08-31,inter-ui,35,62,14,7,8,12,9,11,13,118,90,379,125,187,FALSE,0.493403693931399,2020,2020-2021
IN,2020-08-31,intra-total,2928,1990,581,492,349,314,357,535,663,6002,4786,18997,7714,9704,FALSE,0.510817497499605,2020,2020-2021
IN,2020-08-31,intra-ucfe,2,4,1,1,0,0,0,0,1,8,5,22,7,11,FALSE,0.5,2020,2020-2021
IN,2020-08-31,intra-ucx,8,5,2,1,2,0,1,1,0,0,2,22,10,15,FALSE,0.681818181818182,2020,2020-2021
IN,2020-08-31,intra-ui,2918,1981,578,490,347,314,356,534,662,5994,4779,18953,7697,9678,FALSE,0.510631562285654,2020,2020-2021
IN,2020-09-30,inter-total,21,20,8,12,5,7,5,14,16,104,62,274,83,103,FALSE,0.375912408759124,2020,2020-2021
IN,2020-09-30,inter-ucfe,0,0,0,0,0,0,0,0,0,0,0,0,0,0,FALSE,0,2020,2020-2021
IN,2020-09-30,inter-ucx,0,0,0,0,0,0,0,1,0,0,0,1,0,0,FALSE,0,2020,2020-2021
IN,2020-09-30,inter-ui,21,20,8,12,5,7,5,13,16,104,62,273,83,103,FALSE,0.377289377289377,2020,2020-2021
IN,2020-09-30,intra-total,2649,752,354,296,295,335,402,587,799,4792,2453,13714,5102,5854,FALSE,0.426863059647076,2020,2020-2021
IN,2020-09-30,intra-ucfe,1,0,3,0,2,0,0,2,1,11,1,21,2,2,FALSE,0.0952380952380952,2020,2020-2021
IN,2020-09-30,intra-ucx,6,0,1,1,1,2,0,0,3,8,2,24,8,8,FALSE,0.333333333333333,2020,2020-2021
IN,2020-09-30,intra-ui,2642,752,350,295,292,333,402,585,795,4773,2450,13669,5092,5844,FALSE,0.427536762016241,2020,2020-2021
IN,2020-10-31,inter-total,24,31,11,6,3,9,13,19,14,62,88,280,112,143,FALSE,0.510714285714286,2020,2020-2021
IN,2020-10-31,inter-ucfe,0,0,0,0,0,0,0,0,0,0,0,0,0,0,FALSE,0,2020,2020-2021
IN,2020-10-31,inter-ucx,1,0,0,0,0,0,0,0,0,1,0,2,1,1,FALSE,0.5,2020,2020-2021
IN,2020-10-31,inter-ui,23,31,11,6,3,9,13,19,14,61,88,278,111,142,FALSE,0.510791366906475,2020,2020-2021
IN,2020-10-31,intra-total,5552,740,331,291,218,280,416,665,748,2932,2879,15052,8431,9171,FALSE,0.609287802285411,2020,2020-2021
IN,2020-10-31,intra-ucfe,5,0,3,0,0,1,1,2,1,12,4,29,9,9,FALSE,0.310344827586207,2020,2020-2021
IN,2020-10-31,intra-ucx,13,2,0,3,0,4,2,0,0,10,6,40,19,21,FALSE,0.525,2020,2020-2021
IN,2020-10-31,intra-ui,5534,738,328,288,218,275,413,663,747,2910,2869,14983,8403,9141,FALSE,0.61009143696189,2020,2020-2021
IN,2020-11-30,inter-total,41,21,12,8,6,10,12,10,3,37,66,226,107,128,FALSE,0.566371681415929,2020,2020-2021
IN,2020-11-30,inter-ucfe,0,0,0,0,0,1,0,0,0,0,0,1,0,0,FALSE,0,2020,2020-2021
IN,2020-11-30,inter-ucx,1,0,0,0,0,0,0,0,0,0,0,1,1,1,FALSE,1,2020,2020-2021
IN,2020-11-30,inter-ui,40,21,12,8,6,9,12,10,3,37,66,224,106,127,FALSE,0.566964285714286,2020,2020-2021
IN,2020-11-30,intra-total,10330,724,331,332,603,644,600,425,266,1343,2308,17906,12638,13362,FALSE,0.746230313861276,2020,2020-2021
IN,2020-11-30,intra-ucfe,0,3,6,1,4,1,2,1,1,9,5,33,5,8,FALSE,0.242424242424242,2020,2020-2021
IN,2020-11-30,intra-ucx,3,2,5,0,0,0,0,0,0,10,3,23,6,8,FALSE,0.347826086956522,2020,2020-2021
IN,2020-11-30,intra-ui,10327,719,320,331,599,643,598,424,265,1324,2300,17850,12627,13346,FALSE,0.747675070028011,2020,2020-2021
IN,2020-12-31,inter-total,15,22,7,12,12,8,2,5,5,46,36,170,51,73,FALSE,0.429411764705882,2020,2020-2021
IN,2020-12-31,inter-ucfe,0,0,0,0,0,0,0,0,0,1,0,1,0,0,FALSE,0,2020,2020-2021
IN,2020-12-31,inter-ucx,0,0,0,0,0,0,0,0,0,0,0,0,0,0,FALSE,0,2020,2020-2021
IN,2020-12-31,inter-ui,15,22,7,12,12,8,2,5,5,45,36,169,51,73,FALSE,0.431952662721893,2020,2020-2021
IN,2020-12-31,intra-total,2234,928,769,504,458,345,210,145,95,1108,1899,8695,4133,5061,FALSE,0.58205865439908,2020,2020-2021
IN,2020-12-31,intra-ucfe,0,3,5,3,8,3,1,1,3,5,3,35,3,6,FALSE,0.171428571428571,2020,2020-2021
IN,2020-12-31,intra-ucx,0,0,0,1,1,1,1,1,0,3,1,9,1,1,FALSE,0.111111111111111,2020,2020-2021
IN,2020-12-31,intra-ui,2234,925,764,500,449,341,208,143,92,1100,1895,8651,4129,5054,FALSE,0.584209917928563,2020,2020-2021
IN,2021-01-31,inter-total,22,27,17,9,9,10,5,5,3,39,76,222,98,125,FALSE,0.563063063063063,2020,2020-2021
IN,2021-01-31,inter-ucfe,0,0,0,0,0,1,0,0,0,2,0,3,0,0,FALSE,0,2020,2020-2021
IN,2021-01-31,inter-ucx,0,0,0,0,0,0,0,0,0,0,0,0,0,0,FALSE,0,2020,2020-2021
IN,2021-01-31,inter-ui,22,27,17,9,9,9,5,5,3,37,76,219,98,125,FALSE,0.570776255707763,2020,2020-2021
IN,2021-01-31,intra-total,3028,1724,963,684,395,450,234,118,79,1222,3562,12459,6590,8314,FALSE,0.667308772774701,2020,2020-2021
IN,2021-01-31,intra-ucfe,2,7,3,2,1,0,0,3,0,9,9,36,11,18,FALSE,0.5,2020,2020-2021
IN,2021-01-31,intra-ucx,7,4,3,3,2,3,0,0,0,3,3,28,10,14,FALSE,0.5,2020,2020-2021
IN,2021-01-31,intra-ui,3019,1713,957,679,392,447,234,115,79,1210,3550,12395,6569,8282,FALSE,0.668172650262203,2020,2020-2021
IN,2021-02-28,inter-total,16,26,10,12,9,8,5,4,2,35,43,170,59,85,FALSE,0.5,2020,2020-2021
IN,2021-02-28,inter-ucfe,0,0,0,1,1,0,0,0,0,0,0,2,0,0,FALSE,0,2020,2020-2021
IN,2021-02-28,inter-ucx,0,0,0,0,0,0,0,0,0,0,0,0,0,0,FALSE,0,2020,2020-2021
IN,2021-02-28,inter-ui,16,26,10,11,8,8,5,4,2,35,43,168,59,85,FALSE,0.505952380952381,2020,2020-2021
IN,2021-02-28,intra-total,2159,1374,849,558,485,582,415,265,146,1048,2893,10774,5052,6426,FALSE,0.59643586411732,2020,2020-2021
IN,2021-02-28,intra-ucfe,2,6,4,3,4,5,2,1,1,19,10,57,12,18,FALSE,0.315789473684211,2020,2020-2021
IN,2021-02-28,intra-ucx,7,0,1,0,2,0,0,0,0,2,2,14,9,9,FALSE,0.642857142857143,2020,2020-2021
IN,2021-02-28,intra-ui,2150,1368,844,555,479,577,413,264,145,1027,2881,10703,5031,6399,FALSE,0.597869756143138,2020,2020-2021
IN,2021-03-31,inter-total,21,24,19,8,9,19,35,32,19,72,30,288,51,75,FALSE,0.260416666666667,2020,2020-2021
IN,2021-03-31,inter-ucfe,0,0,2,0,1,0,1,0,0,0,0,4,0,0,FALSE,0,2020,2020-2021
IN,2021-03-31,inter-ucx,0,0,0,0,0,0,1,0,0,0,1,2,1,1,FALSE,0.5,2020,2020-2021
IN,2021-03-31,inter-ui,21,24,17,8,8,19,33,32,19,72,29,282,50,74,FALSE,0.262411347517731,2020,2020-2021
IN,2021-03-31,intra-total,1975,1027,649,477,384,441,594,597,580,1921,2041,10686,4016,5043,FALSE,0.471925884334643,2020,2020-2021
IN,2021-03-31,intra-ucfe,2,7,4,5,3,8,5,1,2,25,2,64,4,11,FALSE,0.171875,2020,2020-2021
IN,2021-03-31,intra-ucx,4,5,2,0,1,1,1,0,0,5,5,24,9,14,FALSE,0.583333333333333,2020,2020-2021
IN,2021-03-31,intra-ui,1969,1015,643,472,380,432,588,596,578,1891,2034,10598,4003,5018,FALSE,0.473485563313833,2020,2020-2021
IN,2021-04-30,inter-total,38,31,5,12,5,0,1,5,4,38,101,240,139,170,FALSE,0.708333333333333,2020,2020-2021
IN,2021-04-30,inter-ucfe,1,0,0,0,0,0,0,0,0,1,0,2,1,1,FALSE,0.5,2020,2020-2021
IN,2021-04-30,inter-ucx,1,0,0,0,0,0,0,0,0,0,0,1,1,1,FALSE,1,2020,2020-2021
IN,2021-04-30,inter-ui,36,31,5,12,5,0,1,5,4,37,101,237,137,168,FALSE,0.708860759493671,2020,2020-2021
IN,2021-04-30,intra-total,5273,2151,732,403,216,148,125,110,88,1006,7003,17255,12276,14427,FALSE,0.836105476673428,2020,2020-2021
IN,2021-04-30,intra-ucfe,11,6,6,4,3,4,3,1,1,20,12,71,23,29,FALSE,0.408450704225352,2020,2020-2021
IN,2021-04-30,intra-ucx,13,3,0,1,1,0,0,0,0,4,4,26,17,20,FALSE,0.769230769230769,2020,2020-2021
IN,2021-04-30,intra-ui,5249,2142,726,398,212,144,122,109,87,982,6987,17158,12236,14378,FALSE,0.837976454132183,2020,2020-2021
IN,2021-05-31,inter-total,29,21,11,4,9,6,3,2,2,29,51,167,80,101,FALSE,0.604790419161677,2020,2020-2021
IN,2021-05-31,inter-ucfe,0,0,0,0,0,0,0,0,0,1,0,1,0,0,FALSE,0,2020,2020-2021
IN,2021-05-31,inter-ucx,0,0,0,0,0,0,0,0,0,0,0,0,0,0,FALSE,0,2020,2020-2021
IN,2021-05-31,inter-ui,29,21,11,4,9,6,3,2,2,28,51,166,80,101,FALSE,0.608433734939759,2020,2020-2021
IN,2021-05-31,intra-total,2786,2026,921,733,561,339,207,150,83,998,7873,16677,10659,12685,FALSE,0.760628410385561,2020,2020-2021
IN,2021-05-31,intra-ucfe,5,9,6,3,4,3,0,0,5,16,10,61,15,24,FALSE,0.39344262295082,2020,2020-2021
IN,2021-05-31,intra-ucx,5,3,1,0,0,1,0,0,0,0,4,14,9,12,FALSE,0.857142857142857,2020,2020-2021
IN,2021-05-31,intra-ui,2776,2014,914,730,557,335,207,150,78,982,7859,16602,10635,12649,FALSE,0.761896157089507,2020,2020-2021
IN,2021-06-30,inter-total,22,13,10,8,5,8,4,4,2,36,33,145,55,68,FALSE,0.468965517241379,2020,2020-2021
IN,2021-06-30,inter-ucfe,0,0,0,0,0,0,0,0,0,1,0,1,0,0,FALSE,0,2020,2020-2021
IN,2021-06-30,inter-ucx,0,0,0,0,0,0,0,0,0,0,0,0,0,0,FALSE,0,2020,2020-2021
IN,2021-06-30,inter-ui,22,13,10,8,5,8,4,4,2,35,33,144,55,68,FALSE,0.472222222222222,2020,2020-2021
IN,2021-06-30,intra-total,1332,978,561,403,336,245,226,186,155,984,2878,8284,4210,5188,FALSE,0.626267503621439,2020,2020-2021
IN,2021-06-30,intra-ucfe,4,2,3,3,2,2,2,3,1,19,5,46,9,11,FALSE,0.239130434782609,2020,2020-2021
IN,2021-06-30,intra-ucx,1,0,0,1,0,0,0,0,0,1,1,4,2,2,FALSE,0.5,2020,2020-2021
IN,2021-06-30,intra-ui,1327,976,558,399,334,243,224,183,154,964,2872,8234,4199,5175,FALSE,0.628491620111732,2020,2020-2021
IN,2021-07-31,inter-total,11,21,5,1,5,1,5,1,1,31,25,107,36,57,FALSE,0.532710280373832,2021,2021-2022
IN,2021-07-31,inter-ucfe,0,0,0,0,0,0,0,0,0,1,0,1,0,0,FALSE,0,2021,2021-2022
IN,2021-07-31,inter-ucx,0,0,0,0,0,0,0,0,0,0,0,0,0,0,FALSE,0,2021,2021-2022
IN,2021-07-31,inter-ui,11,21,5,1,5,1,5,1,1,30,25,106,36,57,FALSE,0.537735849056604,2021,2021-2022
IN,2021-07-31,intra-total,944,882,375,215,128,126,88,112,89,1222,1764,5945,2708,3590,FALSE,0.603868797308663,2021,2021-2022
IN,2021-07-31,intra-ucfe,0,2,0,0,0,0,0,2,2,28,5,39,5,7,FALSE,0.17948717948718,2021,2021-2022
IN,2021-07-31,intra-ucx,5,3,1,0,0,0,0,0,0,1,1,11,6,9,FALSE,0.818181818181818,2021,2021-2022
IN,2021-07-31,intra-ui,939,877,374,215,128,126,88,110,87,1193,1758,5895,2697,3574,FALSE,0.606276505513147,2021,2021-2022
IN,2021-08-31,inter-total,16,17,9,4,2,1,1,2,0,22,104,178,120,137,FALSE,0.769662921348315,2021,2021-2022
IN,2021-08-31,inter-ucfe,0,0,0,0,0,0,0,0,0,0,0,0,0,0,FALSE,0,2021,2021-2022
IN,2021-08-31,inter-ucx,0,0,1,0,0,0,0,0,0,0,0,1,0,0,FALSE,0,2021,2021-2022
IN,2021-08-31,inter-ui,16,17,8,4,2,1,1,2,0,22,104,177,120,137,FALSE,0.774011299435028,2021,2021-2022
IN,2021-08-31,intra-total,1427,996,454,281,181,103,79,63,69,1167,4616,9436,6043,7039,FALSE,0.74597286986011,2021,2021-2022
IN,2021-08-31,intra-ucfe,4,7,3,2,2,0,1,0,1,23,22,65,26,33,FALSE,0.507692307692308,2021,2021-2022
IN,2021-08-31,intra-ucx,6,1,0,0,1,0,0,0,0,3,3,14,9,10,FALSE,0.714285714285714,2021,2021-2022
IN,2021-08-31,intra-ui,1417,988,451,279,178,103,78,63,68,1141,4591,9357,6008,6996,FALSE,0.7476755370311,2021,2021-2022
IN,2021-09-30,inter-total,3,5,1,1,0,2,4,1,3,26,8,54,11,16,FALSE,0.296296296296296,2021,2021-2022
IN,2021-09-30,inter-ucfe,0,0,0,0,0,0,0,0,0,1,0,1,0,0,FALSE,0,2021,2021-2022
IN,2021-09-30,inter-ucx,0,0,0,0,0,0,0,0,0,1,0,1,0,0,FALSE,0,2021,2021-2022
IN,2021-09-30,inter-ui,3,5,1,1,0,2,4,1,3,24,8,52,11,16,FALSE,0.307692307692308,2021,2021-2022
IN,2021-09-30,intra-total,910,612,374,258,179,120,98,129,80,1071,1143,4974,2053,2665,FALSE,0.53578608765581,2021,2021-2022
IN,2021-09-30,intra-ucfe,1,1,8,2,2,1,0,1,1,13,4,34,5,6,FALSE,0.176470588235294,2021,2021-2022
IN,2021-09-30,intra-ucx,2,0,1,1,0,0,0,0,0,1,2,7,4,4,FALSE,0.571428571428571,2021,2021-2022
IN,2021-09-30,intra-ui,907,611,365,255,177,119,98,128,79,1057,1137,4933,2044,2655,FALSE,0.538212041354146,2021,2021-2022
IN,2021-10-31,inter-total,20,1,4,1,2,2,0,1,0,43,7,81,27,28,FALSE,0.345679012345679,2021,2021-2022
IN,2021-10-31,inter-ucfe,0,0,0,0,0,0,0,0,0,1,0,1,0,0,FALSE,0,2021,2021-2022
IN,2021-10-31,inter-ucx,1,0,0,0,0,0,0,0,0,0,0,1,1,1,FALSE,1,2021,2021-2022
IN,2021-10-31,inter-ui,19,1,4,1,2,2,0,1,0,42,7,79,26,27,FALSE,0.341772151898734,2021,2021-2022
IN,2021-10-31,intra-total,1072,231,137,117,91,108,94,97,80,1280,476,3783,1548,1779,FALSE,0.470261697065821,2021,2021-2022
IN,2021-10-31,intra-ucfe,4,1,0,0,1,0,0,3,2,16,4,31,8,9,FALSE,0.290322580645161,2021,2021-2022
IN,2021-10-31,intra-ucx,7,0,0,0,0,0,1,0,0,3,1,12,8,8,FALSE,0.666666666666667,2021,2021-2022
IN,2021-10-31,intra-ui,1061,230,137,117,90,108,93,94,78,1261,471,3740,1532,1762,FALSE,0.471122994652406,2021,2021-2022
IN,2021-11-30,inter-total,16,1,1,2,1,0,2,0,0,40,9,72,25,26,FALSE,0.361111111111111,2021,2021-2022
IN,2021-11-30,inter-ucfe,0,0,0,0,0,0,0,0,0,1,0,1,0,0,FALSE,0,2021,2021-2022
IN,2021-11-30,inter-ucx,0,0,0,0,0,0,0,0,0,0,0,0,0,0,FALSE,0,2021,2021-2022
IN,2021-11-30,inter-ui,16,1,1,2,1,0,2,0,0,39,9,71,25,26,FALSE,0.366197183098592,2021,2021-2022
IN,2021-11-30,intra-total,1187,214,142,90,53,57,38,26,27,1688,551,4073,1738,1952,FALSE,0.479253621409281,2021,2021-2022
IN,2021-11-30,intra-ucfe,2,1,1,0,0,0,1,0,0,16,3,24,5,6,FALSE,0.25,2021,2021-2022
IN,2021-11-30,intra-ucx,6,0,0,0,0,0,1,0,0,1,0,8,6,6,FALSE,0.75,2021,2021-2022
IN,2021-11-30,intra-ui,1179,213,141,90,53,57,36,26,27,1671,548,4041,1727,1940,FALSE,0.480079188319723,2021,2021-2022
IN,2021-12-31,inter-total,24,5,1,2,3,0,2,0,1,25,12,75,36,41,FALSE,0.546666666666667,2021,2021-2022
IN,2021-12-31,inter-ucfe,0,0,0,0,0,0,0,0,0,1,0,1,0,0,FALSE,0,2021,2021-2022
IN,2021-12-31,inter-ucx,0,0,0,0,0,0,0,0,0,0,0,0,0,0,FALSE,0,2021,2021-2022
IN,2021-12-31,inter-ui,24,5,1,2,3,0,2,0,1,24,12,74,36,41,FALSE,0.554054054054054,2021,2021-2022
IN,2021-12-31,intra-total,1492,281,134,68,49,43,28,34,30,912,598,3669,2090,2371,FALSE,0.646225129463069,2021,2021-2022
IN,2021-12-31,intra-ucfe,2,2,3,0,0,1,1,0,1,9,1,20,3,5,FALSE,0.25,2021,2021-2022
IN,2021-12-31,intra-ucx,4,1,1,0,0,1,0,0,0,3,1,11,5,6,FALSE,0.545454545454545,2021,2021-2022
IN,2021-12-31,intra-ui,1486,278,130,68,49,41,27,34,29,900,596,3638,2082,2360,FALSE,0.648708081363386,2021,2021-2022
IN,2022-01-31,inter-total,42,2,3,3,2,1,0,2,0,30,15,100,57,59,FALSE,0.59,2021,2021-2022
IN,2022-01-31,inter-ucfe,0,0,0,0,0,0,0,0,0,1,0,1,0,0,FALSE,0,2021,2021-2022
IN,2022-01-31,inter-ucx,0,0,0,0,0,0,0,0,0,0,0,0,0,0,FALSE,0,2021,2021-2022
IN,2022-01-31,inter-ui,42,2,3,3,2,1,0,2,0,29,15,99,57,59,FALSE,0.595959595959596,2021,2021-2022
IN,2022-01-31,intra-total,2913,402,261,134,98,62,36,22,21,743,1028,5720,3941,4343,FALSE,0.759265734265734,2021,2021-2022
IN,2022-01-31,intra-ucfe,3,4,1,1,2,1,1,1,0,5,1,20,4,8,FALSE,0.4,2021,2021-2022
IN,2022-01-31,intra-ucx,5,1,1,0,0,0,1,0,0,0,2,10,7,8,FALSE,0.8,2021,2021-2022
IN,2022-01-31,intra-ui,2905,397,259,133,96,61,34,21,21,738,1025,5690,3930,4327,FALSE,0.760456942003515,2021,2021-2022
IN,2022-02-28,inter-total,33,8,13,14,8,6,3,1,1,29,20,136,53,61,FALSE,0.448529411764706,2021,2021-2022
IN,2022-02-28,inter-ucfe,0,0,0,0,0,0,0,0,0,0,0,0,0,0,FALSE,0,2021,2021-2022
IN,2022-02-28,inter-ucx,0,0,0,0,0,0,0,0,0,0,0,0,0,0,FALSE,0,2021,2021-2022
IN,2022-02-28,inter-ui,33,8,13,14,8,6,3,1,1,29,20,136,53,61,FALSE,0.448529411764706,2021,2021-2022
IN,2022-02-28,intra-total,1915,627,387,323,306,184,146,100,64,813,793,5658,2708,3335,FALSE,0.589430894308943,2021,2021-2022
IN,2022-02-28,intra-ucfe,2,2,0,1,1,0,0,1,1,7,1,16,3,5,FALSE,0.3125,2021,2021-2022
IN,2022-02-28,intra-ucx,7,2,0,0,0,0,0,0,0,1,1,11,8,10,FALSE,0.909090909090909,2021,2021-2022
IN,2022-02-28,intra-ui,1906,623,387,322,305,184,146,99,63,805,791,5631,2697,3320,FALSE,0.589593322678032,2021,2021-2022
IN,2022-03-31,inter-total,25,12,2,20,11,8,5,9,2,56,20,170,45,57,FALSE,0.335294117647059,2021,2021-2022
IN,2022-03-31,inter-ucfe,0,0,0,0,0,0,0,0,0,0,0,0,0,0,FALSE,0,2021,2021-2022
IN,2022-03-31,inter-ucx,0,0,0,0,0,0,0,1,0,0,0,1,0,0,FALSE,0,2021,2021-2022
IN,2022-03-31,inter-ui,25,12,2,20,11,8,5,8,2,56,20,169,45,57,FALSE,0.337278106508876,2021,2021-2022
IN,2022-03-31,intra-total,1278,327,196,174,148,197,184,168,214,1513,721,5120,1999,2326,FALSE,0.454296875,2021,2021-2022
IN,2022-03-31,intra-ucfe,3,1,0,0,1,0,1,0,1,7,1,15,4,5,FALSE,0.333333333333333,2021,2021-2022
IN,2022-03-31,intra-ucx,2,0,0,0,1,0,1,0,0,3,0,7,2,2,FALSE,0.285714285714286,2021,2021-2022
IN,2022-03-31,intra-ui,1273,326,196,174,146,197,182,168,213,1503,720,5098,1993,2319,FALSE,0.454884268340526,2021,2021-2022
IN,2022-04-30,inter-total,33,6,2,3,3,4,2,2,5,41,20,121,53,59,FALSE,0.487603305785124,2021,2021-2022
IN,2022-04-30,inter-ucfe,1,0,0,0,0,0,0,0,0,0,0,1,1,1,FALSE,1,2021,2021-2022
IN,2022-04-30,inter-ucx,0,0,0,0,0,0,0,0,0,0,0,0,0,0,FALSE,0,2021,2021-2022
IN,2022-04-30,inter-ui,32,6,2,3,3,4,2,2,5,41,20,120,52,58,FALSE,0.483333333333333,2021,2021-2022
IN,2022-04-30,intra-total,1116,236,94,68,58,46,61,87,128,1077,714,3685,1830,2066,FALSE,0.560651289009498,2021,2021-2022
IN,2022-04-30,intra-ucfe,9,2,1,1,0,0,1,3,0,5,6,28,15,17,FALSE,0.607142857142857,2021,2021-2022
IN,2022-04-30,intra-ucx,1,3,1,0,0,0,0,0,0,2,2,9,3,6,FALSE,0.666666666666667,2021,2021-2022
IN,2022-04-30,intra-ui,1106,231,92,67,58,46,60,84,128,1070,706,3648,1812,2043,FALSE,0.560032894736842,2021,2021-2022
IN,2022-05-31,inter-total,42,5,5,3,1,2,1,1,3,21,8,92,50,55,FALSE,0.597826086956522,2021,2021-2022
IN,2022-05-31,inter-ucfe,1,0,0,0,0,0,0,0,0,0,0,1,1,1,FALSE,1,2021,2021-2022
IN,2022-05-31,inter-ucx,0,0,0,0,0,0,0,0,0,0,0,0,0,0,FALSE,0,2021,2021-2022
IN,2022-05-31,inter-ui,41,5,5,3,1,2,1,1,3,21,8,91,49,54,FALSE,0.593406593406593,2021,2021-2022
IN,2022-05-31,intra-total,1357,285,157,103,79,68,60,50,36,499,611,3305,1968,2253,FALSE,0.681694402420575,2021,2021-2022
IN,2022-05-31,intra-ucfe,4,1,1,1,2,0,0,0,0,4,1,14,5,6,FALSE,0.428571428571429,2021,2021-2022
IN,2022-05-31,intra-ucx,8,0,0,1,0,0,0,0,0,2,2,13,10,10,FALSE,0.769230769230769,2021,2021-2022
IN,2022-05-31,intra-ui,1345,284,156,101,77,68,60,50,36,493,608,3278,1953,2237,FALSE,0.682428309945089,2021,2021-2022
IN,2022-06-30,inter-total,41,4,3,3,0,1,0,0,0,8,13,73,54,58,FALSE,0.794520547945206,2021,2021-2022
IN,2022-06-30,inter-ucfe,0,0,0,0,0,0,0,0,0,0,0,0,0,0,FALSE,0,2021,2021-2022
IN,2022-06-30,inter-ucx,0,0,0,0,0,0,0,0,0,0,0,0,0,0,FALSE,0,2021,2021-2022
IN,2022-06-30,inter-ui,41,4,3,3,0,1,0,0,0,8,13,73,54,58,FALSE,0.794520547945206,2021,2021-2022
IN,2022-06-30,intra-total,2087,175,105,60,47,56,33,29,17,394,559,3562,2646,2821,FALSE,0.791970802919708,2021,2021-2022
IN,2022-06-30,intra-ucfe,3,0,0,0,1,1,0,0,1,0,2,8,5,5,FALSE,0.625,2021,2021-2022
IN,2022-06-30,intra-ucx,5,1,0,0,1,0,0,0,0,1,0,8,5,6,FALSE,0.75,2021,2021-2022
IN,2022-06-30,intra-ui,2079,174,105,60,45,55,33,29,16,393,557,3546,2636,2810,FALSE,0.792442188381275,2021,2021-2022
IN,2022-07-31,inter-total,41,12,4,1,2,0,0,0,0,6,17,83,58,70,FALSE,0.843373493975904,2022,2022-2023
IN,2022-07-31,inter-ucfe,0,0,0,0,0,0,0,0,0,1,0,1,0,0,FALSE,0,2022,2022-2023
IN,2022-07-31,inter-ucx,0,0,0,0,0,0,0,0,0,1,0,1,0,0,FALSE,0,2022,2022-2023
IN,2022-07-31,inter-ui,41,12,4,1,2,0,0,0,0,4,17,81,58,70,FALSE,0.864197530864198,2022,2022-2023
IN,2022-07-31,intra-total,1596,345,149,62,54,39,40,31,28,367,927,3638,2523,2868,FALSE,0.788345244639912,2022,2022-2023
IN,2022-07-31,intra-ucfe,1,0,1,2,0,1,2,0,0,6,3,16,4,4,FALSE,0.25,2022,2022-2023
IN,2022-07-31,intra-ucx,3,1,0,0,0,0,0,0,0,1,1,6,4,5,FALSE,0.833333333333333,2022,2022-2023
IN,2022-07-31,intra-ui,1592,344,148,60,54,38,38,31,28,360,923,3616,2515,2859,FALSE,0.790652654867257,2022,2022-2023
IN,2022-08-31,inter-total,39,4,3,0,1,3,0,1,1,18,19,89,58,62,FALSE,0.696629213483146,2022,2022-2023
IN,2022-08-31,inter-ucfe,0,0,1,0,0,0,0,0,0,0,0,1,0,0,FALSE,0,2022,2022-2023
IN,2022-08-31,inter-ucx,0,0,0,0,0,0,0,0,0,0,0,0,0,0,FALSE,0,2022,2022-2023
IN,2022-08-31,inter-ui,39,4,2,0,1,3,0,1,1,18,19,88,58,62,FALSE,0.704545454545455,2022,2022-2023
IN,2022-08-31,intra-total,2329,337,156,132,82,67,48,36,25,394,1003,4609,3332,3669,FALSE,0.796051204165763,2022,2022-2023
IN,2022-08-31,intra-ucfe,1,1,1,0,0,0,0,0,0,3,4,10,5,6,FALSE,0.6,2022,2022-2023
IN,2022-08-31,intra-ucx,8,0,0,2,0,0,1,0,0,1,0,12,8,8,FALSE,0.666666666666667,2022,2022-2023
IN,2022-08-31,intra-ui,2320,336,155,130,82,67,47,36,25,390,999,4587,3319,3655,FALSE,0.796817091781121,2022,2022-2023
IN,2022-09-30,inter-total,30,1,0,3,1,2,1,0,0,10,16,64,46,47,FALSE,0.734375,2022,2022-2023
IN,2022-09-30,inter-ucfe,0,0,0,0,0,0,0,0,0,0,0,0,0,0,FALSE,0,2022,2022-2023
IN,2022-09-30,inter-ucx,0,0,0,0,0,0,0,0,0,0,0,0,0,0,FALSE,0,2022,2022-2023
IN,2022-09-30,inter-ui,30,1,0,3,1,2,1,0,0,10,16,64,46,47,FALSE,0.734375,2022,2022-2023
IN,2022-09-30,intra-total,2503,283,132,85,65,65,44,44,38,365,962,4586,3465,3748,FALSE,0.817269952027911,2022,2022-2023
IN,2022-09-30,intra-ucfe,3,1,1,0,0,1,0,0,0,4,2,12,5,6,FALSE,0.5,2022,2022-2023
IN,2022-09-30,intra-ucx,3,0,0,0,0,0,0,0,0,2,1,6,4,4,FALSE,0.666666666666667,2022,2022-2023
IN,2022-09-30,intra-ui,2497,282,131,85,65,64,44,44,38,359,959,4568,3456,3738,FALSE,0.81830122591944,2022,2022-2023
IN,2022-10-31,inter-total,38,1,1,2,0,1,1,0,0,11,7,62,45,46,FALSE,0.741935483870968,2022,2022-2023
IN,2022-10-31,inter-ucfe,0,0,0,0,0,0,0,0,0,0,0,0,0,0,FALSE,0,2022,2022-2023
IN,2022-10-31,inter-ucx,0,0,0,0,0,0,0,0,0,0,0,0,0,0,FALSE,0,2022,2022-2023
IN,2022-10-31,inter-ui,38,1,1,2,0,1,1,0,0,11,7,62,45,46,FALSE,0.741935483870968,2022,2022-2023
IN,2022-10-31,intra-total,2470,181,92,74,63,52,38,27,25,298,643,3963,3113,3294,FALSE,0.831188493565481,2022,2022-2023
IN,2022-10-31,intra-ucfe,5,0,0,0,0,0,0,0,0,3,4,12,9,9,FALSE,0.75,2022,2022-2023
IN,2022-10-31,intra-ucx,3,0,0,0,0,0,0,0,0,2,0,5,3,3,FALSE,0.6,2022,2022-2023
IN,2022-10-31,intra-ui,2462,181,92,74,63,52,38,27,25,293,639,3946,3101,3282,FALSE,0.831728332488596,2022,2022-2023
IN,2022-11-30,inter-total,29,3,0,0,0,0,0,0,0,10,10,52,39,42,FALSE,0.807692307692308,2022,2022-2023
IN,2022-11-30,inter-ucfe,0,0,0,0,0,0,0,0,0,0,0,0,0,0,FALSE,0,2022,2022-2023
IN,2022-11-30,inter-ucx,0,0,0,0,0,0,0,0,0,0,0,0,0,0,FALSE,0,2022,2022-2023
IN,2022-11-30,inter-ui,29,3,0,0,0,0,0,0,0,10,10,52,39,42,FALSE,0.807692307692308,2022,2022-2023
IN,2022-11-30,intra-total,2021,314,139,90,48,25,27,21,20,252,751,3708,2772,3086,FALSE,0.832254584681769,2022,2022-2023
IN,2022-11-30,intra-ucfe,3,2,1,0,1,0,0,0,0,1,4,12,7,9,FALSE,0.75,2022,2022-2023
IN,2022-11-30,intra-ucx,5,1,0,0,0,0,0,0,0,0,0,6,5,6,FALSE,1,2022,2022-2023
IN,2022-11-30,intra-ui,2013,311,138,90,47,25,27,21,20,251,747,3690,2760,3071,FALSE,0.832249322493225,2022,2022-2023
IN,2022-12-31,inter-total,52,5,4,2,2,1,0,0,0,8,19,93,71,76,FALSE,0.817204301075269,2022,2022-2023
IN,2022-12-31,inter-ucfe,0,0,0,0,0,0,0,0,0,0,0,0,0,0,FALSE,0,2022,2022-2023
IN,2022-12-31,inter-ucx,0,0,0,0,0,0,0,0,0,0,0,0,0,0,FALSE,0,2022,2022-2023
IN,2022-12-31,inter-ui,52,5,4,2,2,1,0,0,0,8,19,93,71,76,FALSE,0.817204301075269,2022,2022-2023
IN,2022-12-31,intra-total,2867,326,195,138,80,63,42,24,23,289,950,4997,3817,4143,FALSE,0.829097458475085,2022,2022-2023
IN,2022-12-31,intra-ucfe,2,2,1,1,0,0,0,0,0,6,1,13,3,5,FALSE,0.384615384615385,2022,2022-2023
IN,2022-12-31,intra-ucx,5,0,0,1,1,1,0,0,0,0,2,10,7,7,FALSE,0.7,2022,2022-2023
IN,2022-12-31,intra-ui,2860,324,194,136,79,62,42,24,23,283,947,4974,3807,4131,FALSE,0.830518697225573,2022,2022-2023
IN,2023-01-31,inter-total,61,8,1,1,3,2,1,1,0,8,34,120,95,103,FALSE,0.858333333333333,2022,2022-2023
IN,2023-01-31,inter-ucfe,0,0,0,0,0,0,0,0,0,1,0,1,0,0,FALSE,0,2022,2022-2023
IN,2023-01-31,inter-ucx,0,0,0,0,0,0,0,0,0,0,0,0,0,0,FALSE,0,2022,2022-2023
IN,2023-01-31,inter-ui,61,8,1,1,3,2,1,1,0,7,34,119,95,103,FALSE,0.865546218487395,2022,2022-2023
IN,2023-01-31,intra-total,4427,554,276,164,215,181,116,99,60,280,1549,7921,5976,6530,FALSE,0.824390859739932,2022,2022-2023
IN,2023-01-31,intra-ucfe,1,0,1,1,0,0,0,0,0,2,1,6,2,2,FALSE,0.333333333333333,2022,2022-2023
IN,2023-01-31,intra-ucx,6,0,0,0,0,0,0,0,0,1,0,7,6,6,FALSE,0.857142857142857,2022,2022-2023
IN,2023-01-31,intra-ui,4420,554,275,163,215,181,116,99,60,277,1548,7908,5968,6522,FALSE,0.824734446130501,2022,2022-2023
IN,2023-02-28,inter-total,110,7,6,1,7,5,2,1,3,3,57,202,167,174,FALSE,0.861386138613861,2022,2022-2023
IN,2023-02-28,inter-ucfe,1,0,0,0,0,0,0,0,0,0,0,1,1,1,FALSE,1,2022,2022-2023
IN,2023-02-28,inter-ucx,0,0,0,0,0,0,0,0,0,0,0,0,0,0,FALSE,0,2022,2022-2023
IN,2023-02-28,inter-ui,109,7,6,1,7,5,2,1,3,3,57,201,166,173,FALSE,0.860696517412935,2022,2022-2023
IN,2023-02-28,intra-total,3004,469,375,245,276,236,192,167,160,482,1394,7000,4398,4867,FALSE,0.695285714285714,2022,2022-2023
IN,2023-02-28,intra-ucfe,2,0,0,0,1,0,0,0,0,3,0,6,2,2,FALSE,0.333333333333333,2022,2022-2023
IN,2023-02-28,intra-ucx,1,0,0,0,0,1,1,0,1,0,1,5,2,2,FALSE,0.4,2022,2022-2023
IN,2023-02-28,intra-ui,3001,469,375,245,275,235,191,167,159,479,1393,6989,4394,4863,FALSE,0.695807697810846,2022,2022-2023
IN,2023-03-31,inter-total,57,4,0,3,1,11,3,1,2,15,22,119,79,83,FALSE,0.697478991596639,2022,2022-2023
IN,2023-03-31,inter-ucfe,0,0,0,0,0,0,0,0,0,0,0,0,0,0,FALSE,0,2022,2022-2023
IN,2023-03-31,inter-ucx,0,0,0,0,0,0,0,0,0,0,0,0,0,0,FALSE,0,2022,2022-2023
IN,2023-03-31,inter-ui,57,4,0,3,1,11,3,1,2,15,22,119,79,83,FALSE,0.697478991596639,2022,2022-2023
IN,2023-03-31,intra-total,1955,186,150,126,130,176,155,125,140,601,714,4458,2669,2855,FALSE,0.640421713772992,2022,2022-2023
IN,2023-03-31,intra-ucfe,4,0,0,0,0,1,0,0,0,1,4,10,8,8,FALSE,0.8,2022,2022-2023
IN,2023-03-31,intra-ucx,2,1,0,1,0,0,0,0,0,0,1,5,3,4,FALSE,0.8,2022,2022-2023
IN,2023-03-31,intra-ui,1949,185,150,125,130,175,155,125,140,600,709,4443,2658,2843,FALSE,0.639882961962638,2022,2022-2023
IN,2023-04-30,inter-total,56,4,3,0,1,1,1,2,1,4,69,142,125,129,FALSE,0.908450704225352,2022,2022-2023
IN,2023-04-30,inter-ucfe,0,0,0,0,0,0,0,0,0,0,0,0,0,0,FALSE,0,2022,2022-2023
IN,2023-04-30,inter-ucx,0,0,0,0,0,0,0,0,0,0,0,0,0,0,FALSE,0,2022,2022-2023
IN,2023-04-30,inter-ui,56,4,3,0,1,1,1,2,1,4,69,142,125,129,FALSE,0.908450704225352,2022,2022-2023
IN,2023-04-30,intra-total,2181,194,94,66,61,59,38,47,47,437,2095,5319,4276,4470,FALSE,0.840383530738861,2022,2022-2023
IN,2023-04-30,intra-ucfe,4,1,0,0,0,0,1,0,0,4,2,12,6,7,FALSE,0.583333333333333,2022,2022-2023
IN,2023-04-30,intra-ucx,3,0,0,0,0,0,1,0,0,1,2,7,5,5,FALSE,0.714285714285714,2022,2022-2023
IN,2023-04-30,intra-ui,2174,193,94,66,61,59,36,47,47,432,2091,5300,4265,4458,FALSE,0.841132075471698,2022,2022-2023
IN,2023-05-31,inter-total,46,5,1,1,3,0,0,1,0,10,18,85,64,69,FALSE,0.811764705882353,2022,2022-2023
IN,2023-05-31,inter-ucfe,0,0,0,0,0,0,0,0,0,0,0,0,0,0,FALSE,0,2022,2022-2023
IN,2023-05-31,inter-ucx,0,0,0,0,0,0,0,0,0,0,0,0,0,0,FALSE,0,2022,2022-2023
IN,2023-05-31,inter-ui,46,5,1,1,3,0,0,1,0,10,18,85,64,69,FALSE,0.811764705882353,2022,2022-2023
IN,2023-05-31,intra-total,1687,170,129,111,115,53,37,28,22,220,654,3226,2341,2511,FALSE,0.778363298202108,2022,2022-2023
IN,2023-05-31,intra-ucfe,2,0,1,1,0,0,0,0,2,3,0,9,2,2,FALSE,0.222222222222222,2022,2022-2023
IN,2023-05-31,intra-ucx,3,0,0,0,0,0,0,0,0,1,1,5,4,4,FALSE,0.8,2022,2022-2023
IN,2023-05-31,intra-ui,1682,170,128,110,115,53,37,28,20,216,653,3212,2335,2505,FALSE,0.779887920298879,2022,2022-2023
IN,2023-06-30,inter-total,50,2,5,0,3,2,0,0,0,10,19,91,69,71,FALSE,0.78021978021978,2022,2022-2023
IN,2023-06-30,inter-ucfe,0,0,0,0,0,0,0,0,0,0,0,0,0,0,FALSE,0,2022,2022-2023
IN,2023-06-30,inter-ucx,0,0,0,0,0,0,0,0,0,0,0,0,0,0,FALSE,0,2022,2022-2023
IN,2023-06-30,inter-ui,50,2,5,0,3,2,0,0,0,10,19,91,69,71,FALSE,0.78021978021978,2022,2022-2023
IN,2023-06-30,intra-total,1656,209,101,60,51,42,41,37,31,230,817,3275,2473,2682,FALSE,0.818931297709924,2022,2022-2023
IN,2023-06-30,intra-ucfe,3,1,1,0,0,1,0,0,0,2,0,8,3,4,FALSE,0.5,2022,2022-2023
IN,2023-06-30,intra-ucx,5,0,0,0,0,0,0,0,0,0,1,6,6,6,FALSE,1,2022,2022-2023
IN,2023-06-30,intra-ui,1648,208,100,60,51,41,41,37,31,228,816,3261,2464,2672,FALSE,0.819380558111009,2022,2022-2023
IN,2023-07-31,inter-total,38,5,3,0,1,2,2,0,0,5,12,68,50,55,FALSE,0.808823529411765,2023,2023-2024
IN,2023-07-31,inter-ucfe,0,0,1,0,0,0,0,0,0,0,0,1,0,0,FALSE,0,2023,2023-2024
IN,2023-07-31,inter-ucx,0,0,0,0,0,0,0,0,0,0,0,0,0,0,FALSE,0,2023,2023-2024
IN,2023-07-31,inter-ui,38,5,2,0,1,2,2,0,0,5,12,67,50,55,FALSE,0.82089552238806,2023,2023-2024
IN,2023-07-31,intra-total,1687,203,107,56,30,27,34,25,17,145,934,3265,2621,2824,FALSE,0.864931087289433,2023,2023-2024
IN,2023-07-31,intra-ucfe,5,0,2,3,1,0,1,0,1,1,8,22,13,13,FALSE,0.590909090909091,2023,2023-2024
IN,2023-07-31,intra-ucx,3,0,0,0,0,0,0,0,0,0,0,3,3,3,FALSE,1,2023,2023-2024
IN,2023-07-31,intra-ui,1679,203,105,53,29,27,33,25,16,144,926,3240,2605,2808,FALSE,0.866666666666667,2023,2023-2024
IN,2023-08-31,inter-total,42,4,0,2,0,0,2,1,0,2,21,74,63,67,FALSE,0.905405405405405,2023,2023-2024
IN,2023-08-31,inter-ucfe,0,0,0,0,0,0,0,0,0,0,1,1,1,1,FALSE,1,2023,2023-2024
IN,2023-08-31,inter-ucx,0,0,0,0,0,0,0,0,0,0,0,0,0,0,FALSE,0,2023,2023-2024
IN,2023-08-31,inter-ui,42,4,0,2,0,0,2,1,0,2,20,73,62,66,FALSE,0.904109589041096,2023,2023-2024
IN,2023-08-31,intra-total,1990,254,100,98,53,51,40,46,24,153,1024,3833,3014,3268,FALSE,0.852595877902426,2023,2023-2024
IN,2023-08-31,intra-ucfe,4,1,0,0,3,1,0,1,1,0,1,12,5,6,FALSE,0.5,2023,2023-2024
IN,2023-08-31,intra-ucx,1,0,0,0,0,0,0,0,0,0,0,1,1,1,FALSE,1,2023,2023-2024
IN,2023-08-31,intra-ui,1985,253,100,98,50,50,40,45,23,153,1023,3820,3008,3261,FALSE,0.853664921465969,2023,2023-2024
IN,2023-09-30,inter-total,34,9,3,2,2,1,1,0,2,3,14,71,48,57,FALSE,0.802816901408451,2023,2023-2024
IN,2023-09-30,inter-ucfe,0,0,0,0,0,0,0,0,0,0,0,0,0,0,FALSE,0,2023,2023-2024
IN,2023-09-30,inter-ucx,0,0,0,0,0,0,0,0,0,0,0,0,0,0,FALSE,0,2023,2023-2024
IN,2023-09-30,inter-ui,34,9,3,2,2,1,1,0,2,3,14,71,48,57,FALSE,0.802816901408451,2023,2023-2024
IN,2023-09-30,intra-total,1905,277,115,56,27,28,26,49,34,171,981,3669,2886,3163,FALSE,0.862087762333061,2023,2023-2024
IN,2023-09-30,intra-ucfe,0,1,0,0,1,0,0,1,0,1,2,6,2,3,FALSE,0.5,2023,2023-2024
IN,2023-09-30,intra-ucx,5,0,0,0,0,0,0,0,0,0,0,5,5,5,FALSE,1,2023,2023-2024
IN,2023-09-30,intra-ui,1900,276,115,56,26,28,26,48,34,170,979,3658,2879,3155,FALSE,0.862493165664298,2023,2023-2024
IN,2023-10-31,inter-total,29,0,1,3,0,0,0,1,2,3,9,48,38,38,FALSE,0.791666666666667,2023,2023-2024
IN,2023-10-31,inter-ucfe,0,0,0,0,0,0,0,0,0,0,0,0,0,0,FALSE,0,2023,2023-2024
IN,2023-10-31,inter-ucx,0,0,0,0,0,0,0,0,0,0,0,0,0,0,FALSE,0,2023,2023-2024
IN,2023-10-31,inter-ui,29,0,1,3,0,0,0,1,2,3,9,48,38,38,FALSE,0.791666666666667,2023,2023-2024
IN,2023-10-31,intra-total,2274,183,97,88,53,29,31,48,31,150,861,3845,3135,3318,FALSE,0.862938881664499,2023,2023-2024
IN,2023-10-31,intra-ucfe,1,0,0,0,0,0,0,0,0,1,1,3,2,2,FALSE,0.666666666666667,2023,2023-2024
IN,2023-10-31,intra-ucx,6,0,0,0,1,1,0,0,0,0,1,9,7,7,FALSE,0.777777777777778,2023,2023-2024
IN,2023-10-31,intra-ui,2267,183,97,88,52,28,31,48,31,149,859,3833,3126,3309,FALSE,0.863292460213932,2023,2023-2024
IN,2023-11-30,inter-total,38,6,4,0,1,3,0,0,0,4,29,85,67,73,FALSE,0.858823529411765,2023,2023-2024
IN,2023-11-30,inter-ucfe,0,0,0,0,0,0,0,0,0,0,0,0,0,0,FALSE,0,2023,2023-2024
IN,2023-11-30,inter-ucx,0,0,0,0,0,0,0,0,0,0,0,0,0,0,FALSE,0,2023,2023-2024
IN,2023-11-30,inter-ui,38,6,4,0,1,3,0,0,0,4,29,85,67,73,FALSE,0.858823529411765,2023,2023-2024
IN,2023-11-30,intra-total,2507,385,126,77,61,53,34,41,22,145,1056,4507,3563,3948,FALSE,0.875970712225427,2023,2023-2024
IN,2023-11-30,intra-ucfe,1,1,1,1,0,0,0,0,0,0,0,4,1,2,FALSE,0.5,2023,2023-2024
IN,2023-11-30,intra-ucx,5,1,0,0,0,0,0,0,0,0,3,9,8,9,FALSE,1,2023,2023-2024
IN,2023-11-30,intra-ui,2501,383,125,76,61,53,34,41,22,145,1053,4494,3554,3937,FALSE,0.876056964842012,2023,2023-2024
IN,2023-12-31,inter-total,63,7,3,0,3,2,0,0,1,1,13,93,76,83,FALSE,0.89247311827957,2023,2023-2024
IN,2023-12-31,inter-ucfe,0,0,0,0,0,0,0,0,0,0,0,0,0,0,FALSE,0,2023,2023-2024
IN,2023-12-31,inter-ucx,0,0,0,0,0,0,0,0,0,0,0,0,0,0,FALSE,0,2023,2023-2024
IN,2023-12-31,inter-ui,63,7,3,0,3,2,0,0,1,1,13,93,76,83,FALSE,0.89247311827957,2023,2023-2024
IN,2023-12-31,intra-total,2827,282,132,64,56,93,81,40,19,134,1107,4835,3934,4216,FALSE,0.871975180972079,2023,2023-2024
IN,2023-12-31,intra-ucfe,2,3,0,0,0,0,0,2,0,1,2,10,4,7,FALSE,0.7,2023,2023-2024
IN,2023-12-31,intra-ucx,1,0,0,0,0,1,0,0,0,0,1,3,2,2,FALSE,0.666666666666667,2023,2023-2024
IN,2023-12-31,intra-ui,2824,279,132,64,56,92,81,38,19,133,1104,4822,3928,4207,FALSE,0.872459560348403,2023,2023-2024
IN,2024-01-31,inter-total,94,14,4,4,4,1,1,0,1,6,30,159,124,138,FALSE,0.867924528301887,2023,2023-2024
IN,2024-01-31,inter-ucfe,0,0,0,0,0,0,0,0,0,0,0,0,0,0,FALSE,0,2023,2023-2024
IN,2024-01-31,inter-ucx,0,0,0,0,0,0,0,0,0,0,0,0,0,0,FALSE,0,2023,2023-2024
IN,2024-01-31,inter-ui,94,14,4,4,4,1,1,0,1,6,30,159,124,138,FALSE,0.867924528301887,2023,2023-2024
IN,2024-01-31,intra-total,4810,709,346,158,72,81,88,152,53,186,1442,8097,6252,6961,FALSE,0.859701123873039,2023,2023-2024
IN,2024-01-31,intra-ucfe,1,1,2,0,0,0,1,3,0,2,1,11,2,3,FALSE,0.272727272727273,2023,2023-2024
IN,2024-01-31,intra-ucx,4,1,0,0,0,0,0,0,0,0,0,5,4,5,FALSE,1,2023,2023-2024
IN,2024-01-31,intra-ui,4805,707,344,158,72,81,87,149,53,184,1441,8081,6246,6953,FALSE,0.860413315183764,2023,2023-2024
IN,2024-02-29,inter-total,101,10,4,0,1,2,1,2,0,6,27,154,128,138,FALSE,0.896103896103896,2023,2023-2024
IN,2024-02-29,inter-ucfe,0,0,0,0,0,0,0,0,0,0,0,0,0,0,FALSE,0,2023,2023-2024
IN,2024-02-29,inter-ucx,0,0,0,0,0,0,0,0,0,0,0,0,0,0,FALSE,0,2023,2023-2024
IN,2024-02-29,inter-ui,101,10,4,0,1,2,1,2,0,6,27,154,128,138,FALSE,0.896103896103896,2023,2023-2024
IN,2024-02-29,intra-total,2729,476,219,98,72,101,61,62,42,202,1257,5319,3986,4462,FALSE,0.838879488625681,2023,2023-2024
IN,2024-02-29,intra-ucfe,2,3,0,0,0,1,0,1,0,2,1,10,3,6,FALSE,0.6,2023,2023-2024
IN,2024-02-29,intra-ucx,3,1,0,0,0,0,0,0,1,0,0,5,3,4,FALSE,0.8,2023,2023-2024
IN,2024-02-29,intra-ui,2724,472,219,98,72,100,61,61,41,200,1256,5304,3980,4452,FALSE,0.839366515837104,2023,2023-2024
IN,2024-03-31,inter-total,46,4,2,2,2,5,5,2,2,4,18,92,64,68,FALSE,0.739130434782609,2023,2023-2024
IN,2024-03-31,inter-ucfe,0,0,0,0,0,0,0,0,0,0,0,0,0,0,FALSE,0,2023,2023-2024
IN,2024-03-31,inter-ucx,0,0,0,0,0,0,0,0,0,0,0,0,0,0,FALSE,0,2023,2023-2024
IN,2024-03-31,inter-ui,46,4,2,2,2,5,5,2,2,4,18,92,64,68,FALSE,0.739130434782609,2023,2023-2024
IN,2024-03-31,intra-total,1696,213,99,71,109,114,89,73,47,171,834,3516,2530,2743,FALSE,0.780147895335609,2023,2023-2024
IN,2024-03-31,intra-ucfe,0,0,1,0,1,0,0,0,1,0,0,3,0,0,FALSE,0,2023,2023-2024
IN,2024-03-31,intra-ucx,3,0,0,0,0,0,1,0,0,0,1,5,4,4,FALSE,0.8,2023,2023-2024
IN,2024-03-31,intra-ui,1693,213,98,71,108,114,88,73,46,171,833,3508,2526,2739,FALSE,0.78078677309008,2023,2023-2024
IN,2024-04-30,inter-total,42,2,1,1,0,1,1,0,2,4,25,79,67,69,FALSE,0.873417721518987,2023,2023-2024
IN,2024-04-30,inter-ucfe,0,0,0,0,0,0,0,0,0,0,0,0,0,0,FALSE,0,2023,2023-2024
IN,2024-04-30,inter-ucx,0,0,0,0,0,0,0,0,0,0,0,0,0,0,FALSE,0,2023,2023-2024
IN,2024-04-30,inter-ui,42,2,1,1,0,1,1,0,2,4,25,79,67,69,FALSE,0.873417721518987,2023,2023-2024
IN,2024-04-30,intra-total,1936,263,104,94,56,45,44,19,22,180,1141,3904,3077,3340,FALSE,0.855532786885246,2023,2023-2024
IN,2024-04-30,intra-ucfe,0,1,0,0,0,0,0,0,0,1,2,4,2,3,FALSE,0.75,2023,2023-2024
IN,2024-04-30,intra-ucx,3,0,0,0,0,0,0,0,0,0,4,7,7,7,FALSE,1,2023,2023-2024
IN,2024-04-30,intra-ui,1933,262,104,94,56,45,44,19,22,179,1135,3893,3068,3330,FALSE,0.8553814538916,2023,2023-2024
IN,2024-05-31,inter-total,51,3,1,2,0,1,1,1,1,2,27,90,78,81,FALSE,0.9,2023,2023-2024
IN,2024-05-31,inter-ucfe,0,0,0,0,0,1,0,0,0,0,0,1,0,0,FALSE,0,2023,2023-2024
IN,2024-05-31,inter-ucx,0,0,0,0,0,0,0,0,0,0,0,0,0,0,FALSE,0,2023,2023-2024
IN,2024-05-31,inter-ui,51,3,1,2,0,0,1,1,1,2,27,89,78,81,FALSE,0.910112359550562,2023,2023-2024
IN,2024-05-31,intra-total,1437,205,70,38,43,35,32,18,14,124,1032,3048,2469,2674,FALSE,0.877296587926509,2023,2023-2024
IN,2024-05-31,intra-ucfe,1,1,0,0,0,1,0,0,0,1,5,9,6,7,FALSE,0.777777777777778,2023,2023-2024
IN,2024-05-31,intra-ucx,1,0,0,0,0,0,0,0,0,0,0,1,1,1,FALSE,1,2023,2023-2024
IN,2024-05-31,intra-ui,1435,204,70,38,43,34,32,18,14,123,1027,3038,2462,2666,FALSE,0.877551020408163,2023,2023-2024
IN,2024-06-30,inter-total,40,1,3,2,0,2,1,0,1,0,25,75,65,66,FALSE,0.88,2023,2023-2024
IN,2024-06-30,inter-ucfe,0,0,0,0,0,0,0,0,0,0,0,0,0,0,FALSE,0,2023,2023-2024
IN,2024-06-30,inter-ucx,0,0,0,0,0,0,0,0,0,0,0,0,0,0,FALSE,0,2023,2023-2024
IN,2024-06-30,inter-ui,40,1,3,2,0,2,1,0,1,0,25,75,65,66,FALSE,0.88,2023,2023-2024
IN,2024-06-30,intra-total,1465,270,67,33,21,35,33,19,16,92,1019,3070,2484,2754,FALSE,0.897068403908795,2023,2023-2024
IN,2024-06-30,intra-ucfe,0,0,1,0,0,1,0,0,0,1,0,3,0,0,FALSE,0,2023,2023-2024
IN,2024-06-30,intra-ucx,3,0,0,0,0,0,0,0,0,0,0,3,3,3,FALSE,1,2023,2023-2024
IN,2024-06-30,intra-ui,1462,270,66,33,21,34,33,19,16,91,1019,3064,2481,2751,FALSE,0.897845953002611,2023,2023-2024
IN,2024-07-31,inter-total,50,10,5,3,1,0,1,0,0,5,20,95,70,80,FALSE,0.842105263157895,2024,2024-2025
IN,2024-07-31,inter-ucfe,0,0,0,0,0,0,0,0,0,0,0,0,0,0,FALSE,0,2024,2024-2025
IN,2024-07-31,inter-ucx,0,0,0,0,0,0,0,0,0,0,0,0,0,0,FALSE,0,2024,2024-2025
IN,2024-07-31,inter-ui,50,10,5,3,1,0,1,0,0,5,20,95,70,80,FALSE,0.842105263157895,2024,2024-2025
IN,2024-07-31,intra-total,2986,390,196,70,26,35,40,33,16,107,1227,5126,4213,4603,FALSE,0.897971127584862,2024,2024-2025
IN,2024-07-31,intra-ucfe,2,0,1,0,0,0,2,1,0,1,2,9,4,4,FALSE,0.444444444444444,2024,2024-2025
IN,2024-07-31,intra-ucx,0,1,0,0,0,0,0,0,0,0,1,2,1,2,FALSE,1,2024,2024-2025
IN,2024-07-31,intra-ui,2984,389,195,70,26,35,38,32,16,106,1224,5115,4208,4597,FALSE,0.898729227761486,2024,2024-2025
IN,2024-08-31,inter-total,26,2,1,0,1,3,0,2,0,1,16,52,42,44,FALSE,0.846153846153846,2024,2024-2025
IN,2024-08-31,inter-ucfe,0,0,0,0,0,0,0,0,0,0,0,0,0,0,FALSE,0,2024,2024-2025
IN,2024-08-31,inter-ucx,0,0,0,0,0,0,0,0,0,0,0,0,0,0,FALSE,0,2024,2024-2025
IN,2024-08-31,inter-ui,26,2,1,0,1,3,0,2,0,1,16,52,42,44,FALSE,0.846153846153846,2024,2024-2025
IN,2024-08-31,intra-total,1959,294,91,70,59,55,55,45,21,141,1065,3855,3024,3318,FALSE,0.860700389105059,2024,2024-2025
IN,2024-08-31,intra-ucfe,1,0,0,0,0,0,1,0,0,1,0,3,1,1,FALSE,0.333333333333333,2024,2024-2025
IN,2024-08-31,intra-ucx,1,0,1,0,0,0,0,0,0,0,1,3,2,2,FALSE,0.666666666666667,2024,2024-2025
IN,2024-08-31,intra-ui,1957,294,90,70,59,55,54,45,21,140,1064,3849,3021,3315,FALSE,0.861262665627436,2024,2024-2025
IN,2024-09-30,inter-total,19,2,2,1,1,1,1,1,1,1,16,46,35,37,FALSE,0.804347826086957,2024,2024-2025
IN,2024-09-30,inter-ucfe,0,0,0,0,0,0,0,0,0,0,0,0,0,0,FALSE,0,2024,2024-2025
IN,2024-09-30,inter-ucx,0,0,0,0,0,0,0,0,0,0,0,0,0,0,FALSE,0,2024,2024-2025
IN,2024-09-30,inter-ui,19,2,2,1,1,1,1,1,1,1,16,46,35,37,FALSE,0.804347826086957,2024,2024-2025
IN,2024-09-30,intra-total,1637,439,92,44,22,30,33,37,28,158,1101,3621,2738,3177,FALSE,0.877381938690969,2024,2024-2025
IN,2024-09-30,intra-ucfe,0,0,2,0,0,0,0,0,0,2,0,4,0,0,FALSE,0,2024,2024-2025
IN,2024-09-30,intra-ucx,0,0,0,0,0,0,0,0,0,0,1,1,1,1,FALSE,1,2024,2024-2025
IN,2024-09-30,intra-ui,1637,439,90,44,22,30,33,37,28,156,1100,3616,2737,3176,FALSE,0.878318584070797,2024,2024-2025
IN,2024-10-31,inter-total,31,7,1,0,1,1,1,0,2,0,25,69,56,63,FALSE,0.91304347826087,2024,2024-2025
IN,2024-10-31,inter-ucfe,0,0,0,0,0,0,0,0,0,0,0,0,0,0,FALSE,0,2024,2024-2025
IN,2024-10-31,inter-ucx,0,0,0,0,0,0,0,0,0,0,0,0,0,0,FALSE,0,2024,2024-2025
IN,2024-10-31,inter-ui,31,7,1,0,1,1,1,0,2,0,25,69,56,63,FALSE,0.91304347826087,2024,2024-2025
IN,2024-10-31,intra-total,1619,448,94,48,53,31,28,32,25,99,1217,3694,2836,3284,FALSE,0.889009204114781,2024,2024-2025
IN,2024-10-31,intra-ucfe,1,1,0,1,0,0,1,0,0,1,0,5,1,2,FALSE,0.4,2024,2024-2025
IN,2024-10-31,intra-ucx,1,0,0,0,0,0,1,0,0,0,0,2,1,1,FALSE,0.5,2024,2024-2025
IN,2024-10-31,intra-ui,1617,447,94,47,53,31,26,32,25,98,1217,3687,2834,3281,FALSE,0.889883374016816,2024,2024-2025
IN,2024-11-30,inter-total,65,5,1,3,1,0,0,0,0,3,16,94,81,86,FALSE,0.914893617021277,2024,2024-2025
IN,2024-11-30,inter-ucfe,0,0,0,0,0,0,0,0,0,0,0,0,0,0,FALSE,0,2024,2024-2025
IN,2024-11-30,inter-ucx,0,0,0,0,0,0,0,0,0,0,0,0,0,0,FALSE,0,2024,2024-2025
IN,2024-11-30,inter-ui,65,5,1,3,1,0,0,0,0,3,16,94,81,86,FALSE,0.914893617021277,2024,2024-2025
IN,2024-11-30,intra-total,2196,253,76,53,32,40,18,11,21,125,949,3774,3145,3398,FALSE,0.900370959194489,2024,2024-2025
IN,2024-11-30,intra-ucfe,0,2,0,0,0,0,0,0,0,0,1,3,1,3,FALSE,1,2024,2024-2025
IN,2024-11-30,intra-ucx,1,1,0,0,0,0,0,0,1,0,2,5,3,4,FALSE,0.8,2024,2024-2025
IN,2024-11-30,intra-ui,2195,250,76,53,32,40,18,11,20,125,946,3766,3141,3391,FALSE,0.900424853956453,2024,2024-2025
IN,2024-12-31,inter-total,77,7,5,0,0,0,2,1,1,4,26,123,103,110,FALSE,0.894308943089431,2024,2024-2025
IN,2024-12-31,inter-ucfe,0,0,0,0,0,0,0,0,0,0,0,0,0,0,FALSE,0,2024,2024-2025
IN,2024-12-31,inter-ucx,0,0,0,0,0,0,0,0,0,0,0,0,0,0,FALSE,0,2024,2024-2025
IN,2024-12-31,inter-ui,77,7,5,0,0,0,2,1,1,4,26,123,103,110,FALSE,0.894308943089431,2024,2024-2025
IN,2024-12-31,intra-total,3081,326,105,52,38,37,47,39,31,136,1101,4993,4182,4508,FALSE,0.902864009613459,2024,2024-2025
IN,2024-12-31,intra-ucfe,1,0,0,1,0,0,0,0,0,4,1,7,2,2,FALSE,0.285714285714286,2024,2024-2025
IN,2024-12-31,intra-ucx,2,0,0,0,2,0,0,1,0,0,0,5,2,2,FALSE,0.4,2024,2024-2025
IN,2024-12-31,intra-ui,3078,326,105,51,36,37,47,38,31,132,1100,4981,4178,4504,FALSE,0.904236097169243,2024,2024-2025
KS,2019-01-31,inter-total,293,7,3,1,2,2,2,2,0,1,27,340,320,327,FALSE,0.961764705882353,2018,2018-2019
KS,2019-01-31,inter-ucfe,4,0,0,0,0,0,0,0,0,0,1,5,5,5,FALSE,1,2018,2018-2019
KS,2019-01-31,inter-ucx,1,0,0,0,0,0,0,0,0,0,0,1,1,1,FALSE,1,2018,2018-2019
KS,2019-01-31,inter-ui,288,7,3,1,2,2,2,2,0,1,26,334,314,321,FALSE,0.961077844311377,2018,2018-2019
KS,2019-01-31,intra-total,4793,184,58,12,4,16,15,14,9,7,522,5634,5315,5499,FALSE,0.976038338658147,2018,2018-2019
KS,2019-01-31,intra-ucfe,167,7,0,0,0,0,0,0,0,0,22,196,189,196,FALSE,1,2018,2018-2019
KS,2019-01-31,intra-ucx,7,1,0,0,0,0,0,0,0,0,2,10,9,10,FALSE,1,2018,2018-2019
KS,2019-01-31,intra-ui,4619,176,58,12,4,16,15,14,9,7,498,5428,5117,5293,FALSE,0.975128960943257,2018,2018-2019
KS,2019-02-28,inter-total,155,8,6,4,1,0,0,0,0,1,15,190,170,178,FALSE,0.936842105263158,2018,2018-2019
KS,2019-02-28,inter-ucfe,1,0,1,0,0,0,0,0,0,0,0,2,1,1,FALSE,0.5,2018,2018-2019
KS,2019-02-28,inter-ucx,0,0,0,0,0,0,0,0,0,0,0,0,0,0,FALSE,0,2018,2018-2019
KS,2019-02-28,inter-ui,154,8,5,4,1,0,0,0,0,1,15,188,169,177,FALSE,0.941489361702128,2018,2018-2019
KS,2019-02-28,intra-total,2514,169,43,27,26,19,20,13,6,17,459,3313,2973,3142,FALSE,0.94838514941141,2018,2018-2019
KS,2019-02-28,intra-ucfe,6,3,0,1,0,1,0,0,0,1,8,20,14,17,FALSE,0.85,2018,2018-2019
KS,2019-02-28,intra-ucx,7,2,0,0,0,0,0,0,0,0,1,10,8,10,FALSE,1,2018,2018-2019
KS,2019-02-28,intra-ui,2501,164,43,26,26,18,20,13,6,16,450,3283,2951,3115,FALSE,0.948827292110874,2018,2018-2019
KS,2019-03-31,inter-total,62,8,2,1,0,0,1,1,0,1,11,87,73,81,FALSE,0.931034482758621,2018,2018-2019
KS,2019-03-31,inter-ucfe,0,0,0,0,0,0,0,0,0,0,0,0,0,0,FALSE,0,2018,2018-2019
KS,2019-03-31,inter-ucx,2,0,0,0,0,0,0,0,0,0,0,2,2,2,FALSE,1,2018,2018-2019
KS,2019-03-31,inter-ui,60,8,2,1,0,0,1,1,0,1,11,85,71,79,FALSE,0.929411764705882,2018,2018-2019
KS,2019-03-31,intra-total,1548,125,37,16,20,30,11,8,4,12,322,2133,1870,1995,FALSE,0.935302390998594,2018,2018-2019
KS,2019-03-31,intra-ucfe,1,0,0,0,0,0,0,0,0,0,0,1,1,1,FALSE,1,2018,2018-2019
KS,2019-03-31,intra-ucx,4,1,0,0,0,0,0,0,0,0,2,7,6,7,FALSE,1,2018,2018-2019
KS,2019-03-31,intra-ui,1543,124,37,16,20,30,11,8,4,12,320,2125,1863,1987,FALSE,0.935058823529412,2018,2018-2019
KS,2019-04-30,inter-total,81,5,1,1,0,1,0,0,0,1,11,101,92,97,FALSE,0.96039603960396,2018,2018-2019
KS,2019-04-30,inter-ucfe,0,1,0,0,0,0,0,0,0,0,0,1,0,1,FALSE,1,2018,2018-2019
KS,2019-04-30,inter-ucx,0,0,0,0,0,0,0,0,0,0,0,0,0,0,FALSE,0,2018,2018-2019
KS,2019-04-30,inter-ui,81,4,1,1,0,1,0,0,0,1,11,100,92,96,FALSE,0.96,2018,2018-2019
KS,2019-04-30,intra-total,1503,99,30,16,22,17,8,8,4,8,297,2012,1800,1899,FALSE,0.943836978131213,2018,2018-2019
KS,2019-04-30,intra-ucfe,2,2,0,0,0,0,0,0,0,1,3,8,5,7,FALSE,0.875,2018,2018-2019
KS,2019-04-30,intra-ucx,6,1,0,0,0,0,0,0,0,0,1,8,7,8,FALSE,1,2018,2018-2019
KS,2019-04-30,intra-ui,1495,96,30,16,22,17,8,8,4,7,293,1996,1788,1884,FALSE,0.943887775551102,2018,2018-2019
KS,2019-05-31,inter-total,76,2,0,2,2,1,1,0,0,2,9,95,85,87,FALSE,0.91578947368421,2018,2018-2019
KS,2019-05-31,inter-ucfe,0,0,0,0,0,0,0,0,0,0,0,0,0,0,FALSE,0,2018,2018-2019
KS,2019-05-31,inter-ucx,2,0,0,0,0,0,0,0,0,0,0,2,2,2,FALSE,1,2018,2018-2019
KS,2019-05-31,inter-ui,74,2,0,2,2,1,1,0,0,2,9,93,83,85,FALSE,0.913978494623656,2018,2018-2019
KS,2019-05-31,intra-total,1357,91,38,13,13,24,12,7,7,13,280,1855,1637,1728,FALSE,0.931536388140162,2018,2018-2019
KS,2019-05-31,intra-ucfe,3,2,0,0,1,0,0,0,0,0,0,6,3,5,FALSE,0.833333333333333,2018,2018-2019
KS,2019-05-31,intra-ucx,8,0,1,0,0,0,0,0,0,0,2,11,10,10,FALSE,0.909090909090909,2018,2018-2019
KS,2019-05-31,intra-ui,1346,89,37,13,12,24,12,7,7,13,278,1838,1624,1713,FALSE,0.931991294885745,2018,2018-2019
KS,2019-06-30,inter-total,86,6,2,1,0,2,2,0,0,0,14,113,100,106,FALSE,0.938053097345133,2018,2018-2019
KS,2019-06-30,inter-ucfe,1,0,1,0,0,1,0,0,0,0,1,4,2,2,FALSE,0.5,2018,2018-2019
KS,2019-06-30,inter-ucx,0,1,0,0,0,0,0,0,0,0,0,1,0,1,FALSE,1,2018,2018-2019
KS,2019-06-30,inter-ui,85,5,1,1,0,1,2,0,0,0,13,108,98,103,FALSE,0.953703703703704,2018,2018-2019
KS,2019-06-30,intra-total,1429,163,105,41,25,26,21,4,3,7,319,2143,1748,1911,FALSE,0.891740550629958,2018,2018-2019
KS,2019-06-30,intra-ucfe,2,2,0,0,0,1,0,0,0,0,0,5,2,4,FALSE,0.8,2018,2018-2019
KS,2019-06-30,intra-ucx,7,0,0,0,0,0,0,0,0,0,0,7,7,7,FALSE,1,2018,2018-2019
KS,2019-06-30,intra-ui,1420,161,105,41,25,25,21,4,3,7,319,2131,1739,1900,FALSE,0.891600187705303,2018,2018-2019
KS,2019-07-31,inter-total,114,13,5,2,0,1,2,0,1,4,15,157,129,142,FALSE,0.904458598726115,2019,2019-2020
KS,2019-07-31,inter-ucfe,1,1,0,0,0,0,1,0,0,0,1,4,2,3,FALSE,0.75,2019,2019-2020
KS,2019-07-31,inter-ucx,0,0,0,0,0,0,0,0,0,0,0,0,0,0,FALSE,0,2019,2019-2020
KS,2019-07-31,inter-ui,113,12,5,2,0,1,1,0,1,4,14,153,127,139,FALSE,0.908496732026144,2019,2019-2020
KS,2019-07-31,intra-total,1587,206,84,33,17,13,9,12,7,13,320,2301,1907,2113,FALSE,0.918296392872664,2019,2019-2020
KS,2019-07-31,intra-ucfe,6,0,2,0,0,0,0,0,0,0,4,12,10,10,FALSE,0.833333333333333,2019,2019-2020
KS,2019-07-31,intra-ucx,7,2,0,0,0,0,0,0,0,0,0,9,7,9,FALSE,1,2019,2019-2020
KS,2019-07-31,intra-ui,1574,204,82,33,17,13,9,12,7,13,316,2280,1890,2094,FALSE,0.918421052631579,2019,2019-2020
KS,2019-08-31,inter-total,97,7,4,2,3,0,2,0,0,2,7,124,104,111,FALSE,0.895161290322581,2019,2019-2020
KS,2019-08-31,inter-ucfe,1,1,0,0,0,0,0,0,0,0,0,2,1,2,FALSE,1,2019,2019-2020
KS,2019-08-31,inter-ucx,0,0,0,0,0,0,0,0,0,0,0,0,0,0,FALSE,0,2019,2019-2020
KS,2019-08-31,inter-ui,96,6,4,2,3,0,2,0,0,2,7,122,103,109,FALSE,0.89344262295082,2019,2019-2020
KS,2019-08-31,intra-total,1212,191,95,36,25,12,20,11,3,20,345,1970,1557,1748,FALSE,0.887309644670051,2019,2019-2020
KS,2019-08-31,intra-ucfe,2,0,1,0,0,0,0,0,0,0,2,5,4,4,FALSE,0.8,2019,2019-2020
KS,2019-08-31,intra-ucx,6,0,1,0,0,0,0,0,0,0,0,7,6,6,FALSE,0.857142857142857,2019,2019-2020
KS,2019-08-31,intra-ui,1204,191,93,36,25,12,20,11,3,20,343,1958,1547,1738,FALSE,0.887640449438202,2019,2019-2020
KS,2019-09-30,inter-total,61,10,3,3,2,1,0,0,1,3,13,97,74,84,FALSE,0.865979381443299,2019,2019-2020
KS,2019-09-30,inter-ucfe,0,1,0,0,0,0,0,0,0,0,1,2,1,2,FALSE,1,2019,2019-2020
KS,2019-09-30,inter-ucx,0,0,0,0,0,0,0,0,0,0,0,0,0,0,FALSE,0,2019,2019-2020
KS,2019-09-30,inter-ui,61,9,3,3,2,1,0,0,1,3,12,95,73,82,FALSE,0.863157894736842,2019,2019-2020
KS,2019-09-30,intra-total,1346,113,58,16,3,11,12,11,9,21,283,1883,1629,1742,FALSE,0.925119490175252,2019,2019-2020
KS,2019-09-30,intra-ucfe,4,0,0,0,0,1,0,0,0,0,1,6,5,5,FALSE,0.833333333333333,2019,2019-2020
KS,2019-09-30,intra-ucx,3,0,0,0,0,0,0,0,0,0,1,4,4,4,FALSE,1,2019,2019-2020
KS,2019-09-30,intra-ui,1339,113,58,16,3,10,12,11,9,21,281,1873,1620,1733,FALSE,0.9252536038441,2019,2019-2020
KS,2019-10-31,inter-total,103,10,4,1,1,1,0,1,1,5,21,148,124,134,FALSE,0.905405405405405,2019,2019-2020
KS,2019-10-31,inter-ucfe,1,1,0,0,0,0,0,0,0,1,1,4,2,3,FALSE,0.75,2019,2019-2020
KS,2019-10-31,inter-ucx,0,0,0,0,0,0,0,0,0,0,0,0,0,0,FALSE,0,2019,2019-2020
KS,2019-10-31,inter-ui,102,9,4,1,1,1,0,1,1,4,20,144,122,131,FALSE,0.909722222222222,2019,2019-2020
KS,2019-10-31,intra-total,1525,155,42,16,14,21,13,13,5,37,346,2187,1871,2026,FALSE,0.926383173296754,2019,2019-2020
KS,2019-10-31,intra-ucfe,5,2,0,0,0,0,0,0,0,0,1,8,6,8,FALSE,1,2019,2019-2020
KS,2019-10-31,intra-ucx,5,1,0,0,0,0,0,0,0,0,1,7,6,7,FALSE,1,2019,2019-2020
KS,2019-10-31,intra-ui,1515,152,42,16,14,21,13,13,5,37,344,2172,1859,2011,FALSE,0.925874769797422,2019,2019-2020
KS,2019-11-30,inter-total,114,1,3,0,0,1,0,2,1,2,11,135,125,126,FALSE,0.933333333333333,2019,2019-2020
KS,2019-11-30,inter-ucfe,0,0,0,0,0,0,0,0,0,0,1,1,1,1,FALSE,1,2019,2019-2020
KS,2019-11-30,inter-ucx,0,0,0,0,0,0,0,0,0,0,0,0,0,0,FALSE,0,2019,2019-2020
KS,2019-11-30,inter-ui,114,1,3,0,0,1,0,2,1,2,10,134,124,125,FALSE,0.932835820895522,2019,2019-2020
KS,2019-11-30,intra-total,1328,113,58,13,12,15,18,16,9,35,226,1843,1554,1667,FALSE,0.904503526858383,2019,2019-2020
KS,2019-11-30,intra-ucfe,5,0,1,1,0,0,0,0,0,1,0,8,5,5,FALSE,0.625,2019,2019-2020
KS,2019-11-30,intra-ucx,3,0,0,0,0,0,0,0,1,0,1,5,4,4,FALSE,0.8,2019,2019-2020
KS,2019-11-30,intra-ui,1320,113,57,12,12,15,18,16,8,34,225,1830,1545,1658,FALSE,0.906010928961749,2019,2019-2020
KS,2019-12-31,inter-total,247,3,2,0,1,0,3,0,0,0,21,277,268,271,FALSE,0.978339350180505,2019,2019-2020
KS,2019-12-31,inter-ucfe,1,0,0,0,0,0,0,0,0,0,0,1,1,1,FALSE,1,2019,2019-2020
KS,2019-12-31,inter-ucx,0,0,0,0,0,0,0,0,0,0,0,0,0,0,FALSE,0,2019,2019-2020
KS,2019-12-31,inter-ui,246,3,2,0,1,0,3,0,0,0,21,276,267,270,FALSE,0.978260869565217,2019,2019-2020
KS,2019-12-31,intra-total,2546,124,43,21,16,13,13,13,3,24,318,3134,2864,2988,FALSE,0.953414167198468,2019,2019-2020
KS,2019-12-31,intra-ucfe,2,0,0,0,0,0,0,0,0,0,0,2,2,2,FALSE,1,2019,2019-2020
KS,2019-12-31,intra-ucx,3,0,0,0,0,0,0,0,0,0,0,3,3,3,FALSE,1,2019,2019-2020
KS,2019-12-31,intra-ui,2541,124,43,21,16,13,13,13,3,24,318,3129,2859,2983,FALSE,0.953339725151806,2019,2019-2020
KS,2020-01-31,inter-total,243,10,6,1,1,0,0,0,1,3,25,290,268,278,FALSE,0.958620689655172,2019,2019-2020
KS,2020-01-31,inter-ucfe,1,0,0,0,0,0,0,0,0,0,0,1,1,1,FALSE,1,2019,2019-2020
KS,2020-01-31,inter-ucx,0,0,0,0,0,0,0,0,0,0,0,0,0,0,FALSE,0,2019,2019-2020
KS,2020-01-31,inter-ui,242,10,6,1,1,0,0,0,1,3,25,289,267,277,FALSE,0.958477508650519,2019,2019-2020
KS,2020-01-31,intra-total,3681,162,59,15,17,17,15,4,12,32,513,4527,4194,4356,FALSE,0.962226640159046,2019,2019-2020
KS,2020-01-31,intra-ucfe,2,1,0,0,0,0,0,0,1,1,1,6,3,4,FALSE,0.666666666666667,2019,2019-2020
KS,2020-01-31,intra-ucx,5,1,0,0,0,0,0,0,0,0,1,7,6,7,FALSE,1,2019,2019-2020
KS,2020-01-31,intra-ui,3674,160,59,15,17,17,15,4,11,31,511,4514,4185,4345,FALSE,0.962560921577315,2019,2019-2020
KS,2020-02-29,inter-total,128,8,1,1,1,0,1,0,2,0,22,164,150,158,FALSE,0.963414634146341,2019,2019-2020
KS,2020-02-29,inter-ucfe,1,1,1,0,0,0,0,0,0,0,0,3,1,2,FALSE,0.666666666666667,2019,2019-2020
KS,2020-02-29,inter-ucx,0,0,0,0,0,0,0,0,0,0,0,0,0,0,FALSE,0,2019,2019-2020
KS,2020-02-29,inter-ui,127,7,0,1,1,0,1,0,2,0,22,161,149,156,FALSE,0.968944099378882,2019,2019-2020
KS,2020-02-29,intra-total,2579,145,76,25,15,23,19,5,5,29,441,3362,3020,3165,FALSE,0.941403926234384,2019,2019-2020
KS,2020-02-29,intra-ucfe,1,1,1,0,0,0,0,0,0,0,0,3,1,2,FALSE,0.666666666666667,2019,2019-2020
KS,2020-02-29,intra-ucx,4,1,1,0,0,0,0,0,0,0,1,7,5,6,FALSE,0.857142857142857,2019,2019-2020
KS,2020-02-29,intra-ui,2574,143,74,25,15,23,19,5,5,29,440,3352,3014,3157,FALSE,0.941825775656325,2019,2019-2020
KS,2020-03-31,inter-total,505,4,4,1,0,0,2,0,0,2,25,543,530,534,FALSE,0.983425414364641,2019,2019-2020
KS,2020-03-31,inter-ucfe,0,0,0,0,0,0,0,0,0,0,0,0,0,0,FALSE,0,2019,2019-2020
KS,2020-03-31,inter-ucx,0,0,0,0,0,0,0,0,0,0,0,0,0,0,FALSE,0,2019,2019-2020
KS,2020-03-31,inter-ui,505,4,4,1,0,0,2,0,0,2,25,543,530,534,FALSE,0.983425414364641,2019,2019-2020
KS,2020-03-31,intra-total,16674,161,56,29,16,11,8,5,1,11,1218,18190,17892,18053,FALSE,0.992468389224849,2019,2019-2020
KS,2020-03-31,intra-ucfe,3,0,1,1,0,0,0,0,0,1,1,7,4,4,FALSE,0.571428571428571,2019,2019-2020
KS,2020-03-31,intra-ucx,10,0,0,0,0,0,0,0,0,0,0,10,10,10,FALSE,1,2019,2019-2020
KS,2020-03-31,intra-ui,16661,161,55,28,16,11,8,5,1,10,1217,18173,17878,18039,FALSE,0.992626423815551,2019,2019-2020
KS,2020-04-30,inter-total,1356,123,41,14,2,0,0,0,1,0,409,1946,1765,1888,FALSE,0.970195272353546,2019,2019-2020
KS,2020-04-30,inter-ucfe,0,0,0,0,0,0,0,0,0,0,0,0,0,0,FALSE,0,2019,2019-2020
KS,2020-04-30,inter-ucx,0,0,0,0,0,0,0,0,0,0,0,0,0,0,FALSE,0,2019,2019-2020
KS,2020-04-30,inter-ui,1356,123,41,14,2,0,0,0,1,0,409,1946,1765,1888,FALSE,0.970195272353546,2019,2019-2020
KS,2020-04-30,intra-total,61754,4280,1364,483,109,3,10,6,5,14,19674,87702,81428,85708,FALSE,0.977263916444323,2019,2019-2020
KS,2020-04-30,intra-ucfe,6,8,1,2,1,0,0,0,0,0,9,27,15,23,FALSE,0.851851851851852,2019,2019-2020
KS,2020-04-30,intra-ucx,2,0,0,2,1,0,0,0,0,0,5,10,7,7,FALSE,0.7,2019,2019-2020
KS,2020-04-30,intra-ui,61746,4272,1363,479,107,3,10,6,5,14,19660,87665,81406,85678,FALSE,0.977334169851138,2019,2019-2020
KS,2020-05-31,inter-total,311,105,92,85,72,30,17,9,3,7,98,829,409,514,FALSE,0.620024125452352,2019,2019-2020
KS,2020-05-31,inter-ucfe,0,0,0,1,0,0,0,0,0,1,0,2,0,0,FALSE,0,2019,2019-2020
KS,2020-05-31,inter-ucx,0,0,0,0,0,0,0,0,0,0,0,0,0,0,FALSE,0,2019,2019-2020
KS,2020-05-31,inter-ui,311,105,92,84,72,30,17,9,3,6,98,827,409,514,FALSE,0.621523579201935,2019,2019-2020
KS,2020-05-31,intra-total,11245,3522,3923,3874,2783,1139,457,225,44,74,4332,31618,15577,19099,FALSE,0.604054652413182,2019,2019-2020
KS,2020-05-31,intra-ucfe,4,5,7,8,3,1,2,1,1,1,1,34,5,10,FALSE,0.294117647058824,2019,2019-2020
KS,2020-05-31,intra-ucx,8,4,2,2,4,0,2,2,0,0,8,32,16,20,FALSE,0.625,2019,2019-2020
KS,2020-05-31,intra-ui,11233,3513,3914,3864,2776,1138,453,222,43,73,4323,31552,15556,19069,FALSE,0.604367393509128,2019,2019-2020
KS,2020-06-30,inter-total,233,83,117,74,54,43,46,37,30,47,81,845,314,397,FALSE,0.469822485207101,2019,2019-2020
KS,2020-06-30,inter-ucfe,0,1,0,0,0,2,0,1,0,1,0,5,0,1,FALSE,0.2,2019,2019-2020
KS,2020-06-30,inter-ucx,0,0,0,0,0,0,0,0,0,1,1,2,1,1,FALSE,0.5,2019,2019-2020
KS,2020-06-30,inter-ui,233,82,117,74,54,41,46,36,30,45,80,838,313,395,FALSE,0.471360381861575,2019,2019-2020
KS,2020-06-30,intra-total,6900,2097,3051,1597,1212,1008,899,708,643,896,2418,21429,9318,11415,FALSE,0.532689346213076,2019,2019-2020
KS,2020-06-30,intra-ucfe,1,4,3,1,3,0,2,0,1,2,2,19,3,7,FALSE,0.368421052631579,2019,2019-2020
KS,2020-06-30,intra-ucx,5,5,3,3,1,1,2,2,1,1,6,30,11,16,FALSE,0.533333333333333,2019,2019-2020
KS,2020-06-30,intra-ui,6894,2088,3045,1593,1208,1007,895,706,641,893,2410,21380,9304,11392,FALSE,0.532834424695978,2019,2019-2020
KS,2020-07-31,inter-total,305,46,42,32,23,24,23,26,20,602,59,1202,364,410,FALSE,0.341098169717138,2020,2020-2021
KS,2020-07-31,inter-ucfe,0,0,0,2,1,0,0,0,0,3,0,6,0,0,FALSE,0,2020,2020-2021
KS,2020-07-31,inter-ucx,0,0,0,0,0,0,0,0,0,0,0,0,0,0,FALSE,0,2020,2020-2021
KS,2020-07-31,inter-ui,305,46,42,30,22,24,23,26,20,599,59,1196,364,410,FALSE,0.342809364548495,2020,2020-2021
KS,2020-07-31,intra-total,5675,1170,1069,815,682,570,601,569,537,11368,1668,24724,7343,8513,FALSE,0.34432130723184,2020,2020-2021
KS,2020-07-31,intra-ucfe,2,4,1,2,4,1,1,0,1,21,2,39,4,8,FALSE,0.205128205128205,2020,2020-2021
KS,2020-07-31,intra-ucx,4,6,2,0,1,0,2,3,0,25,3,46,7,13,FALSE,0.282608695652174,2020,2020-2021
KS,2020-07-31,intra-ui,5669,1160,1066,813,677,569,598,566,536,11322,1663,24639,7332,8492,FALSE,0.344656844839482,2020,2020-2021
KS,2020-08-31,inter-total,235,43,56,37,30,26,20,15,17,136,57,672,292,335,FALSE,0.498511904761905,2020,2020-2021
KS,2020-08-31,inter-ucfe,0,0,1,0,0,0,0,0,0,1,0,2,0,0,FALSE,0,2020,2020-2021
KS,2020-08-31,inter-ucx,0,0,0,0,0,0,0,0,0,0,0,0,0,0,FALSE,0,2020,2020-2021
KS,2020-08-31,inter-ui,235,43,55,37,30,26,20,15,17,135,57,670,292,335,FALSE,0.5,2020,2020-2021
KS,2020-08-31,intra-total,2806,888,1234,838,598,401,302,246,254,2325,916,10808,3722,4610,FALSE,0.426535899333827,2020,2020-2021
KS,2020-08-31,intra-ucfe,0,1,4,4,3,3,2,2,2,8,0,29,0,1,FALSE,0.0344827586206897,2020,2020-2021
KS,2020-08-31,intra-ucx,5,4,1,1,0,1,0,0,0,1,3,16,8,12,FALSE,0.75,2020,2020-2021
KS,2020-08-31,intra-ui,2801,883,1229,833,595,397,300,244,252,2316,913,10763,3714,4597,FALSE,0.42711140016724,2020,2020-2021
KS,2020-09-30,inter-total,631,37,28,34,49,34,23,25,17,189,141,1208,772,809,FALSE,0.669701986754967,2020,2020-2021
KS,2020-09-30,inter-ucfe,0,0,0,0,0,0,0,0,0,1,0,1,0,0,FALSE,0,2020,2020-2021
KS,2020-09-30,inter-ucx,1,0,0,0,0,0,0,0,0,0,0,1,1,1,FALSE,1,2020,2020-2021
KS,2020-09-30,inter-ui,630,37,28,34,49,34,23,25,17,188,141,1206,771,808,FALSE,0.669983416252073,2020,2020-2021
KS,2020-09-30,intra-total,5356,428,555,617,908,638,405,331,267,2640,1026,13171,6382,6810,FALSE,0.517045023156936,2020,2020-2021
KS,2020-09-30,intra-ucfe,3,0,0,0,2,1,0,1,1,3,0,11,3,3,FALSE,0.272727272727273,2020,2020-2021
KS,2020-09-30,intra-ucx,2,0,0,0,1,0,1,0,0,2,1,7,3,3,FALSE,0.428571428571429,2020,2020-2021
KS,2020-09-30,intra-ui,5351,428,555,617,905,637,404,330,266,2635,1025,13153,6376,6804,FALSE,0.51729643427355,2020,2020-2021
KS,2020-10-31,inter-total,980,107,22,20,26,25,26,16,16,160,149,1547,1129,1236,FALSE,0.798965740142211,2020,2020-2021
KS,2020-10-31,inter-ucfe,0,1,0,0,0,0,1,0,0,1,1,4,1,2,FALSE,0.5,2020,2020-2021
KS,2020-10-31,inter-ucx,0,1,0,0,0,0,0,0,0,1,0,2,0,1,FALSE,0.5,2020,2020-2021
KS,2020-10-31,inter-ui,980,105,22,20,26,25,25,16,16,158,148,1541,1128,1233,FALSE,0.800129785853342,2020,2020-2021
KS,2020-10-31,intra-total,11766,954,400,362,383,512,528,283,167,1525,1829,18709,13595,14549,FALSE,0.777647121706131,2020,2020-2021
KS,2020-10-31,intra-ucfe,2,3,3,1,0,2,1,0,1,8,2,23,4,7,FALSE,0.304347826086957,2020,2020-2021
KS,2020-10-31,intra-ucx,1,1,0,0,0,1,1,0,0,3,5,12,6,7,FALSE,0.583333333333333,2020,2020-2021
KS,2020-10-31,intra-ui,11763,950,397,361,383,509,526,283,166,1514,1822,18674,13585,14535,FALSE,0.778354931991004,2020,2020-2021
KS,2020-11-30,inter-total,987,108,23,18,25,25,26,16,16,161,150,1555,1137,1245,FALSE,0.80064308681672,2020,2020-2021
KS,2020-11-30,inter-ucfe,0,1,0,0,0,0,1,0,0,1,1,4,1,2,FALSE,0.5,2020,2020-2021
KS,2020-11-30,inter-ucx,0,1,0,0,0,0,0,0,0,1,0,2,0,1,FALSE,0.5,2020,2020-2021
KS,2020-11-30,inter-ui,987,106,23,18,25,25,25,16,16,159,149,1549,1136,1242,FALSE,0.801807617817947,2020,2020-2021
KS,2020-11-30,intra-total,11758,953,399,362,384,512,528,283,167,1525,1828,18699,13586,14539,FALSE,0.777528210064709,2020,2020-2021
KS,2020-11-30,intra-ucfe,2,3,3,1,0,2,1,0,1,8,2,23,4,7,FALSE,0.304347826086957,2020,2020-2021
KS,2020-11-30,intra-ucx,1,1,0,0,0,1,1,0,0,3,5,12,6,7,FALSE,0.583333333333333,2020,2020-2021
KS,2020-11-30,intra-ui,11755,949,396,361,384,509,526,283,166,1514,1821,18664,13576,14525,FALSE,0.778236176596657,2020,2020-2021
KS,2020-12-31,inter-total,2567,135,40,29,19,20,20,15,10,49,460,3364,3027,3162,FALSE,0.939952437574316,2020,2020-2021
KS,2020-12-31,inter-ucfe,0,0,0,0,0,0,1,1,0,2,0,4,0,0,FALSE,0,2020,2020-2021
KS,2020-12-31,inter-ucx,0,0,0,0,0,0,0,0,0,0,0,0,0,0,FALSE,0,2020,2020-2021
KS,2020-12-31,inter-ui,2567,135,40,29,19,20,19,14,10,47,460,3360,3027,3162,FALSE,0.941071428571428,2020,2020-2021
KS,2020-12-31,intra-total,48816,1852,826,631,486,442,484,414,273,1465,9738,65427,58554,60406,FALSE,0.923257982178611,2020,2020-2021
KS,2020-12-31,intra-ucfe,1,7,6,0,2,0,2,1,0,2,0,21,1,8,FALSE,0.380952380952381,2020,2020-2021
KS,2020-12-31,intra-ucx,0,1,0,0,0,3,0,0,0,1,1,6,1,2,FALSE,0.333333333333333,2020,2020-2021
KS,2020-12-31,intra-ui,48815,1844,820,631,484,439,482,413,273,1462,9737,65400,58552,60396,FALSE,0.92348623853211,2020,2020-2021
KS,2021-01-31,inter-total,1587,87,24,17,21,19,13,11,7,62,361,2209,1948,2035,FALSE,0.921231326392033,2020,2020-2021
KS,2021-01-31,inter-ucfe,0,0,0,0,0,0,0,0,0,1,0,1,0,0,FALSE,0,2020,2020-2021
KS,2021-01-31,inter-ucx,0,0,0,0,0,0,0,0,0,0,0,0,0,0,FALSE,0,2020,2020-2021
KS,2021-01-31,inter-ui,1587,87,24,17,21,19,13,11,7,61,361,2208,1948,2035,FALSE,0.921648550724638,2020,2020-2021
KS,2021-01-31,intra-total,39924,1119,466,350,254,243,244,231,213,1269,13286,57599,53210,54329,FALSE,0.94322818104481,2020,2020-2021
KS,2021-01-31,intra-ucfe,3,1,1,1,2,1,1,2,1,4,3,20,6,7,FALSE,0.35,2020,2020-2021
KS,2021-01-31,intra-ucx,0,0,1,1,0,1,0,0,0,0,1,4,1,1,FALSE,0.25,2020,2020-2021
KS,2021-01-31,intra-ui,39921,1118,464,348,252,241,243,229,212,1265,13282,57575,53203,54321,FALSE,0.943482414242293,2020,2020-2021
KS,2021-02-28,inter-total,89,15,6,5,2,5,4,3,2,42,29,202,118,133,FALSE,0.658415841584159,2020,2020-2021
KS,2021-02-28,inter-ucfe,0,0,0,0,0,0,1,0,0,1,0,2,0,0,FALSE,0,2020,2020-2021
KS,2021-02-28,inter-ucx,0,0,0,0,0,0,0,0,0,0,0,0,0,0,FALSE,0,2020,2020-2021
KS,2021-02-28,inter-ui,89,15,6,5,2,5,3,3,2,41,29,200,118,133,FALSE,0.665,2020,2020-2021
KS,2021-02-28,intra-total,1529,167,204,142,97,92,83,64,43,449,619,3489,2148,2315,FALSE,0.663513900831184,2020,2020-2021
KS,2021-02-28,intra-ucfe,1,0,2,0,0,1,0,0,1,1,0,6,1,1,FALSE,0.166666666666667,2020,2020-2021
KS,2021-02-28,intra-ucx,0,0,0,1,1,0,0,0,0,0,0,2,0,0,FALSE,0,2020,2020-2021
KS,2021-02-28,intra-ui,1528,167,202,141,96,91,83,64,42,448,619,3481,2147,2314,FALSE,0.664751508187303,2020,2020-2021
KS,2021-03-31,inter-total,142,26,5,10,11,4,6,7,4,23,6,244,148,174,FALSE,0.713114754098361,2020,2020-2021
KS,2021-03-31,inter-ucfe,0,0,0,0,1,0,0,0,0,1,0,2,0,0,FALSE,0,2020,2020-2021
KS,2021-03-31,inter-ucx,0,0,0,0,0,0,0,0,0,0,0,0,0,0,FALSE,0,2020,2020-2021
KS,2021-03-31,inter-ui,142,26,5,10,10,4,6,7,4,22,6,242,148,174,FALSE,0.71900826446281,2020,2020-2021
KS,2021-03-31,intra-total,1721,355,124,146,137,1617,509,88,73,762,238,5770,1959,2314,FALSE,0.40103986135182,2020,2020-2021
KS,2021-03-31,intra-ucfe,0,0,0,1,0,1,0,0,0,5,0,7,0,0,FALSE,0,2020,2020-2021
KS,2021-03-31,intra-ucx,1,0,1,0,0,0,0,0,0,0,1,3,2,2,FALSE,0.666666666666667,2020,2020-2021
KS,2021-03-31,intra-ui,1720,355,123,145,137,1616,509,88,73,757,237,5760,1957,2312,FALSE,0.401388888888889,2020,2020-2021
KS,2021-04-30,inter-total,100,11,6,4,3,4,1,7,2,23,17,178,117,128,FALSE,0.719101123595506,2020,2020-2021
KS,2021-04-30,inter-ucfe,0,0,0,0,0,0,0,0,0,0,0,0,0,0,FALSE,0,2020,2020-2021
KS,2021-04-30,inter-ucx,0,0,0,0,0,0,0,0,0,0,0,0,0,0,FALSE,0,2020,2020-2021
KS,2021-04-30,inter-ui,100,11,6,4,3,4,1,7,2,23,17,178,117,128,FALSE,0.719101123595506,2020,2020-2021
KS,2021-04-30,intra-total,1381,226,144,76,52,53,36,33,37,237,283,2558,1664,1890,FALSE,0.738858483189992,2020,2020-2021
KS,2021-04-30,intra-ucfe,0,0,0,0,0,0,0,0,0,0,1,1,1,1,FALSE,1,2020,2020-2021
KS,2021-04-30,intra-ucx,0,0,0,0,1,0,0,0,0,0,0,1,0,0,FALSE,0,2020,2020-2021
KS,2021-04-30,intra-ui,1381,226,144,76,51,53,36,33,37,237,282,2556,1663,1889,FALSE,0.739045383411581,2020,2020-2021
KS,2021-05-31,inter-total,108,21,18,16,8,12,7,6,4,37,33,270,141,162,FALSE,0.6,2020,2020-2021
KS,2021-05-31,inter-ucfe,0,0,0,0,0,0,0,0,0,1,1,2,1,1,FALSE,0.5,2020,2020-2021
KS,2021-05-31,inter-ucx,0,0,0,0,0,0,0,0,0,0,0,0,0,0,FALSE,0,2020,2020-2021
KS,2021-05-31,inter-ui,108,21,18,16,8,12,7,6,4,36,32,268,140,161,FALSE,0.600746268656716,2020,2020-2021
KS,2021-05-31,intra-total,1106,181,300,241,172,158,118,79,54,644,215,3268,1321,1502,FALSE,0.459608323133415,2020,2020-2021
KS,2021-05-31,intra-ucfe,2,2,3,2,2,3,1,0,0,12,0,27,2,4,FALSE,0.148148148148148,2020,2020-2021
KS,2021-05-31,intra-ucx,1,0,0,0,0,0,0,0,0,2,1,4,2,2,FALSE,0.5,2020,2020-2021
KS,2021-05-31,intra-ui,1103,179,297,239,170,155,117,79,54,630,214,3237,1317,1496,FALSE,0.462156317578004,2020,2020-2021
KS,2021-06-30,inter-total,52,7,14,18,18,17,8,8,9,75,22,248,74,81,FALSE,0.326612903225806,2020,2020-2021
KS,2021-06-30,inter-ucfe,0,0,0,0,0,0,0,0,0,0,0,0,0,0,FALSE,0,2020,2020-2021
KS,2021-06-30,inter-ucx,0,0,0,0,0,0,0,0,0,0,0,0,0,0,FALSE,0,2020,2020-2021
KS,2021-06-30,inter-ui,52,7,14,18,18,17,8,8,9,75,22,248,74,81,FALSE,0.326612903225806,2020,2020-2021
KS,2021-06-30,intra-total,951,145,164,186,193,147,104,108,97,710,212,3017,1163,1308,FALSE,0.433543254888963,2020,2020-2021
KS,2021-06-30,intra-ucfe,4,0,0,2,0,0,0,0,0,4,2,12,6,6,FALSE,0.5,2020,2020-2021
KS,2021-06-30,intra-ucx,1,1,0,0,0,0,0,1,0,0,1,4,2,3,FALSE,0.75,2020,2020-2021
KS,2021-06-30,intra-ui,946,144,164,184,193,147,104,107,97,706,209,3001,1155,1299,FALSE,0.432855714761746,2020,2020-2021
KS,2021-07-31,inter-total,192,4,6,6,9,6,14,4,6,25,10,282,202,206,FALSE,0.730496453900709,2021,2021-2022
KS,2021-07-31,inter-ucfe,0,0,0,0,0,0,0,0,0,0,0,0,0,0,FALSE,0,2021,2021-2022
KS,2021-07-31,inter-ucx,0,0,0,0,0,0,0,0,0,0,0,0,0,0,FALSE,0,2021,2021-2022
KS,2021-07-31,inter-ui,192,4,6,6,9,6,14,4,6,25,10,282,202,206,FALSE,0.730496453900709,2021,2021-2022
KS,2021-07-31,intra-total,1366,96,105,98,154,92,76,53,39,450,124,2653,1490,1586,FALSE,0.597813795702978,2021,2021-2022
KS,2021-07-31,intra-ucfe,2,0,0,0,0,1,0,0,0,4,0,7,2,2,FALSE,0.285714285714286,2021,2021-2022
KS,2021-07-31,intra-ucx,1,1,0,1,0,0,0,0,0,0,0,3,1,2,FALSE,0.666666666666667,2021,2021-2022
KS,2021-07-31,intra-ui,1363,95,105,97,154,91,76,53,39,446,124,2643,1487,1582,FALSE,0.598562239878925,2021,2021-2022
KS,2021-08-31,inter-total,44,10,7,5,2,7,4,1,1,38,17,136,61,71,FALSE,0.522058823529412,2021,2021-2022
KS,2021-08-31,inter-ucfe,0,0,1,0,1,0,0,0,0,3,0,5,0,0,FALSE,0,2021,2021-2022
KS,2021-08-31,inter-ucx,0,0,0,0,0,0,0,0,0,0,0,0,0,0,FALSE,0,2021,2021-2022
KS,2021-08-31,inter-ui,44,10,6,5,1,7,4,1,1,35,17,131,61,71,FALSE,0.541984732824428,2021,2021-2022
KS,2021-08-31,intra-total,871,217,131,101,73,57,48,42,41,500,317,2398,1188,1405,FALSE,0.585904920767306,2021,2021-2022
KS,2021-08-31,intra-ucfe,2,0,1,0,0,0,1,1,1,2,2,10,4,4,FALSE,0.4,2021,2021-2022
KS,2021-08-31,intra-ucx,1,0,0,0,1,1,0,0,0,1,0,4,1,1,FALSE,0.25,2021,2021-2022
KS,2021-08-31,intra-ui,868,217,130,101,72,56,47,41,40,497,315,2384,1183,1400,FALSE,0.587248322147651,2021,2021-2022
KS,2021-09-30,inter-total,32,1,4,3,2,5,3,6,1,39,10,106,42,43,FALSE,0.405660377358491,2021,2021-2022
KS,2021-09-30,inter-ucfe,0,0,0,0,0,0,0,0,0,0,1,1,1,1,FALSE,1,2021,2021-2022
KS,2021-09-30,inter-ucx,0,0,0,0,0,0,0,0,0,0,0,0,0,0,FALSE,0,2021,2021-2022
KS,2021-09-30,inter-ui,32,1,4,3,2,5,3,6,1,39,9,105,41,42,FALSE,0.4,2021,2021-2022
KS,2021-09-30,intra-total,601,93,63,44,50,47,40,31,29,490,159,1647,760,853,FALSE,0.517911353976928,2021,2021-2022
KS,2021-09-30,intra-ucfe,0,0,1,0,0,0,0,0,0,3,0,4,0,0,FALSE,0,2021,2021-2022
KS,2021-09-30,intra-ucx,1,0,1,1,0,0,1,0,1,3,1,9,2,2,FALSE,0.222222222222222,2021,2021-2022
KS,2021-09-30,intra-ui,600,93,61,43,50,47,39,31,28,484,158,1634,758,851,FALSE,0.520807833537332,2021,2021-2022
KS,2021-10-31,inter-total,26,1,2,5,5,4,0,1,2,82,8,136,34,35,FALSE,0.257352941176471,2021,2021-2022
KS,2021-10-31,inter-ucfe,0,0,0,0,0,0,0,0,0,0,0,0,0,0,FALSE,0,2021,2021-2022
KS,2021-10-31,inter-ucx,0,0,0,0,0,0,0,0,0,0,0,0,0,0,FALSE,0,2021,2021-2022
KS,2021-10-31,inter-ui,26,1,2,5,5,4,0,1,2,82,8,136,34,35,FALSE,0.257352941176471,2021,2021-2022
KS,2021-10-31,intra-total,488,128,80,51,49,39,27,15,18,466,226,1587,714,842,FALSE,0.530560806553245,2021,2021-2022
KS,2021-10-31,intra-ucfe,0,0,1,1,1,0,0,0,0,6,0,9,0,0,FALSE,0,2021,2021-2022
KS,2021-10-31,intra-ucx,1,0,0,0,0,0,0,0,0,4,2,7,3,3,FALSE,0.428571428571429,2021,2021-2022
KS,2021-10-31,intra-ui,487,128,79,50,48,39,27,15,18,456,224,1571,711,839,FALSE,0.534054742202419,2021,2021-2022
KS,2021-11-30,inter-total,56,3,3,2,1,2,2,1,2,57,10,139,66,69,FALSE,0.496402877697842,2021,2021-2022
KS,2021-11-30,inter-ucfe,0,0,0,0,0,0,1,0,0,0,0,1,0,0,FALSE,0,2021,2021-2022
KS,2021-11-30,inter-ucx,0,0,0,0,0,0,0,0,0,0,0,0,0,0,FALSE,0,2021,2021-2022
KS,2021-11-30,inter-ui,56,3,3,2,1,2,1,1,2,57,10,138,66,69,FALSE,0.5,2021,2021-2022
KS,2021-11-30,intra-total,675,83,51,36,40,33,25,17,20,372,175,1527,850,933,FALSE,0.611001964636542,2021,2021-2022
KS,2021-11-30,intra-ucfe,4,1,2,0,0,1,0,0,0,4,0,12,4,5,FALSE,0.416666666666667,2021,2021-2022
KS,2021-11-30,intra-ucx,4,1,0,1,0,1,1,0,0,2,2,12,6,7,FALSE,0.583333333333333,2021,2021-2022
KS,2021-11-30,intra-ui,667,81,49,35,40,31,24,17,20,366,173,1503,840,921,FALSE,0.612774451097804,2021,2021-2022
KS,2021-12-31,inter-total,75,8,2,4,5,4,2,0,0,33,25,158,100,108,FALSE,0.683544303797468,2021,2021-2022
KS,2021-12-31,inter-ucfe,0,0,0,0,0,0,0,0,0,1,0,1,0,0,FALSE,0,2021,2021-2022
KS,2021-12-31,inter-ucx,0,0,0,0,0,0,0,0,0,0,0,0,0,0,FALSE,0,2021,2021-2022
KS,2021-12-31,inter-ui,75,8,2,4,5,4,2,0,0,32,25,157,100,108,FALSE,0.687898089171975,2021,2021-2022
KS,2021-12-31,intra-total,990,144,70,71,57,26,27,18,19,479,313,2214,1303,1447,FALSE,0.65356820234869,2021,2021-2022
KS,2021-12-31,intra-ucfe,1,0,2,1,0,0,0,0,0,4,0,8,1,1,FALSE,0.125,2021,2021-2022
KS,2021-12-31,intra-ucx,3,1,0,0,1,0,0,0,0,1,1,7,4,5,FALSE,0.714285714285714,2021,2021-2022
KS,2021-12-31,intra-ui,986,143,68,70,56,26,27,18,19,474,312,2199,1298,1441,FALSE,0.655297862664848,2021,2021-2022
KS,2022-01-31,inter-total,136,9,7,8,3,2,3,1,0,13,24,206,160,169,FALSE,0.820388349514563,2021,2021-2022
KS,2022-01-31,inter-ucfe,0,0,0,0,0,0,0,0,0,0,0,0,0,0,FALSE,0,2021,2021-2022
KS,2022-01-31,inter-ucx,1,0,0,0,0,0,0,0,0,0,0,1,1,1,FALSE,1,2021,2021-2022
KS,2022-01-31,inter-ui,135,9,7,8,3,2,3,1,0,13,24,205,159,168,FALSE,0.819512195121951,2021,2021-2022
KS,2022-01-31,intra-total,2475,135,68,56,29,25,11,9,9,302,347,3466,2822,2957,FALSE,0.853144835545297,2021,2021-2022
KS,2022-01-31,intra-ucfe,1,1,0,0,0,0,0,0,1,2,1,6,2,3,FALSE,0.5,2021,2021-2022
KS,2022-01-31,intra-ucx,4,0,0,0,1,1,0,0,0,1,4,11,8,8,FALSE,0.727272727272727,2021,2021-2022
KS,2022-01-31,intra-ui,2470,134,68,56,28,24,11,9,8,299,342,3449,2812,2946,FALSE,0.854160626268484,2021,2021-2022
KS,2022-02-28,inter-total,91,7,10,3,5,1,1,1,0,12,19,150,110,117,FALSE,0.78,2021,2021-2022
KS,2022-02-28,inter-ucfe,0,0,1,0,0,0,0,0,0,0,0,1,0,0,FALSE,0,2021,2021-2022
KS,2022-02-28,inter-ucx,0,0,0,0,0,0,0,0,0,0,0,0,0,0,FALSE,0,2021,2021-2022
KS,2022-02-28,inter-ui,91,7,9,3,5,1,1,1,0,12,19,149,110,117,FALSE,0.785234899328859,2021,2021-2022
KS,2022-02-28,intra-total,1956,137,103,68,41,28,12,14,15,235,465,3074,2421,2558,FALSE,0.832140533506832,2021,2021-2022
KS,2022-02-28,intra-ucfe,2,2,1,1,0,1,0,0,0,1,0,8,2,4,FALSE,0.5,2021,2021-2022
KS,2022-02-28,intra-ucx,2,1,0,0,0,0,0,0,0,0,0,3,2,3,FALSE,1,2021,2021-2022
KS,2022-02-28,intra-ui,1952,134,102,67,41,27,12,14,15,234,465,3063,2417,2551,FALSE,0.832843617368593,2021,2021-2022
KS,2022-03-31,inter-total,78,14,2,3,1,5,0,4,2,16,17,142,95,109,FALSE,0.767605633802817,2021,2021-2022
KS,2022-03-31,inter-ucfe,0,0,0,0,0,0,0,0,0,0,0,0,0,0,FALSE,0,2021,2021-2022
KS,2022-03-31,inter-ucx,0,0,0,0,0,0,0,0,0,0,0,0,0,0,FALSE,0,2021,2021-2022
KS,2022-03-31,inter-ui,78,14,2,3,1,5,0,4,2,16,17,142,95,109,FALSE,0.767605633802817,2021,2021-2022
KS,2022-03-31,intra-total,1903,118,76,59,37,39,17,19,11,222,448,2949,2351,2469,FALSE,0.837232960325534,2021,2021-2022
KS,2022-03-31,intra-ucfe,1,0,1,0,1,0,0,0,1,1,0,5,1,1,FALSE,0.2,2021,2021-2022
KS,2022-03-31,intra-ucx,6,0,0,0,0,0,0,0,0,1,0,7,6,6,FALSE,0.857142857142857,2021,2021-2022
KS,2022-03-31,intra-ui,1896,118,75,59,36,39,17,19,10,220,448,2937,2344,2462,FALSE,0.838270343888322,2021,2021-2022
KS,2022-04-30,inter-total,43,3,1,1,1,2,4,1,2,18,9,85,52,55,FALSE,0.647058823529412,2021,2021-2022
KS,2022-04-30,inter-ucfe,0,0,0,0,0,0,0,0,0,1,0,1,0,0,FALSE,0,2021,2021-2022
KS,2022-04-30,inter-ucx,0,0,0,0,0,0,0,0,0,0,0,0,0,0,FALSE,0,2021,2021-2022
KS,2022-04-30,inter-ui,43,3,1,1,1,2,4,1,2,17,9,84,52,55,FALSE,0.654761904761905,2021,2021-2022
KS,2022-04-30,intra-total,561,69,67,47,37,23,16,15,8,262,217,1322,778,847,FALSE,0.640695915279879,2021,2021-2022
KS,2022-04-30,intra-ucfe,3,1,0,0,0,0,0,0,0,2,3,9,6,7,FALSE,0.777777777777778,2021,2021-2022
KS,2022-04-30,intra-ucx,3,0,1,0,0,0,0,0,0,0,1,5,4,4,FALSE,0.8,2021,2021-2022
KS,2022-04-30,intra-ui,555,68,66,47,37,23,16,15,8,260,213,1308,768,836,FALSE,0.63914373088685,2021,2021-2022
KS,2022-05-31,inter-total,34,6,1,2,1,1,1,0,0,9,13,68,47,53,FALSE,0.779411764705882,2021,2021-2022
KS,2022-05-31,inter-ucfe,0,0,0,0,0,0,0,0,0,2,0,2,0,0,FALSE,0,2021,2021-2022
KS,2022-05-31,inter-ucx,0,0,0,0,0,0,0,0,0,0,0,0,0,0,FALSE,0,2021,2021-2022
KS,2022-05-31,inter-ui,34,6,1,2,1,1,1,0,0,7,13,66,47,53,FALSE,0.803030303030303,2021,2021-2022
KS,2022-05-31,intra-total,523,108,59,44,25,11,12,13,9,178,197,1179,720,828,FALSE,0.702290076335878,2021,2021-2022
KS,2022-05-31,intra-ucfe,0,0,0,0,1,0,0,0,0,1,0,2,0,0,FALSE,0,2021,2021-2022
KS,2022-05-31,intra-ucx,3,0,0,0,0,0,0,0,0,0,1,4,4,4,FALSE,1,2021,2021-2022
KS,2022-05-31,intra-ui,520,108,59,44,24,11,12,13,9,177,196,1173,716,824,FALSE,0.702472293265132,2021,2021-2022
KS,2022-06-30,inter-total,56,9,3,0,2,1,0,0,0,4,12,87,68,77,FALSE,0.885057471264368,2021,2021-2022
KS,2022-06-30,inter-ucfe,0,0,0,0,0,0,0,0,0,0,0,0,0,0,FALSE,0,2021,2021-2022
KS,2022-06-30,inter-ucx,0,0,0,0,0,0,0,0,0,0,0,0,0,0,FALSE,0,2021,2021-2022
KS,2022-06-30,inter-ui,56,9,3,0,2,1,0,0,0,4,12,87,68,77,FALSE,0.885057471264368,2021,2021-2022
KS,2022-06-30,intra-total,829,154,81,45,15,20,14,10,7,156,296,1627,1125,1279,FALSE,0.786109403810695,2021,2021-2022
KS,2022-06-30,intra-ucfe,7,1,0,0,1,0,0,0,0,0,2,11,9,10,FALSE,0.909090909090909,2021,2021-2022
KS,2022-06-30,intra-ucx,6,0,0,0,0,0,0,0,0,0,2,8,8,8,FALSE,1,2021,2021-2022
KS,2022-06-30,intra-ui,816,153,81,45,14,20,14,10,7,156,292,1608,1108,1261,FALSE,0.784203980099503,2021,2021-2022
KS,2022-07-31,inter-total,46,3,6,3,2,0,0,0,0,11,11,82,57,60,FALSE,0.731707317073171,2022,2022-2023
KS,2022-07-31,inter-ucfe,0,0,0,0,0,0,0,0,0,0,1,1,1,1,FALSE,1,2022,2022-2023
KS,2022-07-31,inter-ucx,0,0,0,0,0,0,0,0,0,1,0,1,0,0,FALSE,0,2022,2022-2023
KS,2022-07-31,inter-ui,46,3,6,3,2,0,0,0,0,10,10,80,56,59,FALSE,0.7375,2022,2022-2023
KS,2022-07-31,intra-total,776,108,80,46,27,17,8,10,6,168,214,1460,990,1098,FALSE,0.752054794520548,2022,2022-2023
KS,2022-07-31,intra-ucfe,1,1,1,2,1,0,0,0,0,0,0,6,1,2,FALSE,0.333333333333333,2022,2022-2023
KS,2022-07-31,intra-ucx,6,0,1,0,0,0,0,0,0,0,1,8,7,7,FALSE,0.875,2022,2022-2023
KS,2022-07-31,intra-ui,769,107,78,44,26,17,8,10,6,168,213,1446,982,1089,FALSE,0.753112033195021,2022,2022-2023
KS,2022-08-31,inter-total,58,7,8,5,1,1,0,0,0,7,17,104,75,82,FALSE,0.788461538461538,2022,2022-2023
KS,2022-08-31,inter-ucfe,0,1,0,0,0,0,0,0,0,0,0,1,0,1,FALSE,1,2022,2022-2023
KS,2022-08-31,inter-ucx,0,0,0,0,0,0,0,0,0,0,0,0,0,0,FALSE,0,2022,2022-2023
KS,2022-08-31,inter-ui,58,6,8,5,1,1,0,0,0,7,17,103,75,81,FALSE,0.786407766990291,2022,2022-2023
KS,2022-08-31,intra-total,866,144,76,51,37,12,11,7,6,188,252,1650,1118,1262,FALSE,0.764848484848485,2022,2022-2023
KS,2022-08-31,intra-ucfe,1,0,1,3,2,0,0,1,0,1,2,11,3,3,FALSE,0.272727272727273,2022,2022-2023
KS,2022-08-31,intra-ucx,3,0,0,0,0,0,0,0,0,0,1,4,4,4,FALSE,1,2022,2022-2023
KS,2022-08-31,intra-ui,862,144,75,48,35,12,11,6,6,187,249,1635,1111,1255,FALSE,0.767584097859327,2022,2022-2023
KS,2022-09-30,inter-total,35,5,2,2,0,1,2,0,1,7,13,68,48,53,FALSE,0.779411764705882,2022,2022-2023
KS,2022-09-30,inter-ucfe,0,0,0,0,0,0,0,0,0,1,0,1,0,0,FALSE,0,2022,2022-2023
KS,2022-09-30,inter-ucx,0,0,0,0,0,0,0,0,0,0,0,0,0,0,FALSE,0,2022,2022-2023
KS,2022-09-30,inter-ui,35,5,2,2,0,1,2,0,1,6,13,67,48,53,FALSE,0.791044776119403,2022,2022-2023
KS,2022-09-30,intra-total,663,115,71,40,22,21,8,9,7,191,220,1367,883,998,FALSE,0.730065837600585,2022,2022-2023
KS,2022-09-30,intra-ucfe,0,1,1,0,0,0,1,1,0,0,0,4,0,1,FALSE,0.25,2022,2022-2023
KS,2022-09-30,intra-ucx,5,0,0,1,1,1,1,0,0,0,1,10,6,6,FALSE,0.6,2022,2022-2023
KS,2022-09-30,intra-ui,658,114,70,39,21,20,6,8,7,191,219,1353,877,991,FALSE,0.732446415373245,2022,2022-2023
KS,2022-10-31,inter-total,27,7,3,1,2,1,0,0,1,14,5,61,32,39,FALSE,0.639344262295082,2022,2022-2023
KS,2022-10-31,inter-ucfe,0,0,0,0,1,0,0,0,0,1,0,2,0,0,FALSE,0,2022,2022-2023
KS,2022-10-31,inter-ucx,0,0,0,0,0,0,0,0,0,0,0,0,0,0,FALSE,0,2022,2022-2023
KS,2022-10-31,inter-ui,27,7,3,1,1,1,0,0,1,13,5,59,32,39,FALSE,0.661016949152542,2022,2022-2023
KS,2022-10-31,intra-total,670,125,84,49,32,18,16,14,11,179,198,1396,868,993,FALSE,0.711318051575931,2022,2022-2023
KS,2022-10-31,intra-ucfe,1,1,0,0,0,1,0,0,0,1,0,4,1,2,FALSE,0.5,2022,2022-2023
KS,2022-10-31,intra-ucx,1,0,1,0,0,1,0,0,0,0,1,4,2,2,FALSE,0.5,2022,2022-2023
KS,2022-10-31,intra-ui,668,124,83,49,32,16,16,14,11,178,197,1388,865,989,FALSE,0.712536023054755,2022,2022-2023
KS,2022-11-30,inter-total,70,6,4,1,1,0,0,0,0,8,8,98,78,84,FALSE,0.857142857142857,2022,2022-2023
KS,2022-11-30,inter-ucfe,0,0,0,0,0,0,0,0,0,0,0,0,0,0,FALSE,0,2022,2022-2023
KS,2022-11-30,inter-ucx,0,0,0,0,0,0,0,0,0,0,0,0,0,0,FALSE,0,2022,2022-2023
KS,2022-11-30,inter-ui,70,6,4,1,1,0,0,0,0,8,8,98,78,84,FALSE,0.857142857142857,2022,2022-2023
KS,2022-11-30,intra-total,760,126,77,51,30,14,9,9,7,184,171,1438,931,1057,FALSE,0.735048678720445,2022,2022-2023
KS,2022-11-30,intra-ucfe,1,0,0,0,0,0,0,0,0,2,0,3,1,1,FALSE,0.333333333333333,2022,2022-2023
KS,2022-11-30,intra-ucx,3,1,0,0,0,0,0,0,0,0,0,4,3,4,FALSE,1,2022,2022-2023
KS,2022-11-30,intra-ui,756,125,77,51,30,14,9,9,7,182,171,1431,927,1052,FALSE,0.735150244584207,2022,2022-2023
KS,2022-12-31,inter-total,60,11,9,3,1,1,0,1,0,10,17,113,77,88,FALSE,0.778761061946903,2022,2022-2023
KS,2022-12-31,inter-ucfe,0,1,0,0,0,0,0,0,0,0,0,1,0,1,FALSE,1,2022,2022-2023
KS,2022-12-31,inter-ucx,0,0,0,0,0,0,0,0,0,0,0,0,0,0,FALSE,0,2022,2022-2023
KS,2022-12-31,inter-ui,60,10,9,3,1,1,0,1,0,10,17,112,77,87,FALSE,0.776785714285714,2022,2022-2023
KS,2022-12-31,intra-total,827,203,98,69,66,48,29,22,21,247,278,1908,1105,1308,FALSE,0.685534591194969,2022,2022-2023
KS,2022-12-31,intra-ucfe,3,1,0,0,0,1,0,0,0,1,1,7,4,5,FALSE,0.714285714285714,2022,2022-2023
KS,2022-12-31,intra-ucx,2,0,0,0,1,0,0,0,0,0,2,5,4,4,FALSE,0.8,2022,2022-2023
KS,2022-12-31,intra-ui,822,202,98,69,65,47,29,22,21,246,275,1896,1097,1299,FALSE,0.685126582278481,2022,2022-2023
KS,2023-01-31,inter-total,113,9,6,4,3,0,5,2,0,8,23,173,136,145,FALSE,0.838150289017341,2022,2022-2023
KS,2023-01-31,inter-ucfe,0,0,0,0,0,0,0,0,0,0,0,0,0,0,FALSE,0,2022,2022-2023
KS,2023-01-31,inter-ucx,0,0,0,0,0,0,0,0,0,0,0,0,0,0,FALSE,0,2022,2022-2023
KS,2023-01-31,inter-ui,113,9,6,4,3,0,5,2,0,8,23,173,136,145,FALSE,0.838150289017341,2022,2022-2023
KS,2023-01-31,intra-total,2041,211,103,63,53,32,36,23,16,258,451,3287,2492,2703,FALSE,0.822330392455126,2022,2022-2023
KS,2023-01-31,intra-ucfe,2,1,0,0,1,0,0,0,0,0,0,4,2,3,FALSE,0.75,2022,2022-2023
KS,2023-01-31,intra-ucx,0,0,0,0,0,0,0,0,0,0,0,0,0,0,FALSE,0,2022,2022-2023
KS,2023-01-31,intra-ui,2039,210,103,63,52,32,36,23,16,258,451,3283,2490,2700,FALSE,0.822418519646665,2022,2022-2023
KS,2023-02-28,inter-total,56,15,9,5,1,2,1,0,0,9,21,119,77,92,FALSE,0.773109243697479,2022,2022-2023
KS,2023-02-28,inter-ucfe,0,0,0,0,0,0,0,0,0,0,0,0,0,0,FALSE,0,2022,2022-2023
KS,2023-02-28,inter-ucx,0,0,0,0,0,0,0,0,0,0,0,0,0,0,FALSE,0,2022,2022-2023
KS,2023-02-28,inter-ui,56,15,9,5,1,2,1,0,0,9,21,119,77,92,FALSE,0.773109243697479,2022,2022-2023
KS,2023-02-28,intra-total,1149,214,121,73,65,38,38,27,13,165,373,2276,1522,1736,FALSE,0.76274165202109,2022,2022-2023
KS,2023-02-28,intra-ucfe,0,0,0,0,0,0,0,2,0,1,0,3,0,0,FALSE,0,2022,2022-2023
KS,2023-02-28,intra-ucx,5,1,0,0,1,0,0,0,0,0,0,7,5,6,FALSE,0.857142857142857,2022,2022-2023
KS,2023-02-28,intra-ui,1144,213,121,73,64,38,38,25,13,164,373,2266,1517,1730,FALSE,0.763459841129744,2022,2022-2023
KS,2023-03-31,inter-total,58,8,6,5,2,0,0,0,1,11,12,103,70,78,FALSE,0.757281553398058,2022,2022-2023
KS,2023-03-31,inter-ucfe,1,0,0,0,0,0,0,0,0,1,0,2,1,1,FALSE,0.5,2022,2022-2023
KS,2023-03-31,inter-ucx,0,0,0,0,0,0,0,0,0,0,0,0,0,0,FALSE,0,2022,2022-2023
KS,2023-03-31,inter-ui,57,8,6,5,2,0,0,0,1,10,12,101,69,77,FALSE,0.762376237623762,2022,2022-2023
KS,2023-03-31,intra-total,841,184,105,70,46,20,17,13,10,175,348,1829,1189,1373,FALSE,0.750683433570257,2022,2022-2023
KS,2023-03-31,intra-ucfe,0,1,0,1,1,0,0,0,0,1,1,5,1,2,FALSE,0.4,2022,2022-2023
KS,2023-03-31,intra-ucx,1,1,0,0,0,0,0,0,0,0,1,3,2,3,FALSE,1,2022,2022-2023
KS,2023-03-31,intra-ui,840,182,105,69,45,20,17,13,10,174,346,1821,1186,1368,FALSE,0.751235584843493,2022,2022-2023
KS,2023-04-30,inter-total,24,5,2,2,3,0,1,0,0,11,18,66,42,47,FALSE,0.712121212121212,2022,2022-2023
KS,2023-04-30,inter-ucfe,0,0,0,0,0,0,0,0,0,0,0,0,0,0,FALSE,0,2022,2022-2023
KS,2023-04-30,inter-ucx,0,0,0,0,0,0,0,0,0,0,0,0,0,0,FALSE,0,2022,2022-2023
KS,2023-04-30,inter-ui,24,5,2,2,3,0,1,0,0,11,18,66,42,47,FALSE,0.712121212121212,2022,2022-2023
KS,2023-04-30,intra-total,711,122,52,34,16,16,3,5,5,173,257,1394,968,1090,FALSE,0.781922525107604,2022,2022-2023
KS,2023-04-30,intra-ucfe,0,0,0,0,0,0,1,0,0,3,0,4,0,0,FALSE,0,2022,2022-2023
KS,2023-04-30,intra-ucx,0,0,0,0,0,0,0,0,0,0,0,0,0,0,FALSE,0,2022,2022-2023
KS,2023-04-30,intra-ui,711,122,52,34,16,16,2,5,5,170,257,1390,968,1090,FALSE,0.784172661870504,2022,2022-2023
KS,2023-05-31,inter-total,36,10,4,4,1,1,0,0,0,2,10,68,46,56,FALSE,0.823529411764706,2022,2022-2023
KS,2023-05-31,inter-ucfe,0,0,0,0,0,0,0,0,0,0,0,0,0,0,FALSE,0,2022,2022-2023
KS,2023-05-31,inter-ucx,0,0,0,0,0,0,0,0,0,0,0,0,0,0,FALSE,0,2022,2022-2023
KS,2023-05-31,inter-ui,36,10,4,4,1,1,0,0,0,2,10,68,46,56,FALSE,0.823529411764706,2022,2022-2023
KS,2023-05-31,intra-total,908,145,79,42,23,9,3,4,3,120,312,1648,1220,1365,FALSE,0.828276699029126,2022,2022-2023
KS,2023-05-31,intra-ucfe,2,1,0,0,0,0,0,0,0,2,1,6,3,4,FALSE,0.666666666666667,2022,2022-2023
KS,2023-05-31,intra-ucx,3,1,1,0,0,0,0,0,0,0,1,6,4,5,FALSE,0.833333333333333,2022,2022-2023
KS,2023-05-31,intra-ui,903,143,78,42,23,9,3,4,3,118,310,1636,1213,1356,FALSE,0.828850855745721,2022,2022-2023
KS,2023-06-30,inter-total,50,4,2,1,1,1,0,0,0,3,17,79,67,71,FALSE,0.89873417721519,2022,2022-2023
KS,2023-06-30,inter-ucfe,1,0,0,0,0,0,0,0,0,0,0,1,1,1,FALSE,1,2022,2022-2023
KS,2023-06-30,inter-ucx,0,0,0,0,0,0,0,0,0,0,0,0,0,0,FALSE,0,2022,2022-2023
KS,2023-06-30,inter-ui,49,4,2,1,1,1,0,0,0,3,17,78,66,70,FALSE,0.897435897435897,2022,2022-2023
KS,2023-06-30,intra-total,1099,151,81,38,21,10,5,1,0,73,369,1848,1468,1619,FALSE,0.876082251082251,2022,2022-2023
KS,2023-06-30,intra-ucfe,2,1,0,0,0,0,0,0,0,0,1,4,3,4,FALSE,1,2022,2022-2023
KS,2023-06-30,intra-ucx,0,2,1,0,0,0,0,0,0,1,0,4,0,2,FALSE,0.5,2022,2022-2023
KS,2023-06-30,intra-ui,1097,148,80,38,21,10,5,1,0,72,368,1840,1465,1613,FALSE,0.876630434782609,2022,2022-2023
KS,2023-07-31,inter-total,39,8,5,1,0,1,0,0,0,6,7,67,46,54,FALSE,0.805970149253731,2023,2023-2024
KS,2023-07-31,inter-ucfe,0,0,0,0,0,0,0,0,0,1,0,1,0,0,FALSE,0,2023,2023-2024
KS,2023-07-31,inter-ucx,0,0,0,0,0,0,0,0,0,0,0,0,0,0,FALSE,0,2023,2023-2024
KS,2023-07-31,inter-ui,39,8,5,1,0,1,0,0,0,5,7,66,46,54,FALSE,0.818181818181818,2023,2023-2024
KS,2023-07-31,intra-total,979,130,65,37,16,6,9,4,3,100,336,1685,1315,1445,FALSE,0.857566765578635,2023,2023-2024
KS,2023-07-31,intra-ucfe,1,0,1,0,0,0,0,0,0,1,2,5,3,3,FALSE,0.6,2023,2023-2024
KS,2023-07-31,intra-ucx,3,0,0,0,0,0,0,0,0,0,1,4,4,4,FALSE,1,2023,2023-2024
KS,2023-07-31,intra-ui,975,130,64,37,16,6,9,4,3,99,333,1676,1308,1438,FALSE,0.85799522673031,2023,2023-2024
KS,2023-08-31,inter-total,64,5,4,1,1,0,1,1,1,3,18,99,82,87,FALSE,0.878787878787879,2023,2023-2024
KS,2023-08-31,inter-ucfe,0,0,0,0,0,0,0,0,0,0,0,0,0,0,FALSE,0,2023,2023-2024
KS,2023-08-31,inter-ucx,0,0,0,0,0,0,0,0,0,0,0,0,0,0,FALSE,0,2023,2023-2024
KS,2023-08-31,inter-ui,64,5,4,1,1,0,1,1,1,3,18,99,82,87,FALSE,0.878787878787879,2023,2023-2024
KS,2023-08-31,intra-total,1163,140,63,32,16,10,6,9,3,80,354,1876,1517,1657,FALSE,0.883262260127932,2023,2023-2024
KS,2023-08-31,intra-ucfe,2,1,0,0,0,0,0,0,0,1,0,4,2,3,FALSE,0.75,2023,2023-2024
KS,2023-08-31,intra-ucx,3,1,0,0,0,1,0,0,0,0,0,5,3,4,FALSE,0.8,2023,2023-2024
KS,2023-08-31,intra-ui,1158,138,63,32,16,9,6,9,3,79,354,1867,1512,1650,FALSE,0.883770755222282,2023,2023-2024
KS,2023-09-30,inter-total,34,4,8,4,2,0,0,0,0,3,12,67,46,50,FALSE,0.746268656716418,2023,2023-2024
KS,2023-09-30,inter-ucfe,0,0,0,1,0,0,0,0,0,0,0,1,0,0,FALSE,0,2023,2023-2024
KS,2023-09-30,inter-ucx,0,0,0,0,0,0,0,0,0,0,0,0,0,0,FALSE,0,2023,2023-2024
KS,2023-09-30,inter-ui,34,4,8,3,2,0,0,0,0,3,12,66,46,50,FALSE,0.757575757575758,2023,2023-2024
KS,2023-09-30,intra-total,722,164,86,39,13,12,10,5,2,134,331,1518,1053,1217,FALSE,0.80171277997365,2023,2023-2024
KS,2023-09-30,intra-ucfe,4,0,1,1,0,0,1,0,0,1,1,9,5,5,FALSE,0.555555555555556,2023,2023-2024
KS,2023-09-30,intra-ucx,5,1,0,0,0,1,0,0,0,1,1,9,6,7,FALSE,0.777777777777778,2023,2023-2024
KS,2023-09-30,intra-ui,713,163,85,38,13,11,9,5,2,132,329,1500,1042,1205,FALSE,0.803333333333333,2023,2023-2024
KS,2023-10-31,inter-total,73,5,4,7,0,0,0,0,0,4,21,114,94,99,FALSE,0.868421052631579,2023,2023-2024
KS,2023-10-31,inter-ucfe,2,0,0,2,0,0,0,0,0,0,0,4,2,2,FALSE,0.5,2023,2023-2024
KS,2023-10-31,inter-ucx,0,0,0,0,0,0,0,0,0,0,0,0,0,0,FALSE,0,2023,2023-2024
KS,2023-10-31,inter-ui,71,5,4,5,0,0,0,0,0,4,21,110,92,97,FALSE,0.881818181818182,2023,2023-2024
KS,2023-10-31,intra-total,896,141,75,28,13,8,7,5,5,106,354,1638,1250,1391,FALSE,0.849206349206349,2023,2023-2024
KS,2023-10-31,intra-ucfe,4,1,0,0,0,0,0,0,0,0,4,9,8,9,FALSE,1,2023,2023-2024
KS,2023-10-31,intra-ucx,1,0,0,0,0,0,0,0,0,0,2,3,3,3,FALSE,1,2023,2023-2024
KS,2023-10-31,intra-ui,891,140,75,28,13,8,7,5,5,106,348,1626,1239,1379,FALSE,0.848093480934809,2023,2023-2024
KS,2023-11-30,inter-total,74,6,4,7,0,0,0,0,0,4,21,116,95,101,FALSE,0.870689655172414,2023,2023-2024
KS,2023-11-30,inter-ucfe,1,0,0,2,0,0,0,0,0,0,0,3,1,1,FALSE,0.333333333333333,2023,2023-2024
KS,2023-11-30,inter-ucx,0,0,0,0,0,0,0,0,0,0,0,0,0,0,FALSE,0,2023,2023-2024
KS,2023-11-30,inter-ui,73,6,4,5,0,0,0,0,0,4,21,113,94,100,FALSE,0.88495575221239,2023,2023-2024
KS,2023-11-30,intra-total,892,140,75,28,13,8,7,5,5,106,353,1632,1245,1385,FALSE,0.848651960784314,2023,2023-2024
KS,2023-11-30,intra-ucfe,4,1,0,0,0,0,0,0,0,0,4,9,8,9,FALSE,1,2023,2023-2024
KS,2023-11-30,intra-ucx,1,0,0,0,0,0,0,0,0,0,2,3,3,3,FALSE,1,2023,2023-2024
KS,2023-11-30,intra-ui,887,139,75,28,13,8,7,5,5,106,347,1620,1234,1373,FALSE,0.847530864197531,2023,2023-2024
KS,2023-12-31,inter-total,59,7,2,3,0,0,0,0,0,5,15,91,74,81,FALSE,0.89010989010989,2023,2023-2024
KS,2023-12-31,inter-ucfe,0,0,0,0,0,0,0,0,0,0,0,0,0,0,FALSE,0,2023,2023-2024
KS,2023-12-31,inter-ucx,0,0,0,0,0,0,0,0,0,0,0,0,0,0,FALSE,0,2023,2023-2024
KS,2023-12-31,inter-ui,59,7,2,3,0,0,0,0,0,5,15,91,74,81,FALSE,0.89010989010989,2023,2023-2024
KS,2023-12-31,intra-total,897,169,69,33,17,7,7,4,2,119,355,1679,1252,1421,FALSE,0.846337105419893,2023,2023-2024
KS,2023-12-31,intra-ucfe,5,1,1,1,0,0,0,0,0,0,4,12,9,10,FALSE,0.833333333333333,2023,2023-2024
KS,2023-12-31,intra-ucx,4,0,0,0,0,0,0,0,0,0,2,6,6,6,FALSE,1,2023,2023-2024
KS,2023-12-31,intra-ui,888,168,68,32,17,7,7,4,2,119,349,1661,1237,1405,FALSE,0.845875978326309,2023,2023-2024
KS,2024-01-31,inter-total,187,6,3,3,0,1,0,0,0,4,21,225,208,214,FALSE,0.951111111111111,2023,2023-2024
KS,2024-01-31,inter-ucfe,0,0,0,0,0,0,0,0,0,0,0,0,0,0,FALSE,0,2023,2023-2024
KS,2024-01-31,inter-ucx,0,0,0,0,0,0,0,0,0,0,0,0,0,0,FALSE,0,2023,2023-2024
KS,2024-01-31,inter-ui,187,6,3,3,0,1,0,0,0,4,21,225,208,214,FALSE,0.951111111111111,2023,2023-2024
KS,2024-01-31,intra-total,3243,187,81,35,17,18,11,9,13,111,525,4250,3768,3955,FALSE,0.930588235294118,2023,2023-2024
KS,2024-01-31,intra-ucfe,1,0,1,0,0,0,0,0,0,1,2,5,3,3,FALSE,0.6,2023,2023-2024
KS,2024-01-31,intra-ucx,5,1,0,0,0,0,0,0,0,0,1,7,6,7,FALSE,1,2023,2023-2024
KS,2024-01-31,intra-ui,3237,186,80,35,17,18,11,9,13,110,522,4238,3759,3945,FALSE,0.930863614912695,2023,2023-2024
KS,2024-02-29,inter-total,83,6,10,0,5,1,0,1,0,9,19,134,102,108,FALSE,0.805970149253731,2023,2023-2024
KS,2024-02-29,inter-ucfe,0,0,0,0,0,0,0,0,0,0,0,0,0,0,FALSE,0,2023,2023-2024
KS,2024-02-29,inter-ucx,0,0,0,0,0,0,0,0,0,0,0,0,0,0,FALSE,0,2023,2023-2024
KS,2024-02-29,inter-ui,83,6,10,0,5,1,0,1,0,9,19,134,102,108,FALSE,0.805970149253731,2023,2023-2024
KS,2024-02-29,intra-total,1345,218,103,79,31,36,23,22,14,102,435,2408,1780,1998,FALSE,0.829734219269103,2023,2023-2024
KS,2024-02-29,intra-ucfe,0,1,1,0,1,0,0,1,0,2,1,7,1,2,FALSE,0.285714285714286,2023,2023-2024
KS,2024-02-29,intra-ucx,2,0,0,0,0,0,0,0,0,0,3,5,5,5,FALSE,1,2023,2023-2024
KS,2024-02-29,intra-ui,1343,217,102,79,30,36,23,21,14,100,431,2396,1774,1991,FALSE,0.830968280467446,2023,2023-2024
KS,2024-03-31,inter-total,49,3,5,4,3,3,1,2,0,3,15,88,64,67,FALSE,0.761363636363636,2023,2023-2024
KS,2024-03-31,inter-ucfe,0,0,0,0,0,0,0,0,0,0,0,0,0,0,FALSE,0,2023,2023-2024
KS,2024-03-31,inter-ucx,0,0,0,0,0,0,0,0,0,0,0,0,0,0,FALSE,0,2023,2023-2024
KS,2024-03-31,inter-ui,49,3,5,4,3,3,1,2,0,3,15,88,64,67,FALSE,0.761363636363636,2023,2023-2024
KS,2024-03-31,intra-total,781,191,106,67,34,37,22,18,14,129,385,1784,1166,1357,FALSE,0.760650224215247,2023,2023-2024
KS,2024-03-31,intra-ucfe,0,1,0,0,0,0,0,0,0,0,1,2,1,2,FALSE,1,2023,2023-2024
KS,2024-03-31,intra-ucx,4,0,0,0,0,0,0,0,0,0,2,6,6,6,FALSE,1,2023,2023-2024
KS,2024-03-31,intra-ui,777,190,106,67,34,37,22,18,14,129,382,1776,1159,1349,FALSE,0.759572072072072,2023,2023-2024
KS,2024-04-30,inter-total,71,5,2,1,1,1,0,1,1,4,10,97,81,86,FALSE,0.88659793814433,2023,2023-2024
KS,2024-04-30,inter-ucfe,0,0,0,0,0,0,0,0,0,0,0,0,0,0,FALSE,0,2023,2023-2024
KS,2024-04-30,inter-ucx,0,0,0,0,0,0,0,0,0,0,0,0,0,0,FALSE,0,2023,2023-2024
KS,2024-04-30,inter-ui,71,5,2,1,1,1,0,1,1,4,10,97,81,86,FALSE,0.88659793814433,2023,2023-2024
KS,2024-04-30,intra-total,816,169,98,60,35,26,17,18,16,71,354,1680,1170,1339,FALSE,0.79702380952381,2023,2023-2024
KS,2024-04-30,intra-ucfe,2,2,0,1,0,1,0,0,0,0,2,8,4,6,FALSE,0.75,2023,2023-2024
KS,2024-04-30,intra-ucx,8,0,0,0,0,0,0,0,0,0,1,9,9,9,FALSE,1,2023,2023-2024
KS,2024-04-30,intra-ui,806,167,98,59,35,25,17,18,16,71,351,1663,1157,1324,FALSE,0.796151533373422,2023,2023-2024
KS,2024-05-31,inter-total,61,10,6,1,3,1,1,0,1,3,14,101,75,85,FALSE,0.841584158415842,2023,2023-2024
KS,2024-05-31,inter-ucfe,1,0,0,0,0,0,0,0,0,0,0,1,1,1,FALSE,1,2023,2023-2024
KS,2024-05-31,inter-ucx,0,0,0,0,0,0,0,0,0,0,0,0,0,0,FALSE,0,2023,2023-2024
KS,2024-05-31,inter-ui,60,10,6,1,3,1,1,0,1,3,14,100,74,84,FALSE,0.84,2023,2023-2024
KS,2024-05-31,intra-total,868,200,90,51,16,20,14,13,20,94,414,1800,1282,1482,FALSE,0.823333333333333,2023,2023-2024
KS,2024-05-31,intra-ucfe,2,4,0,0,0,0,0,0,0,0,2,8,4,8,FALSE,1,2023,2023-2024
KS,2024-05-31,intra-ucx,3,0,0,1,0,0,0,0,0,0,2,6,5,5,FALSE,0.833333333333333,2023,2023-2024
KS,2024-05-31,intra-ui,863,196,90,50,16,20,14,13,20,94,410,1786,1273,1469,FALSE,0.822508398656215,2023,2023-2024
KS,2024-06-30,inter-total,44,6,7,1,2,0,1,1,1,4,11,78,55,61,FALSE,0.782051282051282,2023,2023-2024
KS,2024-06-30,inter-ucfe,0,0,0,0,0,0,0,0,0,0,0,0,0,0,FALSE,0,2023,2023-2024
KS,2024-06-30,inter-ucx,0,0,0,0,0,0,0,0,0,0,0,0,0,0,FALSE,0,2023,2023-2024
KS,2024-06-30,inter-ui,44,6,7,1,2,0,1,1,1,4,11,78,55,61,FALSE,0.782051282051282,2023,2023-2024
KS,2024-06-30,intra-total,1075,213,89,43,30,23,6,18,18,84,382,1981,1457,1670,FALSE,0.843008581524483,2023,2023-2024
KS,2024-06-30,intra-ucfe,1,0,1,0,1,0,0,0,0,1,2,6,3,3,FALSE,0.5,2023,2023-2024
KS,2024-06-30,intra-ucx,1,0,0,0,0,1,0,0,0,0,1,3,2,2,FALSE,0.666666666666667,2023,2023-2024
KS,2024-06-30,intra-ui,1073,213,88,43,29,22,6,18,18,83,379,1972,1452,1665,FALSE,0.844320486815416,2023,2023-2024
KS,2024-07-31,inter-total,69,20,4,2,1,1,0,0,0,1,10,108,79,99,FALSE,0.916666666666667,2024,2024-2025
KS,2024-07-31,inter-ucfe,0,0,0,0,0,0,0,0,0,0,0,0,0,0,FALSE,0,2024,2024-2025
KS,2024-07-31,inter-ucx,0,0,0,0,0,0,0,0,0,0,0,0,0,0,FALSE,0,2024,2024-2025
KS,2024-07-31,inter-ui,69,20,4,2,1,1,0,0,0,1,10,108,79,99,FALSE,0.916666666666667,2024,2024-2025
KS,2024-07-31,intra-total,1715,270,119,50,28,12,17,13,8,79,278,2589,1993,2263,FALSE,0.874082657396678,2024,2024-2025
KS,2024-07-31,intra-ucfe,0,0,0,0,0,1,0,0,0,2,0,3,0,0,FALSE,0,2024,2024-2025
KS,2024-07-31,intra-ucx,3,0,0,0,0,0,0,0,0,0,0,3,3,3,FALSE,1,2024,2024-2025
KS,2024-07-31,intra-ui,1712,270,119,50,28,11,17,13,8,77,278,2583,1990,2260,FALSE,0.874951606658924,2024,2024-2025
KS,2024-08-31,inter-total,48,10,4,3,3,3,1,2,0,7,13,94,61,71,FALSE,0.75531914893617,2024,2024-2025
KS,2024-08-31,inter-ucfe,0,0,0,0,0,0,0,0,0,0,0,0,0,0,FALSE,0,2024,2024-2025
KS,2024-08-31,inter-ucx,1,0,0,0,0,0,0,0,0,0,0,1,1,1,FALSE,1,2024,2024-2025
KS,2024-08-31,inter-ui,47,10,4,3,3,3,1,2,0,7,13,93,60,70,FALSE,0.752688172043011,2024,2024-2025
KS,2024-08-31,intra-total,839,276,133,81,59,29,27,32,31,149,394,2050,1233,1509,FALSE,0.73609756097561,2024,2024-2025
KS,2024-08-31,intra-ucfe,1,3,0,0,0,0,0,0,0,2,1,7,2,5,FALSE,0.714285714285714,2024,2024-2025
KS,2024-08-31,intra-ucx,2,0,0,0,0,0,0,1,0,0,3,6,5,5,FALSE,0.833333333333333,2024,2024-2025
KS,2024-08-31,intra-ui,836,273,133,81,59,29,27,31,31,147,390,2037,1226,1499,FALSE,0.735886107020128,2024,2024-2025
KS,2024-09-30,inter-total,54,4,3,3,3,1,2,0,1,3,11,85,65,69,FALSE,0.811764705882353,2024,2024-2025
KS,2024-09-30,inter-ucfe,0,0,1,0,0,0,0,0,0,0,0,1,0,0,FALSE,0,2024,2024-2025
KS,2024-09-30,inter-ucx,0,0,0,0,0,0,0,0,0,0,0,0,0,0,FALSE,0,2024,2024-2025
KS,2024-09-30,inter-ui,54,4,2,3,3,1,2,0,1,3,11,84,65,69,FALSE,0.821428571428571,2024,2024-2025
KS,2024-09-30,intra-total,841,145,67,35,17,21,18,21,23,61,288,1537,1129,1274,FALSE,0.828887443070917,2024,2024-2025
KS,2024-09-30,intra-ucfe,0,0,0,0,0,0,0,0,0,0,0,0,0,0,FALSE,0,2024,2024-2025
KS,2024-09-30,intra-ucx,5,1,0,1,0,1,0,0,0,0,1,9,6,7,FALSE,0.777777777777778,2024,2024-2025
KS,2024-09-30,intra-ui,836,144,67,34,17,20,18,21,23,61,287,1528,1123,1267,FALSE,0.829188481675393,2024,2024-2025
KS,2024-10-31,inter-total,74,3,3,2,0,1,1,1,1,4,9,99,83,86,FALSE,0.868686868686869,2024,2024-2025
KS,2024-10-31,inter-ucfe,0,0,0,0,0,0,0,0,0,0,0,0,0,0,FALSE,0,2024,2024-2025
KS,2024-10-31,inter-ucx,0,0,0,0,0,0,0,0,0,0,0,0,0,0,FALSE,0,2024,2024-2025
KS,2024-10-31,inter-ui,74,3,3,2,0,1,1,1,1,4,9,99,83,86,FALSE,0.868686868686869,2024,2024-2025
KS,2024-10-31,intra-total,1358,98,43,31,26,31,24,28,19,64,318,2040,1676,1774,FALSE,0.869607843137255,2024,2024-2025
KS,2024-10-31,intra-ucfe,2,0,1,0,0,0,0,0,0,0,2,5,4,4,FALSE,0.8,2024,2024-2025
KS,2024-10-31,intra-ucx,3,0,0,0,1,0,0,0,0,0,1,5,4,4,FALSE,0.8,2024,2024-2025
KS,2024-10-31,intra-ui,1353,98,42,31,25,31,24,28,19,64,315,2030,1668,1766,FALSE,0.869950738916256,2024,2024-2025
KY,2019-01-31,inter-total,108,18,7,1,0,1,1,0,0,1,39,176,147,165,TRUE,0.835227272727273,2018,2018-2019
KY,2019-01-31,inter-ucfe,19,2,0,0,0,0,0,0,0,0,5,26,24,26,TRUE,0.923076923076923,2018,2018-2019
KY,2019-01-31,inter-ucx,1,0,0,0,0,0,0,0,0,0,0,1,1,1,TRUE,1,2018,2018-2019
KY,2019-01-31,inter-ui,88,16,7,1,0,1,1,0,0,1,34,149,122,138,TRUE,0.818791946308725,2018,2018-2019
KY,2019-01-31,intra-total,4793,437,129,51,18,37,23,12,13,36,1780,7329,6573,7010,TRUE,0.896848137535817,2018,2018-2019
KY,2019-01-31,intra-ucfe,406,49,9,1,1,0,0,0,0,0,192,658,598,647,TRUE,0.908814589665653,2018,2018-2019
KY,2019-01-31,intra-ucx,8,5,2,0,0,0,0,0,0,0,10,25,18,23,TRUE,0.72,2018,2018-2019
KY,2019-01-31,intra-ui,4379,383,118,50,17,37,23,12,13,36,1578,6646,5957,6340,TRUE,0.896328618718026,2018,2018-2019
KY,2019-02-28,inter-total,77,12,6,7,0,1,1,0,1,0,31,136,108,120,TRUE,0.794117647058824,2018,2018-2019
KY,2019-02-28,inter-ucfe,0,0,1,1,0,0,0,0,0,0,0,2,0,0,TRUE,0,2018,2018-2019
KY,2019-02-28,inter-ucx,0,1,0,1,0,0,0,0,0,0,0,2,0,1,TRUE,0,2018,2018-2019
KY,2019-02-28,inter-ui,77,11,5,5,0,1,1,0,1,0,31,132,108,119,TRUE,0.818181818181818,2018,2018-2019
KY,2019-02-28,intra-total,2500,295,105,54,34,31,19,31,8,38,1258,4373,3758,4053,TRUE,0.859364280814086,2018,2018-2019
KY,2019-02-28,intra-ucfe,2,6,7,4,0,0,0,0,0,0,6,25,8,14,TRUE,0.32,2018,2018-2019
KY,2019-02-28,intra-ucx,8,1,1,0,0,0,0,0,0,0,4,14,12,13,TRUE,0.857142857142857,2018,2018-2019
KY,2019-02-28,intra-ui,2490,288,97,50,34,31,19,31,8,38,1248,4334,3738,4026,TRUE,0.862482694970005,2018,2018-2019
KY,2019-03-31,inter-total,41,2,4,1,9,3,1,0,1,3,27,92,68,70,TRUE,0.739130434782609,2018,2018-2019
KY,2019-03-31,inter-ucfe,0,0,0,0,2,0,0,0,1,0,0,3,0,0,TRUE,0,2018,2018-2019
KY,2019-03-31,inter-ucx,1,0,0,0,0,0,0,0,0,0,1,2,2,2,TRUE,1,2018,2018-2019
KY,2019-03-31,inter-ui,40,2,4,1,7,3,1,0,0,3,26,87,66,68,TRUE,0.758620689655172,2018,2018-2019
KY,2019-03-31,intra-total,1494,175,60,64,39,36,29,13,11,31,906,2858,2400,2575,TRUE,0.839748075577327,2018,2018-2019
KY,2019-03-31,intra-ucfe,1,1,1,0,0,0,0,0,0,0,2,5,3,4,TRUE,0.6,2018,2018-2019
KY,2019-03-31,intra-ucx,11,1,1,0,0,1,0,0,0,0,7,21,18,19,TRUE,0.857142857142857,2018,2018-2019
KY,2019-03-31,intra-ui,1482,173,58,64,39,35,29,13,11,31,897,2832,2379,2552,TRUE,0.840042372881356,2018,2018-2019
KY,2019-04-30,inter-total,45,9,1,3,2,2,1,1,0,2,15,81,60,69,TRUE,0.740740740740741,2018,2018-2019
KY,2019-04-30,inter-ucfe,1,0,0,0,0,0,0,0,0,0,0,1,1,1,TRUE,1,2018,2018-2019
KY,2019-04-30,inter-ucx,1,0,0,0,0,0,0,0,0,0,0,1,1,1,TRUE,1,2018,2018-2019
KY,2019-04-30,inter-ui,43,9,1,3,2,2,1,1,0,2,15,79,58,67,TRUE,0.734177215189873,2018,2018-2019
KY,2019-04-30,intra-total,1623,186,69,35,24,38,23,17,12,28,839,2894,2462,2648,TRUE,0.850725639253628,2018,2018-2019
KY,2019-04-30,intra-ucfe,2,1,0,2,0,0,0,0,0,0,3,8,5,6,TRUE,0.625,2018,2018-2019
KY,2019-04-30,intra-ucx,9,1,1,1,0,0,0,1,0,0,4,17,13,14,TRUE,0.764705882352941,2018,2018-2019
KY,2019-04-30,intra-ui,1612,184,68,32,24,38,23,16,12,28,832,2869,2444,2628,TRUE,0.85186476124085,2018,2018-2019
KY,2019-05-31,inter-total,62,7,7,2,1,2,0,1,1,1,17,101,79,86,TRUE,0.782178217821782,2018,2018-2019
KY,2019-05-31,inter-ucfe,0,0,0,0,0,0,0,0,0,0,0,0,0,0,TRUE,0,2018,2018-2019
KY,2019-05-31,inter-ucx,0,0,0,0,0,0,0,0,0,0,0,0,0,0,TRUE,0,2018,2018-2019
KY,2019-05-31,inter-ui,62,7,7,2,1,2,0,1,1,1,17,101,79,86,TRUE,0.782178217821782,2018,2018-2019
KY,2019-05-31,intra-total,1737,143,52,21,19,36,23,33,15,47,700,2826,2437,2580,TRUE,0.862349610757254,2018,2018-2019
KY,2019-05-31,intra-ucfe,2,2,1,0,0,0,0,1,0,0,1,7,3,5,TRUE,0.428571428571429,2018,2018-2019
KY,2019-05-31,intra-ucx,10,4,0,1,0,0,1,0,0,0,2,18,12,16,TRUE,0.666666666666667,2018,2018-2019
KY,2019-05-31,intra-ui,1725,137,51,20,19,36,22,32,15,47,697,2801,2422,2559,TRUE,0.864691181720814,2018,2018-2019
KY,2019-06-30,inter-total,59,7,7,1,0,0,1,3,0,0,24,102,83,90,TRUE,0.813725490196078,2018,2018-2019
KY,2019-06-30,inter-ucfe,0,1,0,0,0,0,0,0,0,0,0,1,0,1,TRUE,0,2018,2018-2019
KY,2019-06-30,inter-ucx,1,0,1,0,0,0,0,0,0,0,0,2,1,1,TRUE,0.5,2018,2018-2019
KY,2019-06-30,inter-ui,58,6,6,1,0,0,1,3,0,0,24,99,82,88,TRUE,0.828282828282828,2018,2018-2019
KY,2019-06-30,intra-total,1450,189,52,23,22,34,23,25,11,24,964,2817,2414,2603,TRUE,0.856940007099752,2018,2018-2019
KY,2019-06-30,intra-ucfe,1,4,0,0,0,0,0,1,0,0,5,11,6,10,TRUE,0.545454545454545,2018,2018-2019
KY,2019-06-30,intra-ucx,9,0,2,0,1,0,0,0,0,0,3,15,12,12,TRUE,0.8,2018,2018-2019
KY,2019-06-30,intra-ui,1440,185,50,23,21,34,23,24,11,24,956,2791,2396,2581,TRUE,0.85847366535292,2018,2018-2019
KY,2019-07-31,inter-total,71,9,8,6,2,1,1,2,0,3,37,140,108,117,TRUE,0.771428571428571,2019,2019-2020
KY,2019-07-31,inter-ucfe,4,1,1,0,0,0,0,0,0,0,4,10,8,9,TRUE,0.8,2019,2019-2020
KY,2019-07-31,inter-ucx,0,0,1,0,0,0,0,0,0,0,0,1,0,0,TRUE,0,2019,2019-2020
KY,2019-07-31,inter-ui,67,8,6,6,2,1,1,2,0,3,33,129,100,108,TRUE,0.775193798449612,2019,2019-2020
KY,2019-07-31,intra-total,2323,259,92,34,23,41,26,27,21,43,1187,4076,3510,3769,TRUE,0.861138370951914,2019,2019-2020
KY,2019-07-31,intra-ucfe,42,3,1,3,2,0,0,0,0,0,10,61,52,55,TRUE,0.852459016393443,2019,2019-2020
KY,2019-07-31,intra-ucx,6,2,1,0,0,0,0,0,0,0,2,11,8,10,TRUE,0.727272727272727,2019,2019-2020
KY,2019-07-31,intra-ui,2275,254,90,31,21,41,26,27,21,43,1175,4004,3450,3704,TRUE,0.861638361638362,2019,2019-2020
KY,2019-08-31,inter-total,56,10,5,3,1,0,0,2,0,2,27,106,83,93,TRUE,0.783018867924528,2019,2019-2020
KY,2019-08-31,inter-ucfe,2,1,0,0,0,0,0,0,0,0,2,5,4,5,TRUE,0.8,2019,2019-2020
KY,2019-08-31,inter-ucx,0,0,0,0,0,0,0,0,0,0,0,0,0,0,TRUE,0,2019,2019-2020
KY,2019-08-31,inter-ui,54,9,5,3,1,0,0,2,0,2,25,101,79,88,TRUE,0.782178217821782,2019,2019-2020
KY,2019-08-31,intra-total,1529,241,110,68,37,39,49,25,17,60,1026,3201,2555,2796,TRUE,0.798188066229303,2019,2019-2020
KY,2019-08-31,intra-ucfe,6,4,4,2,0,0,0,0,0,0,7,23,13,17,TRUE,0.565217391304348,2019,2019-2020
KY,2019-08-31,intra-ucx,7,1,2,0,0,1,0,0,0,0,3,14,10,11,TRUE,0.714285714285714,2019,2019-2020
KY,2019-08-31,intra-ui,1516,236,104,66,37,38,49,25,17,60,1016,3164,2532,2768,TRUE,0.800252844500632,2019,2019-2020
KY,2019-09-30,inter-total,38,8,3,0,1,2,2,0,0,3,23,80,61,69,TRUE,0.7625,2019,2019-2020
KY,2019-09-30,inter-ucfe,0,1,0,0,0,0,0,0,0,0,0,1,0,1,TRUE,0,2019,2019-2020
KY,2019-09-30,inter-ucx,0,0,0,0,0,0,0,0,0,0,1,1,1,1,TRUE,1,2019,2019-2020
KY,2019-09-30,inter-ui,38,7,3,0,1,2,2,0,0,3,22,78,60,67,TRUE,0.769230769230769,2019,2019-2020
KY,2019-09-30,intra-total,1055,326,91,48,21,34,32,28,16,43,773,2467,1828,2154,TRUE,0.74098094852047,2019,2019-2020
KY,2019-09-30,intra-ucfe,3,5,2,3,1,0,0,0,0,0,14,28,17,22,TRUE,0.607142857142857,2019,2019-2020
KY,2019-09-30,intra-ucx,6,4,2,1,1,0,0,0,0,0,4,18,10,14,TRUE,0.555555555555556,2019,2019-2020
KY,2019-09-30,intra-ui,1046,317,87,44,19,34,32,28,16,43,755,2421,1801,2118,TRUE,0.743907476249484,2019,2019-2020
KY,2019-10-31,inter-total,42,12,4,0,0,4,3,1,0,2,34,102,76,88,TRUE,0.745098039215686,2019,2019-2020
KY,2019-10-31,inter-ucfe,1,0,0,0,0,0,0,0,0,0,2,3,3,3,TRUE,1,2019,2019-2020
KY,2019-10-31,inter-ucx,1,1,0,0,0,0,0,0,0,0,3,5,4,5,TRUE,0.8,2019,2019-2020
KY,2019-10-31,inter-ui,40,11,4,0,0,4,3,1,0,2,29,94,69,80,TRUE,0.734042553191489,2019,2019-2020
KY,2019-10-31,intra-total,1941,394,80,41,39,54,60,37,18,59,970,3693,2911,3305,TRUE,0.788248036826428,2019,2019-2020
KY,2019-10-31,intra-ucfe,5,2,3,0,1,0,1,0,0,1,11,24,16,18,TRUE,0.666666666666667,2019,2019-2020
KY,2019-10-31,intra-ucx,9,0,0,0,0,1,0,0,0,0,13,23,22,22,TRUE,0.956521739130435,2019,2019-2020
KY,2019-10-31,intra-ui,1927,392,77,41,38,53,59,37,18,58,946,3646,2873,3265,TRUE,0.787986834887548,2019,2019-2020
KY,2019-11-30,inter-total,23,12,9,0,0,1,0,2,0,2,19,68,42,54,TRUE,0.617647058823529,2019,2019-2020
KY,2019-11-30,inter-ucfe,0,2,1,0,0,0,0,0,0,0,0,3,0,2,TRUE,0,2019,2019-2020
KY,2019-11-30,inter-ucx,0,1,0,0,0,0,0,0,0,0,0,1,0,1,TRUE,0,2019,2019-2020
KY,2019-11-30,inter-ui,23,9,8,0,0,1,0,2,0,2,19,64,42,51,TRUE,0.65625,2019,2019-2020
KY,2019-11-30,intra-total,1222,430,139,61,40,46,19,19,18,48,705,2747,1927,2357,TRUE,0.701492537313433,2019,2019-2020
KY,2019-11-30,intra-ucfe,5,8,5,3,0,1,0,0,0,1,3,26,8,16,TRUE,0.307692307692308,2019,2019-2020
KY,2019-11-30,intra-ucx,11,1,1,0,1,0,0,0,0,0,8,22,19,20,TRUE,0.863636363636364,2019,2019-2020
KY,2019-11-30,intra-ui,1206,421,133,58,39,45,19,19,18,47,694,2699,1900,2321,TRUE,0.703964431270841,2019,2019-2020
KY,2019-12-31,inter-total,61,21,13,3,1,2,0,0,1,1,31,134,92,113,TRUE,0.686567164179104,2019,2019-2020
KY,2019-12-31,inter-ucfe,0,1,0,0,0,0,0,0,0,0,3,4,3,4,TRUE,0.75,2019,2019-2020
KY,2019-12-31,inter-ucx,1,0,0,0,0,0,0,0,0,0,0,1,1,1,TRUE,1,2019,2019-2020
KY,2019-12-31,inter-ui,60,20,13,3,1,2,0,0,1,1,28,129,88,108,TRUE,0.682170542635659,2019,2019-2020
KY,2019-12-31,intra-total,2362,569,237,107,47,31,28,36,6,48,707,4178,3069,3638,TRUE,0.734561991383437,2019,2019-2020
KY,2019-12-31,intra-ucfe,4,4,1,0,3,0,0,0,0,0,4,16,8,12,TRUE,0.5,2019,2019-2020
KY,2019-12-31,intra-ucx,9,6,0,1,0,0,0,1,0,0,2,19,11,17,TRUE,0.578947368421053,2019,2019-2020
KY,2019-12-31,intra-ui,2349,559,236,106,44,31,28,35,6,48,701,4143,3050,3609,TRUE,0.73618151098238,2019,2019-2020
KY,2020-01-31,inter-total,54,20,11,4,7,5,1,1,0,1,27,131,81,101,TRUE,0.618320610687023,2019,2019-2020
KY,2020-01-31,inter-ucfe,2,0,0,0,0,0,0,0,0,0,0,2,2,2,TRUE,1,2019,2019-2020
KY,2020-01-31,inter-ucx,0,0,1,0,0,0,0,0,0,0,1,2,1,1,TRUE,0.5,2019,2019-2020
KY,2020-01-31,inter-ui,52,20,10,4,7,5,1,1,0,1,26,127,78,98,TRUE,0.614173228346457,2019,2019-2020
KY,2020-01-31,intra-total,4530,453,368,249,93,64,34,33,28,66,1319,7237,5849,6302,TRUE,0.808207820920271,2019,2019-2020
KY,2020-01-31,intra-ucfe,13,5,2,1,0,0,0,0,0,1,11,33,24,29,TRUE,0.727272727272727,2019,2019-2020
KY,2020-01-31,intra-ucx,5,1,1,1,0,0,0,0,0,0,4,12,9,10,TRUE,0.75,2019,2019-2020
KY,2020-01-31,intra-ui,4512,447,365,247,93,64,34,33,28,65,1304,7192,5816,6263,TRUE,0.808676307007787,2019,2019-2020
KY,2020-02-29,inter-total,41,14,4,2,1,3,1,1,1,1,22,91,63,77,TRUE,0.692307692307692,2019,2019-2020
KY,2020-02-29,inter-ucfe,0,1,0,0,0,0,0,0,0,0,0,1,0,1,TRUE,0,2019,2019-2020
KY,2020-02-29,inter-ucx,2,0,0,0,0,0,0,0,0,0,0,2,2,2,TRUE,1,2019,2019-2020
KY,2020-02-29,inter-ui,39,13,4,2,1,3,1,1,1,1,22,88,61,74,TRUE,0.693181818181818,2019,2019-2020
KY,2020-02-29,intra-total,2233,511,291,164,145,105,75,36,24,65,930,4579,3163,3674,TRUE,0.690762175147412,2019,2019-2020
KY,2020-02-29,intra-ucfe,2,4,3,6,1,1,0,0,0,0,5,22,7,11,TRUE,0.318181818181818,2019,2019-2020
KY,2020-02-29,intra-ucx,8,2,0,1,0,0,0,1,0,1,5,18,13,15,TRUE,0.722222222222222,2019,2019-2020
KY,2020-02-29,intra-ui,2223,505,288,157,144,104,75,35,24,64,920,4539,3143,3648,TRUE,0.692443269442609,2019,2019-2020
KY,2020-03-31,inter-total,22,13,3,5,1,2,0,0,0,0,32,78,54,67,TRUE,0.692307692307692,2019,2019-2020
KY,2020-03-31,inter-ucfe,0,1,0,0,0,0,0,0,0,0,0,1,0,1,TRUE,0,2019,2019-2020
KY,2020-03-31,inter-ucx,2,0,0,0,0,0,0,0,0,0,0,2,2,2,TRUE,1,2019,2019-2020
KY,2020-03-31,inter-ui,20,12,3,5,1,2,0,0,0,0,32,75,52,64,TRUE,0.693333333333333,2019,2019-2020
KY,2020-03-31,intra-total,9947,540,255,125,59,72,54,24,29,78,6562,17745,16509,17049,TRUE,0.930346576500423,2019,2019-2020
KY,2020-03-31,intra-ucfe,3,0,2,2,1,3,0,0,2,1,1,15,4,4,TRUE,0.266666666666667,2019,2019-2020
KY,2020-03-31,intra-ucx,4,1,1,0,0,0,0,0,0,2,6,14,10,11,TRUE,0.714285714285714,2019,2019-2020
KY,2020-03-31,intra-ui,9940,539,252,123,58,69,54,24,27,75,6555,17716,16495,17034,TRUE,0.931079250395123,2019,2019-2020
KY,2020-04-30,inter-total,25,52,30,15,5,1,1,0,0,1,458,588,483,535,TRUE,0.821428571428571,2019,2019-2020
KY,2020-04-30,inter-ucfe,0,0,0,0,0,0,0,0,0,0,0,0,0,0,TRUE,0,2019,2019-2020
KY,2020-04-30,inter-ucx,0,0,0,0,0,0,0,0,0,0,0,0,0,0,TRUE,0,2019,2019-2020
KY,2020-04-30,inter-ui,25,52,30,15,5,1,1,0,0,1,458,588,483,535,TRUE,0.821428571428571,2019,2019-2020
KY,2020-04-30,intra-total,16422,17283,8428,5288,1538,108,49,40,32,65,158951,208204,175373,192656,TRUE,0.84231330810167,2019,2019-2020
KY,2020-04-30,intra-ucfe,0,0,3,3,1,0,0,1,0,0,2,10,2,2,TRUE,0.2,2019,2019-2020
KY,2020-04-30,intra-ucx,5,8,4,5,1,0,0,0,0,0,28,51,33,41,TRUE,0.647058823529412,2019,2019-2020
KY,2020-04-30,intra-ui,16417,17275,8421,5280,1536,108,49,39,32,65,158921,208143,175338,192613,TRUE,0.842392009339733,2019,2019-2020
KY,2020-05-31,inter-total,13,32,13,19,24,22,5,6,3,2,194,333,207,239,TRUE,0.621621621621622,2019,2019-2020
KY,2020-05-31,inter-ucfe,0,0,0,0,0,0,0,0,0,0,0,0,0,0,TRUE,0,2019,2019-2020
KY,2020-05-31,inter-ucx,0,0,0,0,0,0,0,0,0,0,0,0,0,0,TRUE,0,2019,2019-2020
KY,2020-05-31,inter-ui,13,32,13,19,24,22,5,6,3,2,194,333,207,239,TRUE,0.621621621621622,2019,2019-2020
KY,2020-05-31,intra-total,4949,4780,2962,3238,4093,4084,2228,912,180,103,36490,64019,41439,46219,TRUE,0.647292210125119,2019,2019-2020
KY,2020-05-31,intra-ucfe,0,0,2,1,2,7,1,2,0,1,0,16,0,0,TRUE,0,2019,2019-2020
KY,2020-05-31,intra-ucx,0,14,3,6,2,4,5,1,1,0,6,42,6,20,TRUE,0.142857142857143,2019,2019-2020
KY,2020-05-31,intra-ui,4949,4766,2957,3231,4089,4073,2222,909,179,102,36484,63961,41433,46199,TRUE,0.647785369209362,2019,2019-2020
KY,2020-06-30,inter-total,12,19,2,2,4,8,8,20,13,18,55,161,67,86,TRUE,0.416149068322981,2019,2019-2020
KY,2020-06-30,inter-ucfe,0,0,0,0,0,0,0,0,0,0,0,0,0,0,TRUE,0,2019,2019-2020
KY,2020-06-30,inter-ucx,0,1,0,0,0,0,0,0,0,0,1,2,1,2,TRUE,0.5,2019,2019-2020
KY,2020-06-30,inter-ui,12,18,2,2,4,8,8,20,13,18,54,159,66,84,TRUE,0.415094339622642,2019,2019-2020
KY,2020-06-30,intra-total,2556,2037,576,460,478,748,1078,1424,1791,3169,5920,20237,8476,10513,TRUE,0.418836784108316,2019,2019-2020
KY,2020-06-30,intra-ucfe,0,0,0,0,0,0,1,3,6,15,0,25,0,0,TRUE,0,2019,2019-2020
KY,2020-06-30,intra-ucx,0,7,6,2,0,2,2,2,3,11,4,39,4,11,TRUE,0.102564102564103,2019,2019-2020
KY,2020-06-30,intra-ui,2556,2030,570,458,478,746,1075,1419,1782,3143,5916,20173,8472,10502,TRUE,0.419967283002032,2019,2019-2020
KY,2020-07-31,inter-total,5,1,4,0,3,0,0,2,4,58,35,112,40,41,TRUE,0.357142857142857,2020,2020-2021
KY,2020-07-31,inter-ucfe,0,0,0,0,0,0,0,0,0,0,0,0,0,0,TRUE,0,2020,2020-2021
KY,2020-07-31,inter-ucx,0,0,0,0,0,0,0,0,0,1,1,2,1,1,TRUE,0.5,2020,2020-2021
KY,2020-07-31,inter-ui,5,1,4,0,3,0,0,2,4,57,34,110,39,40,TRUE,0.354545454545455,2020,2020-2021
KY,2020-07-31,intra-total,1655,839,327,282,234,225,255,221,255,4741,3644,12678,5299,6138,TRUE,0.417968133775043,2020,2020-2021
KY,2020-07-31,intra-ucfe,0,1,0,0,0,0,1,0,0,16,1,19,1,2,TRUE,0.0526315789473684,2020,2020-2021
KY,2020-07-31,intra-ucx,0,6,0,1,2,2,3,0,0,11,9,34,9,15,TRUE,0.264705882352941,2020,2020-2021
KY,2020-07-31,intra-ui,1655,832,327,281,232,223,251,221,255,4714,3634,12625,5289,6121,TRUE,0.418930693069307,2020,2020-2021
KY,2020-08-31,inter-total,5,0,0,1,1,1,0,1,3,49,17,78,22,22,TRUE,0.282051282051282,2020,2020-2021
KY,2020-08-31,inter-ucfe,0,0,0,0,0,0,0,0,0,0,0,0,0,0,TRUE,0,2020,2020-2021
KY,2020-08-31,inter-ucx,0,0,0,0,0,0,0,0,0,1,0,1,0,0,TRUE,0,2020,2020-2021
KY,2020-08-31,inter-ui,5,0,0,1,1,1,0,1,3,48,17,77,22,22,TRUE,0.285714285714286,2020,2020-2021
KY,2020-08-31,intra-total,433,402,207,159,167,193,134,146,145,4736,1830,8552,2263,2665,TRUE,0.264616463985033,2020,2020-2021
KY,2020-08-31,intra-ucfe,0,0,0,0,1,0,0,0,0,24,0,25,0,0,TRUE,0,2020,2020-2021
KY,2020-08-31,intra-ucx,2,2,0,1,0,1,2,0,1,21,5,35,7,9,TRUE,0.2,2020,2020-2021
KY,2020-08-31,intra-ui,431,400,207,158,166,192,132,146,144,4691,1825,8492,2256,2656,TRUE,0.265661799340556,2020,2020-2021
KY,2020-09-30,inter-total,1,3,2,0,0,0,0,1,0,47,7,61,8,11,TRUE,0.131147540983607,2020,2020-2021
KY,2020-09-30,inter-ucfe,0,0,0,0,0,0,0,0,0,0,0,0,0,0,TRUE,0,2020,2020-2021
KY,2020-09-30,inter-ucx,0,0,0,0,0,0,0,0,0,0,0,0,0,0,TRUE,0,2020,2020-2021
KY,2020-09-30,inter-ui,1,3,2,0,0,0,0,1,0,47,7,61,8,11,TRUE,0.131147540983607,2020,2020-2021
KY,2020-09-30,intra-total,246,180,54,59,65,82,95,95,73,2770,936,4655,1182,1362,TRUE,0.253920515574651,2020,2020-2021
KY,2020-09-30,intra-ucfe,0,1,0,0,0,0,1,0,1,12,0,15,0,1,TRUE,0,2020,2020-2021
KY,2020-09-30,intra-ucx,1,1,2,1,1,2,0,3,0,15,14,40,15,16,TRUE,0.375,2020,2020-2021
KY,2020-09-30,intra-ui,245,178,52,58,64,80,94,92,72,2743,922,4600,1167,1345,TRUE,0.253695652173913,2020,2020-2021
KY,2020-10-31,inter-total,1,1,0,1,0,0,1,0,1,47,11,63,12,13,TRUE,0.19047619047619,2020,2020-2021
KY,2020-10-31,inter-ucfe,0,0,0,0,0,0,0,0,0,0,0,0,0,0,TRUE,0,2020,2020-2021
KY,2020-10-31,inter-ucx,0,0,0,0,0,0,0,0,0,0,1,1,1,1,TRUE,1,2020,2020-2021
KY,2020-10-31,inter-ui,1,1,0,1,0,0,1,0,1,47,10,62,11,12,TRUE,0.17741935483871,2020,2020-2021
KY,2020-10-31,intra-total,133,151,60,36,51,43,47,37,54,2842,902,4356,1035,1186,TRUE,0.237603305785124,2020,2020-2021
KY,2020-10-31,intra-ucfe,0,0,0,0,0,0,0,0,0,13,0,13,0,0,TRUE,0,2020,2020-2021
KY,2020-10-31,intra-ucx,0,1,2,1,1,0,0,0,0,5,5,15,5,6,TRUE,0.333333333333333,2020,2020-2021
KY,2020-10-31,intra-ui,133,150,58,35,50,43,47,37,54,2824,897,4328,1030,1180,TRUE,0.237985212569316,2020,2020-2021
KY,2020-11-30,inter-total,1,3,1,2,0,4,1,0,0,29,13,54,14,17,TRUE,0.259259259259259,2020,2020-2021
KY,2020-11-30,inter-ucfe,0,0,0,0,0,0,0,0,0,0,0,0,0,0,TRUE,0,2020,2020-2021
KY,2020-11-30,inter-ucx,0,0,0,0,0,0,0,0,0,0,0,0,0,0,TRUE,0,2020,2020-2021
KY,2020-11-30,inter-ui,1,3,1,2,0,4,1,0,0,29,13,54,14,17,TRUE,0.259259259259259,2020,2020-2021
KY,2020-11-30,intra-total,297,260,69,51,46,40,32,27,25,2092,1088,4027,1385,1645,TRUE,0.343928482741495,2020,2020-2021
KY,2020-11-30,intra-ucfe,0,0,0,1,1,1,0,0,0,9,1,13,1,1,TRUE,0.0769230769230769,2020,2020-2021
KY,2020-11-30,intra-ucx,0,1,0,0,0,0,0,0,0,8,4,13,4,5,TRUE,0.307692307692308,2020,2020-2021
KY,2020-11-30,intra-ui,297,259,69,50,45,39,32,27,25,2075,1083,4001,1380,1639,TRUE,0.344913771557111,2020,2020-2021
KY,2020-12-31,inter-total,2,10,0,0,2,2,0,1,3,39,32,91,34,44,TRUE,0.373626373626374,2020,2020-2021
KY,2020-12-31,inter-ucfe,0,0,0,0,0,0,0,0,0,2,0,2,0,0,TRUE,0,2020,2020-2021
KY,2020-12-31,inter-ucx,0,0,0,0,0,0,0,0,0,1,0,1,0,0,TRUE,0,2020,2020-2021
KY,2020-12-31,inter-ui,2,10,0,0,2,2,0,1,3,36,32,88,34,44,TRUE,0.386363636363636,2020,2020-2021
KY,2020-12-31,intra-total,110,533,88,43,36,29,25,28,20,1990,1579,4481,1689,2222,TRUE,0.376924793572863,2020,2020-2021
KY,2020-12-31,intra-ucfe,0,0,0,0,0,0,0,0,1,7,0,8,0,0,TRUE,0,2020,2020-2021
KY,2020-12-31,intra-ucx,0,2,0,0,0,0,0,0,0,13,0,15,0,2,TRUE,0,2020,2020-2021
KY,2020-12-31,intra-ui,110,531,88,43,36,29,25,28,19,1970,1579,4458,1689,2220,TRUE,0.378869448183042,2020,2020-2021
KY,2021-01-31,inter-total,1,2,1,1,0,1,0,0,0,45,22,73,23,25,TRUE,0.315068493150685,2020,2020-2021
KY,2021-01-31,inter-ucfe,0,0,0,0,0,0,0,0,0,2,0,2,0,0,TRUE,0,2020,2020-2021
KY,2021-01-31,inter-ucx,0,0,0,0,0,0,0,0,0,1,0,1,0,0,TRUE,0,2020,2020-2021
KY,2021-01-31,inter-ui,1,2,1,1,0,1,0,0,0,42,22,70,23,25,TRUE,0.328571428571429,2020,2020-2021
KY,2021-01-31,intra-total,371,699,141,63,60,28,37,32,20,2009,3022,6482,3393,4092,TRUE,0.52344955260722,2020,2020-2021
KY,2021-01-31,intra-ucfe,0,0,0,0,0,0,0,0,0,5,0,5,0,0,TRUE,0,2020,2020-2021
KY,2021-01-31,intra-ucx,0,1,0,0,0,0,0,0,1,11,2,15,2,3,TRUE,0.133333333333333,2020,2020-2021
KY,2021-01-31,intra-ui,371,698,141,63,60,28,37,32,19,1993,3020,6462,3391,4089,TRUE,0.524760136180749,2020,2020-2021
KY,2021-02-28,inter-total,0,5,0,1,2,2,0,2,1,15,21,49,21,26,TRUE,0.428571428571429,2020,2020-2021
KY,2021-02-28,inter-ucfe,0,0,0,0,0,0,0,0,0,1,1,2,1,1,TRUE,0.5,2020,2020-2021
KY,2021-02-28,inter-ucx,0,0,0,0,1,0,0,0,0,1,1,3,1,1,TRUE,0.333333333333333,2020,2020-2021
KY,2021-02-28,inter-ui,0,5,0,1,1,2,0,2,1,13,19,44,19,24,TRUE,0.431818181818182,2020,2020-2021
KY,2021-02-28,intra-total,138,542,128,97,93,75,85,54,35,1271,2228,4746,2366,2908,TRUE,0.498525073746313,2020,2020-2021
KY,2021-02-28,intra-ucfe,0,0,0,0,0,0,0,0,0,6,1,7,1,1,TRUE,0.142857142857143,2020,2020-2021
KY,2021-02-28,intra-ucx,0,0,0,1,0,0,0,0,0,4,3,8,3,3,TRUE,0.375,2020,2020-2021
KY,2021-02-28,intra-ui,138,542,128,96,93,75,85,54,35,1261,2224,4731,2362,2904,TRUE,0.499260198689495,2020,2020-2021
KY,2021-03-31,inter-total,2,1,1,0,3,1,3,0,0,28,9,48,11,12,TRUE,0.229166666666667,2020,2020-2021
KY,2021-03-31,inter-ucfe,0,0,0,0,0,0,0,0,0,0,0,0,0,0,TRUE,0,2020,2020-2021
KY,2021-03-31,inter-ucx,0,0,0,0,0,0,0,0,0,1,1,2,1,1,TRUE,0.5,2020,2020-2021
KY,2021-03-31,inter-ui,2,1,1,0,3,1,3,0,0,27,8,46,10,11,TRUE,0.217391304347826,2020,2020-2021
KY,2021-03-31,intra-total,1944,860,122,69,56,69,70,46,60,930,3594,7820,5538,6398,TRUE,0.708184143222506,2020,2020-2021
KY,2021-03-31,intra-ucfe,0,1,0,0,0,0,0,0,0,8,0,9,0,1,TRUE,0,2020,2020-2021
KY,2021-03-31,intra-ucx,1,1,1,0,0,1,0,0,0,4,7,15,8,9,TRUE,0.533333333333333,2020,2020-2021
KY,2021-03-31,intra-ui,1943,858,121,69,56,68,70,46,60,918,3587,7796,5530,6388,TRUE,0.709338122113905,2020,2020-2021
KY,2021-04-30,inter-total,1,3,1,0,0,1,0,1,1,15,11,34,12,15,TRUE,0.352941176470588,2020,2020-2021
KY,2021-04-30,inter-ucfe,0,0,0,0,0,0,0,0,0,0,0,0,0,0,TRUE,0,2020,2020-2021
KY,2021-04-30,inter-ucx,0,0,0,0,0,0,0,0,0,0,1,1,1,1,TRUE,1,2020,2020-2021
KY,2021-04-30,inter-ui,1,3,1,0,0,1,0,1,1,15,10,33,11,14,TRUE,0.333333333333333,2020,2020-2021
KY,2021-04-30,intra-total,2957,666,152,93,58,46,49,34,32,991,1760,6838,4717,5383,TRUE,0.689821585258848,2020,2020-2021
KY,2021-04-30,intra-ucfe,0,0,0,0,0,0,0,0,0,8,1,9,1,1,TRUE,0.111111111111111,2020,2020-2021
KY,2021-04-30,intra-ucx,0,2,0,1,0,0,0,1,0,5,1,10,1,3,TRUE,0.1,2020,2020-2021
KY,2021-04-30,intra-ui,2957,664,152,92,58,46,49,33,32,978,1758,6819,4715,5379,TRUE,0.691450359290219,2020,2020-2021
KY,2021-05-31,inter-total,1,1,0,1,1,0,1,0,1,14,11,31,12,13,TRUE,0.387096774193548,2020,2020-2021
KY,2021-05-31,inter-ucfe,0,0,0,0,0,0,0,0,0,0,0,0,0,0,TRUE,0,2020,2020-2021
KY,2021-05-31,inter-ucx,0,0,0,0,0,0,0,0,0,0,0,0,0,0,TRUE,0,2020,2020-2021
KY,2021-05-31,inter-ui,1,1,0,1,1,0,1,0,1,14,11,31,12,13,TRUE,0.387096774193548,2020,2020-2021
KY,2021-05-31,intra-total,625,297,259,173,170,188,139,86,51,770,1272,4030,1897,2194,TRUE,0.470719602977668,2020,2020-2021
KY,2021-05-31,intra-ucfe,0,0,0,0,1,0,0,0,0,5,0,6,0,0,TRUE,0,2020,2020-2021
KY,2021-05-31,intra-ucx,0,1,0,0,1,0,0,1,1,2,0,6,0,1,TRUE,0,2020,2020-2021
KY,2021-05-31,intra-ui,625,296,259,173,168,188,139,85,50,763,1272,4018,1897,2193,TRUE,0.47212543554007,2020,2020-2021
KY,2021-06-30,inter-total,2,2,0,0,0,0,1,0,1,18,15,39,17,19,TRUE,0.435897435897436,2020,2020-2021
KY,2021-06-30,inter-ucfe,0,0,0,0,0,0,0,0,0,1,0,1,0,0,TRUE,0,2020,2020-2021
KY,2021-06-30,inter-ucx,0,0,0,0,0,0,0,0,1,0,0,1,0,0,TRUE,0,2020,2020-2021
KY,2021-06-30,inter-ui,2,2,0,0,0,0,1,0,0,17,15,37,17,19,TRUE,0.45945945945946,2020,2020-2021
KY,2021-06-30,intra-total,203,193,115,167,154,205,166,188,163,1171,1112,3837,1315,1508,TRUE,0.342715663278603,2020,2020-2021
KY,2021-06-30,intra-ucfe,0,0,0,0,0,0,0,0,0,7,0,7,0,0,TRUE,0,2020,2020-2021
KY,2021-06-30,intra-ucx,0,0,0,1,1,1,0,0,0,5,4,12,4,4,TRUE,0.333333333333333,2020,2020-2021
KY,2021-06-30,intra-ui,203,193,115,166,153,204,166,188,163,1159,1108,3818,1311,1504,TRUE,0.343373493975904,2020,2020-2021
KY,2021-07-31,inter-total,0,3,0,0,2,0,2,2,2,10,6,27,6,9,TRUE,0.222222222222222,2021,2021-2022
KY,2021-07-31,inter-ucfe,0,0,0,0,0,0,0,0,0,0,0,0,0,0,TRUE,0,2021,2021-2022
KY,2021-07-31,inter-ucx,0,0,0,0,0,0,0,0,0,0,0,0,0,0,TRUE,0,2021,2021-2022
KY,2021-07-31,inter-ui,0,3,0,0,2,0,2,2,2,10,6,27,6,9,TRUE,0.222222222222222,2021,2021-2022
KY,2021-07-31,intra-total,600,151,109,100,120,130,110,137,148,1449,704,3758,1304,1455,TRUE,0.346993081426291,2021,2021-2022
KY,2021-07-31,intra-ucfe,0,0,0,0,0,1,0,0,0,8,2,11,2,2,TRUE,0.181818181818182,2021,2021-2022
KY,2021-07-31,intra-ucx,0,2,0,0,0,0,0,0,0,2,4,8,4,6,TRUE,0.5,2021,2021-2022
KY,2021-07-31,intra-ui,600,149,109,100,120,129,110,137,148,1439,698,3739,1298,1447,TRUE,0.34715164482482,2021,2021-2022
KY,2021-08-31,inter-total,0,1,0,0,0,0,1,0,0,32,6,40,6,7,TRUE,0.15,2021,2021-2022
KY,2021-08-31,inter-ucfe,0,0,0,0,0,0,0,0,0,0,0,0,0,0,TRUE,0,2021,2021-2022
KY,2021-08-31,inter-ucx,0,0,0,0,0,0,0,0,0,0,0,0,0,0,TRUE,0,2021,2021-2022
KY,2021-08-31,inter-ui,0,1,0,0,0,0,1,0,0,32,6,40,6,7,TRUE,0.15,2021,2021-2022
KY,2021-08-31,intra-total,81,150,85,108,93,70,61,83,81,1483,538,2833,619,769,TRUE,0.21849629368161,2021,2021-2022
KY,2021-08-31,intra-ucfe,0,0,0,1,0,0,0,0,0,4,0,5,0,0,TRUE,0,2021,2021-2022
KY,2021-08-31,intra-ucx,0,0,0,0,0,0,0,0,0,2,2,4,2,2,TRUE,0.5,2021,2021-2022
KY,2021-08-31,intra-ui,81,150,85,107,93,70,61,83,81,1477,536,2824,617,767,TRUE,0.218484419263456,2021,2021-2022
KY,2021-09-30,inter-total,3,1,0,0,0,1,1,0,0,27,2,35,5,6,TRUE,0.142857142857143,2021,2021-2022
KY,2021-09-30,inter-ucfe,0,0,0,0,0,0,0,0,0,1,0,1,0,0,TRUE,0,2021,2021-2022
KY,2021-09-30,inter-ucx,0,0,0,0,0,0,0,0,0,1,0,1,0,0,TRUE,0,2021,2021-2022
KY,2021-09-30,inter-ui,3,1,0,0,0,1,1,0,0,25,2,33,5,6,TRUE,0.151515151515152,2021,2021-2022
KY,2021-09-30,intra-total,170,119,68,67,68,70,71,60,49,1228,396,2366,566,685,TRUE,0.239222316145393,2021,2021-2022
KY,2021-09-30,intra-ucfe,0,0,0,0,1,0,0,0,0,6,0,7,0,0,TRUE,0,2021,2021-2022
KY,2021-09-30,intra-ucx,1,0,0,0,0,0,0,0,0,2,0,3,1,1,TRUE,0.333333333333333,2021,2021-2022
KY,2021-09-30,intra-ui,169,119,68,67,67,70,71,60,49,1220,396,2356,565,684,TRUE,0.23981324278438,2021,2021-2022
KY,2021-10-31,inter-total,4,0,0,1,1,1,1,0,1,25,0,34,4,4,TRUE,0.117647058823529,2021,2021-2022
KY,2021-10-31,inter-ucfe,0,0,0,0,0,0,0,0,0,0,0,0,0,0,TRUE,0,2021,2021-2022
KY,2021-10-31,inter-ucx,0,0,0,0,0,0,0,0,0,1,0,1,0,0,TRUE,0,2021,2021-2022
KY,2021-10-31,inter-ui,4,0,0,1,1,1,1,0,1,24,0,33,4,4,TRUE,0.121212121212121,2021,2021-2022
KY,2021-10-31,intra-total,357,35,42,39,63,71,55,55,39,1129,91,1976,448,483,TRUE,0.226720647773279,2021,2021-2022
KY,2021-10-31,intra-ucfe,0,0,0,0,1,0,0,0,0,7,0,8,0,0,TRUE,0,2021,2021-2022
KY,2021-10-31,intra-ucx,5,0,0,1,2,0,0,0,0,0,0,8,5,5,TRUE,0.625,2021,2021-2022
KY,2021-10-31,intra-ui,352,35,42,38,60,71,55,55,39,1122,91,1960,443,478,TRUE,0.226020408163265,2021,2021-2022
KY,2021-11-30,inter-total,6,0,0,0,1,1,0,0,0,18,3,29,9,9,TRUE,0.310344827586207,2021,2021-2022
KY,2021-11-30,inter-ucfe,0,0,0,0,0,0,0,0,0,0,0,0,0,0,TRUE,0,2021,2021-2022
KY,2021-11-30,inter-ucx,0,0,0,0,0,0,0,0,0,1,0,1,0,0,TRUE,0,2021,2021-2022
KY,2021-11-30,inter-ui,6,0,0,0,1,1,0,0,0,17,3,28,9,9,TRUE,0.321428571428571,2021,2021-2022
KY,2021-11-30,intra-total,418,67,51,52,35,23,24,30,27,973,119,1819,537,604,TRUE,0.295217152281473,2021,2021-2022
KY,2021-11-30,intra-ucfe,0,0,0,0,0,0,0,0,1,4,0,5,0,0,TRUE,0,2021,2021-2022
KY,2021-11-30,intra-ucx,2,0,0,0,1,0,0,0,0,3,1,7,3,3,TRUE,0.428571428571429,2021,2021-2022
KY,2021-11-30,intra-ui,416,67,51,52,34,23,24,30,26,966,118,1807,534,601,TRUE,0.29551743220808,2021,2021-2022
KY,2021-12-31,inter-total,3,1,0,0,0,1,0,0,0,21,5,31,8,9,TRUE,0.258064516129032,2021,2021-2022
KY,2021-12-31,inter-ucfe,0,0,0,0,0,0,0,0,0,1,0,1,0,0,TRUE,0,2021,2021-2022
KY,2021-12-31,inter-ucx,0,0,0,0,0,0,0,0,0,0,0,0,0,0,TRUE,0,2021,2021-2022
KY,2021-12-31,inter-ui,3,1,0,0,0,1,0,0,0,20,5,30,8,9,TRUE,0.266666666666667,2021,2021-2022
KY,2021-12-31,intra-total,635,79,44,43,39,39,31,31,26,929,268,2164,903,982,TRUE,0.41728280961183,2021,2021-2022
KY,2021-12-31,intra-ucfe,0,0,0,0,0,0,1,0,0,5,0,6,0,0,TRUE,0,2021,2021-2022
KY,2021-12-31,intra-ucx,2,1,1,0,0,2,0,0,0,6,0,12,2,3,TRUE,0.166666666666667,2021,2021-2022
KY,2021-12-31,intra-ui,633,78,43,43,39,37,30,31,26,918,268,2146,901,979,TRUE,0.419850885368127,2021,2021-2022
KY,2022-01-31,inter-total,10,2,1,0,1,0,0,0,0,22,4,40,14,16,TRUE,0.35,2021,2021-2022
KY,2022-01-31,inter-ucfe,0,0,0,0,0,0,0,0,0,1,0,1,0,0,TRUE,0,2021,2021-2022
KY,2022-01-31,inter-ucx,0,0,0,0,0,0,0,0,0,0,0,0,0,0,TRUE,0,2021,2021-2022
KY,2022-01-31,inter-ui,10,2,1,0,1,0,0,0,0,21,4,39,14,16,TRUE,0.358974358974359,2021,2021-2022
KY,2022-01-31,intra-total,1736,216,173,88,75,36,37,23,32,941,593,3950,2329,2545,TRUE,0.589620253164557,2021,2021-2022
KY,2022-01-31,intra-ucfe,0,0,0,2,1,0,1,0,1,5,1,11,1,1,TRUE,0.0909090909090909,2021,2021-2022
KY,2022-01-31,intra-ucx,3,0,0,0,0,1,0,0,0,9,1,14,4,4,TRUE,0.285714285714286,2021,2021-2022
KY,2022-01-31,intra-ui,1733,216,173,86,74,35,36,23,31,927,591,3925,2324,2540,TRUE,0.592101910828025,2021,2021-2022
KY,2022-02-28,inter-total,12,0,2,1,0,0,0,0,0,18,2,35,14,14,TRUE,0.4,2021,2021-2022
KY,2022-02-28,inter-ucfe,0,0,0,0,0,0,0,0,0,0,0,0,0,0,TRUE,0,2021,2021-2022
KY,2022-02-28,inter-ucx,0,0,0,0,0,0,0,0,0,0,0,0,0,0,TRUE,0,2021,2021-2022
KY,2022-02-28,inter-ui,12,0,2,1,0,0,0,0,0,18,2,35,14,14,TRUE,0.4,2021,2021-2022
KY,2022-02-28,intra-total,922,126,113,101,79,78,74,78,39,1003,276,2889,1198,1324,TRUE,0.414676358601592,2021,2021-2022
KY,2022-02-28,intra-ucfe,0,0,0,0,0,0,2,0,1,7,0,10,0,0,TRUE,0,2021,2021-2022
KY,2022-02-28,intra-ucx,2,0,0,0,0,0,1,0,0,5,2,10,4,4,TRUE,0.4,2021,2021-2022
KY,2022-02-28,intra-ui,920,126,113,101,79,78,71,78,38,991,274,2869,1194,1320,TRUE,0.41617288253747,2021,2021-2022
KY,2022-03-31,inter-total,6,0,1,1,1,1,0,2,0,11,0,23,6,6,TRUE,0.260869565217391,2021,2021-2022
KY,2022-03-31,inter-ucfe,0,0,0,0,0,0,0,0,0,0,0,0,0,0,TRUE,0,2021,2021-2022
KY,2022-03-31,inter-ucx,0,0,0,0,0,0,0,0,0,0,0,0,0,0,TRUE,0,2021,2021-2022
KY,2022-03-31,inter-ui,6,0,1,1,1,1,0,2,0,11,0,23,6,6,TRUE,0.260869565217391,2021,2021-2022
KY,2022-03-31,intra-total,594,111,64,55,69,62,58,53,39,962,164,2231,758,869,TRUE,0.33975795607351,2021,2021-2022
KY,2022-03-31,intra-ucfe,0,1,1,0,0,0,0,1,1,13,0,17,0,1,TRUE,0,2021,2021-2022
KY,2022-03-31,intra-ucx,5,0,0,0,0,1,0,1,0,8,2,17,7,7,TRUE,0.411764705882353,2021,2021-2022
KY,2022-03-31,intra-ui,589,110,63,55,69,61,58,51,38,941,162,2197,751,861,TRUE,0.341829767865271,2021,2021-2022
KY,2022-04-30,inter-total,9,0,0,1,0,0,2,1,0,10,5,28,14,14,TRUE,0.5,2021,2021-2022
KY,2022-04-30,inter-ucfe,0,0,0,0,0,0,0,0,0,0,0,0,0,0,TRUE,0,2021,2021-2022
KY,2022-04-30,inter-ucx,0,0,0,0,0,0,0,0,0,0,0,0,0,0,TRUE,0,2021,2021-2022
KY,2022-04-30,inter-ui,9,0,0,1,0,0,2,1,0,10,5,28,14,14,TRUE,0.5,2021,2021-2022
KY,2022-04-30,intra-total,444,73,61,67,38,46,34,26,13,654,134,1590,578,651,TRUE,0.363522012578616,2021,2021-2022
KY,2022-04-30,intra-ucfe,0,1,0,0,0,0,0,0,0,2,0,3,0,1,TRUE,0,2021,2021-2022
KY,2022-04-30,intra-ucx,4,0,1,0,0,0,0,0,0,0,0,5,4,4,TRUE,0.8,2021,2021-2022
KY,2022-04-30,intra-ui,440,72,60,67,38,46,34,26,13,652,134,1582,574,646,TRUE,0.36283185840708,2021,2021-2022
KY,2022-05-31,inter-total,8,1,0,0,1,0,1,0,1,13,6,31,14,15,TRUE,0.451612903225806,2021,2021-2022
KY,2022-05-31,inter-ucfe,0,0,0,0,0,0,0,0,0,0,0,0,0,0,TRUE,0,2021,2021-2022
KY,2022-05-31,inter-ucx,1,0,0,0,0,0,0,0,0,0,0,1,1,1,TRUE,1,2021,2021-2022
KY,2022-05-31,inter-ui,7,1,0,0,1,0,1,0,1,13,6,30,13,14,TRUE,0.433333333333333,2021,2021-2022
KY,2022-05-31,intra-total,655,100,58,56,38,29,17,12,15,734,173,1887,828,928,TRUE,0.43879173290938,2021,2021-2022
KY,2022-05-31,intra-ucfe,0,2,0,0,0,0,0,0,0,7,0,9,0,2,TRUE,0,2021,2021-2022
KY,2022-05-31,intra-ucx,4,0,1,0,0,0,1,0,0,10,3,19,7,7,TRUE,0.368421052631579,2021,2021-2022
KY,2022-05-31,intra-ui,651,98,57,56,38,29,16,12,15,717,170,1859,821,919,TRUE,0.441635287789134,2021,2021-2022
KY,2022-06-30,inter-total,15,2,1,1,0,0,1,2,0,16,4,42,19,21,TRUE,0.452380952380952,2021,2021-2022
KY,2022-06-30,inter-ucfe,0,0,0,0,0,0,0,0,0,0,0,0,0,0,TRUE,0,2021,2021-2022
KY,2022-06-30,inter-ucx,1,0,0,0,0,0,0,0,0,0,0,1,1,1,TRUE,1,2021,2021-2022
KY,2022-06-30,inter-ui,14,2,1,1,0,0,1,2,0,16,4,41,18,20,TRUE,0.439024390243902,2021,2021-2022
KY,2022-06-30,intra-total,733,136,106,71,49,57,36,41,29,927,247,2432,980,1116,TRUE,0.402960526315789,2021,2021-2022
KY,2022-06-30,intra-ucfe,1,0,0,0,0,0,0,1,0,6,0,8,1,1,TRUE,0.125,2021,2021-2022
KY,2022-06-30,intra-ucx,5,1,0,0,0,0,0,0,0,2,1,9,6,7,TRUE,0.666666666666667,2021,2021-2022
KY,2022-06-30,intra-ui,727,135,106,71,49,57,36,40,29,919,246,2415,973,1108,TRUE,0.402898550724638,2021,2021-2022
KY,2022-07-31,inter-total,19,2,0,2,3,3,0,0,0,20,3,52,22,24,TRUE,0.423076923076923,2022,2022-2023
KY,2022-07-31,inter-ucfe,0,0,0,0,0,0,0,0,0,0,0,0,0,0,TRUE,0,2022,2022-2023
KY,2022-07-31,inter-ucx,0,0,0,0,0,0,0,0,0,1,0,1,0,0,TRUE,0,2022,2022-2023
KY,2022-07-31,inter-ui,19,2,0,2,3,3,0,0,0,19,3,51,22,24,TRUE,0.431372549019608,2022,2022-2023
KY,2022-07-31,intra-total,928,107,86,75,98,72,55,37,36,1044,257,2795,1185,1292,TRUE,0.42397137745975,2022,2022-2023
KY,2022-07-31,intra-ucfe,0,0,2,1,3,1,0,0,0,5,0,12,0,0,TRUE,0,2022,2022-2023
KY,2022-07-31,intra-ucx,0,3,0,0,0,0,0,0,0,3,1,7,1,4,TRUE,0.142857142857143,2022,2022-2023
KY,2022-07-31,intra-ui,928,104,84,74,95,71,55,37,36,1036,256,2776,1184,1288,TRUE,0.426512968299712,2022,2022-2023
KY,2022-08-31,inter-total,28,4,3,3,0,0,0,2,1,18,8,67,36,40,TRUE,0.537313432835821,2022,2022-2023
KY,2022-08-31,inter-ucfe,0,0,0,1,0,0,0,1,1,0,0,3,0,0,TRUE,0,2022,2022-2023
KY,2022-08-31,inter-ucx,0,0,0,0,0,0,0,0,0,1,0,1,0,0,TRUE,0,2022,2022-2023
KY,2022-08-31,inter-ui,28,4,3,2,0,0,0,1,0,17,8,63,36,40,TRUE,0.571428571428571,2022,2022-2023
KY,2022-08-31,intra-total,697,182,158,146,116,87,47,32,10,992,247,2714,944,1126,TRUE,0.347826086956522,2022,2022-2023
KY,2022-08-31,intra-ucfe,0,0,2,0,0,1,0,0,0,3,0,6,0,0,TRUE,0,2022,2022-2023
KY,2022-08-31,intra-ucx,3,0,0,1,0,0,0,0,0,5,1,10,4,4,TRUE,0.4,2022,2022-2023
KY,2022-08-31,intra-ui,694,182,156,145,116,86,47,32,10,984,246,2698,940,1122,TRUE,0.348406226834692,2022,2022-2023
KY,2022-09-30,inter-total,18,5,1,3,2,0,4,0,0,20,4,57,22,27,TRUE,0.385964912280702,2022,2022-2023
KY,2022-09-30,inter-ucfe,0,0,0,0,0,0,0,0,0,0,0,0,0,0,TRUE,0,2022,2022-2023
KY,2022-09-30,inter-ucx,0,0,0,0,0,0,0,0,0,0,0,0,0,0,TRUE,0,2022,2022-2023
KY,2022-09-30,inter-ui,18,5,1,3,2,0,4,0,0,20,4,57,22,27,TRUE,0.385964912280702,2022,2022-2023
KY,2022-09-30,intra-total,591,132,123,152,118,76,33,45,34,659,199,2162,790,922,TRUE,0.365402405180389,2022,2022-2023
KY,2022-09-30,intra-ucfe,1,0,1,0,0,0,0,0,0,2,1,5,2,2,TRUE,0.4,2022,2022-2023
KY,2022-09-30,intra-ucx,7,2,0,0,1,1,0,0,0,6,1,18,8,10,TRUE,0.444444444444444,2022,2022-2023
KY,2022-09-30,intra-ui,583,130,122,152,117,75,33,45,34,651,197,2139,780,910,TRUE,0.364656381486676,2022,2022-2023
KY,2022-10-31,inter-total,9,1,1,1,4,2,0,1,0,16,2,37,11,12,TRUE,0.297297297297297,2022,2022-2023
KY,2022-10-31,inter-ucfe,0,0,0,0,0,1,0,0,0,0,0,1,0,0,TRUE,0,2022,2022-2023
KY,2022-10-31,inter-ucx,0,0,0,0,0,0,0,0,0,0,1,1,1,1,TRUE,1,2022,2022-2023
KY,2022-10-31,inter-ui,9,1,1,1,4,1,0,1,0,16,1,35,10,11,TRUE,0.285714285714286,2022,2022-2023
KY,2022-10-31,intra-total,515,104,121,117,89,55,25,24,11,645,181,1887,696,800,TRUE,0.368839427662957,2022,2022-2023
KY,2022-10-31,intra-ucfe,0,0,0,0,1,0,0,1,0,5,1,8,1,1,TRUE,0.125,2022,2022-2023
KY,2022-10-31,intra-ucx,0,0,0,0,1,0,1,0,0,1,0,3,0,0,TRUE,0,2022,2022-2023
KY,2022-10-31,intra-ui,515,104,121,117,87,55,24,23,11,639,180,1876,695,799,TRUE,0.37046908315565,2022,2022-2023
KY,2022-11-30,inter-total,8,3,2,2,0,0,1,0,0,10,4,30,12,15,TRUE,0.4,2022,2022-2023
KY,2022-11-30,inter-ucfe,0,0,0,0,0,0,0,0,0,1,0,1,0,0,TRUE,0,2022,2022-2023
KY,2022-11-30,inter-ucx,0,0,0,0,0,0,0,0,0,0,0,0,0,0,TRUE,0,2022,2022-2023
KY,2022-11-30,inter-ui,8,3,2,2,0,0,1,0,0,9,4,29,12,15,TRUE,0.413793103448276,2022,2022-2023
KY,2022-11-30,intra-total,668,175,160,106,61,29,27,15,10,721,269,2241,937,1112,TRUE,0.418116912092816,2022,2022-2023
KY,2022-11-30,intra-ucfe,1,1,0,0,0,0,0,0,0,8,0,10,1,2,TRUE,0.1,2022,2022-2023
KY,2022-11-30,intra-ucx,1,0,1,0,0,0,0,1,0,3,0,6,1,1,TRUE,0.166666666666667,2022,2022-2023
KY,2022-11-30,intra-ui,666,174,159,106,61,29,27,14,10,710,269,2225,935,1109,TRUE,0.420224719101124,2022,2022-2023
KY,2022-12-31,inter-total,22,3,1,2,2,1,0,0,1,22,5,59,27,30,TRUE,0.457627118644068,2022,2022-2023
KY,2022-12-31,inter-ucfe,0,0,0,0,0,0,0,0,0,0,0,0,0,0,TRUE,0,2022,2022-2023
KY,2022-12-31,inter-ucx,0,0,0,0,0,1,0,0,0,0,0,1,0,0,TRUE,0,2022,2022-2023
KY,2022-12-31,inter-ui,22,3,1,2,2,0,0,0,1,22,5,58,27,30,TRUE,0.46551724137931,2022,2022-2023
KY,2022-12-31,intra-total,1190,176,149,96,60,40,31,23,15,642,393,2815,1583,1759,TRUE,0.562344582593251,2022,2022-2023
KY,2022-12-31,intra-ucfe,0,1,3,0,1,0,1,1,0,3,1,11,1,2,TRUE,0.0909090909090909,2022,2022-2023
KY,2022-12-31,intra-ucx,0,1,2,2,0,0,0,0,0,2,2,9,2,3,TRUE,0.222222222222222,2022,2022-2023
KY,2022-12-31,intra-ui,1190,174,144,94,59,40,30,22,15,637,390,2795,1580,1754,TRUE,0.565295169946333,2022,2022-2023
KY,2023-01-31,inter-total,14,3,2,0,3,1,0,1,0,14,8,46,22,25,TRUE,0.478260869565217,2022,2022-2023
KY,2023-01-31,inter-ucfe,0,0,0,0,0,0,0,0,0,1,0,1,0,0,TRUE,0,2022,2022-2023
KY,2023-01-31,inter-ucx,0,0,0,0,0,0,0,0,0,0,0,0,0,0,TRUE,0,2022,2022-2023
KY,2023-01-31,inter-ui,14,3,2,0,3,1,0,1,0,13,8,45,22,25,TRUE,0.488888888888889,2022,2022-2023
KY,2023-01-31,intra-total,2094,229,154,122,79,60,44,26,25,258,648,3739,2742,2971,TRUE,0.733351163412677,2022,2022-2023
KY,2023-01-31,intra-ucfe,1,0,0,0,0,0,0,0,0,3,1,5,2,2,TRUE,0.4,2022,2022-2023
KY,2023-01-31,intra-ucx,3,1,0,0,1,0,0,0,0,2,0,7,3,4,TRUE,0.428571428571429,2022,2022-2023
KY,2023-01-31,intra-ui,2090,228,154,122,78,60,44,26,25,253,647,3727,2737,2965,TRUE,0.73437080762007,2022,2022-2023
KY,2023-02-28,inter-total,16,3,0,2,3,2,2,3,1,10,3,45,19,22,TRUE,0.422222222222222,2022,2022-2023
KY,2023-02-28,inter-ucfe,0,0,0,0,0,0,1,0,0,0,0,1,0,0,TRUE,0,2022,2022-2023
KY,2023-02-28,inter-ucx,1,0,0,0,0,0,0,0,0,0,0,1,1,1,TRUE,1,2022,2022-2023
KY,2023-02-28,inter-ui,15,3,0,2,3,2,1,3,1,10,3,43,18,21,TRUE,0.418604651162791,2022,2022-2023
KY,2023-02-28,intra-total,866,159,113,88,82,49,40,34,33,412,359,2235,1225,1384,TRUE,0.548098434004474,2022,2022-2023
KY,2023-02-28,intra-ucfe,0,0,2,1,0,1,1,0,0,5,0,10,0,0,TRUE,0,2022,2022-2023
KY,2023-02-28,intra-ucx,2,0,2,0,1,1,0,0,0,1,1,8,3,3,TRUE,0.375,2022,2022-2023
KY,2023-02-28,intra-ui,864,159,109,87,81,47,39,34,33,406,358,2217,1222,1381,TRUE,0.551195308976094,2022,2022-2023
KY,2023-03-31,inter-total,2,1,1,2,3,1,0,0,0,5,1,16,3,4,TRUE,0.1875,2022,2022-2023
KY,2023-03-31,inter-ucfe,0,0,0,0,0,0,0,0,0,0,0,0,0,0,TRUE,0,2022,2022-2023
KY,2023-03-31,inter-ucx,0,0,0,1,0,0,0,0,0,0,0,1,0,0,TRUE,0,2022,2022-2023
KY,2023-03-31,inter-ui,2,1,1,1,3,1,0,0,0,5,1,15,3,4,TRUE,0.2,2022,2022-2023
KY,2023-03-31,intra-total,518,118,89,73,55,79,50,75,70,321,221,1669,739,857,TRUE,0.442780107849011,2022,2022-2023
KY,2023-03-31,intra-ucfe,0,0,0,0,0,1,0,1,0,1,1,4,1,1,TRUE,0.25,2022,2022-2023
KY,2023-03-31,intra-ucx,0,0,0,1,1,0,0,0,1,2,3,8,3,3,TRUE,0.375,2022,2022-2023
KY,2023-03-31,intra-ui,518,118,89,72,54,78,50,74,69,318,217,1657,735,853,TRUE,0.443572721786361,2022,2022-2023
KY,2023-04-30,inter-total,11,0,3,1,0,0,1,0,0,13,3,32,14,14,TRUE,0.4375,2022,2022-2023
KY,2023-04-30,inter-ucfe,0,0,0,0,0,0,0,0,0,1,0,1,0,0,TRUE,0,2022,2022-2023
KY,2023-04-30,inter-ucx,0,0,0,0,0,0,0,0,0,0,0,0,0,0,TRUE,0,2022,2022-2023
KY,2023-04-30,inter-ui,11,0,3,1,0,0,1,0,0,12,3,31,14,14,TRUE,0.451612903225806,2022,2022-2023
KY,2023-04-30,intra-total,574,72,44,51,29,22,22,31,23,416,177,1461,751,823,TRUE,0.514031485284052,2022,2022-2023
KY,2023-04-30,intra-ucfe,0,0,0,0,0,0,0,0,0,6,0,6,0,0,TRUE,0,2022,2022-2023
KY,2023-04-30,intra-ucx,2,1,0,0,0,1,0,1,0,3,1,9,3,4,TRUE,0.333333333333333,2022,2022-2023
KY,2023-04-30,intra-ui,572,71,44,51,29,21,22,30,23,407,176,1446,748,819,TRUE,0.517289073305671,2022,2022-2023
KY,2023-05-31,inter-total,11,5,1,1,1,1,1,2,1,10,9,43,20,25,TRUE,0.465116279069768,2022,2022-2023
KY,2023-05-31,inter-ucfe,0,0,0,0,0,0,0,0,0,0,0,0,0,0,TRUE,0,2022,2022-2023
KY,2023-05-31,inter-ucx,0,0,0,0,0,0,0,0,0,0,0,0,0,0,TRUE,0,2022,2022-2023
KY,2023-05-31,inter-ui,11,5,1,1,1,1,1,2,1,10,9,43,20,25,TRUE,0.465116279069768,2022,2022-2023
KY,2023-05-31,intra-total,721,131,95,85,72,44,43,37,41,437,208,1914,929,1060,TRUE,0.485370950888192,2022,2022-2023
KY,2023-05-31,intra-ucfe,0,0,0,0,1,1,0,0,0,3,0,5,0,0,TRUE,0,2022,2022-2023
KY,2023-05-31,intra-ucx,4,0,1,0,0,0,0,1,0,4,0,10,4,4,TRUE,0.4,2022,2022-2023
KY,2023-05-31,intra-ui,717,131,94,85,71,43,43,36,41,430,208,1899,925,1056,TRUE,0.487098472880463,2022,2022-2023
KY,2023-06-30,inter-total,12,2,2,0,0,1,0,1,0,13,6,37,18,20,TRUE,0.486486486486487,2022,2022-2023
KY,2023-06-30,inter-ucfe,1,0,0,0,0,0,0,0,0,1,0,2,1,1,TRUE,0.5,2022,2022-2023
KY,2023-06-30,inter-ucx,0,0,0,0,0,0,0,0,0,1,0,1,0,0,TRUE,0,2022,2022-2023
KY,2023-06-30,inter-ui,11,2,2,0,0,1,0,1,0,11,6,34,17,19,TRUE,0.5,2022,2022-2023
KY,2023-06-30,intra-total,917,138,87,48,36,52,94,68,52,710,278,2480,1195,1333,TRUE,0.481854838709677,2022,2022-2023
KY,2023-06-30,intra-ucfe,1,1,1,0,0,0,0,0,0,2,2,7,3,4,TRUE,0.428571428571429,2022,2022-2023
KY,2023-06-30,intra-ucx,2,1,0,0,0,0,0,0,0,3,0,6,2,3,TRUE,0.333333333333333,2022,2022-2023
KY,2023-06-30,intra-ui,914,136,86,48,36,52,94,68,52,705,276,2467,1190,1326,TRUE,0.482367247669234,2022,2022-2023
KY,2023-07-31,inter-total,12,1,2,0,0,1,1,3,3,10,5,38,17,18,TRUE,0.447368421052632,2023,2023-2024
KY,2023-07-31,inter-ucfe,0,0,0,0,0,0,0,0,0,0,0,0,0,0,TRUE,0,2023,2023-2024
KY,2023-07-31,inter-ucx,0,0,0,0,0,0,0,0,0,1,0,1,0,0,TRUE,0,2023,2023-2024
KY,2023-07-31,inter-ui,12,1,2,0,0,1,1,3,3,9,5,37,17,18,TRUE,0.45945945945946,2023,2023-2024
KY,2023-07-31,intra-total,940,212,133,152,130,118,91,90,57,313,369,2605,1309,1521,TRUE,0.502495201535509,2023,2023-2024
KY,2023-07-31,intra-ucfe,1,0,1,1,0,0,0,0,0,1,0,4,1,1,TRUE,0.25,2023,2023-2024
KY,2023-07-31,intra-ucx,3,1,0,0,1,0,0,0,0,0,0,5,3,4,TRUE,0.6,2023,2023-2024
KY,2023-07-31,intra-ui,936,211,132,151,129,118,91,90,57,312,369,2596,1305,1516,TRUE,0.502696456086287,2023,2023-2024
KY,2023-08-31,inter-total,18,5,1,1,3,2,1,2,1,10,13,57,31,36,TRUE,0.543859649122807,2023,2023-2024
KY,2023-08-31,inter-ucfe,1,0,0,0,0,0,0,1,0,0,0,2,1,1,TRUE,0.5,2023,2023-2024
KY,2023-08-31,inter-ucx,0,0,0,0,0,0,0,0,0,0,0,0,0,0,TRUE,0,2023,2023-2024
KY,2023-08-31,inter-ui,17,5,1,1,3,2,1,1,1,10,13,55,30,35,TRUE,0.545454545454545,2023,2023-2024
KY,2023-08-31,intra-total,772,305,153,126,92,72,55,57,51,284,546,2513,1318,1623,TRUE,0.524472741742937,2023,2023-2024
KY,2023-08-31,intra-ucfe,0,0,1,0,0,2,0,0,0,2,1,6,1,1,TRUE,0.166666666666667,2023,2023-2024
KY,2023-08-31,intra-ucx,1,3,1,0,0,0,0,0,0,3,2,10,3,6,TRUE,0.3,2023,2023-2024
KY,2023-08-31,intra-ui,771,302,151,126,92,70,55,57,51,279,543,2497,1314,1616,TRUE,0.526231477773328,2023,2023-2024
KY,2023-09-30,inter-total,9,2,2,4,2,0,0,4,0,9,5,37,14,16,TRUE,0.378378378378378,2023,2023-2024
KY,2023-09-30,inter-ucfe,0,0,0,0,0,0,0,0,0,1,0,1,0,0,TRUE,0,2023,2023-2024
KY,2023-09-30,inter-ucx,0,0,0,0,0,0,0,0,0,0,0,0,0,0,TRUE,0,2023,2023-2024
KY,2023-09-30,inter-ui,9,2,2,4,2,0,0,4,0,8,5,36,14,16,TRUE,0.388888888888889,2023,2023-2024
KY,2023-09-30,intra-total,619,148,77,37,29,29,29,21,10,178,324,1501,943,1091,TRUE,0.628247834776816,2023,2023-2024
KY,2023-09-30,intra-ucfe,0,0,0,0,2,0,0,0,0,1,1,4,1,1,TRUE,0.25,2023,2023-2024
KY,2023-09-30,intra-ucx,1,1,1,0,0,0,0,1,0,0,0,4,1,2,TRUE,0.25,2023,2023-2024
KY,2023-09-30,intra-ui,618,147,76,37,27,29,29,20,10,177,323,1493,941,1088,TRUE,0.630274614869391,2023,2023-2024
KY,2023-10-31,inter-total,19,1,3,2,0,0,0,0,0,4,5,34,24,25,TRUE,0.705882352941177,2023,2023-2024
KY,2023-10-31,inter-ucfe,0,0,0,0,0,0,0,0,0,0,0,0,0,0,TRUE,0,2023,2023-2024
KY,2023-10-31,inter-ucx,0,0,0,0,0,0,0,0,0,0,0,0,0,0,TRUE,0,2023,2023-2024
KY,2023-10-31,inter-ui,19,1,3,2,0,0,0,0,0,4,5,34,24,25,TRUE,0.705882352941177,2023,2023-2024
KY,2023-10-31,intra-total,1109,140,52,43,35,14,16,10,9,141,405,1974,1514,1654,TRUE,0.766970618034448,2023,2023-2024
KY,2023-10-31,intra-ucfe,2,1,1,0,0,0,2,0,0,1,1,8,3,4,TRUE,0.375,2023,2023-2024
KY,2023-10-31,intra-ucx,3,0,0,0,0,0,0,0,0,0,2,5,5,5,TRUE,1,2023,2023-2024
KY,2023-10-31,intra-ui,1104,139,51,43,35,14,14,10,9,140,402,1961,1506,1645,TRUE,0.767975522692504,2023,2023-2024
KY,2023-11-30,inter-total,12,2,1,2,1,0,0,1,0,4,7,30,19,21,TRUE,0.633333333333333,2023,2023-2024
KY,2023-11-30,inter-ucfe,0,0,0,0,0,0,0,0,0,0,0,0,0,0,TRUE,0,2023,2023-2024
KY,2023-11-30,inter-ucx,0,0,0,0,0,0,0,1,0,0,0,1,0,0,TRUE,0,2023,2023-2024
KY,2023-11-30,inter-ui,12,2,1,2,1,0,0,0,0,4,7,29,19,21,TRUE,0.655172413793103,2023,2023-2024
KY,2023-11-30,intra-total,996,264,106,53,18,10,9,7,7,126,528,2124,1524,1788,TRUE,0.717514124293785,2023,2023-2024
KY,2023-11-30,intra-ucfe,0,1,1,0,1,0,0,1,0,1,0,5,0,1,TRUE,0,2023,2023-2024
KY,2023-11-30,intra-ucx,0,3,0,0,0,0,0,0,0,1,0,4,0,3,TRUE,0,2023,2023-2024
KY,2023-11-30,intra-ui,996,260,105,53,17,10,9,6,7,124,528,2115,1524,1784,TRUE,0.720567375886525,2023,2023-2024
KY,2023-12-31,inter-total,13,0,3,2,1,1,0,0,0,1,5,26,18,18,TRUE,0.692307692307692,2023,2023-2024
KY,2023-12-31,inter-ucfe,1,0,0,0,0,0,0,0,0,0,0,1,1,1,TRUE,1,2023,2023-2024
KY,2023-12-31,inter-ucx,0,0,0,0,0,0,0,0,0,0,0,0,0,0,TRUE,0,2023,2023-2024
KY,2023-12-31,inter-ui,12,0,3,2,1,1,0,0,0,1,5,25,17,17,TRUE,0.68,2023,2023-2024
KY,2023-12-31,intra-total,869,185,196,111,38,28,15,13,3,76,227,1761,1096,1281,TRUE,0.622373651334469,2023,2023-2024
KY,2023-12-31,intra-ucfe,1,0,1,0,0,0,0,0,0,2,0,4,1,1,TRUE,0.25,2023,2023-2024
KY,2023-12-31,intra-ucx,3,0,0,0,0,0,0,0,0,0,0,3,3,3,TRUE,1,2023,2023-2024
KY,2023-12-31,intra-ui,865,185,195,111,38,28,15,13,3,74,227,1754,1092,1277,TRUE,0.622576966932725,2023,2023-2024
KY,2024-01-31,inter-total,26,2,0,4,5,1,2,1,1,1,8,51,34,36,TRUE,0.666666666666667,2023,2023-2024
KY,2024-01-31,inter-ucfe,0,0,0,0,0,0,0,0,0,0,0,0,0,0,TRUE,0,2023,2023-2024
KY,2024-01-31,inter-ucx,0,0,0,0,0,0,0,0,0,0,0,0,0,0,TRUE,0,2023,2023-2024
KY,2024-01-31,inter-ui,26,2,0,4,5,1,2,1,1,1,8,51,34,36,TRUE,0.666666666666667,2023,2023-2024
KY,2024-01-31,intra-total,2144,160,128,124,182,104,43,37,23,107,494,3546,2638,2798,TRUE,0.743936830231247,2023,2023-2024
KY,2024-01-31,intra-ucfe,0,0,0,0,0,1,0,0,0,3,4,8,4,4,TRUE,0.5,2023,2023-2024
KY,2024-01-31,intra-ucx,2,0,0,1,0,0,0,0,0,0,1,4,3,3,TRUE,0.75,2023,2023-2024
KY,2024-01-31,intra-ui,2142,160,128,123,182,103,43,37,23,104,489,3534,2631,2791,TRUE,0.744482173174873,2023,2023-2024
KY,2024-02-29,inter-total,20,0,4,0,0,0,1,0,1,5,4,35,24,24,TRUE,0.685714285714286,2023,2023-2024
KY,2024-02-29,inter-ucfe,0,0,0,0,0,0,0,0,0,0,0,0,0,0,TRUE,0,2023,2023-2024
KY,2024-02-29,inter-ucx,1,0,0,0,0,0,0,0,0,0,0,1,1,1,TRUE,1,2023,2023-2024
KY,2024-02-29,inter-ui,19,0,4,0,0,0,1,0,1,5,4,34,23,23,TRUE,0.676470588235294,2023,2023-2024
KY,2024-02-29,intra-total,1133,137,112,105,89,117,192,80,44,147,334,2490,1467,1604,TRUE,0.589156626506024,2023,2023-2024
KY,2024-02-29,intra-ucfe,1,0,2,1,0,0,0,1,0,2,0,7,1,1,TRUE,0.142857142857143,2023,2023-2024
KY,2024-02-29,intra-ucx,4,0,0,3,1,0,2,0,0,0,1,11,5,5,TRUE,0.454545454545455,2023,2023-2024
KY,2024-02-29,intra-ui,1128,137,110,101,88,117,190,79,44,145,333,2472,1461,1598,TRUE,0.591019417475728,2023,2023-2024
KY,2024-03-31,inter-total,21,3,1,1,1,2,5,4,3,6,7,54,28,31,TRUE,0.518518518518519,2023,2023-2024
KY,2024-03-31,inter-ucfe,0,0,0,0,0,0,0,0,0,0,0,0,0,0,TRUE,0,2023,2023-2024
KY,2024-03-31,inter-ucx,0,0,0,0,0,0,1,0,0,0,0,1,0,0,TRUE,0,2023,2023-2024
KY,2024-03-31,inter-ui,21,3,1,1,1,2,4,4,3,6,7,53,28,31,TRUE,0.528301886792453,2023,2023-2024
KY,2024-03-31,intra-total,626,69,62,71,76,125,151,90,38,144,174,1626,800,869,TRUE,0.492004920049201,2023,2023-2024
KY,2024-03-31,intra-ucfe,1,0,0,1,0,0,0,0,0,0,0,2,1,1,TRUE,0.5,2023,2023-2024
KY,2024-03-31,intra-ucx,1,1,0,0,0,2,1,0,0,2,3,10,4,5,TRUE,0.4,2023,2023-2024
KY,2024-03-31,intra-ui,624,68,62,70,76,123,150,90,38,142,171,1614,795,863,TRUE,0.492565055762082,2023,2023-2024
KY,2024-04-30,inter-total,14,2,1,0,1,2,1,3,0,5,5,34,19,21,TRUE,0.558823529411765,2023,2023-2024
KY,2024-04-30,inter-ucfe,0,0,0,0,0,0,0,0,0,0,0,0,0,0,TRUE,0,2023,2023-2024
KY,2024-04-30,inter-ucx,0,0,0,0,0,0,0,0,0,0,0,0,0,0,TRUE,0,2023,2023-2024
KY,2024-04-30,inter-ui,14,2,1,0,1,2,1,3,0,5,5,34,19,21,TRUE,0.558823529411765,2023,2023-2024
KY,2024-04-30,intra-total,682,68,36,21,44,55,58,82,148,263,209,1666,891,959,TRUE,0.534813925570228,2023,2023-2024
KY,2024-04-30,intra-ucfe,0,1,0,0,0,0,0,0,0,4,0,5,0,1,TRUE,0,2023,2023-2024
KY,2024-04-30,intra-ucx,4,1,0,0,0,0,0,0,1,2,0,8,4,5,TRUE,0.5,2023,2023-2024
KY,2024-04-30,intra-ui,678,66,36,21,44,55,58,82,147,257,209,1653,887,953,TRUE,0.536600120992136,2023,2023-2024
KY,2024-05-31,inter-total,19,2,0,0,0,0,1,0,0,7,6,35,25,27,TRUE,0.714285714285714,2023,2023-2024
KY,2024-05-31,inter-ucfe,0,0,0,0,0,0,1,0,0,0,1,2,1,1,TRUE,0.5,2023,2023-2024
KY,2024-05-31,inter-ucx,0,0,0,0,0,0,0,0,0,0,0,0,0,0,TRUE,0,2023,2023-2024
KY,2024-05-31,inter-ui,19,2,0,0,0,0,0,0,0,7,5,33,24,26,TRUE,0.727272727272727,2023,2023-2024
KY,2024-05-31,intra-total,784,63,29,31,15,37,31,38,117,406,190,1741,974,1037,TRUE,0.55944859276278,2023,2023-2024
KY,2024-05-31,intra-ucfe,0,1,0,0,1,0,0,0,0,4,0,6,0,1,TRUE,0,2023,2023-2024
KY,2024-05-31,intra-ucx,2,0,0,0,0,0,1,0,0,1,0,4,2,2,TRUE,0.5,2023,2023-2024
KY,2024-05-31,intra-ui,782,62,29,31,14,37,30,38,117,401,190,1731,972,1034,TRUE,0.561525129982669,2023,2023-2024
KY,2024-06-30,inter-total,18,2,2,0,0,1,0,0,1,6,2,32,20,22,TRUE,0.625,2023,2023-2024
KY,2024-06-30,inter-ucfe,1,0,0,0,0,0,0,0,0,0,0,1,1,1,TRUE,1,2023,2023-2024
KY,2024-06-30,inter-ucx,0,0,0,0,0,0,0,0,0,0,0,0,0,0,TRUE,0,2023,2023-2024
KY,2024-06-30,inter-ui,17,2,2,0,0,1,0,0,1,6,2,31,19,21,TRUE,0.612903225806452,2023,2023-2024
KY,2024-06-30,intra-total,775,53,31,15,22,18,31,44,38,446,213,1686,988,1041,TRUE,0.586002372479241,2023,2023-2024
KY,2024-06-30,intra-ucfe,0,0,2,0,0,0,0,0,0,2,0,4,0,0,TRUE,0,2023,2023-2024
KY,2024-06-30,intra-ucx,2,0,0,0,1,0,0,0,0,0,0,3,2,2,TRUE,0.666666666666667,2023,2023-2024
KY,2024-06-30,intra-ui,773,53,29,15,21,18,31,44,38,444,213,1679,986,1039,TRUE,0.587254318046456,2023,2023-2024
KY,2024-07-31,inter-total,5,1,1,6,0,1,1,0,2,9,8,34,13,14,TRUE,0.382352941176471,2024,2024-2025
KY,2024-07-31,inter-ucfe,0,0,0,1,0,0,0,0,0,0,1,2,1,1,TRUE,0.5,2024,2024-2025
KY,2024-07-31,inter-ucx,0,0,0,0,0,0,0,0,0,0,0,0,0,0,TRUE,0,2024,2024-2025
KY,2024-07-31,inter-ui,5,1,1,5,0,1,1,0,2,9,7,32,12,13,TRUE,0.375,2024,2024-2025
KY,2024-07-31,intra-total,1148,77,50,28,15,19,41,25,35,499,272,2209,1420,1497,TRUE,0.642824807605251,2024,2024-2025
KY,2024-07-31,intra-ucfe,0,0,0,1,1,0,0,0,0,2,0,4,0,0,TRUE,0,2024,2024-2025
KY,2024-07-31,intra-ucx,2,0,0,0,1,0,0,0,0,1,2,6,4,4,TRUE,0.666666666666667,2024,2024-2025
KY,2024-07-31,intra-ui,1146,77,50,27,13,19,41,25,35,496,270,2199,1416,1493,TRUE,0.643929058663029,2024,2024-2025
KY,2024-08-31,inter-total,13,1,0,3,2,0,0,0,0,18,3,40,16,17,TRUE,0.4,2024,2024-2025
KY,2024-08-31,inter-ucfe,0,0,0,0,0,0,0,0,0,0,0,0,0,0,TRUE,0,2024,2024-2025
KY,2024-08-31,inter-ucx,0,0,0,0,0,0,0,0,0,0,0,0,0,0,TRUE,0,2024,2024-2025
KY,2024-08-31,inter-ui,13,1,0,3,2,0,0,0,0,18,3,40,16,17,TRUE,0.4,2024,2024-2025
KY,2024-08-31,intra-total,743,46,44,32,18,19,19,21,11,661,192,1806,935,981,TRUE,0.517718715393134,2024,2024-2025
KY,2024-08-31,intra-ucfe,0,1,0,0,0,0,0,1,0,4,1,7,1,2,TRUE,0.142857142857143,2024,2024-2025
KY,2024-08-31,intra-ucx,3,1,0,0,0,0,1,0,0,1,1,7,4,5,TRUE,0.571428571428571,2024,2024-2025
KY,2024-08-31,intra-ui,740,44,44,32,18,19,18,20,11,656,190,1792,930,974,TRUE,0.518973214285714,2024,2024-2025
KY,2024-09-30,inter-total,18,3,1,1,0,0,1,0,0,9,8,41,26,29,TRUE,0.634146341463415,2024,2024-2025
KY,2024-09-30,inter-ucfe,0,0,0,0,0,0,0,0,0,0,0,0,0,0,TRUE,0,2024,2024-2025
KY,2024-09-30,inter-ucx,0,0,0,0,0,0,0,0,0,0,0,0,0,0,TRUE,0,2024,2024-2025
KY,2024-09-30,inter-ui,18,3,1,1,0,0,1,0,0,9,8,41,26,29,TRUE,0.634146341463415,2024,2024-2025
KY,2024-09-30,intra-total,589,41,22,19,9,15,10,23,12,612,155,1507,744,785,TRUE,0.493696084936961,2024,2024-2025
KY,2024-09-30,intra-ucfe,0,0,0,0,0,0,0,0,0,1,0,1,0,0,TRUE,0,2024,2024-2025
KY,2024-09-30,intra-ucx,2,0,0,0,0,0,0,0,0,1,0,3,2,2,TRUE,0.666666666666667,2024,2024-2025
KY,2024-09-30,intra-ui,587,41,22,19,9,15,10,23,12,610,155,1503,742,783,TRUE,0.493679308050566,2024,2024-2025
KY,2024-10-31,inter-total,20,1,0,1,2,0,0,0,1,19,1,45,21,22,TRUE,0.466666666666667,2024,2024-2025
KY,2024-10-31,inter-ucfe,0,0,0,0,0,0,0,0,0,0,0,0,0,0,TRUE,0,2024,2024-2025
KY,2024-10-31,inter-ucx,0,0,0,0,0,0,0,0,0,0,0,0,0,0,TRUE,0,2024,2024-2025
KY,2024-10-31,inter-ui,20,1,0,1,2,0,0,0,1,19,1,45,21,22,TRUE,0.466666666666667,2024,2024-2025
KY,2024-10-31,intra-total,821,55,26,22,18,13,16,15,17,933,163,2099,984,1039,TRUE,0.468794664125774,2024,2024-2025
KY,2024-10-31,intra-ucfe,2,0,1,0,1,0,0,0,0,1,0,5,2,2,TRUE,0.4,2024,2024-2025
KY,2024-10-31,intra-ucx,3,0,0,0,0,0,0,0,0,2,0,5,3,3,TRUE,0.6,2024,2024-2025
KY,2024-10-31,intra-ui,816,55,25,22,17,13,16,15,17,930,163,2089,979,1034,TRUE,0.468645284825275,2024,2024-2025
KY,2024-11-30,inter-total,20,2,1,0,0,1,0,0,0,10,8,42,28,30,TRUE,0.666666666666667,2024,2024-2025
KY,2024-11-30,inter-ucfe,0,0,0,0,0,0,0,0,0,0,0,0,0,0,TRUE,0,2024,2024-2025
KY,2024-11-30,inter-ucx,0,0,1,0,0,0,0,0,0,0,0,1,0,0,TRUE,0,2024,2024-2025
KY,2024-11-30,inter-ui,20,2,0,0,0,1,0,0,0,10,8,41,28,30,TRUE,0.682926829268293,2024,2024-2025
KY,2024-11-30,intra-total,847,56,25,20,9,10,10,17,18,684,210,1906,1057,1113,TRUE,0.554564533053515,2024,2024-2025
KY,2024-11-30,intra-ucfe,1,1,0,0,0,0,1,0,0,3,2,8,3,4,TRUE,0.375,2024,2024-2025
KY,2024-11-30,intra-ucx,3,0,0,0,0,0,0,0,0,2,2,7,5,5,TRUE,0.714285714285714,2024,2024-2025
KY,2024-11-30,intra-ui,843,55,25,20,9,10,9,17,18,679,206,1891,1049,1104,TRUE,0.554732945531465,2024,2024-2025
LA,2019-01-31,inter-total,190,31,4,1,1,1,1,1,0,2,111,343,301,332,FALSE,0.967930029154519,2018,2018-2019
LA,2019-01-31,inter-ucfe,2,0,0,0,0,0,0,0,0,0,1,3,3,3,FALSE,1,2018,2018-2019
LA,2019-01-31,inter-ucx,0,0,0,0,0,0,0,0,0,0,0,0,0,0,FALSE,0,2018,2018-2019
LA,2019-01-31,inter-ui,188,31,4,1,1,1,1,1,0,2,110,340,298,329,FALSE,0.967647058823529,2018,2018-2019
LA,2019-01-31,intra-total,1779,295,69,29,32,27,16,13,6,20,1030,3316,2809,3104,FALSE,0.936067551266586,2018,2018-2019
LA,2019-01-31,intra-ucfe,77,0,0,0,0,1,0,0,0,1,13,92,90,90,FALSE,0.978260869565217,2018,2018-2019
LA,2019-01-31,intra-ucx,3,0,0,0,0,0,0,0,0,0,1,4,4,4,FALSE,1,2018,2018-2019
LA,2019-01-31,intra-ui,1699,295,69,29,32,26,16,13,6,19,1016,3220,2715,3010,FALSE,0.934782608695652,2018,2018-2019
LA,2019-02-28,inter-total,213,3,3,1,0,1,0,0,0,1,48,270,261,264,FALSE,0.977777777777778,2018,2018-2019
LA,2019-02-28,inter-ucfe,0,0,0,0,0,0,0,0,0,0,1,1,1,1,FALSE,1,2018,2018-2019
LA,2019-02-28,inter-ucx,0,0,0,0,0,0,0,0,0,0,0,0,0,0,FALSE,0,2018,2018-2019
LA,2019-02-28,inter-ui,213,3,3,1,0,1,0,0,0,1,47,269,260,263,FALSE,0.977695167286245,2018,2018-2019
LA,2019-02-28,intra-total,1732,47,15,23,33,16,12,6,2,21,445,2352,2177,2224,FALSE,0.945578231292517,2018,2018-2019
LA,2019-02-28,intra-ucfe,0,4,1,2,0,0,1,1,0,2,3,14,3,7,FALSE,0.5,2018,2018-2019
LA,2019-02-28,intra-ucx,3,0,0,0,0,0,1,0,0,0,0,4,3,3,FALSE,0.75,2018,2018-2019
LA,2019-02-28,intra-ui,1729,43,14,21,33,16,10,5,2,19,442,2334,2171,2214,FALSE,0.948586118251928,2018,2018-2019
LA,2019-03-31,inter-total,148,6,0,3,2,0,1,0,0,0,37,197,185,191,FALSE,0.969543147208122,2018,2018-2019
LA,2019-03-31,inter-ucfe,0,0,0,0,0,0,0,0,0,0,1,1,1,1,FALSE,1,2018,2018-2019
LA,2019-03-31,inter-ucx,0,0,0,0,0,0,0,0,0,0,0,0,0,0,FALSE,0,2018,2018-2019
LA,2019-03-31,inter-ui,148,6,0,3,2,0,1,0,0,0,36,196,184,190,FALSE,0.969387755102041,2018,2018-2019
LA,2019-03-31,intra-total,1277,82,34,39,23,18,10,9,6,17,423,1938,1700,1782,FALSE,0.919504643962848,2018,2018-2019
LA,2019-03-31,intra-ucfe,2,0,0,0,0,0,0,0,0,1,2,5,4,4,FALSE,0.8,2018,2018-2019
LA,2019-03-31,intra-ucx,1,0,0,0,0,0,0,0,0,0,0,1,1,1,FALSE,1,2018,2018-2019
LA,2019-03-31,intra-ui,1274,82,34,39,23,18,10,9,6,16,421,1932,1695,1777,FALSE,0.919772256728779,2018,2018-2019
LA,2019-04-30,inter-total,136,3,0,1,0,1,0,0,0,4,57,202,193,196,FALSE,0.97029702970297,2018,2018-2019
LA,2019-04-30,inter-ucfe,0,0,0,1,0,1,0,0,0,1,0,3,0,0,FALSE,0,2018,2018-2019
LA,2019-04-30,inter-ucx,0,0,0,0,0,0,0,0,0,0,0,0,0,0,FALSE,0,2018,2018-2019
LA,2019-04-30,inter-ui,136,3,0,0,0,0,0,0,0,3,57,199,193,196,FALSE,0.984924623115578,2018,2018-2019
LA,2019-04-30,intra-total,1395,47,24,19,15,8,6,5,1,70,433,2023,1828,1875,FALSE,0.9268413247652,2018,2018-2019
LA,2019-04-30,intra-ucfe,5,0,0,0,0,0,0,0,0,2,1,8,6,6,FALSE,0.75,2018,2018-2019
LA,2019-04-30,intra-ucx,2,0,0,0,0,0,0,0,0,1,0,3,2,2,FALSE,0.666666666666667,2018,2018-2019
LA,2019-04-30,intra-ui,1388,47,24,19,15,8,6,5,1,67,432,2012,1820,1867,FALSE,0.9279324055666,2018,2018-2019
LA,2019-05-31,inter-total,151,5,0,2,1,2,1,0,0,4,48,214,199,204,FALSE,0.953271028037383,2018,2018-2019
LA,2019-05-31,inter-ucfe,0,0,0,0,0,0,0,0,0,0,0,0,0,0,FALSE,0,2018,2018-2019
LA,2019-05-31,inter-ucx,0,0,0,0,0,0,0,0,0,0,0,0,0,0,FALSE,0,2018,2018-2019
LA,2019-05-31,inter-ui,151,5,0,2,1,2,1,0,0,4,48,214,199,204,FALSE,0.953271028037383,2018,2018-2019
LA,2019-05-31,intra-total,1560,87,31,30,24,15,5,2,2,26,642,2424,2202,2289,FALSE,0.944306930693069,2018,2018-2019
LA,2019-05-31,intra-ucfe,7,0,2,0,0,0,0,0,0,2,4,15,11,11,FALSE,0.733333333333333,2018,2018-2019
LA,2019-05-31,intra-ucx,1,0,0,0,0,0,0,0,0,0,1,2,2,2,FALSE,1,2018,2018-2019
LA,2019-05-31,intra-ui,1552,87,29,30,24,15,5,2,2,24,637,2407,2189,2276,FALSE,0.94557540506855,2018,2018-2019
LA,2019-06-30,inter-total,127,9,5,1,2,0,0,1,1,0,76,222,203,212,FALSE,0.954954954954955,2018,2018-2019
LA,2019-06-30,inter-ucfe,1,0,1,0,0,0,0,0,0,0,0,2,1,1,FALSE,0.5,2018,2018-2019
LA,2019-06-30,inter-ucx,0,0,0,0,0,0,0,0,0,0,0,0,0,0,FALSE,0,2018,2018-2019
LA,2019-06-30,inter-ui,126,9,4,1,2,0,0,1,1,0,76,220,202,211,FALSE,0.959090909090909,2018,2018-2019
LA,2019-06-30,intra-total,2557,182,35,22,19,17,7,7,3,20,1165,4034,3722,3904,FALSE,0.96777392166584,2018,2018-2019
LA,2019-06-30,intra-ucfe,4,2,0,1,0,0,0,0,0,0,3,10,7,9,FALSE,0.9,2018,2018-2019
LA,2019-06-30,intra-ucx,1,1,0,0,0,0,0,0,0,0,1,3,2,3,FALSE,1,2018,2018-2019
LA,2019-06-30,intra-ui,2552,179,35,21,19,17,7,7,3,20,1161,4021,3713,3892,FALSE,0.967918428251679,2018,2018-2019
LA,2019-07-31,inter-total,193,15,3,2,1,0,0,2,0,2,83,301,276,291,FALSE,0.966777408637874,2019,2019-2020
LA,2019-07-31,inter-ucfe,0,0,0,0,0,0,0,0,0,0,0,0,0,0,FALSE,0,2019,2019-2020
LA,2019-07-31,inter-ucx,0,0,0,0,0,0,0,0,0,0,0,0,0,0,FALSE,0,2019,2019-2020
LA,2019-07-31,inter-ui,193,15,3,2,1,0,0,2,0,2,83,301,276,291,FALSE,0.966777408637874,2019,2019-2020
LA,2019-07-31,intra-total,2159,172,41,42,31,26,14,7,3,10,1193,3698,3352,3524,FALSE,0.952947539210384,2019,2019-2020
LA,2019-07-31,intra-ucfe,4,2,0,0,0,0,0,0,0,0,5,11,9,11,FALSE,1,2019,2019-2020
LA,2019-07-31,intra-ucx,2,0,0,0,0,0,0,0,0,0,2,4,4,4,FALSE,1,2019,2019-2020
LA,2019-07-31,intra-ui,2153,170,41,42,31,26,14,7,3,10,1186,3683,3339,3509,FALSE,0.952755905511811,2019,2019-2020
LA,2019-08-31,inter-total,176,11,2,5,0,1,0,1,1,1,67,265,243,254,FALSE,0.958490566037736,2019,2019-2020
LA,2019-08-31,inter-ucfe,0,0,0,0,0,0,0,0,0,0,1,1,1,1,FALSE,1,2019,2019-2020
LA,2019-08-31,inter-ucx,1,0,0,0,0,0,0,0,0,0,0,1,1,1,FALSE,1,2019,2019-2020
LA,2019-08-31,inter-ui,175,11,2,5,0,1,0,1,1,1,66,263,241,252,FALSE,0.958174904942966,2019,2019-2020
LA,2019-08-31,intra-total,1651,138,40,36,28,23,21,5,4,23,849,2818,2500,2638,FALSE,0.936124911284599,2019,2019-2020
LA,2019-08-31,intra-ucfe,5,3,0,0,0,0,0,0,0,0,4,12,9,12,FALSE,1,2019,2019-2020
LA,2019-08-31,intra-ucx,1,1,0,0,0,0,0,0,0,0,3,5,4,5,FALSE,1,2019,2019-2020
LA,2019-08-31,intra-ui,1645,134,40,36,28,23,21,5,4,23,842,2801,2487,2621,FALSE,0.935737236701178,2019,2019-2020
LA,2019-09-30,inter-total,156,7,5,5,0,1,0,1,0,2,39,216,195,202,FALSE,0.935185185185185,2019,2019-2020
LA,2019-09-30,inter-ucfe,0,0,0,0,0,0,0,0,0,0,0,0,0,0,FALSE,0,2019,2019-2020
LA,2019-09-30,inter-ucx,0,0,0,0,0,0,0,0,0,0,0,0,0,0,FALSE,0,2019,2019-2020
LA,2019-09-30,inter-ui,156,7,5,5,0,1,0,1,0,2,39,216,195,202,FALSE,0.935185185185185,2019,2019-2020
LA,2019-09-30,intra-total,1357,124,42,32,33,18,12,9,4,21,653,2305,2010,2134,FALSE,0.925813449023861,2019,2019-2020
LA,2019-09-30,intra-ucfe,7,0,0,0,1,0,0,0,0,1,4,13,11,11,FALSE,0.846153846153846,2019,2019-2020
LA,2019-09-30,intra-ucx,1,0,0,0,0,0,0,0,0,0,1,2,2,2,FALSE,1,2019,2019-2020
LA,2019-09-30,intra-ui,1349,124,42,32,32,18,12,9,4,20,648,2290,1997,2121,FALSE,0.926200873362445,2019,2019-2020
LA,2019-10-31,inter-total,161,1,2,2,0,0,1,1,0,2,29,199,190,191,FALSE,0.959798994974874,2019,2019-2020
LA,2019-10-31,inter-ucfe,0,0,0,0,0,0,0,0,0,0,0,0,0,0,FALSE,0,2019,2019-2020
LA,2019-10-31,inter-ucx,0,0,0,0,0,0,0,0,0,0,0,0,0,0,FALSE,0,2019,2019-2020
LA,2019-10-31,inter-ui,161,1,2,2,0,0,1,1,0,2,29,199,190,191,FALSE,0.959798994974874,2019,2019-2020
LA,2019-10-31,intra-total,1651,58,20,35,28,24,15,3,4,16,525,2379,2176,2234,FALSE,0.939050021017234,2019,2019-2020
LA,2019-10-31,intra-ucfe,7,3,0,0,0,0,0,0,0,0,6,16,13,16,FALSE,1,2019,2019-2020
LA,2019-10-31,intra-ucx,1,0,0,0,0,0,0,0,0,0,1,2,2,2,FALSE,1,2019,2019-2020
LA,2019-10-31,intra-ui,1643,55,20,35,28,24,15,3,4,16,518,2361,2161,2216,FALSE,0.938585345192715,2019,2019-2020
LA,2019-11-30,inter-total,159,5,1,0,3,0,0,0,0,3,46,217,205,210,FALSE,0.967741935483871,2019,2019-2020
LA,2019-11-30,inter-ucfe,0,0,0,0,0,0,0,0,0,0,0,0,0,0,FALSE,0,2019,2019-2020
LA,2019-11-30,inter-ucx,0,0,0,0,0,0,0,0,0,0,0,0,0,0,FALSE,0,2019,2019-2020
LA,2019-11-30,inter-ui,159,5,1,0,3,0,0,0,0,3,46,217,205,210,FALSE,0.967741935483871,2019,2019-2020
LA,2019-11-30,intra-total,1381,55,28,23,23,22,9,5,4,26,500,2076,1881,1936,FALSE,0.932562620423892,2019,2019-2020
LA,2019-11-30,intra-ucfe,3,0,1,0,0,0,0,0,0,0,5,9,8,8,FALSE,0.888888888888889,2019,2019-2020
LA,2019-11-30,intra-ucx,1,0,0,0,0,0,0,0,0,0,1,2,2,2,FALSE,1,2019,2019-2020
LA,2019-11-30,intra-ui,1377,55,27,23,23,22,9,5,4,26,494,2065,1871,1926,FALSE,0.932687651331719,2019,2019-2020
LA,2019-12-31,inter-total,227,7,1,1,1,1,0,0,0,1,81,320,308,315,FALSE,0.984375,2019,2019-2020
LA,2019-12-31,inter-ucfe,0,0,0,0,0,0,0,0,0,0,0,0,0,0,FALSE,0,2019,2019-2020
LA,2019-12-31,inter-ucx,0,0,0,0,0,0,0,0,0,0,0,0,0,0,FALSE,0,2019,2019-2020
LA,2019-12-31,inter-ui,227,7,1,1,1,1,0,0,0,1,81,320,308,315,FALSE,0.984375,2019,2019-2020
LA,2019-12-31,intra-total,1541,88,29,24,23,12,10,9,3,22,692,2453,2233,2321,FALSE,0.946188340807175,2019,2019-2020
LA,2019-12-31,intra-ucfe,4,0,1,0,0,0,0,0,0,1,3,9,7,7,FALSE,0.777777777777778,2019,2019-2020
LA,2019-12-31,intra-ucx,1,0,0,0,0,0,0,0,0,0,1,2,2,2,FALSE,1,2019,2019-2020
LA,2019-12-31,intra-ui,1536,88,28,24,23,12,10,9,3,21,688,2442,2224,2312,FALSE,0.946764946764947,2019,2019-2020
LA,2020-01-31,inter-total,250,17,6,1,0,1,1,1,0,1,75,353,325,342,FALSE,0.968838526912181,2019,2019-2020
LA,2020-01-31,inter-ucfe,0,0,0,0,0,0,0,0,0,0,0,0,0,0,FALSE,0,2019,2019-2020
LA,2020-01-31,inter-ucx,0,0,0,0,0,0,0,0,0,0,0,0,0,0,FALSE,0,2019,2019-2020
LA,2020-01-31,inter-ui,250,17,6,1,0,1,1,1,0,1,75,353,325,342,FALSE,0.968838526912181,2019,2019-2020
LA,2020-01-31,intra-total,1723,182,31,29,25,12,10,9,6,30,902,2959,2625,2807,FALSE,0.948631294356201,2019,2019-2020
LA,2020-01-31,intra-ucfe,5,1,0,0,0,0,1,0,0,0,0,7,5,6,FALSE,0.857142857142857,2019,2019-2020
LA,2020-01-31,intra-ucx,2,0,0,0,0,0,0,0,0,0,3,5,5,5,FALSE,1,2019,2019-2020
LA,2020-01-31,intra-ui,1716,181,31,29,25,12,9,9,6,30,899,2947,2615,2796,FALSE,0.948761452324398,2019,2019-2020
LA,2020-02-29,inter-total,263,6,0,3,2,0,0,0,0,1,44,319,307,313,FALSE,0.981191222570533,2019,2019-2020
LA,2020-02-29,inter-ucfe,0,0,0,0,0,0,0,0,0,0,0,0,0,0,FALSE,0,2019,2019-2020
LA,2020-02-29,inter-ucx,0,0,0,0,0,0,0,0,0,0,0,0,0,0,FALSE,0,2019,2019-2020
LA,2020-02-29,inter-ui,263,6,0,3,2,0,0,0,0,1,44,319,307,313,FALSE,0.981191222570533,2019,2019-2020
LA,2020-02-29,intra-total,1483,51,17,21,19,9,11,9,9,20,594,2243,2077,2128,FALSE,0.948729380294249,2019,2019-2020
LA,2020-02-29,intra-ucfe,1,0,0,0,0,0,0,0,0,1,2,4,3,3,FALSE,0.75,2019,2019-2020
LA,2020-02-29,intra-ucx,2,0,0,0,0,0,0,0,0,0,0,2,2,2,FALSE,1,2019,2019-2020
LA,2020-02-29,intra-ui,1480,51,17,21,19,9,11,9,9,19,592,2237,2072,2123,FALSE,0.949038891372374,2019,2019-2020
LA,2020-03-31,inter-total,787,6,2,2,1,2,0,0,0,0,105,905,892,898,FALSE,0.992265193370166,2019,2019-2020
LA,2020-03-31,inter-ucfe,0,0,0,0,0,0,0,0,0,0,1,1,1,1,FALSE,1,2019,2019-2020
LA,2020-03-31,inter-ucx,0,0,0,0,0,0,0,0,0,0,0,0,0,0,FALSE,0,2019,2019-2020
LA,2020-03-31,inter-ui,787,6,2,2,1,2,0,0,0,0,104,904,891,897,FALSE,0.992256637168142,2019,2019-2020
LA,2020-03-31,intra-total,42073,123,25,36,26,18,11,7,2,17,2103,44441,44176,44299,FALSE,0.996804752368309,2019,2019-2020
LA,2020-03-31,intra-ucfe,6,0,0,0,0,0,0,0,0,0,3,9,9,9,FALSE,1,2019,2019-2020
LA,2020-03-31,intra-ucx,3,0,0,0,0,0,0,0,0,0,3,6,6,6,FALSE,1,2019,2019-2020
LA,2020-03-31,intra-ui,42064,123,25,36,26,18,11,7,2,17,2097,44426,44161,44284,FALSE,0.996803673524513,2019,2019-2020
LA,2020-04-30,inter-total,4112,66,30,9,5,1,0,0,0,2,492,4717,4604,4670,FALSE,0.99003603985584,2019,2019-2020
LA,2020-04-30,inter-ucfe,0,0,0,0,0,0,0,0,0,0,0,0,0,0,FALSE,0,2019,2019-2020
LA,2020-04-30,inter-ucx,0,0,0,0,0,0,0,0,0,0,1,1,1,1,FALSE,1,2019,2019-2020
LA,2020-04-30,inter-ui,4112,66,30,9,5,1,0,0,0,2,491,4716,4603,4669,FALSE,0.990033927056828,2019,2019-2020
LA,2020-04-30,intra-total,190642,3385,891,263,62,19,12,9,2,68,26298,221651,216940,220325,FALSE,0.994017622298117,2019,2019-2020
LA,2020-04-30,intra-ucfe,22,7,1,0,0,0,0,0,0,0,22,52,44,51,FALSE,0.980769230769231,2019,2019-2020
LA,2020-04-30,intra-ucx,12,4,0,0,0,0,0,0,0,0,8,24,20,24,FALSE,1,2019,2019-2020
LA,2020-04-30,intra-ui,190608,3374,890,263,62,19,12,9,2,68,26268,221575,216876,220250,FALSE,0.994020083493174,2019,2019-2020
LA,2020-05-31,inter-total,1933,111,60,30,14,7,2,4,0,4,249,2414,2182,2293,FALSE,0.949875724937862,2019,2019-2020
LA,2020-05-31,inter-ucfe,0,0,0,0,0,0,0,0,0,0,0,0,0,0,FALSE,0,2019,2019-2020
LA,2020-05-31,inter-ucx,0,0,0,0,0,0,0,0,0,0,0,0,0,0,FALSE,0,2019,2019-2020
LA,2020-05-31,inter-ui,1933,111,60,30,14,7,2,4,0,4,249,2414,2182,2293,FALSE,0.949875724937862,2019,2019-2020
LA,2020-05-31,intra-total,53003,3136,1571,661,335,109,60,17,7,180,6319,65398,59322,62458,FALSE,0.955044496773602,2019,2019-2020
LA,2020-05-31,intra-ucfe,1,2,2,1,2,0,0,0,0,0,0,8,1,3,FALSE,0.375,2019,2019-2020
LA,2020-05-31,intra-ucx,1,4,0,1,0,0,1,0,0,0,2,9,3,7,FALSE,0.777777777777778,2019,2019-2020
LA,2020-05-31,intra-ui,53001,3130,1569,659,333,109,59,17,7,180,6317,65381,59318,62448,FALSE,0.955139872440006,2019,2019-2020
LA,2020-06-30,inter-total,1089,134,99,40,17,12,8,5,8,9,268,1689,1357,1491,FALSE,0.882770870337478,2019,2019-2020
LA,2020-06-30,inter-ucfe,0,0,0,0,0,0,0,0,0,0,0,0,0,0,FALSE,0,2019,2019-2020
LA,2020-06-30,inter-ucx,0,0,0,1,0,0,0,0,0,0,0,1,0,0,FALSE,0,2019,2019-2020
LA,2020-06-30,inter-ui,1089,134,99,39,17,12,8,5,8,9,268,1688,1357,1491,FALSE,0.883293838862559,2019,2019-2020
LA,2020-06-30,intra-total,26956,2505,2156,937,419,213,86,76,56,94,5634,39132,32590,35095,FALSE,0.896836348768271,2019,2019-2020
LA,2020-06-30,intra-ucfe,9,2,0,3,2,1,1,1,0,1,7,27,16,18,FALSE,0.666666666666667,2019,2019-2020
LA,2020-06-30,intra-ucx,0,1,1,5,4,4,2,0,0,0,0,17,0,1,FALSE,0.0588235294117647,2019,2019-2020
LA,2020-06-30,intra-ui,26947,2502,2155,929,413,208,83,75,56,93,5627,39088,32574,35076,FALSE,0.897359803520262,2019,2019-2020
LA,2020-07-31,inter-total,926,66,36,46,35,13,14,5,2,7,252,1402,1178,1244,FALSE,0.887303851640514,2020,2020-2021
LA,2020-07-31,inter-ucfe,0,0,0,0,0,0,0,0,0,0,0,0,0,0,FALSE,0,2020,2020-2021
LA,2020-07-31,inter-ucx,0,0,0,0,0,0,0,0,0,0,0,0,0,0,FALSE,0,2020,2020-2021
LA,2020-07-31,inter-ui,926,66,36,46,35,13,14,5,2,7,252,1402,1178,1244,FALSE,0.887303851640514,2020,2020-2021
LA,2020-07-31,intra-total,25155,1595,1184,1209,912,476,227,153,75,346,4919,36251,30074,31669,FALSE,0.873603486800364,2020,2020-2021
LA,2020-07-31,intra-ucfe,12,1,4,6,6,2,1,1,1,3,5,42,17,18,FALSE,0.428571428571429,2020,2020-2021
LA,2020-07-31,intra-ucx,3,2,1,3,7,1,1,2,3,10,2,35,5,7,FALSE,0.2,2020,2020-2021
LA,2020-07-31,intra-ui,25140,1592,1179,1200,899,473,225,150,71,333,4912,36174,30052,31644,FALSE,0.874771935644386,2020,2020-2021
LA,2020-08-31,inter-total,8,4,0,2,0,0,0,0,0,1,5,20,13,17,FALSE,0.85,2020,2020-2021
LA,2020-08-31,inter-ucfe,0,0,0,0,0,0,0,0,0,0,0,0,0,0,FALSE,0,2020,2020-2021
LA,2020-08-31,inter-ucx,0,0,0,0,0,0,0,0,0,0,0,0,0,0,FALSE,0,2020,2020-2021
LA,2020-08-31,inter-ui,8,4,0,2,0,0,0,0,0,1,5,20,13,17,FALSE,0.85,2020,2020-2021
LA,2020-08-31,intra-total,403,138,51,34,26,32,21,13,11,23,162,914,565,703,FALSE,0.769146608315099,2020,2020-2021
LA,2020-08-31,intra-ucfe,0,0,1,0,0,0,1,0,0,5,0,7,0,0,FALSE,0,2020,2020-2021
LA,2020-08-31,intra-ucx,0,0,0,0,1,0,0,0,0,1,0,2,0,0,FALSE,0,2020,2020-2021
LA,2020-08-31,intra-ui,403,138,50,34,25,32,20,13,11,17,162,905,565,703,FALSE,0.776795580110497,2020,2020-2021
LA,2020-09-30,inter-total,118,87,20,19,13,10,13,24,16,34,201,555,319,406,FALSE,0.731531531531532,2020,2020-2021
LA,2020-09-30,inter-ucfe,0,0,0,0,0,0,0,0,0,0,0,0,0,0,FALSE,0,2020,2020-2021
LA,2020-09-30,inter-ucx,0,0,0,0,0,0,0,0,0,0,0,0,0,0,FALSE,0,2020,2020-2021
LA,2020-09-30,inter-ui,118,87,20,19,13,10,13,24,16,34,201,555,319,406,FALSE,0.731531531531532,2020,2020-2021
LA,2020-09-30,intra-total,3213,1324,464,233,137,163,268,334,343,553,3530,10562,6743,8067,FALSE,0.763775800037872,2020,2020-2021
LA,2020-09-30,intra-ucfe,0,6,1,9,1,4,2,2,2,10,1,38,1,7,FALSE,0.184210526315789,2020,2020-2021
LA,2020-09-30,intra-ucx,0,2,4,5,3,1,1,0,0,6,1,23,1,3,FALSE,0.130434782608696,2020,2020-2021
LA,2020-09-30,intra-ui,3213,1316,459,219,133,158,265,332,341,537,3528,10501,6741,8057,FALSE,0.767260260927531,2020,2020-2021
LA,2020-10-31,inter-total,106,57,26,22,26,24,55,1,7,59,179,562,285,342,FALSE,0.608540925266904,2020,2020-2021
LA,2020-10-31,inter-ucfe,0,0,0,0,0,0,1,0,0,0,0,1,0,0,FALSE,0,2020,2020-2021
LA,2020-10-31,inter-ucx,0,0,0,0,0,0,0,0,0,0,0,0,0,0,FALSE,0,2020,2020-2021
LA,2020-10-31,inter-ui,106,57,26,22,26,24,54,1,7,59,179,561,285,342,FALSE,0.609625668449198,2020,2020-2021
LA,2020-10-31,intra-total,2203,924,382,373,477,801,1884,41,56,922,3269,11332,5472,6396,FALSE,0.564419343452171,2020,2020-2021
LA,2020-10-31,intra-ucfe,1,1,0,2,0,2,0,0,0,4,1,11,2,3,FALSE,0.272727272727273,2020,2020-2021
LA,2020-10-31,intra-ucx,0,3,2,0,0,0,0,0,0,1,1,7,1,4,FALSE,0.571428571428571,2020,2020-2021
LA,2020-10-31,intra-ui,2202,920,380,371,477,799,1884,41,56,917,3267,11314,5469,6389,FALSE,0.564698603500088,2020,2020-2021
LA,2020-11-30,inter-total,68,53,15,10,6,1,4,2,1,26,92,278,160,213,FALSE,0.766187050359712,2020,2020-2021
LA,2020-11-30,inter-ucfe,0,0,0,0,0,0,0,0,0,0,0,0,0,0,FALSE,0,2020,2020-2021
LA,2020-11-30,inter-ucx,0,0,0,0,0,0,0,0,0,0,0,0,0,0,FALSE,0,2020,2020-2021
LA,2020-11-30,inter-ui,68,53,15,10,6,1,4,2,1,26,92,278,160,213,FALSE,0.766187050359712,2020,2020-2021
LA,2020-11-30,intra-total,1298,885,286,132,67,40,43,56,41,582,1541,4971,2839,3724,FALSE,0.749145041239187,2020,2020-2021
LA,2020-11-30,intra-ucfe,0,2,5,2,1,1,0,0,0,4,0,15,0,2,FALSE,0.133333333333333,2020,2020-2021
LA,2020-11-30,intra-ucx,0,0,0,0,0,0,0,0,0,1,1,2,1,1,FALSE,0.5,2020,2020-2021
LA,2020-11-30,intra-ui,1298,883,281,130,66,39,43,56,41,577,1540,4954,2838,3721,FALSE,0.75111021396851,2020,2020-2021
LA,2020-12-31,inter-total,5,3,2,1,7,1,0,2,0,10,11,42,16,19,FALSE,0.452380952380952,2020,2020-2021
LA,2020-12-31,inter-ucfe,0,0,0,0,0,0,0,0,0,0,0,0,0,0,FALSE,0,2020,2020-2021
LA,2020-12-31,inter-ucx,0,0,0,0,0,0,0,0,0,0,0,0,0,0,FALSE,0,2020,2020-2021
LA,2020-12-31,inter-ui,5,3,2,1,7,1,0,2,0,10,11,42,16,19,FALSE,0.452380952380952,2020,2020-2021
LA,2020-12-31,intra-total,303,119,74,68,97,55,73,42,18,327,267,1443,570,689,FALSE,0.477477477477478,2020,2020-2021
LA,2020-12-31,intra-ucfe,1,2,1,1,2,1,1,0,0,8,0,17,1,3,FALSE,0.176470588235294,2020,2020-2021
LA,2020-12-31,intra-ucx,0,0,0,1,0,0,1,0,0,5,0,7,0,0,FALSE,0,2020,2020-2021
LA,2020-12-31,intra-ui,302,117,73,66,95,54,71,42,18,314,267,1419,569,686,FALSE,0.483439041578577,2020,2020-2021
LA,2021-01-31,inter-total,10,3,3,3,10,2,3,3,5,16,5,63,15,18,FALSE,0.285714285714286,2020,2020-2021
LA,2021-01-31,inter-ucfe,0,0,0,0,0,0,0,0,0,0,0,0,0,0,FALSE,0,2020,2020-2021
LA,2021-01-31,inter-ucx,0,0,0,0,0,0,0,0,0,0,0,0,0,0,FALSE,0,2020,2020-2021
LA,2021-01-31,inter-ui,10,3,3,3,10,2,3,3,5,16,5,63,15,18,FALSE,0.285714285714286,2020,2020-2021
LA,2021-01-31,intra-total,796,311,105,234,170,137,110,105,117,316,424,2825,1220,1531,FALSE,0.541946902654867,2020,2020-2021
LA,2021-01-31,intra-ucfe,0,1,0,0,1,1,2,1,2,2,0,10,0,1,FALSE,0.1,2020,2020-2021
LA,2021-01-31,intra-ucx,1,0,0,0,0,0,0,1,0,0,0,2,1,1,FALSE,0.5,2020,2020-2021
LA,2021-01-31,intra-ui,795,310,105,234,169,136,108,103,115,314,424,2813,1219,1529,FALSE,0.543547813722005,2020,2020-2021
LA,2021-02-28,inter-total,19,11,10,3,4,3,6,6,1,18,18,99,37,48,FALSE,0.484848484848485,2020,2020-2021
LA,2021-02-28,inter-ucfe,0,0,0,0,0,0,0,0,0,1,0,1,0,0,FALSE,0,2020,2020-2021
LA,2021-02-28,inter-ucx,0,0,0,0,0,0,0,0,0,0,0,0,0,0,FALSE,0,2020,2020-2021
LA,2021-02-28,inter-ui,19,11,10,3,4,3,6,6,1,17,18,98,37,48,FALSE,0.489795918367347,2020,2020-2021
LA,2021-02-28,intra-total,718,658,745,526,328,221,239,248,216,642,587,5128,1305,1963,FALSE,0.382800312012481,2020,2020-2021
LA,2021-02-28,intra-ucfe,0,2,3,2,4,1,0,1,1,5,0,19,0,2,FALSE,0.105263157894737,2020,2020-2021
LA,2021-02-28,intra-ucx,0,1,0,0,1,0,0,1,0,1,0,4,0,1,FALSE,0.25,2020,2020-2021
LA,2021-02-28,intra-ui,718,655,742,524,323,220,239,246,215,636,587,5105,1305,1960,FALSE,0.383937316356513,2020,2020-2021
LA,2021-03-31,inter-total,15,15,17,20,10,15,6,4,4,19,26,151,41,56,FALSE,0.370860927152318,2020,2020-2021
LA,2021-03-31,inter-ucfe,0,0,0,0,0,0,0,0,0,0,0,0,0,0,FALSE,0,2020,2020-2021
LA,2021-03-31,inter-ucx,0,0,0,0,0,0,0,0,0,0,0,0,0,0,FALSE,0,2020,2020-2021
LA,2021-03-31,inter-ui,15,15,17,20,10,15,6,4,4,19,26,151,41,56,FALSE,0.370860927152318,2020,2020-2021
LA,2021-03-31,intra-total,735,693,689,820,768,607,251,168,160,746,795,6432,1530,2223,FALSE,0.345615671641791,2020,2020-2021
LA,2021-03-31,intra-ucfe,0,2,5,2,3,3,2,0,1,5,2,25,2,4,FALSE,0.16,2020,2020-2021
LA,2021-03-31,intra-ucx,1,1,3,0,0,0,0,1,0,0,2,8,3,4,FALSE,0.5,2020,2020-2021
LA,2021-03-31,intra-ui,734,690,681,818,765,604,249,167,159,741,791,6399,1525,2215,FALSE,0.346147835599312,2020,2020-2021
LA,2021-04-30,inter-total,1,24,24,20,7,5,1,3,3,58,15,161,16,40,FALSE,0.248447204968944,2020,2020-2021
LA,2021-04-30,inter-ucfe,0,0,0,0,0,0,0,0,0,0,0,0,0,0,FALSE,0,2020,2020-2021
LA,2021-04-30,inter-ucx,0,0,0,0,0,0,0,0,0,0,0,0,0,0,FALSE,0,2020,2020-2021
LA,2021-04-30,inter-ui,1,24,24,20,7,5,1,3,3,58,15,161,16,40,FALSE,0.248447204968944,2020,2020-2021
LA,2021-04-30,intra-total,556,2151,2376,1648,501,260,204,223,233,2905,2051,13108,2607,4758,FALSE,0.362984436985047,2020,2020-2021
LA,2021-04-30,intra-ucfe,0,2,0,0,1,0,0,0,1,4,3,11,3,5,FALSE,0.454545454545455,2020,2020-2021
LA,2021-04-30,intra-ucx,0,1,2,0,0,0,0,0,1,6,0,10,0,1,FALSE,0.1,2020,2020-2021
LA,2021-04-30,intra-ui,556,2148,2374,1648,500,260,204,223,231,2895,2048,13087,2604,4752,FALSE,0.363108428211202,2020,2020-2021
LA,2021-05-31,inter-total,5,37,18,20,15,2,3,2,2,20,17,141,22,59,FALSE,0.418439716312057,2020,2020-2021
LA,2021-05-31,inter-ucfe,0,0,0,0,0,0,0,0,0,0,0,0,0,0,FALSE,0,2020,2020-2021
LA,2021-05-31,inter-ucx,0,0,0,0,0,0,0,0,0,0,0,0,0,0,FALSE,0,2020,2020-2021
LA,2021-05-31,inter-ui,5,37,18,20,15,2,3,2,2,20,17,141,22,59,FALSE,0.418439716312057,2020,2020-2021
LA,2021-05-31,intra-total,891,2714,1948,1630,1340,640,423,306,186,955,2266,13299,3157,5871,FALSE,0.441461764042409,2020,2020-2021
LA,2021-05-31,intra-ucfe,2,3,1,2,1,2,0,0,0,1,5,17,7,10,FALSE,0.588235294117647,2020,2020-2021
LA,2021-05-31,intra-ucx,1,0,0,0,0,0,0,0,0,1,0,2,1,1,FALSE,0.5,2020,2020-2021
LA,2021-05-31,intra-ui,888,2711,1947,1628,1339,638,423,306,186,953,2261,13280,3149,5860,FALSE,0.441265060240964,2020,2020-2021
LA,2021-06-30,inter-total,17,22,5,3,4,1,1,0,0,13,29,95,46,68,FALSE,0.715789473684211,2020,2020-2021
LA,2021-06-30,inter-ucfe,0,0,0,0,0,0,0,0,0,0,0,0,0,0,FALSE,0,2020,2020-2021
LA,2021-06-30,inter-ucx,0,0,0,0,0,0,0,0,0,0,0,0,0,0,FALSE,0,2020,2020-2021
LA,2021-06-30,inter-ui,17,22,5,3,4,1,1,0,0,13,29,95,46,68,FALSE,0.715789473684211,2020,2020-2021
LA,2021-06-30,intra-total,1882,1553,795,466,490,300,202,177,154,777,2817,9613,4699,6252,FALSE,0.650369291584313,2020,2020-2021
LA,2021-06-30,intra-ucfe,2,0,0,0,0,0,0,1,0,5,6,14,8,8,FALSE,0.571428571428571,2020,2020-2021
LA,2021-06-30,intra-ucx,2,1,0,0,0,1,0,1,0,0,1,6,3,4,FALSE,0.666666666666667,2020,2020-2021
LA,2021-06-30,intra-ui,1878,1552,795,466,490,299,202,175,154,772,2810,9593,4688,6240,FALSE,0.650474304180131,2020,2020-2021
LA,2021-07-31,inter-total,14,7,5,0,1,2,1,1,0,4,21,56,35,42,FALSE,0.75,2021,2021-2022
LA,2021-07-31,inter-ucfe,0,0,0,0,0,0,0,0,0,0,0,0,0,0,FALSE,0,2021,2021-2022
LA,2021-07-31,inter-ucx,0,0,0,0,0,0,0,0,0,0,0,0,0,0,FALSE,0,2021,2021-2022
LA,2021-07-31,inter-ui,14,7,5,0,1,2,1,1,0,4,21,56,35,42,FALSE,0.75,2021,2021-2022
LA,2021-07-31,intra-total,1643,607,246,155,126,100,111,117,89,503,2166,5863,3809,4416,FALSE,0.753198021490705,2021,2021-2022
LA,2021-07-31,intra-ucfe,1,4,0,0,0,0,0,0,0,2,1,8,2,6,FALSE,0.75,2021,2021-2022
LA,2021-07-31,intra-ucx,0,0,0,0,0,0,0,0,0,1,0,1,0,0,FALSE,0,2021,2021-2022
LA,2021-07-31,intra-ui,1642,603,246,155,126,100,111,117,89,500,2165,5854,3807,4410,FALSE,0.753331055688418,2021,2021-2022
LA,2021-08-31,inter-total,20,7,7,1,2,1,1,3,1,13,18,74,38,45,FALSE,0.608108108108108,2021,2021-2022
LA,2021-08-31,inter-ucfe,0,0,0,0,1,0,0,0,0,0,0,1,0,0,FALSE,0,2021,2021-2022
LA,2021-08-31,inter-ucx,0,0,0,0,0,0,0,0,0,0,0,0,0,0,FALSE,0,2021,2021-2022
LA,2021-08-31,inter-ui,20,7,7,1,1,1,1,3,1,13,18,73,38,45,FALSE,0.616438356164384,2021,2021-2022
LA,2021-08-31,intra-total,1259,432,153,91,73,73,56,67,53,665,1061,3983,2320,2752,FALSE,0.690936480040171,2021,2021-2022
LA,2021-08-31,intra-ucfe,1,1,1,2,0,0,0,0,0,4,2,11,3,4,FALSE,0.363636363636364,2021,2021-2022
LA,2021-08-31,intra-ucx,1,0,0,0,0,0,0,1,0,1,3,6,4,4,FALSE,0.666666666666667,2021,2021-2022
LA,2021-08-31,intra-ui,1257,431,152,89,73,73,56,66,53,660,1056,3966,2313,2744,FALSE,0.691880988401412,2021,2021-2022
LA,2021-09-30,inter-total,11,10,1,1,4,6,0,6,4,51,18,112,29,39,FALSE,0.348214285714286,2021,2021-2022
LA,2021-09-30,inter-ucfe,0,0,0,0,0,0,0,0,0,0,1,1,1,1,FALSE,1,2021,2021-2022
LA,2021-09-30,inter-ucx,0,0,0,0,0,0,0,0,0,0,0,0,0,0,FALSE,0,2021,2021-2022
LA,2021-09-30,inter-ui,11,10,1,1,4,6,0,6,4,51,17,111,28,38,FALSE,0.342342342342342,2021,2021-2022
LA,2021-09-30,intra-total,6919,924,287,75,115,115,146,143,108,2343,2598,13773,9517,10441,FALSE,0.758077397807304,2021,2021-2022
LA,2021-09-30,intra-ucfe,1,4,1,1,0,1,0,0,0,1,11,20,12,16,FALSE,0.8,2021,2021-2022
LA,2021-09-30,intra-ucx,0,1,0,0,0,0,0,0,0,0,2,3,2,3,FALSE,1,2021,2021-2022
LA,2021-09-30,intra-ui,6918,919,286,74,115,114,146,143,108,2342,2585,13750,9503,10422,FALSE,0.757963636363636,2021,2021-2022
LA,2021-10-31,inter-total,4,14,6,7,1,0,1,4,0,14,25,76,29,43,FALSE,0.565789473684211,2021,2021-2022
LA,2021-10-31,inter-ucfe,0,0,0,0,0,0,0,0,0,0,0,0,0,0,FALSE,0,2021,2021-2022
LA,2021-10-31,inter-ucx,0,0,0,0,0,0,0,0,0,0,0,0,0,0,FALSE,0,2021,2021-2022
LA,2021-10-31,inter-ui,4,14,6,7,1,0,1,4,0,14,25,76,29,43,FALSE,0.565789473684211,2021,2021-2022
LA,2021-10-31,intra-total,393,1109,674,631,364,154,79,47,39,631,1142,5263,1535,2644,FALSE,0.502375071252138,2021,2021-2022
LA,2021-10-31,intra-ucfe,0,6,1,1,0,0,1,1,0,5,1,16,1,7,FALSE,0.4375,2021,2021-2022
LA,2021-10-31,intra-ucx,1,1,0,0,0,0,0,0,0,0,3,5,4,5,FALSE,1,2021,2021-2022
LA,2021-10-31,intra-ui,392,1102,673,630,364,154,78,46,39,626,1138,5242,1530,2632,FALSE,0.50209843571156,2021,2021-2022
LA,2021-11-30,inter-total,28,9,7,4,1,0,0,0,0,15,22,86,50,59,FALSE,0.686046511627907,2021,2021-2022
LA,2021-11-30,inter-ucfe,0,0,0,0,0,0,0,0,0,0,0,0,0,0,FALSE,0,2021,2021-2022
LA,2021-11-30,inter-ucx,0,0,0,0,0,0,0,0,0,0,0,0,0,0,FALSE,0,2021,2021-2022
LA,2021-11-30,inter-ui,28,9,7,4,1,0,0,0,0,15,22,86,50,59,FALSE,0.686046511627907,2021,2021-2022
LA,2021-11-30,intra-total,641,361,183,97,73,87,41,58,52,608,520,2721,1161,1522,FALSE,0.559353178978317,2021,2021-2022
LA,2021-11-30,intra-ucfe,0,4,0,0,0,0,0,0,0,2,2,8,2,6,FALSE,0.75,2021,2021-2022
LA,2021-11-30,intra-ucx,1,1,0,0,0,0,0,0,1,1,4,8,5,6,FALSE,0.75,2021,2021-2022
LA,2021-11-30,intra-ui,640,356,183,97,73,87,41,58,51,605,514,2705,1154,1510,FALSE,0.55822550831793,2021,2021-2022
LA,2021-12-31,inter-total,42,8,3,2,1,0,1,2,1,34,16,110,58,66,FALSE,0.6,2021,2021-2022
LA,2021-12-31,inter-ucfe,1,0,0,0,0,0,0,0,0,0,0,1,1,1,FALSE,1,2021,2021-2022
LA,2021-12-31,inter-ucx,0,0,0,0,0,0,0,0,0,0,0,0,0,0,FALSE,0,2021,2021-2022
LA,2021-12-31,inter-ui,41,8,3,2,1,0,1,2,1,34,16,109,57,65,FALSE,0.596330275229358,2021,2021-2022
LA,2021-12-31,intra-total,854,137,47,16,7,7,8,14,22,1155,321,2588,1175,1312,FALSE,0.506955177743431,2021,2021-2022
LA,2021-12-31,intra-ucfe,1,2,0,0,0,0,0,0,1,3,2,9,3,5,FALSE,0.555555555555556,2021,2021-2022
LA,2021-12-31,intra-ucx,1,0,1,0,0,0,0,0,0,0,1,3,2,2,FALSE,0.666666666666667,2021,2021-2022
LA,2021-12-31,intra-ui,852,135,46,16,7,7,8,14,21,1152,318,2576,1170,1305,FALSE,0.506599378881988,2021,2021-2022
LA,2022-01-31,inter-total,29,2,4,0,2,1,1,0,0,10,19,68,48,50,FALSE,0.735294117647059,2021,2021-2022
LA,2022-01-31,inter-ucfe,0,0,0,0,0,0,0,0,0,0,0,0,0,0,FALSE,0,2021,2021-2022
LA,2022-01-31,inter-ucx,0,0,0,0,0,0,0,0,0,0,0,0,0,0,FALSE,0,2021,2021-2022
LA,2022-01-31,inter-ui,29,2,4,0,2,1,1,0,0,10,19,68,48,50,FALSE,0.735294117647059,2021,2021-2022
LA,2022-01-31,intra-total,656,115,63,25,11,15,14,7,3,492,310,1711,966,1081,FALSE,0.631794272355348,2021,2021-2022
LA,2022-01-31,intra-ucfe,3,0,0,0,0,0,0,0,0,0,2,5,5,5,FALSE,1,2021,2021-2022
LA,2022-01-31,intra-ucx,1,0,1,1,0,0,0,0,0,1,1,5,2,2,FALSE,0.4,2021,2021-2022
LA,2022-01-31,intra-ui,652,115,62,24,11,15,14,7,3,491,307,1701,959,1074,FALSE,0.631393298059965,2021,2021-2022
LA,2022-02-28,inter-total,18,11,7,6,2,0,1,1,1,20,23,90,41,52,FALSE,0.577777777777778,2021,2021-2022
LA,2022-02-28,inter-ucfe,1,0,0,0,0,0,0,0,0,0,0,1,1,1,FALSE,1,2021,2021-2022
LA,2022-02-28,inter-ucx,0,0,0,0,0,0,0,0,0,0,0,0,0,0,FALSE,0,2021,2021-2022
LA,2022-02-28,inter-ui,17,11,7,6,2,0,1,1,1,20,23,89,40,51,FALSE,0.573033707865169,2021,2021-2022
LA,2022-02-28,intra-total,434,324,208,90,36,17,11,5,3,574,378,2080,812,1136,FALSE,0.546153846153846,2021,2021-2022
LA,2022-02-28,intra-ucfe,4,0,0,0,0,0,0,0,0,1,2,7,6,6,FALSE,0.857142857142857,2021,2021-2022
LA,2022-02-28,intra-ucx,1,0,0,0,0,0,0,0,0,1,0,2,1,1,FALSE,0.5,2021,2021-2022
LA,2022-02-28,intra-ui,429,324,208,90,36,17,11,5,3,572,376,2071,805,1129,FALSE,0.545147271849348,2021,2021-2022
LA,2022-03-31,inter-total,29,7,10,3,5,0,1,2,0,9,23,89,52,59,FALSE,0.662921348314607,2021,2021-2022
LA,2022-03-31,inter-ucfe,0,0,0,0,0,0,0,0,0,1,0,1,0,0,FALSE,0,2021,2021-2022
LA,2022-03-31,inter-ucx,0,0,0,0,0,0,0,0,0,0,0,0,0,0,FALSE,0,2021,2021-2022
LA,2022-03-31,inter-ui,29,7,10,3,5,0,1,2,0,8,23,88,52,59,FALSE,0.670454545454545,2021,2021-2022
LA,2022-03-31,intra-total,694,162,99,61,54,42,25,18,7,214,383,1759,1077,1239,FALSE,0.704377487208641,2021,2021-2022
LA,2022-03-31,intra-ucfe,2,1,0,0,0,0,0,0,0,0,4,7,6,7,FALSE,1,2021,2021-2022
LA,2022-03-31,intra-ucx,0,0,0,1,0,0,0,0,0,1,0,2,0,0,FALSE,0,2021,2021-2022
LA,2022-03-31,intra-ui,692,161,99,60,54,42,25,18,7,213,379,1750,1071,1232,FALSE,0.704,2021,2021-2022
LA,2022-04-30,inter-total,23,10,5,1,1,1,0,0,3,5,15,64,38,48,FALSE,0.75,2021,2021-2022
LA,2022-04-30,inter-ucfe,0,0,0,0,0,0,0,0,0,0,0,0,0,0,FALSE,0,2021,2021-2022
LA,2022-04-30,inter-ucx,0,0,0,0,0,0,0,0,0,0,0,0,0,0,FALSE,0,2021,2021-2022
LA,2022-04-30,inter-ui,23,10,5,1,1,1,0,0,3,5,15,64,38,48,FALSE,0.75,2021,2021-2022
LA,2022-04-30,intra-total,817,120,69,36,16,13,13,16,14,172,347,1633,1164,1284,FALSE,0.786282914880588,2021,2021-2022
LA,2022-04-30,intra-ucfe,4,1,0,0,0,0,0,0,2,0,3,10,7,8,FALSE,0.8,2021,2021-2022
LA,2022-04-30,intra-ucx,0,0,0,0,0,0,0,0,0,0,0,0,0,0,FALSE,0,2021,2021-2022
LA,2022-04-30,intra-ui,813,119,69,36,16,13,13,16,12,172,344,1623,1157,1276,FALSE,0.786198398028343,2021,2021-2022
LA,2022-05-31,inter-total,32,1,4,2,2,0,1,0,2,5,13,62,45,46,FALSE,0.741935483870968,2021,2021-2022
LA,2022-05-31,inter-ucfe,0,0,0,0,0,0,0,0,0,0,0,0,0,0,FALSE,0,2021,2021-2022
LA,2022-05-31,inter-ucx,0,0,0,0,0,0,0,0,0,0,0,0,0,0,FALSE,0,2021,2021-2022
LA,2022-05-31,inter-ui,32,1,4,2,2,0,1,0,2,5,13,62,45,46,FALSE,0.741935483870968,2021,2021-2022
LA,2022-05-31,intra-total,1123,117,51,25,19,13,6,7,8,167,442,1978,1565,1682,FALSE,0.850353892821031,2021,2021-2022
LA,2022-05-31,intra-ucfe,6,1,1,1,0,0,0,0,0,2,5,16,11,12,FALSE,0.75,2021,2021-2022
LA,2022-05-31,intra-ucx,3,0,0,0,0,0,0,0,0,0,2,5,5,5,FALSE,1,2021,2021-2022
LA,2022-05-31,intra-ui,1114,116,50,24,19,13,6,7,8,165,435,1957,1549,1665,FALSE,0.850792028615227,2021,2021-2022
LA,2022-06-30,inter-total,19,2,1,3,0,0,0,0,0,4,8,37,27,29,FALSE,0.783783783783784,2021,2021-2022
LA,2022-06-30,inter-ucfe,0,0,0,0,0,0,0,0,0,0,0,0,0,0,FALSE,0,2021,2021-2022
LA,2022-06-30,inter-ucx,0,0,0,0,0,0,0,0,0,0,0,0,0,0,FALSE,0,2021,2021-2022
LA,2022-06-30,inter-ui,19,2,1,3,0,0,0,0,0,4,8,37,27,29,FALSE,0.783783783783784,2021,2021-2022
LA,2022-06-30,intra-total,1265,167,68,25,18,14,13,14,13,136,522,2255,1787,1954,FALSE,0.866518847006652,2021,2021-2022
LA,2022-06-30,intra-ucfe,17,1,0,0,0,0,0,1,0,1,3,23,20,21,FALSE,0.91304347826087,2021,2021-2022
LA,2022-06-30,intra-ucx,1,0,0,1,0,0,0,0,0,0,0,2,1,1,FALSE,0.5,2021,2021-2022
LA,2022-06-30,intra-ui,1247,166,68,24,18,14,13,13,13,135,519,2230,1766,1932,FALSE,0.866367713004484,2021,2021-2022
LA,2022-07-31,inter-total,6,11,13,3,1,2,1,1,0,7,8,53,14,25,FALSE,0.471698113207547,2022,2022-2023
LA,2022-07-31,inter-ucfe,0,0,0,0,0,0,0,0,0,0,0,0,0,0,FALSE,0,2022,2022-2023
LA,2022-07-31,inter-ucx,0,0,0,0,0,0,0,0,0,0,0,0,0,0,FALSE,0,2022,2022-2023
LA,2022-07-31,inter-ui,6,11,13,3,1,2,1,1,0,7,8,53,14,25,FALSE,0.471698113207547,2022,2022-2023
LA,2022-07-31,intra-total,578,590,358,197,159,96,50,27,18,264,555,2892,1133,1723,FALSE,0.595781466113416,2022,2022-2023
LA,2022-07-31,intra-ucfe,4,2,0,0,1,0,0,0,0,1,4,12,8,10,FALSE,0.833333333333333,2022,2022-2023
LA,2022-07-31,intra-ucx,3,0,0,0,0,0,0,0,0,0,1,4,4,4,FALSE,1,2022,2022-2023
LA,2022-07-31,intra-ui,571,588,358,197,158,96,50,27,18,263,550,2876,1121,1709,FALSE,0.5942280945758,2022,2022-2023
LA,2022-08-31,inter-total,13,12,3,2,4,1,1,0,0,5,17,58,30,42,FALSE,0.724137931034483,2022,2022-2023
LA,2022-08-31,inter-ucfe,0,0,0,0,0,0,0,0,0,0,1,1,1,1,FALSE,1,2022,2022-2023
LA,2022-08-31,inter-ucx,0,0,0,0,0,0,0,0,0,0,0,0,0,0,FALSE,0,2022,2022-2023
LA,2022-08-31,inter-ui,13,12,3,2,4,1,1,0,0,5,16,57,29,41,FALSE,0.719298245614035,2022,2022-2023
LA,2022-08-31,intra-total,845,434,199,135,82,47,41,28,21,205,793,2830,1638,2072,FALSE,0.732155477031802,2022,2022-2023
LA,2022-08-31,intra-ucfe,12,1,0,0,0,0,0,1,0,0,2,16,14,15,FALSE,0.9375,2022,2022-2023
LA,2022-08-31,intra-ucx,5,1,0,0,0,0,0,0,0,0,2,8,7,8,FALSE,1,2022,2022-2023
LA,2022-08-31,intra-ui,828,432,199,135,82,47,41,27,21,205,789,2806,1617,2049,FALSE,0.730220955096223,2022,2022-2023
LA,2022-09-30,inter-total,25,6,2,3,3,1,0,0,0,2,8,50,33,39,FALSE,0.78,2022,2022-2023
LA,2022-09-30,inter-ucfe,2,0,0,0,0,0,0,0,0,0,0,2,2,2,FALSE,1,2022,2022-2023
LA,2022-09-30,inter-ucx,0,0,0,0,0,0,0,0,0,0,0,0,0,0,FALSE,0,2022,2022-2023
LA,2022-09-30,inter-ui,23,6,2,3,3,1,0,0,0,2,8,48,31,37,FALSE,0.770833333333333,2022,2022-2023
LA,2022-09-30,intra-total,977,259,121,67,63,42,27,19,17,158,611,2361,1588,1847,FALSE,0.782295637441762,2022,2022-2023
LA,2022-09-30,intra-ucfe,5,2,0,0,0,0,0,0,0,0,1,8,6,8,FALSE,1,2022,2022-2023
LA,2022-09-30,intra-ucx,3,0,0,0,0,1,0,0,0,0,2,6,5,5,FALSE,0.833333333333333,2022,2022-2023
LA,2022-09-30,intra-ui,969,257,121,67,63,41,27,19,17,158,608,2347,1577,1834,FALSE,0.781423093310609,2022,2022-2023
LA,2022-10-31,inter-total,19,2,3,1,1,0,0,0,0,1,8,35,27,29,FALSE,0.828571428571429,2022,2022-2023
LA,2022-10-31,inter-ucfe,0,0,0,0,0,0,0,0,0,0,0,0,0,0,FALSE,0,2022,2022-2023
LA,2022-10-31,inter-ucx,0,0,0,0,0,0,0,0,0,0,0,0,0,0,FALSE,0,2022,2022-2023
LA,2022-10-31,inter-ui,19,2,3,1,1,0,0,0,0,1,8,35,27,29,FALSE,0.828571428571429,2022,2022-2023
LA,2022-10-31,intra-total,1238,104,70,43,28,38,20,13,14,129,395,2092,1633,1737,FALSE,0.830305927342256,2022,2022-2023
LA,2022-10-31,intra-ucfe,3,1,0,0,0,1,0,0,1,0,4,10,7,8,FALSE,0.8,2022,2022-2023
LA,2022-10-31,intra-ucx,3,0,0,0,0,0,0,0,0,1,1,5,4,4,FALSE,0.8,2022,2022-2023
LA,2022-10-31,intra-ui,1232,103,70,43,28,37,20,13,13,128,390,2077,1622,1725,FALSE,0.830524795377949,2022,2022-2023
LA,2022-11-30,inter-total,30,5,1,0,1,0,0,0,0,1,10,48,40,45,FALSE,0.9375,2022,2022-2023
LA,2022-11-30,inter-ucfe,0,0,0,0,0,0,0,0,0,0,0,0,0,0,FALSE,0,2022,2022-2023
LA,2022-11-30,inter-ucx,0,0,0,0,0,0,0,0,0,0,0,0,0,0,FALSE,0,2022,2022-2023
LA,2022-11-30,inter-ui,30,5,1,0,1,0,0,0,0,1,10,48,40,45,FALSE,0.9375,2022,2022-2023
LA,2022-11-30,intra-total,970,120,48,41,30,19,20,11,17,84,426,1786,1396,1516,FALSE,0.848824188129899,2022,2022-2023
LA,2022-11-30,intra-ucfe,1,1,0,0,0,0,0,1,0,0,2,5,3,4,FALSE,0.8,2022,2022-2023
LA,2022-11-30,intra-ucx,0,0,0,0,0,0,0,0,0,0,0,0,0,0,FALSE,0,2022,2022-2023
LA,2022-11-30,intra-ui,969,119,48,41,30,19,20,10,17,84,424,1781,1393,1512,FALSE,0.848961257720382,2022,2022-2023
LA,2022-12-31,inter-total,46,7,4,3,0,0,0,0,0,1,26,87,72,79,FALSE,0.908045977011494,2022,2022-2023
LA,2022-12-31,inter-ucfe,0,0,0,0,0,0,0,0,0,0,0,0,0,0,FALSE,0,2022,2022-2023
LA,2022-12-31,inter-ucx,0,0,0,0,0,0,0,0,0,0,0,0,0,0,FALSE,0,2022,2022-2023
LA,2022-12-31,inter-ui,46,7,4,3,0,0,0,0,0,1,26,87,72,79,FALSE,0.908045977011494,2022,2022-2023
LA,2022-12-31,intra-total,1114,162,72,27,18,39,33,12,20,86,505,2088,1619,1781,FALSE,0.852969348659004,2022,2022-2023
LA,2022-12-31,intra-ucfe,2,0,0,0,1,0,0,0,0,0,1,4,3,3,FALSE,0.75,2022,2022-2023
LA,2022-12-31,intra-ucx,3,0,0,0,0,0,0,0,0,0,0,3,3,3,FALSE,1,2022,2022-2023
LA,2022-12-31,intra-ui,1109,162,72,27,17,39,33,12,20,86,504,2081,1613,1775,FALSE,0.852955309947141,2022,2022-2023
LA,2023-01-31,inter-total,28,11,9,6,8,2,0,1,0,5,37,107,65,76,FALSE,0.710280373831776,2022,2022-2023
LA,2023-01-31,inter-ucfe,0,0,0,0,0,0,0,0,0,0,0,0,0,0,FALSE,0,2022,2022-2023
LA,2023-01-31,inter-ucx,0,0,0,0,0,0,0,0,0,0,0,0,0,0,FALSE,0,2022,2022-2023
LA,2023-01-31,inter-ui,28,11,9,6,8,2,0,1,0,5,37,107,65,76,FALSE,0.710280373831776,2022,2022-2023
LA,2023-01-31,intra-total,673,416,202,114,74,37,29,21,19,155,633,2373,1306,1722,FALSE,0.725663716814159,2022,2022-2023
LA,2023-01-31,intra-ucfe,1,0,0,0,0,0,1,0,0,1,3,6,4,4,FALSE,0.666666666666667,2022,2022-2023
LA,2023-01-31,intra-ucx,1,0,0,0,0,0,0,0,0,1,0,2,1,1,FALSE,0.5,2022,2022-2023
LA,2023-01-31,intra-ui,671,416,202,114,74,37,28,21,19,153,630,2365,1301,1717,FALSE,0.72600422832981,2022,2022-2023
LA,2023-02-28,inter-total,18,11,10,2,2,1,2,0,3,0,19,68,37,48,FALSE,0.705882352941177,2022,2022-2023
LA,2023-02-28,inter-ucfe,0,0,0,0,0,0,0,0,0,0,1,1,1,1,FALSE,1,2022,2022-2023
LA,2023-02-28,inter-ucx,0,0,0,0,0,0,0,0,0,0,0,0,0,0,FALSE,0,2022,2022-2023
LA,2023-02-28,inter-ui,18,11,10,2,2,1,2,0,3,0,18,67,36,47,FALSE,0.701492537313433,2022,2022-2023
LA,2023-02-28,intra-total,557,492,226,105,61,48,40,30,19,52,610,2240,1167,1659,FALSE,0.740625,2022,2022-2023
LA,2023-02-28,intra-ucfe,2,0,0,1,0,1,0,0,0,0,0,4,2,2,FALSE,0.5,2022,2022-2023
LA,2023-02-28,intra-ucx,1,0,0,0,0,0,0,0,0,0,1,2,2,2,FALSE,1,2022,2022-2023
LA,2023-02-28,intra-ui,554,492,226,104,61,47,40,30,19,52,609,2234,1163,1655,FALSE,0.7408236347359,2022,2022-2023
LA,2023-03-31,inter-total,14,3,2,3,1,0,0,1,0,3,10,37,24,27,FALSE,0.72972972972973,2022,2022-2023
LA,2023-03-31,inter-ucfe,0,0,0,0,0,0,0,0,0,0,0,0,0,0,FALSE,0,2022,2022-2023
LA,2023-03-31,inter-ucx,0,0,0,0,0,0,0,0,0,0,0,0,0,0,FALSE,0,2022,2022-2023
LA,2023-03-31,inter-ui,14,3,2,3,1,0,0,1,0,3,10,37,24,27,FALSE,0.72972972972973,2022,2022-2023
LA,2023-03-31,intra-total,806,242,174,89,61,46,42,26,18,147,583,2234,1389,1631,FALSE,0.730080572963295,2022,2022-2023
LA,2023-03-31,intra-ucfe,2,0,0,0,1,0,0,0,0,0,1,4,3,3,FALSE,0.75,2022,2022-2023
LA,2023-03-31,intra-ucx,0,1,0,0,0,0,0,0,0,1,0,2,0,1,FALSE,0.5,2022,2022-2023
LA,2023-03-31,intra-ui,804,241,174,89,60,46,42,26,18,146,582,2228,1386,1627,FALSE,0.730251346499102,2022,2022-2023
LA,2023-04-30,inter-total,26,2,2,0,0,1,1,0,0,1,11,44,37,39,FALSE,0.886363636363636,2022,2022-2023
LA,2023-04-30,inter-ucfe,0,0,0,0,0,0,0,0,0,0,0,0,0,0,FALSE,0,2022,2022-2023
LA,2023-04-30,inter-ucx,0,0,0,0,0,0,0,0,0,0,0,0,0,0,FALSE,0,2022,2022-2023
LA,2023-04-30,inter-ui,26,2,2,0,0,1,1,0,0,1,11,44,37,39,FALSE,0.886363636363636,2022,2022-2023
LA,2023-04-30,intra-total,890,171,63,34,22,23,19,12,21,102,468,1825,1358,1529,FALSE,0.837808219178082,2022,2022-2023
LA,2023-04-30,intra-ucfe,2,0,0,0,0,0,0,0,0,0,3,5,5,5,FALSE,1,2022,2022-2023
LA,2023-04-30,intra-ucx,0,0,0,0,0,0,0,0,0,0,0,0,0,0,FALSE,0,2022,2022-2023
LA,2023-04-30,intra-ui,888,171,63,34,22,23,19,12,21,102,465,1820,1353,1524,FALSE,0.837362637362637,2022,2022-2023
LA,2023-05-31,inter-total,13,4,1,1,0,0,0,0,1,2,18,40,31,35,FALSE,0.875,2022,2022-2023
LA,2023-05-31,inter-ucfe,0,0,0,0,0,0,0,0,0,0,0,0,0,0,FALSE,0,2022,2022-2023
LA,2023-05-31,inter-ucx,0,0,0,0,0,0,0,0,0,0,0,0,0,0,FALSE,0,2022,2022-2023
LA,2023-05-31,inter-ui,13,4,1,1,0,0,0,0,1,2,18,40,31,35,FALSE,0.875,2022,2022-2023
LA,2023-05-31,intra-total,1025,269,73,40,25,20,19,19,8,98,719,2315,1744,2013,FALSE,0.869546436285097,2022,2022-2023
LA,2023-05-31,intra-ucfe,4,0,2,0,0,0,0,0,0,0,1,7,5,5,FALSE,0.714285714285714,2022,2022-2023
LA,2023-05-31,intra-ucx,1,0,0,0,0,0,0,0,0,0,0,1,1,1,FALSE,1,2022,2022-2023
LA,2023-05-31,intra-ui,1020,269,71,40,25,20,19,19,8,98,718,2307,1738,2007,FALSE,0.869960988296489,2022,2022-2023
LA,2023-06-30,inter-total,19,6,1,1,1,0,0,0,1,2,17,48,36,42,FALSE,0.875,2022,2022-2023
LA,2023-06-30,inter-ucfe,0,0,0,0,0,0,0,0,0,0,0,0,0,0,FALSE,0,2022,2022-2023
LA,2023-06-30,inter-ucx,0,0,0,0,0,0,0,0,0,0,0,0,0,0,FALSE,0,2022,2022-2023
LA,2023-06-30,inter-ui,19,6,1,1,1,0,0,0,1,2,17,48,36,42,FALSE,0.875,2022,2022-2023
LA,2023-06-30,intra-total,1631,381,104,37,24,22,23,21,22,127,1047,3439,2678,3059,FALSE,0.889502762430939,2022,2022-2023
LA,2023-06-30,intra-ucfe,1,2,0,0,0,0,0,0,0,1,3,7,4,6,FALSE,0.857142857142857,2022,2022-2023
LA,2023-06-30,intra-ucx,1,0,1,0,0,0,0,0,0,0,0,2,1,1,FALSE,0.5,2022,2022-2023
LA,2023-06-30,intra-ui,1629,379,103,37,24,22,23,21,22,126,1044,3430,2673,3052,FALSE,0.889795918367347,2022,2022-2023
LA,2023-07-31,inter-total,7,9,4,3,2,0,0,1,0,0,10,36,17,26,FALSE,0.722222222222222,2023,2023-2024
LA,2023-07-31,inter-ucfe,0,0,0,0,0,0,0,0,0,0,0,0,0,0,FALSE,0,2023,2023-2024
LA,2023-07-31,inter-ucx,0,0,0,0,0,0,0,0,0,0,0,0,0,0,FALSE,0,2023,2023-2024
LA,2023-07-31,inter-ui,7,9,4,3,2,0,0,1,0,0,10,36,17,26,FALSE,0.722222222222222,2023,2023-2024
LA,2023-07-31,intra-total,912,444,252,110,80,30,22,25,18,84,901,2878,1813,2257,FALSE,0.784225156358582,2023,2023-2024
LA,2023-07-31,intra-ucfe,4,1,0,2,1,0,0,0,0,1,2,11,6,7,FALSE,0.636363636363636,2023,2023-2024
LA,2023-07-31,intra-ucx,1,1,0,0,0,0,0,0,0,0,1,3,2,3,FALSE,1,2023,2023-2024
LA,2023-07-31,intra-ui,907,442,252,108,79,30,22,25,18,83,898,2864,1805,2247,FALSE,0.784567039106145,2023,2023-2024
LA,2023-08-31,inter-total,10,7,4,2,3,4,2,1,1,1,8,43,18,25,FALSE,0.581395348837209,2023,2023-2024
LA,2023-08-31,inter-ucfe,0,0,0,0,0,0,0,0,0,0,0,0,0,0,FALSE,0,2023,2023-2024
LA,2023-08-31,inter-ucx,0,0,0,0,0,0,0,0,0,0,0,0,0,0,FALSE,0,2023,2023-2024
LA,2023-08-31,inter-ui,10,7,4,2,3,4,2,1,1,1,8,43,18,25,FALSE,0.581395348837209,2023,2023-2024
LA,2023-08-31,intra-total,971,320,167,154,106,59,41,40,34,127,641,2660,1612,1932,FALSE,0.726315789473684,2023,2023-2024
LA,2023-08-31,intra-ucfe,5,1,1,1,0,0,0,0,0,0,2,10,7,8,FALSE,0.8,2023,2023-2024
LA,2023-08-31,intra-ucx,2,0,0,0,0,0,0,0,0,0,0,2,2,2,FALSE,1,2023,2023-2024
LA,2023-08-31,intra-ui,964,319,166,153,106,59,41,40,34,127,639,2648,1603,1922,FALSE,0.72583081570997,2023,2023-2024
LA,2023-09-30,inter-total,10,2,4,2,3,1,4,1,3,11,11,52,21,23,FALSE,0.442307692307692,2023,2023-2024
LA,2023-09-30,inter-ucfe,0,0,0,0,0,0,0,0,0,0,0,0,0,0,FALSE,0,2023,2023-2024
LA,2023-09-30,inter-ucx,0,0,0,0,0,0,0,0,0,0,0,0,0,0,FALSE,0,2023,2023-2024
LA,2023-09-30,inter-ui,10,2,4,2,3,1,4,1,3,11,11,52,21,23,FALSE,0.442307692307692,2023,2023-2024
LA,2023-09-30,intra-total,721,103,78,101,87,102,97,76,40,192,322,1919,1043,1146,FALSE,0.597186034392913,2023,2023-2024
LA,2023-09-30,intra-ucfe,0,0,0,0,0,0,0,0,0,0,0,0,0,0,FALSE,0,2023,2023-2024
LA,2023-09-30,intra-ucx,2,0,0,0,0,0,0,0,0,0,1,3,3,3,FALSE,1,2023,2023-2024
LA,2023-09-30,intra-ui,719,103,78,101,87,102,97,76,40,192,321,1916,1040,1143,FALSE,0.596555323590814,2023,2023-2024
LA,2023-10-31,inter-total,20,5,4,2,2,6,3,5,3,11,8,69,28,33,FALSE,0.478260869565217,2023,2023-2024
LA,2023-10-31,inter-ucfe,1,0,0,0,0,0,0,0,0,0,0,1,1,1,FALSE,1,2023,2023-2024
LA,2023-10-31,inter-ucx,0,0,0,0,0,0,0,0,0,0,0,0,0,0,FALSE,0,2023,2023-2024
LA,2023-10-31,inter-ui,19,5,4,2,2,6,3,5,3,11,8,68,27,32,FALSE,0.470588235294118,2023,2023-2024
LA,2023-10-31,intra-total,677,225,121,96,104,87,92,88,106,238,687,2521,1364,1589,FALSE,0.630305434351448,2023,2023-2024
LA,2023-10-31,intra-ucfe,2,0,0,1,0,0,0,0,0,0,1,4,3,3,FALSE,0.75,2023,2023-2024
LA,2023-10-31,intra-ucx,6,0,0,0,0,1,0,0,0,0,2,9,8,8,FALSE,0.888888888888889,2023,2023-2024
LA,2023-10-31,intra-ui,669,225,121,95,104,86,92,88,106,238,684,2508,1353,1578,FALSE,0.629186602870813,2023,2023-2024
LA,2023-11-30,inter-total,26,6,2,3,0,0,1,0,1,6,18,63,44,50,FALSE,0.793650793650794,2023,2023-2024
LA,2023-11-30,inter-ucfe,0,0,0,0,0,0,0,0,0,0,0,0,0,0,FALSE,0,2023,2023-2024
LA,2023-11-30,inter-ucx,0,0,0,0,0,0,0,0,0,0,0,0,0,0,FALSE,0,2023,2023-2024
LA,2023-11-30,inter-ui,26,6,2,3,0,0,1,0,1,6,18,63,44,50,FALSE,0.793650793650794,2023,2023-2024
LA,2023-11-30,intra-total,651,259,123,101,52,48,36,29,42,269,572,2182,1223,1482,FALSE,0.679193400549954,2023,2023-2024
LA,2023-11-30,intra-ucfe,6,0,0,0,0,1,0,0,0,1,1,9,7,7,FALSE,0.777777777777778,2023,2023-2024
LA,2023-11-30,intra-ucx,0,0,0,0,0,0,0,0,0,0,0,0,0,0,FALSE,0,2023,2023-2024
LA,2023-11-30,intra-ui,645,259,123,101,52,47,36,29,42,268,571,2173,1216,1475,FALSE,0.67878508973769,2023,2023-2024
LA,2023-12-31,inter-total,21,3,12,6,4,1,1,0,0,4,18,70,39,42,FALSE,0.6,2023,2023-2024
LA,2023-12-31,inter-ucfe,0,0,1,0,0,0,0,0,0,0,0,1,0,0,FALSE,0,2023,2023-2024
LA,2023-12-31,inter-ucx,0,0,0,0,0,0,0,0,0,0,0,0,0,0,FALSE,0,2023,2023-2024
LA,2023-12-31,inter-ui,21,3,11,6,4,1,1,0,0,4,18,69,39,42,FALSE,0.608695652173913,2023,2023-2024
LA,2023-12-31,intra-total,702,339,193,85,52,62,31,31,21,225,638,2379,1340,1679,FALSE,0.705758722152165,2023,2023-2024
LA,2023-12-31,intra-ucfe,2,1,0,0,0,0,1,0,0,0,3,7,5,6,FALSE,0.857142857142857,2023,2023-2024
LA,2023-12-31,intra-ucx,0,0,0,0,0,0,0,0,0,0,0,0,0,0,FALSE,0,2023,2023-2024
LA,2023-12-31,intra-ui,700,338,193,85,52,62,30,31,21,225,635,2372,1335,1673,FALSE,0.70531197301855,2023,2023-2024
LA,2024-01-31,inter-total,20,15,8,5,2,1,1,1,3,6,18,80,38,53,FALSE,0.6625,2023,2023-2024
LA,2024-01-31,inter-ucfe,0,0,0,0,0,0,0,0,0,0,0,0,0,0,FALSE,0,2023,2023-2024
LA,2024-01-31,inter-ucx,0,0,0,0,0,0,0,0,0,0,0,0,0,0,FALSE,0,2023,2023-2024
LA,2024-01-31,inter-ui,20,15,8,5,2,1,1,1,3,6,18,80,38,53,FALSE,0.6625,2023,2023-2024
LA,2024-01-31,intra-total,454,400,220,137,77,37,17,20,16,97,621,2096,1075,1475,FALSE,0.703721374045801,2023,2023-2024
LA,2024-01-31,intra-ucfe,3,0,0,0,0,0,0,0,0,0,2,5,5,5,FALSE,1,2023,2023-2024
LA,2024-01-31,intra-ucx,2,0,0,0,0,0,0,0,0,0,0,2,2,2,FALSE,1,2023,2023-2024
LA,2024-01-31,intra-ui,449,400,220,137,77,37,17,20,16,97,619,2089,1068,1468,FALSE,0.702728578267113,2023,2023-2024
LA,2024-02-29,inter-total,24,7,3,3,0,2,0,1,1,4,21,66,45,52,FALSE,0.787878787878788,2023,2023-2024
LA,2024-02-29,inter-ucfe,0,0,0,0,0,0,0,0,0,0,0,0,0,0,FALSE,0,2023,2023-2024
LA,2024-02-29,inter-ucx,0,0,0,0,0,0,0,0,0,0,0,0,0,0,FALSE,0,2023,2023-2024
LA,2024-02-29,inter-ui,24,7,3,3,0,2,0,1,1,4,21,66,45,52,FALSE,0.787878787878788,2023,2023-2024
LA,2024-02-29,intra-total,865,295,142,69,55,31,19,15,11,90,718,2310,1583,1878,FALSE,0.812987012987013,2023,2023-2024
LA,2024-02-29,intra-ucfe,3,0,0,0,0,0,0,0,0,0,2,5,5,5,FALSE,1,2023,2023-2024
LA,2024-02-29,intra-ucx,2,0,0,0,0,0,0,0,0,0,0,2,2,2,FALSE,1,2023,2023-2024
LA,2024-02-29,intra-ui,860,295,142,69,55,31,19,15,11,90,716,2303,1576,1871,FALSE,0.812418584455059,2023,2023-2024
LA,2024-03-31,inter-total,27,0,1,3,1,1,1,1,0,0,16,51,43,43,FALSE,0.843137254901961,2023,2023-2024
LA,2024-03-31,inter-ucfe,0,0,0,0,0,0,0,0,0,0,0,0,0,0,FALSE,0,2023,2023-2024
LA,2024-03-31,inter-ucx,0,0,0,0,0,0,0,0,0,0,0,0,0,0,FALSE,0,2023,2023-2024
LA,2024-03-31,inter-ui,27,0,1,3,1,1,1,1,0,0,16,51,43,43,FALSE,0.843137254901961,2023,2023-2024
LA,2024-03-31,intra-total,1055,105,69,51,29,27,21,11,13,100,447,1928,1502,1607,FALSE,0.83350622406639,2023,2023-2024
LA,2024-03-31,intra-ucfe,2,0,1,0,0,1,0,0,0,0,0,4,2,2,FALSE,0.5,2023,2023-2024
LA,2024-03-31,intra-ucx,2,0,1,0,0,0,0,0,0,0,0,3,2,2,FALSE,0.666666666666667,2023,2023-2024
LA,2024-03-31,intra-ui,1051,105,67,51,29,26,21,11,13,100,447,1921,1498,1603,FALSE,0.834461218115565,2023,2023-2024
LA,2024-04-30,inter-total,27,3,2,0,1,0,1,0,1,2,19,56,46,49,FALSE,0.875,2023,2023-2024
LA,2024-04-30,inter-ucfe,0,0,0,0,0,0,0,0,0,0,0,0,0,0,FALSE,0,2023,2023-2024
LA,2024-04-30,inter-ucx,0,0,0,0,0,0,0,0,0,0,0,0,0,0,FALSE,0,2023,2023-2024
LA,2024-04-30,inter-ui,27,3,2,0,1,0,1,0,1,2,19,56,46,49,FALSE,0.875,2023,2023-2024
LA,2024-04-30,intra-total,1123,105,48,35,20,8,17,15,14,118,528,2031,1651,1756,FALSE,0.864598719842442,2023,2023-2024
LA,2024-04-30,intra-ucfe,4,0,0,0,0,0,0,0,0,0,2,6,6,6,FALSE,1,2023,2023-2024
LA,2024-04-30,intra-ucx,1,0,0,0,0,0,0,0,0,1,3,5,4,4,FALSE,0.8,2023,2023-2024
LA,2024-04-30,intra-ui,1118,105,48,35,20,8,17,15,14,117,523,2020,1641,1746,FALSE,0.864356435643564,2023,2023-2024
LA,2024-05-31,inter-total,25,3,1,0,0,1,1,0,0,6,15,52,40,43,FALSE,0.826923076923077,2023,2023-2024
LA,2024-05-31,inter-ucfe,0,0,0,0,0,0,0,0,0,0,0,0,0,0,FALSE,0,2023,2023-2024
LA,2024-05-31,inter-ucx,0,0,0,0,0,0,0,0,0,0,0,0,0,0,FALSE,0,2023,2023-2024
LA,2024-05-31,inter-ui,25,3,1,0,0,1,1,0,0,6,15,52,40,43,FALSE,0.826923076923077,2023,2023-2024
LA,2024-05-31,intra-total,1066,122,51,32,31,20,29,17,13,146,616,2143,1682,1804,FALSE,0.841810545963602,2023,2023-2024
LA,2024-05-31,intra-ucfe,2,1,0,0,0,1,0,0,0,0,3,7,5,6,FALSE,0.857142857142857,2023,2023-2024
LA,2024-05-31,intra-ucx,3,0,1,0,0,0,0,0,0,0,2,6,5,5,FALSE,0.833333333333333,2023,2023-2024
LA,2024-05-31,intra-ui,1061,121,50,32,31,19,29,17,13,146,611,2130,1672,1793,FALSE,0.841784037558685,2023,2023-2024
LA,2024-06-30,inter-total,11,2,5,3,3,1,1,0,0,0,23,49,34,36,FALSE,0.73469387755102,2023,2023-2024
LA,2024-06-30,inter-ucfe,1,0,0,0,0,0,0,0,0,0,1,2,2,2,FALSE,1,2023,2023-2024
LA,2024-06-30,inter-ucx,0,0,0,0,0,0,0,0,0,0,0,0,0,0,FALSE,0,2023,2023-2024
LA,2024-06-30,inter-ui,10,2,5,3,3,1,1,0,0,0,22,47,32,34,FALSE,0.723404255319149,2023,2023-2024
LA,2024-06-30,intra-total,1254,302,107,56,27,13,12,9,4,121,1035,2940,2289,2591,FALSE,0.881292517006803,2023,2023-2024
LA,2024-06-30,intra-ucfe,1,0,0,0,0,0,0,0,0,0,2,3,3,3,FALSE,1,2023,2023-2024
LA,2024-06-30,intra-ucx,1,0,0,0,0,0,0,0,0,0,0,1,1,1,FALSE,1,2023,2023-2024
LA,2024-06-30,intra-ui,1252,302,107,56,27,13,12,9,4,121,1033,2936,2285,2587,FALSE,0.881130790190736,2023,2023-2024
LA,2024-07-31,inter-total,14,8,4,1,2,0,0,0,0,0,12,41,26,34,FALSE,0.829268292682927,2024,2024-2025
LA,2024-07-31,inter-ucfe,0,1,0,0,0,0,0,0,0,0,0,1,0,1,FALSE,1,2024,2024-2025
LA,2024-07-31,inter-ucx,0,0,0,0,0,0,0,0,0,0,0,0,0,0,FALSE,0,2024,2024-2025
LA,2024-07-31,inter-ui,14,7,4,1,2,0,0,0,0,0,12,40,26,33,FALSE,0.825,2024,2024-2025
LA,2024-07-31,intra-total,1010,400,225,183,117,74,47,28,14,104,798,3000,1808,2208,FALSE,0.736,2024,2024-2025
LA,2024-07-31,intra-ucfe,3,0,0,1,0,0,0,0,0,1,1,6,4,4,FALSE,0.666666666666667,2024,2024-2025
LA,2024-07-31,intra-ucx,0,0,0,0,0,0,0,0,0,0,0,0,0,0,FALSE,0,2024,2024-2025
LA,2024-07-31,intra-ui,1007,400,225,182,117,74,47,28,14,103,797,2994,1804,2204,FALSE,0.736138944555778,2024,2024-2025
LA,2024-08-31,inter-total,9,5,6,2,4,0,2,2,0,2,22,54,31,36,FALSE,0.666666666666667,2024,2024-2025
LA,2024-08-31,inter-ucfe,0,0,0,0,0,0,0,1,0,0,0,1,0,0,FALSE,0,2024,2024-2025
LA,2024-08-31,inter-ucx,0,1,0,0,0,0,0,0,0,0,0,1,0,1,FALSE,1,2024,2024-2025
LA,2024-08-31,inter-ui,9,4,6,2,4,0,2,1,0,2,22,52,31,35,FALSE,0.673076923076923,2024,2024-2025
LA,2024-08-31,intra-total,630,307,195,174,100,81,59,66,37,97,696,2442,1326,1633,FALSE,0.668714168714169,2024,2024-2025
LA,2024-08-31,intra-ucfe,4,0,0,0,0,1,0,0,0,0,0,5,4,4,FALSE,0.8,2024,2024-2025
LA,2024-08-31,intra-ucx,4,1,0,0,0,0,0,0,0,0,2,7,6,7,FALSE,1,2024,2024-2025
LA,2024-08-31,intra-ui,622,306,195,174,100,80,59,66,37,97,694,2430,1316,1622,FALSE,0.667489711934156,2024,2024-2025
LA,2024-09-30,inter-total,14,8,5,4,5,1,2,0,0,1,16,56,30,38,FALSE,0.678571428571429,2024,2024-2025
LA,2024-09-30,inter-ucfe,0,0,0,0,0,0,0,0,0,0,0,0,0,0,FALSE,0,2024,2024-2025
LA,2024-09-30,inter-ucx,0,0,0,0,0,0,0,0,0,0,0,0,0,0,FALSE,0,2024,2024-2025
LA,2024-09-30,inter-ui,14,8,5,4,5,1,2,0,0,1,16,56,30,38,FALSE,0.678571428571429,2024,2024-2025
LA,2024-09-30,intra-total,559,250,153,135,110,77,74,40,35,105,571,2109,1130,1380,FALSE,0.654338549075391,2024,2024-2025
LA,2024-09-30,intra-ucfe,2,0,0,0,0,0,1,0,0,0,1,4,3,3,FALSE,0.75,2024,2024-2025
LA,2024-09-30,intra-ucx,0,1,0,0,0,0,0,0,0,1,2,4,2,3,FALSE,0.75,2024,2024-2025
LA,2024-09-30,intra-ui,557,249,153,135,110,77,73,40,35,104,568,2101,1125,1374,FALSE,0.653974297953356,2024,2024-2025
LA,2024-10-31,inter-total,16,4,4,3,3,3,2,3,0,5,27,70,43,47,FALSE,0.671428571428571,2024,2024-2025
LA,2024-10-31,inter-ucfe,0,0,0,0,0,0,0,0,0,0,1,1,1,1,FALSE,1,2024,2024-2025
LA,2024-10-31,inter-ucx,0,0,0,0,0,0,0,0,0,0,0,0,0,0,FALSE,0,2024,2024-2025
LA,2024-10-31,inter-ui,16,4,4,3,3,3,2,3,0,5,26,69,42,46,FALSE,0.666666666666667,2024,2024-2025
LA,2024-10-31,intra-total,752,241,114,95,114,102,73,82,40,146,614,2373,1366,1607,FALSE,0.677201854193005,2024,2024-2025
LA,2024-10-31,intra-ucfe,2,1,0,0,0,0,0,0,0,0,1,4,3,4,FALSE,1,2024,2024-2025
LA,2024-10-31,intra-ucx,1,0,0,1,0,0,0,0,0,0,0,2,1,1,FALSE,0.5,2024,2024-2025
LA,2024-10-31,intra-ui,749,240,114,94,114,102,73,82,40,146,613,2367,1362,1602,FALSE,0.67680608365019,2024,2024-2025
LA,2024-11-30,inter-total,20,6,2,1,2,2,1,2,0,3,18,57,38,44,FALSE,0.771929824561403,2024,2024-2025
LA,2024-11-30,inter-ucfe,0,0,0,0,0,0,0,0,0,0,0,0,0,0,FALSE,0,2024,2024-2025
LA,2024-11-30,inter-ucx,0,0,0,0,0,0,0,0,0,0,0,0,0,0,FALSE,0,2024,2024-2025
LA,2024-11-30,inter-ui,20,6,2,1,2,2,1,2,0,3,18,57,38,44,FALSE,0.771929824561403,2024,2024-2025
LA,2024-11-30,intra-total,725,198,71,63,41,30,26,30,22,98,574,1878,1299,1497,FALSE,0.797124600638978,2024,2024-2025
LA,2024-11-30,intra-ucfe,4,0,0,0,0,0,0,0,0,1,1,6,5,5,FALSE,0.833333333333333,2024,2024-2025
LA,2024-11-30,intra-ucx,0,0,1,0,0,0,0,0,0,0,0,1,0,0,FALSE,0,2024,2024-2025
LA,2024-11-30,intra-ui,721,198,70,63,41,30,26,30,22,97,573,1871,1294,1492,FALSE,0.797434526990914,2024,2024-2025
LA,2024-12-31,inter-total,34,7,4,2,0,1,1,0,0,2,37,88,71,78,FALSE,0.886363636363636,2024,2024-2025
LA,2024-12-31,inter-ucfe,1,0,0,0,0,0,0,0,0,1,0,2,1,1,FALSE,0.5,2024,2024-2025
LA,2024-12-31,inter-ucx,0,0,0,0,0,0,0,0,0,0,0,0,0,0,FALSE,0,2024,2024-2025
LA,2024-12-31,inter-ui,33,7,4,2,0,1,1,0,0,1,37,86,70,77,FALSE,0.895348837209302,2024,2024-2025
LA,2024-12-31,intra-total,1040,195,79,61,35,38,28,22,9,97,699,2303,1739,1934,FALSE,0.839774207555363,2024,2024-2025
LA,2024-12-31,intra-ucfe,2,0,0,0,0,0,0,0,0,0,0,2,2,2,FALSE,1,2024,2024-2025
LA,2024-12-31,intra-ucx,0,0,0,0,0,0,0,0,0,0,0,0,0,0,FALSE,0,2024,2024-2025
LA,2024-12-31,intra-ui,1038,195,79,61,35,38,28,22,9,97,699,2301,1737,1932,FALSE,0.839634941329857,2024,2024-2025
MA,2019-01-31,inter-total,714,46,19,22,12,6,4,3,2,17,175,1020,889,935,FALSE,0.916666666666667,2018,2018-2019
MA,2019-01-31,inter-ucfe,33,0,0,0,0,0,0,0,1,0,6,40,39,39,FALSE,0.975,2018,2018-2019
MA,2019-01-31,inter-ucx,5,0,0,1,0,0,0,0,0,0,0,6,5,5,FALSE,0.833333333333333,2018,2018-2019
MA,2019-01-31,inter-ui,676,46,19,21,12,6,4,3,1,17,169,974,845,891,FALSE,0.914784394250513,2018,2018-2019
MA,2019-01-31,intra-total,18830,1025,519,301,187,130,92,96,57,349,4410,25996,23240,24265,FALSE,0.933412832743499,2018,2018-2019
MA,2019-01-31,intra-ucfe,453,7,2,1,0,1,0,1,0,2,98,565,551,558,FALSE,0.987610619469027,2018,2018-2019
MA,2019-01-31,intra-ucx,12,3,1,1,0,0,1,1,0,1,2,22,14,17,FALSE,0.772727272727273,2018,2018-2019
MA,2019-01-31,intra-ui,18365,1015,516,299,187,129,91,94,57,346,4310,25409,22675,23690,FALSE,0.932346806249754,2018,2018-2019
MA,2019-02-28,inter-total,450,34,18,15,18,9,8,4,3,8,136,703,586,620,FALSE,0.881934566145092,2018,2018-2019
MA,2019-02-28,inter-ucfe,0,0,2,0,0,0,1,0,0,1,0,4,0,0,FALSE,0,2018,2018-2019
MA,2019-02-28,inter-ucx,0,0,0,0,0,0,1,0,0,0,0,1,0,0,FALSE,0,2018,2018-2019
MA,2019-02-28,inter-ui,450,34,16,15,18,9,6,4,3,7,136,698,586,620,FALSE,0.888252148997135,2018,2018-2019
MA,2019-02-28,intra-total,10721,819,446,366,299,208,139,86,71,334,3043,16532,13764,14583,FALSE,0.882107428018389,2018,2018-2019
MA,2019-02-28,intra-ucfe,10,5,10,10,1,2,0,0,0,1,6,45,16,21,FALSE,0.466666666666667,2018,2018-2019
MA,2019-02-28,intra-ucx,10,3,0,0,0,0,0,0,0,1,0,14,10,13,FALSE,0.928571428571429,2018,2018-2019
MA,2019-02-28,intra-ui,10701,811,436,356,298,206,139,86,71,332,3037,16473,13738,14549,FALSE,0.883202816730407,2018,2018-2019
MA,2019-03-31,inter-total,351,32,17,7,13,10,6,6,9,15,77,543,428,460,FALSE,0.847145488029466,2018,2018-2019
MA,2019-03-31,inter-ucfe,1,0,0,0,0,0,0,0,0,0,0,1,1,1,FALSE,1,2018,2018-2019
MA,2019-03-31,inter-ucx,1,0,0,0,0,0,0,0,0,0,1,2,2,2,FALSE,1,2018,2018-2019
MA,2019-03-31,inter-ui,349,32,17,7,13,10,6,6,9,15,76,540,425,457,FALSE,0.846296296296296,2018,2018-2019
MA,2019-03-31,intra-total,6804,622,347,295,247,250,187,138,90,428,2554,11962,9358,9980,FALSE,0.834308644039458,2018,2018-2019
MA,2019-03-31,intra-ucfe,3,6,2,1,0,0,0,0,0,2,5,19,8,14,FALSE,0.736842105263158,2018,2018-2019
MA,2019-03-31,intra-ucx,7,0,0,1,0,0,0,0,0,1,4,13,11,11,FALSE,0.846153846153846,2018,2018-2019
MA,2019-03-31,intra-ui,6794,616,345,293,247,250,187,138,90,425,2545,11930,9339,9955,FALSE,0.834450963956412,2018,2018-2019
MA,2019-04-30,inter-total,285,26,13,4,7,4,6,8,6,23,93,475,378,404,FALSE,0.850526315789474,2018,2018-2019
MA,2019-04-30,inter-ucfe,1,0,0,0,0,0,0,0,0,0,0,1,1,1,FALSE,1,2018,2018-2019
MA,2019-04-30,inter-ucx,1,0,0,0,0,0,0,1,0,0,1,3,2,2,FALSE,0.666666666666667,2018,2018-2019
MA,2019-04-30,inter-ui,283,26,13,4,7,4,6,7,6,23,92,471,375,401,FALSE,0.851380042462845,2018,2018-2019
MA,2019-04-30,intra-total,6233,496,257,181,133,112,122,100,92,457,2008,10191,8241,8737,FALSE,0.857325090766362,2018,2018-2019
MA,2019-04-30,intra-ucfe,5,3,0,1,0,1,1,0,0,3,2,16,7,10,FALSE,0.625,2018,2018-2019
MA,2019-04-30,intra-ucx,7,0,1,0,1,0,0,0,0,0,4,13,11,11,FALSE,0.846153846153846,2018,2018-2019
MA,2019-04-30,intra-ui,6221,493,256,180,132,111,121,100,92,454,2002,10162,8223,8716,FALSE,0.857705176146428,2018,2018-2019
MA,2019-05-31,inter-total,259,18,8,15,5,4,8,5,0,33,77,432,336,354,FALSE,0.819444444444445,2018,2018-2019
MA,2019-05-31,inter-ucfe,0,0,0,0,1,0,0,0,0,0,1,2,1,1,FALSE,0.5,2018,2018-2019
MA,2019-05-31,inter-ucx,0,0,0,0,0,1,0,0,0,1,1,3,1,1,FALSE,0.333333333333333,2018,2018-2019
MA,2019-05-31,inter-ui,259,18,8,15,4,3,8,5,0,32,75,427,334,352,FALSE,0.824355971896956,2018,2018-2019
MA,2019-05-31,intra-total,5694,496,237,220,148,104,91,92,62,546,1782,9472,7476,7972,FALSE,0.841638513513514,2018,2018-2019
MA,2019-05-31,intra-ucfe,4,0,1,1,0,0,0,1,1,3,3,14,7,7,FALSE,0.5,2018,2018-2019
MA,2019-05-31,intra-ucx,15,2,1,0,0,0,0,1,0,2,2,23,17,19,FALSE,0.826086956521739,2018,2018-2019
MA,2019-05-31,intra-ui,5675,494,235,219,148,104,91,90,61,541,1777,9435,7452,7946,FALSE,0.842183359830419,2018,2018-2019
MA,2019-06-30,inter-total,271,19,13,4,6,6,9,5,2,21,90,446,361,380,FALSE,0.852017937219731,2018,2018-2019
MA,2019-06-30,inter-ucfe,1,0,0,0,0,0,0,0,0,1,0,2,1,1,FALSE,0.5,2018,2018-2019
MA,2019-06-30,inter-ucx,0,0,0,0,0,0,0,0,0,0,2,2,2,2,FALSE,1,2018,2018-2019
MA,2019-06-30,inter-ui,270,19,13,4,6,6,9,5,2,20,88,442,358,377,FALSE,0.852941176470588,2018,2018-2019
MA,2019-06-30,intra-total,6110,496,218,187,150,122,114,109,77,413,1771,9767,7881,8377,FALSE,0.857684038087437,2018,2018-2019
MA,2019-06-30,intra-ucfe,6,0,0,1,1,1,0,0,2,2,3,16,9,9,FALSE,0.5625,2018,2018-2019
MA,2019-06-30,intra-ucx,10,2,0,0,1,3,1,0,0,1,1,19,11,13,FALSE,0.68421052631579,2018,2018-2019
MA,2019-06-30,intra-ui,6094,494,218,186,148,118,113,109,75,410,1767,9732,7861,8355,FALSE,0.858508014796547,2018,2018-2019
MA,2019-07-31,inter-total,341,22,7,9,13,6,4,5,1,25,77,510,418,440,FALSE,0.862745098039216,2019,2019-2020
MA,2019-07-31,inter-ucfe,0,0,1,0,0,0,0,0,0,0,0,1,0,0,FALSE,0,2019,2019-2020
MA,2019-07-31,inter-ucx,1,0,1,0,0,0,0,0,0,0,0,2,1,1,FALSE,0.5,2019,2019-2020
MA,2019-07-31,inter-ui,340,22,5,9,13,6,4,5,1,25,77,507,417,439,FALSE,0.865877712031558,2019,2019-2020
MA,2019-07-31,intra-total,9978,648,275,182,152,129,120,77,67,810,2810,15248,12788,13436,FALSE,0.881164742917104,2019,2019-2020
MA,2019-07-31,intra-ucfe,14,4,3,0,1,2,2,0,0,2,7,35,21,25,FALSE,0.714285714285714,2019,2019-2020
MA,2019-07-31,intra-ucx,16,1,1,0,0,1,0,0,1,1,4,25,20,21,FALSE,0.84,2019,2019-2020
MA,2019-07-31,intra-ui,9948,643,271,182,151,126,118,77,66,807,2799,15188,12747,13390,FALSE,0.88161706610482,2019,2019-2020
MA,2019-08-31,inter-total,256,17,11,14,15,9,7,2,3,34,75,443,331,348,FALSE,0.785553047404063,2019,2019-2020
MA,2019-08-31,inter-ucfe,0,0,1,0,0,0,0,0,0,1,0,2,0,0,FALSE,0,2019,2019-2020
MA,2019-08-31,inter-ucx,2,0,0,0,0,0,0,0,0,0,0,2,2,2,FALSE,1,2019,2019-2020
MA,2019-08-31,inter-ui,254,17,10,14,15,9,7,2,3,33,75,439,329,346,FALSE,0.788154897494305,2019,2019-2020
MA,2019-08-31,intra-total,5709,556,286,279,200,192,166,101,60,615,1843,10007,7552,8108,FALSE,0.81023283701409,2019,2019-2020
MA,2019-08-31,intra-ucfe,0,1,2,5,0,1,0,0,0,5,0,14,0,1,FALSE,0.0714285714285714,2019,2019-2020
MA,2019-08-31,intra-ucx,5,0,0,0,0,0,0,0,0,1,4,10,9,9,FALSE,0.9,2019,2019-2020
MA,2019-08-31,intra-ui,5704,555,284,274,200,191,166,101,60,609,1839,9983,7543,8098,FALSE,0.811179004307322,2019,2019-2020
MA,2019-09-30,inter-total,238,11,11,9,5,11,2,5,4,23,57,376,295,306,FALSE,0.813829787234043,2019,2019-2020
MA,2019-09-30,inter-ucfe,0,0,0,0,0,0,0,0,0,0,0,0,0,0,FALSE,0,2019,2019-2020
MA,2019-09-30,inter-ucx,4,0,0,0,0,0,0,0,0,0,1,5,5,5,FALSE,1,2019,2019-2020
MA,2019-09-30,inter-ui,234,11,11,9,5,11,2,5,4,23,56,371,290,301,FALSE,0.811320754716981,2019,2019-2020
MA,2019-09-30,intra-total,4752,463,222,139,126,122,95,112,104,570,1522,8227,6274,6737,FALSE,0.818889023945545,2019,2019-2020
MA,2019-09-30,intra-ucfe,5,1,2,1,1,2,0,0,0,1,4,17,9,10,FALSE,0.588235294117647,2019,2019-2020
MA,2019-09-30,intra-ucx,10,1,0,1,2,0,0,0,0,2,2,18,12,13,FALSE,0.722222222222222,2019,2019-2020
MA,2019-09-30,intra-ui,4737,461,220,137,123,120,95,112,104,567,1516,8192,6253,6714,FALSE,0.819580078125,2019,2019-2020
MA,2019-10-31,inter-total,272,17,19,8,14,8,5,6,6,39,79,473,351,368,FALSE,0.778012684989429,2019,2019-2020
MA,2019-10-31,inter-ucfe,0,1,0,0,0,0,0,0,0,0,0,1,0,1,FALSE,1,2019,2019-2020
MA,2019-10-31,inter-ucx,2,0,1,0,0,1,0,0,0,0,0,4,2,2,FALSE,0.5,2019,2019-2020
MA,2019-10-31,inter-ui,270,16,18,8,14,7,5,6,6,39,79,468,349,365,FALSE,0.77991452991453,2019,2019-2020
MA,2019-10-31,intra-total,4792,567,249,185,176,184,130,95,93,653,1699,8823,6491,7058,FALSE,0.799954663946504,2019,2019-2020
MA,2019-10-31,intra-ucfe,3,1,0,1,1,0,2,0,1,3,3,15,6,7,FALSE,0.466666666666667,2019,2019-2020
MA,2019-10-31,intra-ucx,7,1,1,0,0,1,0,0,0,3,2,15,9,10,FALSE,0.666666666666667,2019,2019-2020
MA,2019-10-31,intra-ui,4782,565,248,184,175,183,128,95,92,647,1694,8793,6476,7041,FALSE,0.800750597065848,2019,2019-2020
MA,2019-11-30,inter-total,398,24,10,11,7,12,9,2,3,27,96,599,494,518,FALSE,0.864774624373957,2019,2019-2020
MA,2019-11-30,inter-ucfe,0,1,2,0,0,0,0,0,0,0,0,3,0,1,FALSE,0.333333333333333,2019,2019-2020
MA,2019-11-30,inter-ucx,2,0,0,0,0,0,0,0,0,0,1,3,3,3,FALSE,1,2019,2019-2020
MA,2019-11-30,inter-ui,396,23,8,11,7,12,9,2,3,27,95,593,491,514,FALSE,0.866779089376054,2019,2019-2020
MA,2019-11-30,intra-total,6909,527,280,200,233,144,135,115,88,644,2075,11350,8984,9511,FALSE,0.837973568281938,2019,2019-2020
MA,2019-11-30,intra-ucfe,7,1,1,1,0,0,3,1,0,5,9,28,16,17,FALSE,0.607142857142857,2019,2019-2020
MA,2019-11-30,intra-ucx,6,0,2,2,0,0,0,0,0,1,8,19,14,14,FALSE,0.736842105263158,2019,2019-2020
MA,2019-11-30,intra-ui,6896,526,277,197,233,144,132,114,88,638,2058,11303,8954,9480,FALSE,0.838715385295939,2019,2019-2020
MA,2019-12-31,inter-total,528,28,12,10,3,8,7,2,5,30,102,735,630,658,FALSE,0.895238095238095,2019,2019-2020
MA,2019-12-31,inter-ucfe,1,2,1,0,0,0,0,0,0,0,2,6,3,5,FALSE,0.833333333333333,2019,2019-2020
MA,2019-12-31,inter-ucx,3,0,0,0,0,0,0,0,0,1,1,5,4,4,FALSE,0.8,2019,2019-2020
MA,2019-12-31,inter-ui,524,26,11,10,3,8,7,2,5,29,99,724,623,649,FALSE,0.896408839779006,2019,2019-2020
MA,2019-12-31,intra-total,13191,521,276,184,162,116,114,135,98,505,2415,17717,15606,16127,FALSE,0.910255686628662,2019,2019-2020
MA,2019-12-31,intra-ucfe,11,2,3,1,2,2,1,0,0,1,5,28,16,18,FALSE,0.642857142857143,2019,2019-2020
MA,2019-12-31,intra-ucx,7,1,2,0,1,1,0,0,0,1,3,16,10,11,FALSE,0.6875,2019,2019-2020
MA,2019-12-31,intra-ui,13173,518,271,183,159,113,113,135,98,503,2407,17673,15580,16098,FALSE,0.910881004922764,2019,2019-2020
MA,2020-01-31,inter-total,591,32,13,18,8,3,11,7,5,42,112,842,703,735,FALSE,0.8729216152019,2019,2019-2020
MA,2020-01-31,inter-ucfe,0,0,0,0,0,0,0,0,1,0,0,1,0,0,FALSE,0,2019,2019-2020
MA,2020-01-31,inter-ucx,3,1,0,0,0,0,0,0,0,0,0,4,3,4,FALSE,1,2019,2019-2020
MA,2020-01-31,inter-ui,588,31,13,18,8,3,11,7,4,42,112,837,700,731,FALSE,0.873357228195938,2019,2019-2020
MA,2020-01-31,intra-total,16855,865,368,245,243,182,162,143,108,690,3757,23618,20612,21477,FALSE,0.909348801761368,2019,2019-2020
MA,2020-01-31,intra-ucfe,9,2,0,2,1,0,4,1,1,3,4,27,13,15,FALSE,0.555555555555556,2019,2019-2020
MA,2020-01-31,intra-ucx,11,1,2,1,0,0,1,0,1,2,2,21,13,14,FALSE,0.666666666666667,2019,2019-2020
MA,2020-01-31,intra-ui,16835,862,366,242,242,182,157,142,106,685,3751,23570,20586,21448,FALSE,0.909970301230378,2019,2019-2020
MA,2020-02-29,inter-total,375,28,17,17,8,15,9,4,8,37,141,659,516,544,FALSE,0.825493171471927,2019,2019-2020
MA,2020-02-29,inter-ucfe,0,0,0,0,0,0,1,0,0,1,0,2,0,0,FALSE,0,2019,2019-2020
MA,2020-02-29,inter-ucx,2,2,0,0,0,0,0,0,0,0,1,5,3,5,FALSE,1,2019,2019-2020
MA,2020-02-29,inter-ui,373,26,17,17,8,15,8,4,8,36,140,652,513,539,FALSE,0.826687116564417,2019,2019-2020
MA,2020-02-29,intra-total,9183,901,549,330,272,197,197,151,127,749,3764,16420,12947,13848,FALSE,0.843361753958587,2019,2019-2020
MA,2020-02-29,intra-ucfe,4,0,1,1,0,0,1,2,0,6,2,17,6,6,FALSE,0.352941176470588,2019,2019-2020
MA,2020-02-29,intra-ucx,11,2,4,0,0,0,1,0,1,1,0,20,11,13,FALSE,0.65,2019,2019-2020
MA,2020-02-29,intra-ui,9168,899,544,329,272,197,195,149,126,742,3762,16383,12930,13829,FALSE,0.84410669596533,2019,2019-2020
MA,2020-03-31,inter-total,654,60,17,12,9,4,9,2,5,25,202,999,856,916,FALSE,0.916916916916917,2019,2019-2020
MA,2020-03-31,inter-ucfe,1,0,0,0,0,0,0,0,0,0,2,3,3,3,FALSE,1,2019,2019-2020
MA,2020-03-31,inter-ucx,4,1,0,0,0,0,0,0,0,0,0,5,4,5,FALSE,1,2019,2019-2020
MA,2020-03-31,inter-ui,649,59,17,12,9,4,9,2,5,25,200,991,849,908,FALSE,0.916246215943491,2019,2019-2020
MA,2020-03-31,intra-total,29953,2546,425,208,200,176,188,142,108,654,11947,46547,41900,44446,FALSE,0.954862826820203,2019,2019-2020
MA,2020-03-31,intra-ucfe,0,0,0,0,0,0,1,0,0,2,1,4,1,1,FALSE,0.25,2019,2019-2020
MA,2020-03-31,intra-ucx,5,1,2,1,1,0,0,0,0,1,5,16,10,11,FALSE,0.6875,2019,2019-2020
MA,2020-03-31,intra-ui,29948,2545,423,207,199,176,187,142,108,651,11941,46527,41889,44434,FALSE,0.955015367421067,2019,2019-2020
MA,2020-04-30,inter-total,1116,890,209,73,33,16,7,8,4,46,1703,4105,2819,3709,FALSE,0.90353227771011,2019,2019-2020
MA,2020-04-30,inter-ucfe,0,0,0,1,0,0,0,0,0,0,2,3,2,2,FALSE,0.666666666666667,2019,2019-2020
MA,2020-04-30,inter-ucx,1,2,0,1,0,0,0,0,0,1,1,6,2,4,FALSE,0.666666666666667,2019,2019-2020
MA,2020-04-30,inter-ui,1115,888,209,71,33,16,7,8,4,45,1700,4096,2815,3703,FALSE,0.904052734375,2019,2019-2020
MA,2020-04-30,intra-total,63280,31824,6540,3148,1443,447,222,174,168,1508,70166,178920,133446,165270,FALSE,0.923708920187793,2019,2019-2020
MA,2020-04-30,intra-ucfe,13,12,4,3,1,1,1,3,1,1,24,64,37,49,FALSE,0.765625,2019,2019-2020
MA,2020-04-30,intra-ucx,8,17,2,5,5,0,0,0,0,1,22,60,30,47,FALSE,0.783333333333333,2019,2019-2020
MA,2020-04-30,intra-ui,63259,31795,6534,3140,1437,446,221,171,167,1506,70120,178796,133379,165174,FALSE,0.923812613257567,2019,2019-2020
MA,2020-05-31,inter-total,543,551,191,81,94,80,67,25,6,83,714,2435,1257,1808,FALSE,0.742505133470226,2019,2019-2020
MA,2020-05-31,inter-ucfe,0,1,0,0,0,0,0,0,0,0,1,2,1,2,FALSE,1,2019,2019-2020
MA,2020-05-31,inter-ucx,0,0,0,0,0,0,0,0,0,0,0,0,0,0,FALSE,0,2019,2019-2020
MA,2020-05-31,inter-ui,543,550,191,81,94,80,67,25,6,83,713,2433,1256,1806,FALSE,0.7422934648582,2019,2019-2020
MA,2020-05-31,intra-total,25193,16857,4957,2813,2789,2636,2176,1239,442,2376,23124,84602,48317,65174,FALSE,0.770360038769769,2019,2019-2020
MA,2020-05-31,intra-ucfe,26,30,4,1,5,1,2,0,1,4,36,110,62,92,FALSE,0.836363636363636,2019,2019-2020
MA,2020-05-31,intra-ucx,10,19,3,0,0,1,1,2,1,1,22,60,32,51,FALSE,0.85,2019,2019-2020
MA,2020-05-31,intra-ui,25157,16808,4950,2812,2784,2634,2173,1237,440,2371,23066,84432,48223,65031,FALSE,0.770217453098351,2019,2019-2020
MA,2020-06-30,inter-total,335,291,62,30,34,29,29,32,45,131,412,1430,747,1038,FALSE,0.725874125874126,2019,2019-2020
MA,2020-06-30,inter-ucfe,0,1,0,0,0,0,0,0,0,1,0,2,0,1,FALSE,0.5,2019,2019-2020
MA,2020-06-30,inter-ucx,0,0,0,0,0,0,0,0,0,0,0,0,0,0,FALSE,0,2019,2019-2020
MA,2020-06-30,inter-ui,335,290,62,30,34,29,29,32,45,130,412,1428,747,1037,FALSE,0.726190476190476,2019,2019-2020
MA,2020-06-30,intra-total,15770,7423,2078,1012,773,656,693,960,1211,4027,15644,50247,31414,38837,FALSE,0.77292176647362,2019,2019-2020
MA,2020-06-30,intra-ucfe,8,13,6,5,2,1,1,5,6,4,13,64,21,34,FALSE,0.53125,2019,2019-2020
MA,2020-06-30,intra-ucx,11,11,2,0,0,0,0,3,0,3,5,35,16,27,FALSE,0.771428571428571,2019,2019-2020
MA,2020-06-30,intra-ui,15751,7399,2070,1007,771,655,692,952,1205,4020,15626,50148,31377,38776,FALSE,0.773231235542793,2019,2019-2020
MA,2020-07-31,inter-total,164,245,62,32,19,19,4,12,15,155,467,1194,631,876,FALSE,0.733668341708543,2020,2020-2021
MA,2020-07-31,inter-ucfe,0,0,0,0,0,0,0,0,0,0,0,0,0,0,FALSE,0,2020,2020-2021
MA,2020-07-31,inter-ucx,0,0,0,0,0,0,0,0,0,0,0,0,0,0,FALSE,0,2020,2020-2021
MA,2020-07-31,inter-ui,164,245,62,32,19,19,4,12,15,155,467,1194,631,876,FALSE,0.733668341708543,2020,2020-2021
MA,2020-07-31,intra-total,6536,8137,2269,965,660,453,350,259,220,2838,15538,38225,22074,30211,FALSE,0.790346631785481,2020,2020-2021
MA,2020-07-31,intra-ucfe,4,5,2,0,2,0,1,2,0,5,6,27,10,15,FALSE,0.555555555555556,2020,2020-2021
MA,2020-07-31,intra-ucx,4,2,0,0,0,2,0,0,2,12,8,30,12,14,FALSE,0.466666666666667,2020,2020-2021
MA,2020-07-31,intra-ui,6528,8130,2267,965,658,451,349,257,218,2821,15524,38168,22052,30182,FALSE,0.790767134772584,2020,2020-2021
MA,2020-08-31,inter-total,110,184,84,28,23,25,10,10,9,78,229,790,339,523,FALSE,0.662025316455696,2020,2020-2021
MA,2020-08-31,inter-ucfe,0,0,0,0,0,0,0,0,0,1,0,1,0,0,FALSE,0,2020,2020-2021
MA,2020-08-31,inter-ucx,1,1,0,0,0,0,0,0,0,0,0,2,1,2,FALSE,1,2020,2020-2021
MA,2020-08-31,inter-ui,109,183,84,28,23,25,10,10,9,77,229,787,338,521,FALSE,0.662007623888183,2020,2020-2021
MA,2020-08-31,intra-total,2716,5185,2379,972,536,434,304,297,231,1791,6093,20938,8809,13994,FALSE,0.668354188556691,2020,2020-2021
MA,2020-08-31,intra-ucfe,4,8,2,3,3,0,3,0,0,7,4,34,8,16,FALSE,0.470588235294118,2020,2020-2021
MA,2020-08-31,intra-ucx,4,4,1,0,1,1,0,0,0,6,3,20,7,11,FALSE,0.55,2020,2020-2021
MA,2020-08-31,intra-ui,2708,5173,2376,969,532,433,301,297,231,1778,6086,20884,8794,13967,FALSE,0.668789503926451,2020,2020-2021
MA,2020-09-30,inter-total,782,142,51,27,10,5,7,3,10,92,228,1357,1010,1152,FALSE,0.848931466470155,2020,2020-2021
MA,2020-09-30,inter-ucfe,0,0,0,1,0,0,1,0,0,0,0,2,0,0,FALSE,0,2020,2020-2021
MA,2020-09-30,inter-ucx,0,0,0,0,0,0,0,0,0,0,0,0,0,0,FALSE,0,2020,2020-2021
MA,2020-09-30,inter-ui,782,142,51,26,10,5,6,3,10,92,228,1355,1010,1152,FALSE,0.850184501845019,2020,2020-2021
MA,2020-09-30,intra-total,3822,3707,1826,532,298,218,178,199,177,1928,5720,18605,9542,13249,FALSE,0.712120397742542,2020,2020-2021
MA,2020-09-30,intra-ucfe,1,5,1,1,1,1,0,1,0,1,6,18,7,12,FALSE,0.666666666666667,2020,2020-2021
MA,2020-09-30,intra-ucx,4,4,2,0,1,0,0,0,0,12,3,26,7,11,FALSE,0.423076923076923,2020,2020-2021
MA,2020-09-30,intra-ui,3817,3698,1823,531,296,217,178,198,177,1915,5711,18561,9528,13226,FALSE,0.712569365874684,2020,2020-2021
MA,2020-10-31,inter-total,1595,119,37,18,8,7,3,5,4,90,240,2126,1835,1954,FALSE,0.919096895578551,2020,2020-2021
MA,2020-10-31,inter-ucfe,0,0,0,0,0,0,0,0,0,0,0,0,0,0,FALSE,0,2020,2020-2021
MA,2020-10-31,inter-ucx,1,0,1,0,0,0,0,0,0,1,0,3,1,1,FALSE,0.333333333333333,2020,2020-2021
MA,2020-10-31,inter-ui,1594,119,36,18,8,7,3,5,4,89,240,2123,1834,1953,FALSE,0.919924634950542,2020,2020-2021
MA,2020-10-31,intra-total,5655,2135,1004,434,206,133,107,87,69,1339,4450,15619,10105,12240,FALSE,0.783660925795506,2020,2020-2021
MA,2020-10-31,intra-ucfe,2,7,2,2,1,2,0,0,0,11,6,33,8,15,FALSE,0.454545454545455,2020,2020-2021
MA,2020-10-31,intra-ucx,5,3,0,1,0,0,0,0,0,5,3,17,8,11,FALSE,0.647058823529412,2020,2020-2021
MA,2020-10-31,intra-ui,5648,2125,1002,431,205,131,107,87,69,1323,4441,15569,10089,12214,FALSE,0.784507675509024,2020,2020-2021
MA,2020-11-30,inter-total,30,45,33,22,21,17,16,5,5,49,90,333,120,165,FALSE,0.495495495495496,2020,2020-2021
MA,2020-11-30,inter-ucfe,0,0,0,0,0,0,0,0,0,0,1,1,1,1,FALSE,1,2020,2020-2021
MA,2020-11-30,inter-ucx,0,0,0,0,0,1,0,0,0,1,0,2,0,0,FALSE,0,2020,2020-2021
MA,2020-11-30,inter-ui,30,45,33,22,21,16,16,5,5,48,89,330,119,164,FALSE,0.496969696969697,2020,2020-2021
MA,2020-11-30,intra-total,1005,1805,1132,727,488,286,401,104,93,915,1861,8817,2866,4671,FALSE,0.529772031303164,2020,2020-2021
MA,2020-11-30,intra-ucfe,2,23,14,15,2,0,1,0,0,5,21,83,23,46,FALSE,0.55421686746988,2020,2020-2021
MA,2020-11-30,intra-ucx,1,1,3,0,1,0,0,0,0,6,3,15,4,5,FALSE,0.333333333333333,2020,2020-2021
MA,2020-11-30,intra-ui,1002,1781,1115,712,485,286,400,104,93,904,1837,8719,2839,4620,FALSE,0.52987727950453,2020,2020-2021
MA,2020-12-31,inter-total,69,64,28,13,9,7,10,6,13,61,89,369,158,222,FALSE,0.601626016260163,2020,2020-2021
MA,2020-12-31,inter-ucfe,0,0,0,0,0,0,0,0,0,1,0,1,0,0,FALSE,0,2020,2020-2021
MA,2020-12-31,inter-ucx,0,0,0,0,0,0,0,0,0,0,1,1,1,1,FALSE,1,2020,2020-2021
MA,2020-12-31,inter-ui,69,64,28,13,9,7,10,6,13,60,88,367,157,221,FALSE,0.602179836512262,2020,2020-2021
MA,2020-12-31,intra-total,2982,1556,846,609,289,154,141,115,101,1067,3877,11737,6859,8415,FALSE,0.716963448922212,2020,2020-2021
MA,2020-12-31,intra-ucfe,4,12,5,7,3,1,5,0,0,14,35,86,39,51,FALSE,0.593023255813954,2020,2020-2021
MA,2020-12-31,intra-ucx,3,2,1,3,3,0,0,0,0,13,0,25,3,5,FALSE,0.2,2020,2020-2021
MA,2020-12-31,intra-ui,2975,1542,840,599,283,153,136,115,101,1040,3842,11626,6817,8359,FALSE,0.718991914674007,2020,2020-2021
MA,2021-01-31,inter-total,74,49,41,32,29,15,10,10,4,53,80,397,154,203,FALSE,0.511335012594459,2020,2020-2021
MA,2021-01-31,inter-ucfe,0,0,0,0,0,1,0,0,0,0,0,1,0,0,FALSE,0,2020,2020-2021
MA,2021-01-31,inter-ucx,0,0,0,0,0,1,0,0,0,0,0,1,0,0,FALSE,0,2020,2020-2021
MA,2021-01-31,inter-ui,74,49,41,32,29,13,10,10,4,53,80,395,154,203,FALSE,0.513924050632911,2020,2020-2021
MA,2021-01-31,intra-total,2910,1517,1395,1013,697,230,122,130,80,821,4199,13114,7109,8626,FALSE,0.657770321793503,2020,2020-2021
MA,2021-01-31,intra-ucfe,5,5,2,1,0,1,1,1,1,3,13,33,18,23,FALSE,0.696969696969697,2020,2020-2021
MA,2021-01-31,intra-ucx,3,0,5,1,0,0,0,0,0,11,4,24,7,7,FALSE,0.291666666666667,2020,2020-2021
MA,2021-01-31,intra-ui,2902,1512,1388,1011,697,229,121,129,79,807,4182,13057,7084,8596,FALSE,0.658344183196753,2020,2020-2021
MA,2021-02-28,inter-total,52,41,28,33,46,32,28,21,23,103,112,519,164,205,FALSE,0.394990366088632,2020,2020-2021
MA,2021-02-28,inter-ucfe,0,0,0,0,0,0,0,0,0,2,0,2,0,0,FALSE,0,2020,2020-2021
MA,2021-02-28,inter-ucx,0,0,0,0,0,0,0,0,0,0,0,0,0,0,FALSE,0,2020,2020-2021
MA,2021-02-28,inter-ui,52,41,28,33,46,32,28,21,23,101,112,517,164,205,FALSE,0.39651837524178,2020,2020-2021
MA,2021-02-28,intra-total,2098,1417,997,1192,1417,962,528,406,306,1394,3552,14269,5650,7067,FALSE,0.495269465274371,2020,2020-2021
MA,2021-02-28,intra-ucfe,1,4,0,3,5,2,0,3,0,16,4,38,5,9,FALSE,0.236842105263158,2020,2020-2021
MA,2021-02-28,intra-ucx,1,2,3,1,0,0,0,0,0,13,1,21,2,4,FALSE,0.19047619047619,2020,2020-2021
MA,2021-02-28,intra-ui,2096,1411,994,1188,1412,960,528,403,306,1365,3547,14210,5643,7054,FALSE,0.496410978184377,2020,2020-2021
MA,2021-03-31,inter-total,46,61,27,36,35,51,50,58,40,232,125,761,171,232,FALSE,0.304862023653088,2020,2020-2021
MA,2021-03-31,inter-ucfe,0,0,0,0,0,0,0,0,0,2,1,3,1,1,FALSE,0.333333333333333,2020,2020-2021
MA,2021-03-31,inter-ucx,1,0,0,0,0,0,0,0,0,1,0,2,1,1,FALSE,0.5,2020,2020-2021
MA,2021-03-31,inter-ui,45,61,27,36,35,51,50,58,40,229,124,756,169,230,FALSE,0.304232804232804,2020,2020-2021
MA,2021-03-31,intra-total,1602,1193,851,828,1035,1128,1172,892,873,5077,4252,18903,5854,7047,FALSE,0.372797968576416,2020,2020-2021
MA,2021-03-31,intra-ucfe,0,1,3,0,1,3,4,1,3,18,4,38,4,5,FALSE,0.131578947368421,2020,2020-2021
MA,2021-03-31,intra-ucx,1,0,4,1,0,0,1,1,1,12,1,22,2,2,FALSE,0.0909090909090909,2020,2020-2021
MA,2021-03-31,intra-ui,1601,1192,844,827,1034,1125,1167,890,869,5047,4247,18843,5848,7040,FALSE,0.373613543490952,2020,2020-2021
MA,2021-04-30,inter-total,70,68,16,11,15,12,7,9,11,100,209,528,279,347,FALSE,0.65719696969697,2020,2020-2021
MA,2021-04-30,inter-ucfe,0,0,0,0,0,0,0,0,0,0,1,1,1,1,FALSE,1,2020,2020-2021
MA,2021-04-30,inter-ucx,0,1,1,0,0,0,0,0,0,3,0,5,0,1,FALSE,0.2,2020,2020-2021
MA,2021-04-30,inter-ui,70,67,15,11,15,12,7,9,11,97,208,522,278,345,FALSE,0.660919540229885,2020,2020-2021
MA,2021-04-30,intra-total,2047,1432,382,256,218,204,163,166,160,2047,5753,12828,7800,9232,FALSE,0.719675709385719,2020,2020-2021
MA,2021-04-30,intra-ucfe,2,2,0,1,2,0,2,0,1,10,2,22,4,6,FALSE,0.272727272727273,2020,2020-2021
MA,2021-04-30,intra-ucx,6,3,1,0,0,1,0,0,1,3,2,17,8,11,FALSE,0.647058823529412,2020,2020-2021
MA,2021-04-30,intra-ui,2039,1427,381,255,216,203,161,166,158,2034,5749,12789,7788,9215,FALSE,0.720541089999218,2020,2020-2021
MA,2021-05-31,inter-total,38,30,15,7,5,6,10,5,7,73,101,297,139,169,FALSE,0.569023569023569,2020,2020-2021
MA,2021-05-31,inter-ucfe,0,0,1,0,0,0,0,0,0,0,0,1,0,0,FALSE,0,2020,2020-2021
MA,2021-05-31,inter-ucx,0,0,0,0,0,0,0,0,0,0,1,1,1,1,FALSE,1,2020,2020-2021
MA,2021-05-31,inter-ui,38,30,14,7,5,6,10,5,7,73,100,295,138,168,FALSE,0.569491525423729,2020,2020-2021
MA,2021-05-31,intra-total,1498,1081,312,294,214,263,441,186,159,1630,3258,9336,4756,5837,FALSE,0.625214224507284,2020,2020-2021
MA,2021-05-31,intra-ucfe,4,2,0,2,0,0,0,0,0,9,18,35,22,24,FALSE,0.685714285714286,2020,2020-2021
MA,2021-05-31,intra-ucx,4,0,1,0,1,0,0,0,0,28,5,39,9,9,FALSE,0.230769230769231,2020,2020-2021
MA,2021-05-31,intra-ui,1490,1079,311,292,213,263,441,186,159,1593,3235,9262,4725,5804,FALSE,0.626646512632261,2020,2020-2021
MA,2021-06-30,inter-total,58,44,14,8,8,5,11,12,7,103,111,381,169,213,FALSE,0.559055118110236,2020,2020-2021
MA,2021-06-30,inter-ucfe,0,0,0,0,0,0,0,0,0,0,2,2,2,2,FALSE,1,2020,2020-2021
MA,2021-06-30,inter-ucx,0,0,0,0,0,0,0,0,0,0,0,0,0,0,FALSE,0,2020,2020-2021
MA,2021-06-30,inter-ui,58,44,14,8,8,5,11,12,7,103,109,379,167,211,FALSE,0.556728232189974,2020,2020-2021
MA,2021-06-30,intra-total,1880,984,289,209,206,171,205,244,253,2282,2985,9708,4865,5849,FALSE,0.602492789451998,2020,2020-2021
MA,2021-06-30,intra-ucfe,0,1,0,1,0,0,1,0,0,10,3,16,3,4,FALSE,0.25,2020,2020-2021
MA,2021-06-30,intra-ucx,4,5,0,0,0,0,0,0,0,12,0,21,4,9,FALSE,0.428571428571429,2020,2020-2021
MA,2021-06-30,intra-ui,1876,978,289,208,206,171,204,244,253,2260,2982,9671,4858,5836,FALSE,0.603453624237411,2020,2020-2021
MA,2021-07-31,inter-total,44,43,12,7,6,7,7,4,5,81,91,307,135,178,FALSE,0.579804560260586,2021,2021-2022
MA,2021-07-31,inter-ucfe,0,0,0,0,0,0,0,0,0,1,1,2,1,1,FALSE,0.5,2021,2021-2022
MA,2021-07-31,inter-ucx,0,0,0,0,0,1,0,0,0,0,0,1,0,0,FALSE,0,2021,2021-2022
MA,2021-07-31,inter-ui,44,43,12,7,6,6,7,4,5,80,90,304,134,177,FALSE,0.582236842105263,2021,2021-2022
MA,2021-07-31,intra-total,1990,1045,325,239,179,153,119,187,155,2176,3118,9686,5108,6153,FALSE,0.635246747883543,2021,2021-2022
MA,2021-07-31,intra-ucfe,2,3,1,0,0,0,0,1,0,7,3,17,5,8,FALSE,0.470588235294118,2021,2021-2022
MA,2021-07-31,intra-ucx,1,1,0,0,0,0,0,1,0,11,1,15,2,3,FALSE,0.2,2021,2021-2022
MA,2021-07-31,intra-ui,1987,1041,324,239,179,153,119,185,155,2158,3114,9654,5101,6142,FALSE,0.63621296871763,2021,2021-2022
MA,2021-08-31,inter-total,36,38,16,11,2,7,3,9,6,101,77,306,113,151,FALSE,0.493464052287582,2021,2021-2022
MA,2021-08-31,inter-ucfe,0,0,0,0,0,0,0,0,0,2,0,2,0,0,FALSE,0,2021,2021-2022
MA,2021-08-31,inter-ucx,0,1,0,0,0,0,0,0,0,1,0,2,0,1,FALSE,0.5,2021,2021-2022
MA,2021-08-31,inter-ui,36,37,16,11,2,7,3,9,6,98,77,302,113,150,FALSE,0.496688741721854,2021,2021-2022
MA,2021-08-31,intra-total,1226,775,276,260,191,165,181,165,141,2563,2000,7943,3226,4001,FALSE,0.503713961979101,2021,2021-2022
MA,2021-08-31,intra-ucfe,2,1,0,0,0,0,2,1,1,14,5,26,7,8,FALSE,0.307692307692308,2021,2021-2022
MA,2021-08-31,intra-ucx,2,3,1,0,0,1,2,1,1,26,1,38,3,6,FALSE,0.157894736842105,2021,2021-2022
MA,2021-08-31,intra-ui,1222,771,275,260,191,164,177,163,139,2523,1994,7879,3216,3987,FALSE,0.506028683843127,2021,2021-2022
MA,2021-09-30,inter-total,223,40,9,10,3,1,10,3,6,122,86,513,309,349,FALSE,0.680311890838207,2021,2021-2022
MA,2021-09-30,inter-ucfe,0,0,0,0,0,0,0,0,0,0,2,2,2,2,FALSE,1,2021,2021-2022
MA,2021-09-30,inter-ucx,0,0,0,0,0,0,0,0,1,0,0,1,0,0,FALSE,0,2021,2021-2022
MA,2021-09-30,inter-ui,223,40,9,10,3,1,10,3,5,122,84,510,307,347,FALSE,0.680392156862745,2021,2021-2022
MA,2021-09-30,intra-total,7964,1048,307,200,167,140,137,148,147,3580,2960,16798,10924,11972,FALSE,0.712703893320633,2021,2021-2022
MA,2021-09-30,intra-ucfe,9,2,2,1,0,1,0,0,0,4,3,22,12,14,FALSE,0.636363636363636,2021,2021-2022
MA,2021-09-30,intra-ucx,0,1,1,0,0,3,1,0,0,7,1,14,1,2,FALSE,0.142857142857143,2021,2021-2022
MA,2021-09-30,intra-ui,7955,1045,304,199,167,136,136,148,147,3569,2956,16762,10911,11956,FALSE,0.713280038181601,2021,2021-2022
MA,2021-10-31,inter-total,120,14,19,8,7,8,6,6,3,96,58,345,178,192,FALSE,0.556521739130435,2021,2021-2022
MA,2021-10-31,inter-ucfe,0,0,0,0,0,0,0,0,0,1,0,1,0,0,FALSE,0,2021,2021-2022
MA,2021-10-31,inter-ucx,0,0,0,0,0,0,0,0,0,0,0,0,0,0,FALSE,0,2021,2021-2022
MA,2021-10-31,inter-ui,120,14,19,8,7,8,6,6,3,95,58,344,178,192,FALSE,0.558139534883721,2021,2021-2022
MA,2021-10-31,intra-total,2377,480,529,325,174,147,87,88,90,2668,1290,8255,3667,4147,FALSE,0.502362204724409,2021,2021-2022
MA,2021-10-31,intra-ucfe,4,3,0,2,0,0,0,1,1,3,1,15,5,8,FALSE,0.533333333333333,2021,2021-2022
MA,2021-10-31,intra-ucx,4,0,0,2,0,0,2,1,1,15,2,27,6,6,FALSE,0.222222222222222,2021,2021-2022
MA,2021-10-31,intra-ui,2369,477,529,321,174,147,85,86,88,2650,1287,8213,3656,4133,FALSE,0.503226591988311,2021,2021-2022
MA,2021-11-30,inter-total,177,27,16,7,4,3,3,1,8,109,121,476,298,325,FALSE,0.682773109243698,2021,2021-2022
MA,2021-11-30,inter-ucfe,0,0,0,0,0,0,1,0,0,1,2,4,2,2,FALSE,0.5,2021,2021-2022
MA,2021-11-30,inter-ucx,1,0,0,0,0,0,0,0,0,0,0,1,1,1,FALSE,1,2021,2021-2022
MA,2021-11-30,inter-ui,176,27,16,7,4,3,2,1,8,108,119,471,295,322,FALSE,0.683651804670913,2021,2021-2022
MA,2021-11-30,intra-total,3700,722,315,175,125,88,146,124,111,2785,2081,10372,5781,6503,FALSE,0.626976475125338,2021,2021-2022
MA,2021-11-30,intra-ucfe,1,0,1,0,0,0,0,2,0,9,4,17,5,5,FALSE,0.294117647058824,2021,2021-2022
MA,2021-11-30,intra-ucx,7,2,1,1,1,1,0,2,2,15,4,36,11,13,FALSE,0.361111111111111,2021,2021-2022
MA,2021-11-30,intra-ui,3692,720,313,174,124,87,146,120,109,2761,2073,10319,5765,6485,FALSE,0.628452369415641,2021,2021-2022
MA,2021-12-31,inter-total,285,30,15,14,5,9,3,4,6,90,103,564,388,418,FALSE,0.74113475177305,2021,2021-2022
MA,2021-12-31,inter-ucfe,0,0,0,0,0,0,0,0,0,0,1,1,1,1,FALSE,1,2021,2021-2022
MA,2021-12-31,inter-ucx,0,0,0,0,0,1,0,0,0,0,0,1,0,0,FALSE,0,2021,2021-2022
MA,2021-12-31,inter-ui,285,30,15,14,5,8,3,4,6,90,102,562,387,417,FALSE,0.741992882562278,2021,2021-2022
MA,2021-12-31,intra-total,6659,791,389,228,155,143,142,106,92,2407,2094,13206,8753,9544,FALSE,0.722701802211116,2021,2021-2022
MA,2021-12-31,intra-ucfe,4,2,2,0,0,1,0,1,0,9,3,22,7,9,FALSE,0.409090909090909,2021,2021-2022
MA,2021-12-31,intra-ucx,5,0,1,1,1,0,0,0,0,3,2,13,7,7,FALSE,0.538461538461538,2021,2021-2022
MA,2021-12-31,intra-ui,6650,789,386,227,154,142,142,105,92,2395,2089,13171,8739,9528,FALSE,0.723407486143801,2021,2021-2022
MA,2022-01-31,inter-total,388,27,20,9,10,10,5,6,4,91,135,705,523,550,FALSE,0.780141843971631,2021,2021-2022
MA,2022-01-31,inter-ucfe,0,0,0,0,0,0,0,0,0,1,0,1,0,0,FALSE,0,2021,2021-2022
MA,2022-01-31,inter-ucx,0,0,0,1,0,0,0,0,0,0,0,1,0,0,FALSE,0,2021,2021-2022
MA,2022-01-31,inter-ui,388,27,20,8,10,10,5,6,4,90,135,703,523,550,FALSE,0.782361308677098,2021,2021-2022
MA,2022-01-31,intra-total,11492,1117,532,355,228,192,174,129,105,1823,3611,19758,15103,16220,FALSE,0.820933292843405,2021,2021-2022
MA,2022-01-31,intra-ucfe,5,2,1,2,0,2,1,1,2,9,1,26,6,8,FALSE,0.307692307692308,2021,2021-2022
MA,2022-01-31,intra-ucx,5,2,0,0,1,1,0,0,0,4,1,14,6,8,FALSE,0.571428571428571,2021,2021-2022
MA,2022-01-31,intra-ui,11482,1113,531,353,227,189,173,128,103,1810,3609,19718,15091,16204,FALSE,0.821787199513135,2021,2021-2022
MA,2022-02-28,inter-total,252,32,19,13,9,10,5,9,4,120,77,550,329,361,FALSE,0.656363636363636,2021,2021-2022
MA,2022-02-28,inter-ucfe,0,0,0,0,0,0,1,0,0,1,1,3,1,1,FALSE,0.333333333333333,2021,2021-2022
MA,2022-02-28,inter-ucx,0,0,1,0,0,0,0,0,0,0,0,1,0,0,FALSE,0,2021,2021-2022
MA,2022-02-28,inter-ui,252,32,18,13,9,10,4,9,4,119,76,546,328,360,FALSE,0.659340659340659,2021,2021-2022
MA,2022-02-28,intra-total,6223,1010,547,507,293,238,184,142,147,2510,2302,14103,8525,9535,FALSE,0.676097284265759,2021,2021-2022
MA,2022-02-28,intra-ucfe,1,1,0,1,0,0,0,0,0,7,3,13,4,5,FALSE,0.384615384615385,2021,2021-2022
MA,2022-02-28,intra-ucx,3,0,2,0,0,0,1,0,1,4,1,12,4,4,FALSE,0.333333333333333,2021,2021-2022
MA,2022-02-28,intra-ui,6219,1009,545,506,293,238,183,142,146,2499,2298,14078,8517,9526,FALSE,0.676658616280722,2021,2021-2022
MA,2022-03-31,inter-total,202,30,20,7,15,8,13,9,8,141,90,543,292,322,FALSE,0.593001841620626,2021,2021-2022
MA,2022-03-31,inter-ucfe,1,0,0,0,0,0,0,0,0,0,0,1,1,1,FALSE,1,2021,2021-2022
MA,2022-03-31,inter-ucx,1,0,0,0,1,0,0,0,0,0,1,3,2,2,FALSE,0.666666666666667,2021,2021-2022
MA,2022-03-31,inter-ui,200,30,20,7,14,8,13,9,8,141,89,539,289,319,FALSE,0.591836734693878,2021,2021-2022
MA,2022-03-31,intra-total,4217,1213,583,356,327,247,234,240,211,2828,2254,12710,6471,7684,FALSE,0.60456333595594,2021,2021-2022
MA,2022-03-31,intra-ucfe,1,3,3,1,0,1,1,1,0,10,2,23,3,6,FALSE,0.260869565217391,2021,2021-2022
MA,2022-03-31,intra-ucx,2,0,1,0,1,0,1,0,0,3,2,10,4,4,FALSE,0.4,2021,2021-2022
MA,2022-03-31,intra-ui,4214,1210,579,355,326,246,232,239,211,2815,2250,12677,6464,7674,FALSE,0.605348268517788,2021,2021-2022
MA,2022-04-30,inter-total,131,27,15,9,9,9,5,6,11,109,75,406,206,233,FALSE,0.573891625615764,2021,2021-2022
MA,2022-04-30,inter-ucfe,0,0,0,0,0,0,0,0,0,1,1,2,1,1,FALSE,0.5,2021,2021-2022
MA,2022-04-30,inter-ucx,0,0,0,0,1,0,0,0,0,0,0,1,0,0,FALSE,0,2021,2021-2022
MA,2022-04-30,inter-ui,131,27,15,9,8,9,5,6,11,108,74,403,205,232,FALSE,0.575682382133995,2021,2021-2022
MA,2022-04-30,intra-total,3531,740,425,304,216,196,193,178,200,2884,1825,10692,5356,6096,FALSE,0.570145903479237,2021,2021-2022
MA,2022-04-30,intra-ucfe,6,5,1,4,0,0,1,2,1,16,4,40,10,15,FALSE,0.375,2021,2021-2022
MA,2022-04-30,intra-ucx,8,3,1,1,1,0,0,0,1,7,2,24,10,13,FALSE,0.541666666666667,2021,2021-2022
MA,2022-04-30,intra-ui,3517,732,423,299,215,196,192,176,198,2861,1819,10628,5336,6068,FALSE,0.570944674444863,2021,2021-2022
MA,2022-05-31,inter-total,120,26,19,13,5,2,5,3,5,61,82,341,202,228,FALSE,0.668621700879765,2021,2021-2022
MA,2022-05-31,inter-ucfe,0,0,0,0,0,0,0,0,0,0,0,0,0,0,FALSE,0,2021,2021-2022
MA,2022-05-31,inter-ucx,1,0,0,0,0,0,0,0,0,0,0,1,1,1,FALSE,1,2021,2021-2022
MA,2022-05-31,inter-ui,119,26,19,13,5,2,5,3,5,61,82,340,201,227,FALSE,0.667647058823529,2021,2021-2022
MA,2022-05-31,intra-total,2911,901,352,188,127,80,93,77,71,1708,2038,8546,4949,5850,FALSE,0.684530774631407,2021,2021-2022
MA,2022-05-31,intra-ucfe,4,3,3,3,0,0,0,2,0,5,4,24,8,11,FALSE,0.458333333333333,2021,2021-2022
MA,2022-05-31,intra-ucx,4,1,0,0,1,1,0,0,0,2,1,10,5,6,FALSE,0.6,2021,2021-2022
MA,2022-05-31,intra-ui,2903,897,349,185,126,79,93,75,71,1701,2033,8512,4936,5833,FALSE,0.685267857142857,2021,2021-2022
MA,2022-06-30,inter-total,198,34,13,10,6,4,3,2,3,58,83,414,281,315,FALSE,0.760869565217391,2021,2021-2022
MA,2022-06-30,inter-ucfe,1,0,0,0,0,0,0,0,0,0,0,1,1,1,FALSE,1,2021,2021-2022
MA,2022-06-30,inter-ucx,1,0,0,0,0,0,0,0,0,0,0,1,1,1,FALSE,1,2021,2021-2022
MA,2022-06-30,inter-ui,196,34,13,10,6,4,3,2,3,58,83,412,279,313,FALSE,0.759708737864078,2021,2021-2022
MA,2022-06-30,intra-total,4245,1005,403,187,119,88,70,64,48,966,2440,9635,6685,7690,FALSE,0.798131811105345,2021,2021-2022
MA,2022-06-30,intra-ucfe,11,4,0,3,2,0,1,0,1,6,8,36,19,23,FALSE,0.638888888888889,2021,2021-2022
MA,2022-06-30,intra-ucx,9,2,0,0,2,0,1,0,0,1,5,20,14,16,FALSE,0.8,2021,2021-2022
MA,2022-06-30,intra-ui,4225,999,403,184,115,88,68,64,47,959,2427,9579,6652,7651,FALSE,0.798726380624282,2021,2021-2022
MA,2022-07-31,inter-total,184,43,18,9,7,3,4,2,1,34,119,424,303,346,FALSE,0.816037735849057,2022,2022-2023
MA,2022-07-31,inter-ucfe,0,0,0,0,0,0,0,0,0,1,0,1,0,0,FALSE,0,2022,2022-2023
MA,2022-07-31,inter-ucx,1,0,0,0,0,0,0,0,0,0,0,1,1,1,FALSE,1,2022,2022-2023
MA,2022-07-31,inter-ui,183,43,18,9,7,3,4,2,1,33,119,422,302,345,FALSE,0.817535545023697,2022,2022-2023
MA,2022-07-31,intra-total,6880,1373,413,192,118,71,50,38,47,612,3617,13411,10497,11870,FALSE,0.88509432555365,2022,2022-2023
MA,2022-07-31,intra-ucfe,1,2,0,0,1,0,0,0,1,5,4,14,5,7,FALSE,0.5,2022,2022-2023
MA,2022-07-31,intra-ucx,7,2,0,0,0,0,0,0,0,1,0,10,7,9,FALSE,0.9,2022,2022-2023
MA,2022-07-31,intra-ui,6872,1369,413,192,117,71,50,38,46,606,3613,13387,10485,11854,FALSE,0.885485919175319,2022,2022-2023
MA,2022-08-31,inter-total,184,36,13,10,6,9,1,2,3,30,85,379,269,305,FALSE,0.804749340369393,2022,2022-2023
MA,2022-08-31,inter-ucfe,0,0,0,0,0,0,0,0,0,1,0,1,0,0,FALSE,0,2022,2022-2023
MA,2022-08-31,inter-ucx,2,0,0,0,0,0,0,0,0,2,0,4,2,2,FALSE,0.5,2022,2022-2023
MA,2022-08-31,inter-ui,182,36,13,10,6,9,1,2,3,27,85,374,267,303,FALSE,0.810160427807487,2022,2022-2023
MA,2022-08-31,intra-total,5316,928,403,203,136,100,78,49,41,585,2412,10251,7728,8656,FALSE,0.844405423861087,2022,2022-2023
MA,2022-08-31,intra-ucfe,6,3,2,0,0,0,1,1,0,5,5,23,11,14,FALSE,0.608695652173913,2022,2022-2023
MA,2022-08-31,intra-ucx,3,2,0,0,0,0,0,0,0,1,3,9,6,8,FALSE,0.888888888888889,2022,2022-2023
MA,2022-08-31,intra-ui,5307,923,401,203,136,100,77,48,41,579,2404,10219,7711,8634,FALSE,0.844896760935512,2022,2022-2023
MA,2022-09-30,inter-total,128,26,7,11,7,7,7,0,3,27,57,280,185,211,FALSE,0.753571428571429,2022,2022-2023
MA,2022-09-30,inter-ucfe,0,0,0,0,0,0,0,0,0,0,0,0,0,0,FALSE,0,2022,2022-2023
MA,2022-09-30,inter-ucx,1,0,0,0,0,0,0,0,0,0,0,1,1,1,FALSE,1,2022,2022-2023
MA,2022-09-30,inter-ui,127,26,7,11,7,7,7,0,3,27,57,279,184,210,FALSE,0.752688172043011,2022,2022-2023
MA,2022-09-30,intra-total,3562,654,287,149,80,77,59,56,37,588,1693,7242,5255,5909,FALSE,0.815934824634079,2022,2022-2023
MA,2022-09-30,intra-ucfe,2,2,1,1,1,2,2,0,0,7,4,22,6,8,FALSE,0.363636363636364,2022,2022-2023
MA,2022-09-30,intra-ucx,2,3,0,0,0,0,0,0,0,0,4,9,6,9,FALSE,1,2022,2022-2023
MA,2022-09-30,intra-ui,3558,649,286,148,79,75,57,56,37,581,1685,7211,5243,5892,FALSE,0.817085009014006,2022,2022-2023
MA,2022-10-31,inter-total,154,39,16,9,7,8,5,2,4,39,65,348,219,258,FALSE,0.741379310344828,2022,2022-2023
MA,2022-10-31,inter-ucfe,3,0,0,0,0,0,0,0,0,0,0,3,3,3,FALSE,1,2022,2022-2023
MA,2022-10-31,inter-ucx,0,0,0,0,0,0,0,0,0,0,0,0,0,0,FALSE,0,2022,2022-2023
MA,2022-10-31,inter-ui,151,39,16,9,7,8,5,2,4,39,65,345,216,255,FALSE,0.739130434782609,2022,2022-2023
MA,2022-10-31,intra-total,3158,751,344,214,126,99,62,48,33,579,1592,7006,4750,5501,FALSE,0.78518412789038,2022,2022-2023
MA,2022-10-31,intra-ucfe,3,0,0,0,0,2,0,1,1,4,4,15,7,7,FALSE,0.466666666666667,2022,2022-2023
MA,2022-10-31,intra-ucx,4,1,0,0,1,0,1,0,0,2,3,12,7,8,FALSE,0.666666666666667,2022,2022-2023
MA,2022-10-31,intra-ui,3151,750,344,214,125,97,61,47,32,573,1585,6979,4736,5486,FALSE,0.786072503223958,2022,2022-2023
MA,2022-11-30,inter-total,274,35,15,17,13,4,4,1,5,43,110,521,384,419,FALSE,0.804222648752399,2022,2022-2023
MA,2022-11-30,inter-ucfe,1,0,0,0,0,0,0,0,0,2,4,7,5,5,FALSE,0.714285714285714,2022,2022-2023
MA,2022-11-30,inter-ucx,0,0,0,0,0,0,0,0,0,0,1,1,1,1,FALSE,1,2022,2022-2023
MA,2022-11-30,inter-ui,273,35,15,17,13,4,4,1,5,41,105,513,378,413,FALSE,0.805068226120858,2022,2022-2023
MA,2022-11-30,intra-total,5504,895,405,272,184,147,76,73,40,615,2170,10381,7674,8569,FALSE,0.825450341970908,2022,2022-2023
MA,2022-11-30,intra-ucfe,2,0,0,1,1,1,1,0,0,5,1,12,3,3,FALSE,0.25,2022,2022-2023
MA,2022-11-30,intra-ucx,7,1,0,1,0,0,0,0,0,0,1,10,8,9,FALSE,0.9,2022,2022-2023
MA,2022-11-30,intra-ui,5495,894,405,270,183,146,75,73,40,610,2168,10359,7663,8557,FALSE,0.826044985037166,2022,2022-2023
MA,2022-12-31,inter-total,359,50,26,14,16,12,6,2,2,33,98,618,457,507,FALSE,0.820388349514563,2022,2022-2023
MA,2022-12-31,inter-ucfe,0,0,0,0,0,0,0,0,0,0,2,2,2,2,FALSE,1,2022,2022-2023
MA,2022-12-31,inter-ucx,1,0,0,1,0,0,0,0,0,1,0,3,1,1,FALSE,0.333333333333333,2022,2022-2023
MA,2022-12-31,inter-ui,358,50,26,13,16,12,6,2,2,32,96,613,454,504,FALSE,0.822185970636215,2022,2022-2023
MA,2022-12-31,intra-total,8878,1000,474,342,232,253,143,72,56,648,2659,14757,11537,12537,FALSE,0.849562919292539,2022,2022-2023
MA,2022-12-31,intra-ucfe,4,1,4,2,0,2,0,0,1,3,5,22,9,10,FALSE,0.454545454545455,2022,2022-2023
MA,2022-12-31,intra-ucx,0,2,0,2,1,1,0,0,0,3,4,13,4,6,FALSE,0.461538461538462,2022,2022-2023
MA,2022-12-31,intra-ui,8874,997,470,338,231,250,143,72,55,642,2650,14722,11524,12521,FALSE,0.850495856541231,2022,2022-2023
MA,2023-01-31,inter-total,492,45,21,17,12,11,2,5,1,38,126,770,618,663,FALSE,0.861038961038961,2022,2022-2023
MA,2023-01-31,inter-ucfe,0,0,0,0,0,0,0,0,0,0,0,0,0,0,FALSE,0,2022,2022-2023
MA,2023-01-31,inter-ucx,1,0,0,0,0,0,0,0,0,0,0,1,1,1,FALSE,1,2022,2022-2023
MA,2023-01-31,inter-ui,491,45,21,17,12,11,2,5,1,38,126,769,617,662,FALSE,0.860858257477243,2022,2022-2023
MA,2023-01-31,intra-total,15453,1337,602,400,245,207,138,107,131,760,4549,23929,20002,21339,FALSE,0.89176313260061,2022,2022-2023
MA,2023-01-31,intra-ucfe,5,1,3,2,1,1,2,2,1,7,5,30,10,11,FALSE,0.366666666666667,2022,2022-2023
MA,2023-01-31,intra-ucx,8,0,2,0,0,0,1,1,3,7,2,24,10,10,FALSE,0.416666666666667,2022,2022-2023
MA,2023-01-31,intra-ui,15440,1336,597,398,244,206,135,104,127,746,4542,23875,19982,21318,FALSE,0.892900523560209,2022,2022-2023
MA,2023-02-28,inter-total,267,50,21,15,17,11,3,9,1,38,103,535,370,420,FALSE,0.785046728971963,2022,2022-2023
MA,2023-02-28,inter-ucfe,0,0,0,0,0,0,0,0,0,0,0,0,0,0,FALSE,0,2022,2022-2023
MA,2023-02-28,inter-ucx,0,0,0,0,0,0,0,0,0,1,0,1,0,0,FALSE,0,2022,2022-2023
MA,2023-02-28,inter-ui,267,50,21,15,17,11,3,9,1,37,103,534,370,420,FALSE,0.786516853932584,2022,2022-2023
MA,2023-02-28,intra-total,8028,1227,632,469,312,215,180,129,98,732,3379,15401,11407,12634,FALSE,0.820336341795987,2022,2022-2023
MA,2023-02-28,intra-ucfe,7,1,1,3,1,0,2,0,0,5,0,20,7,8,FALSE,0.4,2022,2022-2023
MA,2023-02-28,intra-ucx,1,1,1,0,0,0,1,0,1,4,1,10,2,3,FALSE,0.3,2022,2022-2023
MA,2023-02-28,intra-ui,8020,1225,630,466,311,215,177,129,97,723,3378,15371,11398,12623,FALSE,0.82122178127643,2022,2022-2023
MA,2023-03-31,inter-total,222,34,23,23,13,5,11,5,5,50,96,487,318,352,FALSE,0.722792607802875,2022,2022-2023
MA,2023-03-31,inter-ucfe,0,0,0,0,0,0,0,0,0,1,0,1,0,0,FALSE,0,2022,2022-2023
MA,2023-03-31,inter-ucx,1,0,0,1,0,0,0,0,0,1,0,3,1,1,FALSE,0.333333333333333,2022,2022-2023
MA,2023-03-31,inter-ui,221,34,23,22,13,5,11,5,5,48,96,483,317,351,FALSE,0.726708074534162,2022,2022-2023
MA,2023-03-31,intra-total,5723,1162,626,431,353,270,248,247,134,1058,2898,13150,8621,9783,FALSE,0.743954372623574,2022,2022-2023
MA,2023-03-31,intra-ucfe,2,3,2,0,1,5,0,0,1,6,0,20,2,5,FALSE,0.25,2022,2022-2023
MA,2023-03-31,intra-ucx,8,0,0,0,2,1,0,0,0,12,1,24,9,9,FALSE,0.375,2022,2022-2023
MA,2023-03-31,intra-ui,5713,1159,624,431,350,264,248,247,133,1040,2897,13106,8610,9769,FALSE,0.745383793682283,2022,2022-2023
MA,2023-04-30,inter-total,173,30,29,9,8,5,7,4,6,25,76,372,249,279,FALSE,0.75,2022,2022-2023
MA,2023-04-30,inter-ucfe,0,0,0,0,0,0,0,0,0,0,0,0,0,0,FALSE,0,2022,2022-2023
MA,2023-04-30,inter-ucx,0,0,0,0,0,0,0,0,0,0,0,0,0,0,FALSE,0,2022,2022-2023
MA,2023-04-30,inter-ui,173,30,29,9,8,5,7,4,6,25,76,372,249,279,FALSE,0.75,2022,2022-2023
MA,2023-04-30,intra-total,4869,939,491,276,238,173,188,143,134,1235,2187,10873,7056,7995,FALSE,0.73530764278488,2022,2022-2023
MA,2023-04-30,intra-ucfe,0,1,1,2,1,1,0,0,0,5,2,13,2,3,FALSE,0.230769230769231,2022,2022-2023
MA,2023-04-30,intra-ucx,4,0,2,0,0,0,1,0,1,3,0,11,4,4,FALSE,0.363636363636364,2022,2022-2023
MA,2023-04-30,intra-ui,4865,938,488,274,237,172,187,143,133,1227,2185,10849,7050,7988,FALSE,0.736289058899438,2022,2022-2023
MA,2023-05-31,inter-total,162,30,24,13,11,8,6,4,5,33,108,404,270,300,FALSE,0.742574257425743,2022,2022-2023
MA,2023-05-31,inter-ucfe,0,0,0,0,0,0,0,0,0,1,0,1,0,0,FALSE,0,2022,2022-2023
MA,2023-05-31,inter-ucx,0,0,0,0,0,1,0,0,0,0,0,1,0,0,FALSE,0,2022,2022-2023
MA,2023-05-31,inter-ui,162,30,24,13,11,7,6,4,5,32,108,402,270,300,FALSE,0.746268656716418,2022,2022-2023
MA,2023-05-31,intra-total,4750,1133,637,438,366,196,188,120,127,1101,2652,11708,7402,8535,FALSE,0.72898872565767,2022,2022-2023
MA,2023-05-31,intra-ucfe,0,1,1,2,0,0,2,1,0,4,1,12,1,2,FALSE,0.166666666666667,2022,2022-2023
MA,2023-05-31,intra-ucx,3,0,0,1,0,0,0,0,0,0,1,5,4,4,FALSE,0.8,2022,2022-2023
MA,2023-05-31,intra-ui,4747,1132,636,435,366,196,186,119,127,1097,2650,11691,7397,8529,FALSE,0.729535540159097,2022,2022-2023
MA,2023-06-30,inter-total,188,38,20,21,9,12,5,5,3,38,73,412,261,299,FALSE,0.725728155339806,2022,2022-2023
MA,2023-06-30,inter-ucfe,0,0,0,0,0,0,0,0,0,0,0,0,0,0,FALSE,0,2022,2022-2023
MA,2023-06-30,inter-ucx,0,0,0,0,0,0,0,0,0,0,0,0,0,0,FALSE,0,2022,2022-2023
MA,2023-06-30,inter-ui,188,38,20,21,9,12,5,5,3,38,73,412,261,299,FALSE,0.725728155339806,2022,2022-2023
MA,2023-06-30,intra-total,5119,1085,504,354,340,262,177,144,101,866,2281,11233,7400,8485,FALSE,0.755363660642749,2022,2022-2023
MA,2023-06-30,intra-ucfe,1,2,0,0,0,1,0,1,0,4,0,9,1,3,FALSE,0.333333333333333,2022,2022-2023
MA,2023-06-30,intra-ucx,9,1,0,0,0,0,0,0,0,0,2,12,11,12,FALSE,1,2022,2022-2023
MA,2023-06-30,intra-ui,5109,1082,504,354,340,261,177,143,101,862,2279,11212,7388,8470,FALSE,0.755440599357831,2022,2022-2023
MA,2023-07-31,inter-total,234,33,23,6,6,6,7,8,2,30,85,440,319,352,FALSE,0.8,2023,2023-2024
MA,2023-07-31,inter-ucfe,1,0,0,0,0,0,0,0,0,0,0,1,1,1,FALSE,1,2023,2023-2024
MA,2023-07-31,inter-ucx,1,0,0,0,0,0,0,1,0,2,0,4,1,1,FALSE,0.25,2023,2023-2024
MA,2023-07-31,inter-ui,232,33,23,6,6,6,7,7,2,28,85,435,317,350,FALSE,0.804597701149425,2023,2023-2024
MA,2023-07-31,intra-total,7372,1290,700,390,301,231,163,123,99,779,2963,14411,10335,11625,FALSE,0.806675456248699,2023,2023-2024
MA,2023-07-31,intra-ucfe,2,1,1,0,0,1,0,0,1,5,1,12,3,4,FALSE,0.333333333333333,2023,2023-2024
MA,2023-07-31,intra-ucx,9,1,0,1,1,0,1,0,0,0,3,16,12,13,FALSE,0.8125,2023,2023-2024
MA,2023-07-31,intra-ui,7361,1288,699,389,300,230,162,123,98,774,2959,14383,10320,11608,FALSE,0.807063894875895,2023,2023-2024
MA,2023-08-31,inter-total,204,60,28,14,13,14,6,6,5,31,101,482,305,365,FALSE,0.757261410788382,2023,2023-2024
MA,2023-08-31,inter-ucfe,0,0,1,0,0,0,0,0,0,0,0,1,0,0,FALSE,0,2023,2023-2024
MA,2023-08-31,inter-ucx,1,0,0,0,0,0,0,0,0,1,1,3,2,2,FALSE,0.666666666666667,2023,2023-2024
MA,2023-08-31,inter-ui,203,60,27,14,13,14,6,6,5,30,100,478,303,363,FALSE,0.759414225941423,2023,2023-2024
MA,2023-08-31,intra-total,5325,1276,714,494,401,272,184,131,112,741,2290,11940,7615,8891,FALSE,0.74463986599665,2023,2023-2024
MA,2023-08-31,intra-ucfe,5,1,1,0,2,1,1,0,1,1,1,14,6,7,FALSE,0.5,2023,2023-2024
MA,2023-08-31,intra-ucx,9,1,0,1,1,1,1,0,0,1,4,19,13,14,FALSE,0.736842105263158,2023,2023-2024
MA,2023-08-31,intra-ui,5311,1274,713,493,398,270,182,131,111,739,2285,11907,7596,8870,FALSE,0.744939951289158,2023,2023-2024
MA,2023-09-30,inter-total,175,33,25,18,15,12,8,6,10,22,79,403,254,287,FALSE,0.712158808933002,2023,2023-2024
MA,2023-09-30,inter-ucfe,0,0,0,0,0,0,0,0,0,0,0,0,0,0,FALSE,0,2023,2023-2024
MA,2023-09-30,inter-ucx,0,0,0,0,0,0,0,0,0,0,0,0,0,0,FALSE,0,2023,2023-2024
MA,2023-09-30,inter-ui,175,33,25,18,15,12,8,6,10,22,79,403,254,287,FALSE,0.712158808933002,2023,2023-2024
MA,2023-09-30,intra-total,3346,1015,587,354,291,260,179,155,240,653,1910,8990,5256,6271,FALSE,0.697552836484983,2023,2023-2024
MA,2023-09-30,intra-ucfe,1,4,1,1,0,0,0,0,0,4,3,14,4,8,FALSE,0.571428571428571,2023,2023-2024
MA,2023-09-30,intra-ucx,2,1,1,1,0,0,0,0,1,2,1,9,3,4,FALSE,0.444444444444444,2023,2023-2024
MA,2023-09-30,intra-ui,3343,1010,585,352,291,260,179,155,239,647,1906,8967,5249,6259,FALSE,0.698003791680607,2023,2023-2024
MA,2023-10-31,inter-total,196,46,21,14,10,9,4,3,4,37,84,428,280,326,FALSE,0.761682242990654,2023,2023-2024
MA,2023-10-31,inter-ucfe,0,0,0,0,0,0,0,0,0,1,1,2,1,1,FALSE,0.5,2023,2023-2024
MA,2023-10-31,inter-ucx,0,0,0,1,0,0,0,0,0,0,0,1,0,0,FALSE,0,2023,2023-2024
MA,2023-10-31,inter-ui,196,46,21,13,10,9,4,3,4,36,83,425,279,325,FALSE,0.764705882352941,2023,2023-2024
MA,2023-10-31,intra-total,3936,1280,392,254,211,161,192,183,121,565,2419,9714,6355,7635,FALSE,0.785978999382335,2023,2023-2024
MA,2023-10-31,intra-ucfe,1,0,0,0,0,2,2,0,0,6,5,16,6,6,FALSE,0.375,2023,2023-2024
MA,2023-10-31,intra-ucx,5,0,1,0,0,2,1,0,0,1,3,13,8,8,FALSE,0.615384615384615,2023,2023-2024
MA,2023-10-31,intra-ui,3930,1280,391,254,211,157,189,183,121,558,2411,9685,6341,7621,FALSE,0.786886938564791,2023,2023-2024
MA,2023-11-30,inter-total,324,43,18,22,8,8,2,1,4,23,118,571,442,485,FALSE,0.84938704028021,2023,2023-2024
MA,2023-11-30,inter-ucfe,1,0,0,1,0,0,0,0,0,0,1,3,2,2,FALSE,0.666666666666667,2023,2023-2024
MA,2023-11-30,inter-ucx,1,0,1,0,0,0,0,0,0,0,0,2,1,1,FALSE,0.5,2023,2023-2024
MA,2023-11-30,inter-ui,322,43,17,21,8,8,2,1,4,23,117,566,439,482,FALSE,0.851590106007067,2023,2023-2024
MA,2023-11-30,intra-total,5954,1049,331,199,155,110,83,76,58,452,2902,11369,8856,9905,FALSE,0.871228780015833,2023,2023-2024
MA,2023-11-30,intra-ucfe,4,0,2,1,0,1,1,0,0,2,9,20,13,13,FALSE,0.65,2023,2023-2024
MA,2023-11-30,intra-ucx,6,7,2,0,0,0,0,0,0,1,6,22,12,19,FALSE,0.863636363636364,2023,2023-2024
MA,2023-11-30,intra-ui,5944,1042,327,198,155,109,82,76,58,449,2887,11327,8831,9873,FALSE,0.871634148494747,2023,2023-2024
MA,2023-12-31,inter-total,322,52,19,10,8,8,3,2,0,14,92,530,414,466,FALSE,0.879245283018868,2023,2023-2024
MA,2023-12-31,inter-ucfe,2,2,0,0,0,0,0,0,0,0,0,4,2,4,FALSE,1,2023,2023-2024
MA,2023-12-31,inter-ucx,0,0,1,1,0,0,0,0,0,0,0,2,0,0,FALSE,0,2023,2023-2024
MA,2023-12-31,inter-ui,320,50,18,9,8,8,3,2,0,14,92,524,412,462,FALSE,0.881679389312977,2023,2023-2024
MA,2023-12-31,intra-total,9175,996,325,216,144,103,90,57,46,311,2904,14367,12079,13075,FALSE,0.91007169207211,2023,2023-2024
MA,2023-12-31,intra-ucfe,2,3,1,1,0,0,1,0,1,4,2,15,4,7,FALSE,0.466666666666667,2023,2023-2024
MA,2023-12-31,intra-ucx,4,2,1,1,1,0,0,0,0,4,2,15,6,8,FALSE,0.533333333333333,2023,2023-2024
MA,2023-12-31,intra-ui,9169,991,323,214,143,103,89,57,45,303,2900,14337,12069,13060,FALSE,0.910929762153868,2023,2023-2024
MA,2024-01-31,inter-total,483,58,17,10,5,5,7,7,3,22,154,771,637,695,FALSE,0.901426718547341,2023,2023-2024
MA,2024-01-31,inter-ucfe,0,0,1,0,0,0,0,0,0,0,0,1,0,0,FALSE,0,2023,2023-2024
MA,2024-01-31,inter-ucx,0,0,0,0,0,0,0,0,0,0,0,0,0,0,FALSE,0,2023,2023-2024
MA,2024-01-31,inter-ui,483,58,16,10,5,5,7,7,3,22,154,770,637,695,FALSE,0.902597402597403,2023,2023-2024
MA,2024-01-31,intra-total,15858,1661,522,235,177,151,117,99,86,411,4468,23785,20326,21987,FALSE,0.924406138322472,2023,2023-2024
MA,2024-01-31,intra-ucfe,4,3,4,1,1,1,0,0,0,3,4,21,8,11,FALSE,0.523809523809524,2023,2023-2024
MA,2024-01-31,intra-ucx,1,0,0,0,0,0,0,0,1,0,1,3,2,2,FALSE,0.666666666666667,2023,2023-2024
MA,2024-01-31,intra-ui,15853,1658,518,234,176,150,117,99,85,408,4463,23761,20316,21974,FALSE,0.924792727578806,2023,2023-2024
MA,2024-02-29,inter-total,262,63,22,8,14,7,5,8,3,35,101,528,363,426,FALSE,0.806818181818182,2023,2023-2024
MA,2024-02-29,inter-ucfe,0,0,0,0,0,0,0,0,0,1,0,1,0,0,FALSE,0,2023,2023-2024
MA,2024-02-29,inter-ucx,2,0,0,0,0,0,0,0,0,0,1,3,3,3,FALSE,1,2023,2023-2024
MA,2024-02-29,inter-ui,260,63,22,8,14,7,5,8,3,34,100,524,360,423,FALSE,0.807251908396947,2023,2023-2024
MA,2024-02-29,intra-total,8259,1833,654,438,256,210,145,132,97,552,3025,15601,11284,13117,FALSE,0.840779437215563,2023,2023-2024
MA,2024-02-29,intra-ucfe,3,1,2,1,0,1,1,1,0,7,2,19,5,6,FALSE,0.315789473684211,2023,2023-2024
MA,2024-02-29,intra-ucx,9,0,2,0,0,0,1,0,0,1,0,13,9,9,FALSE,0.692307692307692,2023,2023-2024
MA,2024-02-29,intra-ui,8247,1832,650,437,256,209,143,131,97,544,3023,15569,11270,13102,FALSE,0.841544094033014,2023,2023-2024
MA,2024-03-31,inter-total,176,61,24,15,18,6,15,8,5,40,98,466,274,335,FALSE,0.718884120171674,2023,2023-2024
MA,2024-03-31,inter-ucfe,0,0,0,0,0,0,0,1,0,0,0,1,0,0,FALSE,0,2023,2023-2024
MA,2024-03-31,inter-ucx,0,0,0,0,0,0,0,0,0,0,0,0,0,0,FALSE,0,2023,2023-2024
MA,2024-03-31,inter-ui,176,61,24,15,18,6,15,7,5,40,98,465,274,335,FALSE,0.720430107526882,2023,2023-2024
MA,2024-03-31,intra-total,4473,1644,574,446,442,252,190,138,103,777,2723,11762,7196,8840,FALSE,0.751572861758204,2023,2023-2024
MA,2024-03-31,intra-ucfe,1,2,0,1,0,1,1,2,1,4,2,15,3,5,FALSE,0.333333333333333,2023,2023-2024
MA,2024-03-31,intra-ucx,1,0,1,0,0,0,1,0,0,1,1,5,2,2,FALSE,0.4,2023,2023-2024
MA,2024-03-31,intra-ui,4471,1642,573,445,442,251,188,136,102,772,2720,11742,7191,8833,FALSE,0.752256855731562,2023,2023-2024
MA,2024-04-30,inter-total,141,48,13,18,6,5,7,5,1,36,71,351,212,260,FALSE,0.740740740740741,2023,2023-2024
MA,2024-04-30,inter-ucfe,0,0,0,0,0,0,0,0,0,0,0,0,0,0,FALSE,0,2023,2023-2024
MA,2024-04-30,inter-ucx,1,0,0,0,0,0,0,0,0,0,0,1,1,1,FALSE,1,2023,2023-2024
MA,2024-04-30,inter-ui,140,48,13,18,6,5,7,5,1,36,71,350,211,259,FALSE,0.74,2023,2023-2024
MA,2024-04-30,intra-total,4142,1568,476,313,288,179,154,136,104,651,2191,10202,6333,7901,FALSE,0.774455989021761,2023,2023-2024
MA,2024-04-30,intra-ucfe,1,0,1,1,1,0,1,0,0,2,1,8,2,2,FALSE,0.25,2023,2023-2024
MA,2024-04-30,intra-ucx,3,0,2,0,0,0,0,0,0,0,3,8,6,6,FALSE,0.75,2023,2023-2024
MA,2024-04-30,intra-ui,4138,1568,473,312,287,179,153,136,104,649,2187,10186,6325,7893,FALSE,0.774887099941096,2023,2023-2024
MA,2024-05-31,inter-total,145,44,19,9,15,3,9,5,2,23,89,363,234,278,FALSE,0.765840220385675,2023,2023-2024
MA,2024-05-31,inter-ucfe,1,0,0,0,0,0,1,0,0,1,0,3,1,1,FALSE,0.333333333333333,2023,2023-2024
MA,2024-05-31,inter-ucx,2,0,0,1,1,0,0,0,0,0,0,4,2,2,FALSE,0.5,2023,2023-2024
MA,2024-05-31,inter-ui,142,44,19,8,14,3,8,5,2,22,89,356,231,275,FALSE,0.77247191011236,2023,2023-2024
MA,2024-05-31,intra-total,3384,1170,403,334,281,225,181,138,136,692,2223,9167,5607,6777,FALSE,0.739282207919712,2023,2023-2024
MA,2024-05-31,intra-ucfe,0,0,0,2,0,2,1,0,0,4,3,12,3,3,FALSE,0.25,2023,2023-2024
MA,2024-05-31,intra-ucx,3,0,0,0,1,1,0,1,0,3,1,10,4,4,FALSE,0.4,2023,2023-2024
MA,2024-05-31,intra-ui,3381,1170,403,332,280,222,180,137,136,685,2219,9145,5600,6770,FALSE,0.740295243302351,2023,2023-2024
MA,2024-06-30,inter-total,90,36,21,14,5,7,4,5,5,29,91,307,181,217,FALSE,0.706840390879479,2023,2023-2024
MA,2024-06-30,inter-ucfe,0,0,0,0,0,0,0,0,0,0,0,0,0,0,FALSE,0,2023,2023-2024
MA,2024-06-30,inter-ucx,0,0,0,0,0,0,0,0,0,0,2,2,2,2,FALSE,1,2023,2023-2024
MA,2024-06-30,inter-ui,90,36,21,14,5,7,4,5,5,29,89,305,179,215,FALSE,0.704918032786885,2023,2023-2024
MA,2024-06-30,intra-total,2694,1024,363,274,197,195,188,111,101,515,2216,7878,4910,5934,FALSE,0.753236862147753,2023,2023-2024
MA,2024-06-30,intra-ucfe,1,1,1,0,0,2,0,0,0,6,2,13,3,4,FALSE,0.307692307692308,2023,2023-2024
MA,2024-06-30,intra-ucx,2,2,2,0,0,0,1,0,0,2,4,13,6,8,FALSE,0.615384615384615,2023,2023-2024
MA,2024-06-30,intra-ui,2691,1021,360,274,197,193,187,111,101,507,2210,7852,4901,5922,FALSE,0.754202750891493,2023,2023-2024
MA,2024-07-31,inter-total,183,58,29,21,12,9,8,6,8,29,81,444,264,322,FALSE,0.725225225225225,2024,2024-2025
MA,2024-07-31,inter-ucfe,0,0,0,0,0,1,0,0,0,1,1,3,1,1,FALSE,0.333333333333333,2024,2024-2025
MA,2024-07-31,inter-ucx,0,0,0,0,0,0,0,0,0,1,0,1,0,0,FALSE,0,2024,2024-2025
MA,2024-07-31,inter-ui,183,58,29,21,12,8,8,6,8,27,80,440,263,321,FALSE,0.729545454545455,2024,2024-2025
MA,2024-07-31,intra-total,6381,1647,892,512,315,219,158,132,114,505,2941,13816,9322,10969,FALSE,0.793934568616097,2024,2024-2025
MA,2024-07-31,intra-ucfe,1,3,0,1,0,0,0,0,1,5,0,11,1,4,FALSE,0.363636363636364,2024,2024-2025
MA,2024-07-31,intra-ucx,0,0,2,0,0,0,0,0,1,8,0,11,0,0,FALSE,0,2024,2024-2025
MA,2024-07-31,intra-ui,6380,1644,890,511,315,219,158,132,112,492,2941,13794,9321,10965,FALSE,0.794910830795998,2024,2024-2025
MA,2024-08-31,inter-total,164,52,27,11,10,12,5,12,1,23,106,423,270,322,FALSE,0.761229314420804,2024,2024-2025
MA,2024-08-31,inter-ucfe,0,0,0,0,0,0,0,0,0,0,0,0,0,0,FALSE,0,2024,2024-2025
MA,2024-08-31,inter-ucx,1,0,0,0,0,1,0,0,0,0,0,2,1,1,FALSE,0.5,2024,2024-2025
MA,2024-08-31,inter-ui,163,52,27,11,10,11,5,12,1,23,106,421,269,321,FALSE,0.762470308788599,2024,2024-2025
MA,2024-08-31,intra-total,3910,1322,546,457,321,302,233,162,134,569,2211,10167,6121,7443,FALSE,0.732074358217763,2024,2024-2025
MA,2024-08-31,intra-ucfe,0,2,2,0,0,0,0,0,0,4,1,9,1,3,FALSE,0.333333333333333,2024,2024-2025
MA,2024-08-31,intra-ucx,8,1,0,0,0,0,0,0,0,1,2,12,10,11,FALSE,0.916666666666667,2024,2024-2025
MA,2024-08-31,intra-ui,3902,1319,544,457,321,302,233,162,134,564,2208,10146,6110,7429,FALSE,0.732209737827715,2024,2024-2025
MA,2024-09-30,inter-total,199,54,19,10,17,12,11,15,7,46,69,459,268,322,FALSE,0.701525054466231,2024,2024-2025
MA,2024-09-30,inter-ucfe,0,0,0,0,0,0,0,0,0,0,0,0,0,0,FALSE,0,2024,2024-2025
MA,2024-09-30,inter-ucx,0,0,0,0,0,0,0,1,0,0,0,1,0,0,FALSE,0,2024,2024-2025
MA,2024-09-30,inter-ui,199,54,19,10,17,12,11,14,7,46,69,458,268,322,FALSE,0.703056768558952,2024,2024-2025
MA,2024-09-30,intra-total,5000,1175,518,338,267,209,154,142,107,685,2018,10613,7018,8193,FALSE,0.771977763120701,2024,2024-2025
MA,2024-09-30,intra-ucfe,0,2,0,1,2,1,0,0,0,2,1,9,1,3,FALSE,0.333333333333333,2024,2024-2025
MA,2024-09-30,intra-ucx,5,0,1,0,0,0,0,0,0,1,9,16,14,14,FALSE,0.875,2024,2024-2025
MA,2024-09-30,intra-ui,4995,1173,517,337,265,208,154,142,107,682,2008,10588,7003,8176,FALSE,0.772194937665281,2024,2024-2025
MA,2024-10-31,inter-total,237,39,23,19,10,6,11,10,1,36,77,469,314,353,FALSE,0.752665245202559,2024,2024-2025
MA,2024-10-31,inter-ucfe,1,0,0,0,0,1,0,0,0,0,0,2,1,1,FALSE,0.5,2024,2024-2025
MA,2024-10-31,inter-ucx,2,0,0,0,0,0,0,0,0,0,0,2,2,2,FALSE,1,2024,2024-2025
MA,2024-10-31,inter-ui,234,39,23,19,10,5,11,10,1,36,77,465,311,350,FALSE,0.752688172043011,2024,2024-2025
MA,2024-10-31,intra-total,4639,1216,549,319,244,182,145,115,95,736,1699,9939,6338,7554,FALSE,0.760036220947781,2024,2024-2025
MA,2024-10-31,intra-ucfe,1,0,0,1,0,0,0,2,0,5,0,9,1,1,FALSE,0.111111111111111,2024,2024-2025
MA,2024-10-31,intra-ucx,4,0,1,1,1,0,0,0,0,2,1,10,5,5,FALSE,0.5,2024,2024-2025
MA,2024-10-31,intra-ui,4634,1216,548,317,243,182,145,113,95,729,1698,9920,6332,7548,FALSE,0.760887096774194,2024,2024-2025
MA,2024-11-30,inter-total,280,49,26,16,8,6,4,0,3,23,78,493,358,407,FALSE,0.825557809330629,2024,2024-2025
MA,2024-11-30,inter-ucfe,0,0,0,0,0,0,0,0,0,0,2,2,2,2,FALSE,1,2024,2024-2025
MA,2024-11-30,inter-ucx,0,0,0,0,0,0,0,0,0,0,0,0,0,0,FALSE,0,2024,2024-2025
MA,2024-11-30,inter-ui,280,49,26,16,8,6,4,0,3,23,76,491,356,405,FALSE,0.824847250509165,2024,2024-2025
MA,2024-11-30,intra-total,4578,876,567,371,293,202,136,122,102,812,1571,9630,6149,7025,FALSE,0.729491173416407,2024,2024-2025
MA,2024-11-30,intra-ucfe,2,0,1,2,0,1,1,0,0,3,2,12,4,4,FALSE,0.333333333333333,2024,2024-2025
MA,2024-11-30,intra-ucx,4,1,0,1,1,0,0,0,0,0,0,7,4,5,FALSE,0.714285714285714,2024,2024-2025
MA,2024-11-30,intra-ui,4572,875,566,368,292,201,135,122,102,809,1569,9611,6141,7016,FALSE,0.729996878576631,2024,2024-2025
MA,2024-12-31,inter-total,339,54,27,22,17,18,6,9,7,33,112,644,451,505,FALSE,0.78416149068323,2024,2024-2025
MA,2024-12-31,inter-ucfe,3,0,0,0,0,0,0,0,0,1,1,5,4,4,FALSE,0.8,2024,2024-2025
MA,2024-12-31,inter-ucx,1,0,0,0,0,0,0,0,0,0,0,1,1,1,FALSE,1,2024,2024-2025
MA,2024-12-31,inter-ui,335,54,27,22,17,18,6,9,7,32,111,638,446,500,FALSE,0.783699059561129,2024,2024-2025
MA,2024-12-31,intra-total,9569,1311,697,549,339,284,220,154,143,761,2564,16591,12133,13444,FALSE,0.810318847567959,2024,2024-2025
MA,2024-12-31,intra-ucfe,6,1,2,1,0,0,0,0,0,1,1,12,7,8,FALSE,0.666666666666667,2024,2024-2025
MA,2024-12-31,intra-ucx,4,0,1,0,0,0,0,1,0,1,2,9,6,6,FALSE,0.666666666666667,2024,2024-2025
MA,2024-12-31,intra-ui,9559,1310,694,548,339,284,220,153,143,759,2561,16570,12120,13430,FALSE,0.810500905250453,2024,2024-2025
MD,2019-01-31,inter-total,111,23,10,2,4,3,2,2,2,4,88,251,199,222,TRUE,0.792828685258964,2018,2018-2019
MD,2019-01-31,inter-ucfe,2,2,1,0,0,0,0,0,1,1,4,11,6,8,TRUE,0.545454545454545,2018,2018-2019
MD,2019-01-31,inter-ucx,0,0,0,0,0,0,0,0,0,0,1,1,1,1,TRUE,1,2018,2018-2019
MD,2019-01-31,inter-ui,109,21,9,2,4,3,2,2,1,3,83,239,192,213,TRUE,0.803347280334728,2018,2018-2019
MD,2019-01-31,intra-total,6312,1486,368,97,40,26,28,30,31,51,3767,12236,10079,11565,TRUE,0.823716900948022,2018,2018-2019
MD,2019-01-31,intra-ucfe,333,260,79,3,1,0,1,0,1,0,648,1326,981,1241,TRUE,0.739819004524887,2018,2018-2019
MD,2019-01-31,intra-ucx,7,0,1,1,0,0,1,0,1,0,2,13,9,9,TRUE,0.692307692307692,2018,2018-2019
MD,2019-01-31,intra-ui,5972,1226,288,93,39,26,26,30,29,51,3117,10897,9089,10315,TRUE,0.834082775075709,2018,2018-2019
MD,2019-02-28,inter-total,73,28,17,5,4,1,0,0,0,4,54,186,127,155,TRUE,0.682795698924731,2018,2018-2019
MD,2019-02-28,inter-ucfe,0,1,0,1,0,0,0,0,0,1,0,3,0,1,TRUE,0,2018,2018-2019
MD,2019-02-28,inter-ucx,0,0,0,0,0,0,0,0,0,0,0,0,0,0,TRUE,0,2018,2018-2019
MD,2019-02-28,inter-ui,73,27,17,4,4,1,0,0,0,3,54,183,127,154,TRUE,0.693989071038251,2018,2018-2019
MD,2019-02-28,intra-total,2758,1117,318,108,61,63,32,40,20,39,1978,6534,4736,5853,TRUE,0.72482399755127,2018,2018-2019
MD,2019-02-28,intra-ucfe,4,42,9,7,8,6,3,1,1,4,10,95,14,56,TRUE,0.147368421052632,2018,2018-2019
MD,2019-02-28,intra-ucx,9,3,2,0,0,0,0,0,0,0,5,19,14,17,TRUE,0.736842105263158,2018,2018-2019
MD,2019-02-28,intra-ui,2745,1072,307,101,53,57,29,39,19,35,1963,6420,4708,5780,TRUE,0.733333333333333,2018,2018-2019
MD,2019-03-31,inter-total,66,18,3,2,3,1,1,1,2,4,45,146,111,129,TRUE,0.76027397260274,2018,2018-2019
MD,2019-03-31,inter-ucfe,1,0,1,0,0,0,0,0,1,0,0,3,1,1,TRUE,0.333333333333333,2018,2018-2019
MD,2019-03-31,inter-ucx,0,0,0,0,0,0,0,0,0,0,0,0,0,0,TRUE,0,2018,2018-2019
MD,2019-03-31,inter-ui,65,18,2,2,3,1,1,1,1,4,45,143,110,128,TRUE,0.769230769230769,2018,2018-2019
MD,2019-03-31,intra-total,2028,554,175,69,43,40,41,47,11,26,1703,4737,3731,4285,TRUE,0.787629301245514,2018,2018-2019
MD,2019-03-31,intra-ucfe,5,7,4,1,2,0,0,2,0,0,11,32,16,23,TRUE,0.5,2018,2018-2019
MD,2019-03-31,intra-ucx,11,2,0,0,0,0,0,0,0,0,3,16,14,16,TRUE,0.875,2018,2018-2019
MD,2019-03-31,intra-ui,2012,545,171,68,41,40,41,45,11,26,1689,4689,3701,4246,TRUE,0.789294092557048,2018,2018-2019
MD,2019-04-30,inter-total,54,11,5,1,1,5,1,1,1,1,44,125,98,109,TRUE,0.784,2018,2018-2019
MD,2019-04-30,inter-ucfe,0,1,1,0,0,0,0,0,0,0,1,3,1,2,TRUE,0.333333333333333,2018,2018-2019
MD,2019-04-30,inter-ucx,0,0,1,0,0,0,0,0,0,0,0,1,0,0,TRUE,0,2018,2018-2019
MD,2019-04-30,inter-ui,54,10,3,1,1,5,1,1,1,1,43,121,97,107,TRUE,0.801652892561983,2018,2018-2019
MD,2019-04-30,intra-total,1718,479,109,34,33,42,36,27,15,33,1561,4087,3279,3758,TRUE,0.802299975532175,2018,2018-2019
MD,2019-04-30,intra-ucfe,4,5,3,1,0,1,0,0,0,0,8,22,12,17,TRUE,0.545454545454545,2018,2018-2019
MD,2019-04-30,intra-ucx,6,2,3,1,0,0,0,0,0,0,3,15,9,11,TRUE,0.6,2018,2018-2019
MD,2019-04-30,intra-ui,1708,472,103,32,33,41,36,27,15,33,1550,4050,3258,3730,TRUE,0.804444444444444,2018,2018-2019
MD,2019-05-31,inter-total,87,10,4,2,2,1,0,0,1,2,48,157,135,145,TRUE,0.859872611464968,2018,2018-2019
MD,2019-05-31,inter-ucfe,0,0,0,0,0,0,0,0,0,0,0,0,0,0,TRUE,0,2018,2018-2019
MD,2019-05-31,inter-ucx,0,0,0,0,0,0,0,0,0,0,0,0,0,0,TRUE,0,2018,2018-2019
MD,2019-05-31,inter-ui,87,10,4,2,2,1,0,0,1,2,48,157,135,145,TRUE,0.859872611464968,2018,2018-2019
MD,2019-05-31,intra-total,1725,539,156,48,49,30,29,14,6,24,1614,4234,3339,3878,TRUE,0.788615965989608,2018,2018-2019
MD,2019-05-31,intra-ucfe,3,5,2,0,0,0,0,0,0,1,4,15,7,12,TRUE,0.466666666666667,2018,2018-2019
MD,2019-05-31,intra-ucx,8,0,0,0,0,0,0,0,0,0,4,12,12,12,TRUE,1,2018,2018-2019
MD,2019-05-31,intra-ui,1714,534,154,48,49,30,29,14,6,23,1606,4207,3320,3854,TRUE,0.789160922272403,2018,2018-2019
MD,2019-06-30,inter-total,73,10,5,1,2,1,1,0,1,1,50,145,123,133,TRUE,0.848275862068966,2018,2018-2019
MD,2019-06-30,inter-ucfe,0,0,1,0,0,0,0,0,0,0,2,3,2,2,TRUE,0.666666666666667,2018,2018-2019
MD,2019-06-30,inter-ucx,0,1,0,0,0,0,0,0,0,0,0,1,0,1,TRUE,0,2018,2018-2019
MD,2019-06-30,inter-ui,73,9,4,1,2,1,1,0,1,1,48,141,121,130,TRUE,0.858156028368794,2018,2018-2019
MD,2019-06-30,intra-total,2633,485,135,53,29,34,34,16,8,16,1535,4978,4168,4653,TRUE,0.837284049819204,2018,2018-2019
MD,2019-06-30,intra-ucfe,4,4,2,2,0,0,0,1,1,0,6,20,10,14,TRUE,0.5,2018,2018-2019
MD,2019-06-30,intra-ucx,5,0,2,1,0,0,0,0,0,0,2,10,7,7,TRUE,0.7,2018,2018-2019
MD,2019-06-30,intra-ui,2624,481,131,50,29,34,34,15,7,16,1527,4948,4151,4632,TRUE,0.838924818108327,2018,2018-2019
MD,2019-07-31,inter-total,89,28,7,2,3,1,1,0,1,0,73,205,162,190,TRUE,0.790243902439024,2019,2019-2020
MD,2019-07-31,inter-ucfe,0,1,1,0,0,0,0,0,0,0,0,2,0,1,TRUE,0,2019,2019-2020
MD,2019-07-31,inter-ucx,0,0,0,0,0,0,0,0,0,0,0,0,0,0,TRUE,0,2019,2019-2020
MD,2019-07-31,inter-ui,89,27,6,2,3,1,1,0,1,0,73,203,162,189,TRUE,0.798029556650246,2019,2019-2020
MD,2019-07-31,intra-total,3140,950,246,66,36,29,44,27,9,32,1761,6340,4901,5851,TRUE,0.773028391167193,2019,2019-2020
MD,2019-07-31,intra-ucfe,8,7,3,1,0,1,1,0,0,0,8,29,16,23,TRUE,0.551724137931035,2019,2019-2020
MD,2019-07-31,intra-ucx,12,3,0,1,0,0,0,0,0,1,7,24,19,22,TRUE,0.791666666666667,2019,2019-2020
MD,2019-07-31,intra-ui,3120,940,243,64,36,28,43,27,9,31,1746,6287,4866,5806,TRUE,0.77397804994433,2019,2019-2020
MD,2019-08-31,inter-total,87,24,5,4,2,3,1,1,0,2,56,185,143,167,TRUE,0.772972972972973,2019,2019-2020
MD,2019-08-31,inter-ucfe,0,2,0,0,0,0,0,0,0,0,1,3,1,3,TRUE,0.333333333333333,2019,2019-2020
MD,2019-08-31,inter-ucx,0,0,0,1,0,0,0,0,0,0,0,1,0,0,TRUE,0,2019,2019-2020
MD,2019-08-31,inter-ui,87,22,5,3,2,3,1,1,0,2,55,181,142,164,TRUE,0.784530386740332,2019,2019-2020
MD,2019-08-31,intra-total,1914,804,194,66,56,36,44,28,13,24,1626,4805,3540,4344,TRUE,0.736732570239334,2019,2019-2020
MD,2019-08-31,intra-ucfe,11,13,2,3,0,0,0,0,0,0,9,38,20,33,TRUE,0.526315789473684,2019,2019-2020
MD,2019-08-31,intra-ucx,11,3,1,0,0,0,0,0,0,0,9,24,20,23,TRUE,0.833333333333333,2019,2019-2020
MD,2019-08-31,intra-ui,1892,788,191,63,56,36,44,28,13,24,1608,4743,3500,4288,TRUE,0.737929580434324,2019,2019-2020
MD,2019-09-30,inter-total,17,24,7,3,0,1,0,0,1,1,31,85,48,72,TRUE,0.564705882352941,2019,2019-2020
MD,2019-09-30,inter-ucfe,0,2,2,0,0,0,0,0,0,0,0,4,0,2,TRUE,0,2019,2019-2020
MD,2019-09-30,inter-ucx,0,0,0,0,0,0,0,0,0,0,0,0,0,0,TRUE,0,2019,2019-2020
MD,2019-09-30,inter-ui,17,22,5,3,0,1,0,0,1,1,31,81,48,70,TRUE,0.592592592592593,2019,2019-2020
MD,2019-09-30,intra-total,369,1164,218,76,48,36,18,2,0,6,1408,3345,1777,2941,TRUE,0.531240657698057,2019,2019-2020
MD,2019-09-30,intra-ucfe,4,13,5,3,2,0,0,1,0,2,16,46,20,33,TRUE,0.434782608695652,2019,2019-2020
MD,2019-09-30,intra-ucx,0,3,0,2,0,0,0,0,0,0,7,12,7,10,TRUE,0.583333333333333,2019,2019-2020
MD,2019-09-30,intra-ui,365,1148,213,71,46,36,18,1,0,4,1385,3287,1750,2898,TRUE,0.532400365074536,2019,2019-2020
MD,2019-10-31,inter-total,63,21,7,2,3,2,2,2,0,0,48,150,111,132,TRUE,0.74,2019,2019-2020
MD,2019-10-31,inter-ucfe,0,1,0,0,0,0,0,0,0,0,0,1,0,1,TRUE,0,2019,2019-2020
MD,2019-10-31,inter-ucx,0,0,0,0,0,0,0,0,0,0,0,0,0,0,TRUE,0,2019,2019-2020
MD,2019-10-31,inter-ui,63,20,7,2,3,2,2,2,0,0,48,149,111,131,TRUE,0.74496644295302,2019,2019-2020
MD,2019-10-31,intra-total,1718,549,145,41,28,32,33,29,18,43,1776,4412,3494,4043,TRUE,0.79193109700816,2019,2019-2020
MD,2019-10-31,intra-ucfe,4,7,2,1,0,1,0,0,0,1,10,26,14,21,TRUE,0.538461538461538,2019,2019-2020
MD,2019-10-31,intra-ucx,9,3,0,0,0,0,0,0,0,0,2,14,11,14,TRUE,0.785714285714286,2019,2019-2020
MD,2019-10-31,intra-ui,1705,539,143,40,28,31,33,29,18,42,1764,4372,3469,4008,TRUE,0.793458371454712,2019,2019-2020
MD,2019-11-30,inter-total,70,20,9,1,2,2,0,3,2,1,51,161,121,141,TRUE,0.751552795031056,2019,2019-2020
MD,2019-11-30,inter-ucfe,1,1,1,0,0,0,0,0,0,1,2,6,3,4,TRUE,0.5,2019,2019-2020
MD,2019-11-30,inter-ucx,0,0,0,0,0,0,0,0,0,0,0,0,0,0,TRUE,0,2019,2019-2020
MD,2019-11-30,inter-ui,69,19,8,1,2,2,0,3,2,0,49,155,118,137,TRUE,0.761290322580645,2019,2019-2020
MD,2019-11-30,intra-total,2041,647,163,49,15,27,29,26,23,35,1325,4380,3366,4013,TRUE,0.768493150684932,2019,2019-2020
MD,2019-11-30,intra-ucfe,11,4,3,2,0,1,0,0,0,1,9,31,20,24,TRUE,0.645161290322581,2019,2019-2020
MD,2019-11-30,intra-ucx,12,1,0,0,0,0,0,0,0,0,2,15,14,15,TRUE,0.933333333333333,2019,2019-2020
MD,2019-11-30,intra-ui,2018,642,160,47,15,26,29,26,23,34,1314,4334,3332,3974,TRUE,0.768804799261652,2019,2019-2020
MD,2019-12-31,inter-total,103,26,6,2,6,1,0,0,2,4,58,208,161,187,TRUE,0.774038461538462,2019,2019-2020
MD,2019-12-31,inter-ucfe,1,0,1,0,0,0,0,0,0,0,0,2,1,1,TRUE,0.5,2019,2019-2020
MD,2019-12-31,inter-ucx,1,0,0,0,0,0,0,0,0,0,0,1,1,1,TRUE,1,2019,2019-2020
MD,2019-12-31,inter-ui,101,26,5,2,6,1,0,0,2,4,58,205,159,185,TRUE,0.775609756097561,2019,2019-2020
MD,2019-12-31,intra-total,3933,1038,309,82,42,17,25,35,34,40,1466,7021,5399,6437,TRUE,0.768978777951859,2019,2019-2020
MD,2019-12-31,intra-ucfe,2,9,4,4,2,2,0,0,0,1,8,32,10,19,TRUE,0.3125,2019,2019-2020
MD,2019-12-31,intra-ucx,9,3,1,0,0,0,0,0,0,0,4,17,13,16,TRUE,0.764705882352941,2019,2019-2020
MD,2019-12-31,intra-ui,3922,1026,304,78,40,15,25,35,34,39,1454,6972,5376,6402,TRUE,0.771084337349398,2019,2019-2020
MD,2020-01-31,inter-total,106,33,8,3,4,0,0,6,2,3,72,237,178,211,TRUE,0.751054852320675,2019,2019-2020
MD,2020-01-31,inter-ucfe,0,0,0,0,0,0,0,0,2,0,0,2,0,0,TRUE,0,2019,2019-2020
MD,2020-01-31,inter-ucx,0,0,0,0,0,0,0,0,0,0,0,0,0,0,TRUE,0,2019,2019-2020
MD,2020-01-31,inter-ui,106,33,8,3,4,0,0,6,0,3,72,235,178,211,TRUE,0.757446808510638,2019,2019-2020
MD,2020-01-31,intra-total,5138,1150,337,111,47,19,41,42,29,55,2518,9487,7656,8806,TRUE,0.806999051333404,2019,2019-2020
MD,2020-01-31,intra-ucfe,3,11,3,4,0,0,0,0,1,0,5,27,8,19,TRUE,0.296296296296296,2019,2019-2020
MD,2020-01-31,intra-ucx,8,1,1,0,0,0,0,0,0,0,9,19,17,18,TRUE,0.894736842105263,2019,2019-2020
MD,2020-01-31,intra-ui,5127,1138,333,107,47,19,41,42,28,55,2504,9441,7631,8769,TRUE,0.808283020866434,2019,2019-2020
MD,2020-02-29,inter-total,79,25,6,5,2,1,0,1,2,3,47,171,126,151,TRUE,0.736842105263158,2019,2019-2020
MD,2020-02-29,inter-ucfe,0,3,0,0,0,0,0,0,0,0,0,3,0,3,TRUE,0,2019,2019-2020
MD,2020-02-29,inter-ucx,1,0,0,0,0,0,0,0,0,0,0,1,1,1,TRUE,1,2019,2019-2020
MD,2020-02-29,inter-ui,78,22,6,5,2,1,0,1,2,3,47,167,125,147,TRUE,0.748502994011976,2019,2019-2020
MD,2020-02-29,intra-total,2704,958,331,90,60,33,29,38,15,49,1416,5723,4120,5078,TRUE,0.719902149222436,2019,2019-2020
MD,2020-02-29,intra-ucfe,6,4,5,1,2,0,0,1,0,1,4,24,10,14,TRUE,0.416666666666667,2019,2019-2020
MD,2020-02-29,intra-ucx,7,3,1,0,0,0,1,0,0,0,6,18,13,16,TRUE,0.722222222222222,2019,2019-2020
MD,2020-02-29,intra-ui,2691,951,325,89,58,33,28,37,15,48,1406,5681,4097,5048,TRUE,0.721175849322302,2019,2019-2020
MD,2020-03-31,inter-total,153,17,12,1,3,4,2,1,0,2,78,273,231,248,TRUE,0.846153846153846,2019,2019-2020
MD,2020-03-31,inter-ucfe,0,0,0,0,0,0,0,0,0,0,0,0,0,0,TRUE,0,2019,2019-2020
MD,2020-03-31,inter-ucx,0,0,0,0,0,0,0,0,0,0,0,0,0,0,TRUE,0,2019,2019-2020
MD,2020-03-31,inter-ui,153,17,12,1,3,4,2,1,0,2,78,273,231,248,TRUE,0.846153846153846,2019,2019-2020
MD,2020-03-31,intra-total,11372,824,258,77,47,26,33,30,9,24,7661,20361,19033,19857,TRUE,0.934777270271598,2019,2019-2020
MD,2020-03-31,intra-ucfe,1,2,4,0,0,0,0,0,0,0,4,11,5,7,TRUE,0.454545454545455,2019,2019-2020
MD,2020-03-31,intra-ucx,8,3,1,0,0,0,0,0,0,0,7,19,15,18,TRUE,0.789473684210526,2019,2019-2020
MD,2020-03-31,intra-ui,11363,819,253,77,47,26,33,30,9,24,7650,20331,19013,19832,TRUE,0.935172888692145,2019,2019-2020
MD,2020-04-30,inter-total,667,137,76,33,13,0,0,1,0,2,481,1410,1148,1285,TRUE,0.814184397163121,2019,2019-2020
MD,2020-04-30,inter-ucfe,0,0,0,0,0,0,0,0,0,0,0,0,0,0,TRUE,0,2019,2019-2020
MD,2020-04-30,inter-ucx,0,0,0,0,0,0,0,0,0,0,0,0,0,0,TRUE,0,2019,2019-2020
MD,2020-04-30,inter-ui,667,137,76,33,13,0,0,1,0,2,481,1410,1148,1285,TRUE,0.814184397163121,2019,2019-2020
MD,2020-04-30,intra-total,63372,18644,10377,3499,457,27,12,11,18,60,45855,142332,109227,127871,TRUE,0.767409999156901,2019,2019-2020
MD,2020-04-30,intra-ucfe,1,9,7,6,1,0,1,0,0,0,10,35,11,20,TRUE,0.314285714285714,2019,2019-2020
MD,2020-04-30,intra-ucx,37,11,7,3,0,0,0,0,0,0,29,87,66,77,TRUE,0.758620689655172,2019,2019-2020
MD,2020-04-30,intra-ui,63334,18624,10363,3490,456,27,11,11,18,60,45816,142210,109150,127774,TRUE,0.767526896842697,2019,2019-2020
MD,2020-05-31,inter-total,97,67,69,53,65,61,39,42,8,1,136,638,233,300,TRUE,0.365203761755486,2019,2019-2020
MD,2020-05-31,inter-ucfe,0,0,0,0,0,0,0,0,0,0,0,0,0,0,TRUE,0,2019,2019-2020
MD,2020-05-31,inter-ucx,0,0,0,0,0,0,0,0,0,0,1,1,1,1,TRUE,1,2019,2019-2020
MD,2020-05-31,inter-ui,97,67,69,53,65,61,39,42,8,1,135,637,232,299,TRUE,0.364207221350079,2019,2019-2020
MD,2020-05-31,intra-total,4634,3540,5515,7167,7348,5976,4754,2693,253,133,6019,48032,10653,14193,TRUE,0.22178964023984,2019,2019-2020
MD,2020-05-31,intra-ucfe,1,3,1,2,2,3,3,2,3,0,1,21,2,5,TRUE,0.0952380952380952,2019,2019-2020
MD,2020-05-31,intra-ucx,3,21,4,6,1,2,3,2,1,0,8,51,11,32,TRUE,0.215686274509804,2019,2019-2020
MD,2020-05-31,intra-ui,4630,3516,5510,7159,7345,5971,4748,2689,249,133,6010,47960,10640,14156,TRUE,0.22185154295246,2019,2019-2020
MD,2020-06-30,inter-total,26,15,18,40,35,64,92,138,68,160,24,680,50,65,TRUE,0.0735294117647059,2019,2019-2020
MD,2020-06-30,inter-ucfe,0,0,0,1,0,0,1,1,0,2,0,5,0,0,TRUE,0,2019,2019-2020
MD,2020-06-30,inter-ucx,0,0,0,0,0,1,0,0,0,0,0,1,0,0,TRUE,0,2019,2019-2020
MD,2020-06-30,inter-ui,26,15,18,39,35,63,91,137,68,158,24,674,50,65,TRUE,0.0741839762611276,2019,2019-2020
MD,2020-06-30,intra-total,2150,746,988,1497,1475,2089,2813,5349,4270,7439,1405,30221,3555,4301,TRUE,0.11763343370504,2019,2019-2020
MD,2020-06-30,intra-ucfe,0,3,0,0,3,1,2,5,3,13,0,30,0,3,TRUE,0,2019,2019-2020
MD,2020-06-30,intra-ucx,4,7,8,7,9,5,5,6,6,9,0,66,4,11,TRUE,0.0606060606060606,2019,2019-2020
MD,2020-06-30,intra-ui,2146,736,980,1490,1463,2083,2806,5338,4261,7417,1405,30125,3551,4287,TRUE,0.117875518672199,2019,2019-2020
MD,2020-07-31,inter-total,29,23,15,14,13,10,8,8,23,653,44,840,73,96,TRUE,0.0869047619047619,2020,2020-2021
MD,2020-07-31,inter-ucfe,0,0,0,0,0,0,0,0,0,2,0,2,0,0,TRUE,0,2020,2020-2021
MD,2020-07-31,inter-ucx,0,0,0,0,0,0,0,0,1,1,0,2,0,0,TRUE,0,2020,2020-2021
MD,2020-07-31,inter-ui,29,23,15,14,13,10,8,8,22,650,44,836,73,96,TRUE,0.0873205741626794,2020,2020-2021
MD,2020-07-31,intra-total,1991,989,498,347,257,191,140,180,260,13727,1926,20506,3917,4906,TRUE,0.191017263240027,2020,2020-2021
MD,2020-07-31,intra-ucfe,1,1,2,1,0,0,1,1,0,33,0,40,1,2,TRUE,0.025,2020,2020-2021
MD,2020-07-31,intra-ucx,0,1,1,2,0,1,1,0,0,31,0,37,0,1,TRUE,0,2020,2020-2021
MD,2020-07-31,intra-ui,1990,987,495,344,257,190,138,179,260,13663,1926,20429,3916,4903,TRUE,0.191688286259729,2020,2020-2021
MD,2020-08-31,inter-total,19,30,17,22,5,4,9,5,8,120,57,296,76,106,TRUE,0.256756756756757,2020,2020-2021
MD,2020-08-31,inter-ucfe,0,0,0,0,0,0,0,0,0,1,0,1,0,0,TRUE,0,2020,2020-2021
MD,2020-08-31,inter-ucx,0,0,1,0,0,0,0,0,0,0,0,1,0,0,TRUE,0,2020,2020-2021
MD,2020-08-31,inter-ui,19,30,16,22,5,4,9,5,8,119,57,294,76,106,TRUE,0.258503401360544,2020,2020-2021
MD,2020-08-31,intra-total,794,1016,287,208,308,261,226,189,155,4369,1474,9287,2268,3284,TRUE,0.24421233982987,2020,2020-2021
MD,2020-08-31,intra-ucfe,0,0,0,1,2,1,0,0,0,10,0,14,0,0,TRUE,0,2020,2020-2021
MD,2020-08-31,intra-ucx,1,1,1,0,0,1,0,0,0,9,1,14,2,3,TRUE,0.142857142857143,2020,2020-2021
MD,2020-08-31,intra-ui,793,1015,286,207,306,259,226,189,155,4350,1473,9259,2266,3281,TRUE,0.244734852575872,2020,2020-2021
MD,2020-09-30,inter-total,12,27,8,14,11,4,5,6,2,77,32,198,44,71,TRUE,0.222222222222222,2020,2020-2021
MD,2020-09-30,inter-ucfe,0,0,0,0,0,0,0,0,0,0,0,0,0,0,TRUE,0,2020,2020-2021
MD,2020-09-30,inter-ucx,0,0,0,0,0,0,0,0,0,1,1,2,1,1,TRUE,0.5,2020,2020-2021
MD,2020-09-30,inter-ui,12,27,8,14,11,4,5,6,2,76,31,196,43,70,TRUE,0.219387755102041,2020,2020-2021
MD,2020-09-30,intra-total,715,535,145,133,103,146,140,156,154,1886,908,5021,1623,2158,TRUE,0.323242381995618,2020,2020-2021
MD,2020-09-30,intra-ucfe,0,1,1,1,0,0,1,0,0,10,2,16,2,3,TRUE,0.125,2020,2020-2021
MD,2020-09-30,intra-ucx,1,4,0,0,0,1,0,0,0,4,2,12,3,7,TRUE,0.25,2020,2020-2021
MD,2020-09-30,intra-ui,714,530,144,132,103,145,139,156,154,1872,904,4993,1618,2148,TRUE,0.324053675145203,2020,2020-2021
MD,2020-10-31,inter-total,17,35,17,12,11,8,7,2,6,177,21,313,38,73,TRUE,0.121405750798722,2020,2020-2021
MD,2020-10-31,inter-ucfe,0,0,0,0,0,0,1,0,0,1,0,2,0,0,TRUE,0,2020,2020-2021
MD,2020-10-31,inter-ucx,1,0,0,0,0,0,0,0,0,0,0,1,1,1,TRUE,1,2020,2020-2021
MD,2020-10-31,inter-ui,16,35,17,12,11,8,6,2,6,176,21,310,37,72,TRUE,0.119354838709677,2020,2020-2021
MD,2020-10-31,intra-total,1060,1187,532,362,441,274,275,204,235,5917,962,11449,2022,3209,TRUE,0.176609310856843,2020,2020-2021
MD,2020-10-31,intra-ucfe,1,1,1,0,1,1,2,1,0,11,2,21,3,4,TRUE,0.142857142857143,2020,2020-2021
MD,2020-10-31,intra-ucx,0,0,0,0,0,1,0,0,0,0,0,1,0,0,TRUE,0,2020,2020-2021
MD,2020-10-31,intra-ui,1059,1186,531,362,440,272,273,203,235,5906,960,11427,2019,3205,TRUE,0.176686794434235,2020,2020-2021
MD,2020-11-30,inter-total,15,27,13,2,5,1,3,4,4,61,16,151,31,58,TRUE,0.205298013245033,2020,2020-2021
MD,2020-11-30,inter-ucfe,0,1,0,0,0,0,0,0,0,2,0,3,0,1,TRUE,0,2020,2020-2021
MD,2020-11-30,inter-ucx,0,0,0,0,0,0,0,0,0,1,0,1,0,0,TRUE,0,2020,2020-2021
MD,2020-11-30,inter-ui,15,26,13,2,5,1,3,4,4,58,16,147,31,57,TRUE,0.210884353741497,2020,2020-2021
MD,2020-11-30,intra-total,1276,944,241,99,161,79,72,105,74,1641,824,5516,2100,3044,TRUE,0.380710659898477,2020,2020-2021
MD,2020-11-30,intra-ucfe,1,1,1,2,2,1,0,0,0,8,2,18,3,4,TRUE,0.166666666666667,2020,2020-2021
MD,2020-11-30,intra-ucx,0,1,0,0,1,0,1,1,0,0,1,5,1,2,TRUE,0.2,2020,2020-2021
MD,2020-11-30,intra-ui,1275,942,240,97,158,78,71,104,74,1633,821,5493,2096,3038,TRUE,0.381576551975241,2020,2020-2021
MD,2020-12-31,inter-total,29,29,20,15,18,15,5,5,7,143,41,327,70,99,TRUE,0.214067278287462,2020,2020-2021
MD,2020-12-31,inter-ucfe,0,0,0,2,0,0,0,0,0,0,0,2,0,0,TRUE,0,2020,2020-2021
MD,2020-12-31,inter-ucx,0,0,0,0,0,0,0,0,0,0,0,0,0,0,TRUE,0,2020,2020-2021
MD,2020-12-31,inter-ui,29,29,20,13,18,15,5,5,7,143,41,325,70,99,TRUE,0.215384615384615,2020,2020-2021
MD,2020-12-31,intra-total,1326,1234,616,592,385,346,245,147,129,4839,1854,11713,3180,4414,TRUE,0.271493212669683,2020,2020-2021
MD,2020-12-31,intra-ucfe,1,2,4,4,4,0,2,1,2,24,4,48,5,7,TRUE,0.104166666666667,2020,2020-2021
MD,2020-12-31,intra-ucx,2,1,0,1,0,0,0,0,0,4,2,10,4,5,TRUE,0.4,2020,2020-2021
MD,2020-12-31,intra-ui,1323,1231,612,587,381,346,243,146,127,4811,1848,11655,3171,4402,TRUE,0.272072072072072,2020,2020-2021
MD,2021-01-31,inter-total,49,44,11,5,1,3,3,1,2,111,66,296,115,159,TRUE,0.388513513513514,2020,2020-2021
MD,2021-01-31,inter-ucfe,0,0,0,0,0,0,0,0,0,4,0,4,0,0,TRUE,0,2020,2020-2021
MD,2021-01-31,inter-ucx,0,0,0,0,0,0,0,0,0,2,0,2,0,0,TRUE,0,2020,2020-2021
MD,2021-01-31,inter-ui,49,44,11,5,1,3,3,1,2,105,66,290,115,159,TRUE,0.396551724137931,2020,2020-2021
MD,2021-01-31,intra-total,4139,2208,389,150,77,76,42,36,40,4325,3007,14489,7146,9354,TRUE,0.493201739250466,2020,2020-2021
MD,2021-01-31,intra-ucfe,3,1,1,4,1,0,0,2,2,31,2,47,5,6,TRUE,0.106382978723404,2020,2020-2021
MD,2021-01-31,intra-ucx,6,1,0,0,1,0,1,0,0,2,1,12,7,8,TRUE,0.583333333333333,2020,2020-2021
MD,2021-01-31,intra-ui,4130,2206,388,146,75,76,41,34,38,4292,3004,14430,7134,9340,TRUE,0.494386694386694,2020,2020-2021
MD,2021-02-28,inter-total,28,67,14,9,2,5,1,2,2,169,49,348,77,144,TRUE,0.221264367816092,2020,2020-2021
MD,2021-02-28,inter-ucfe,0,1,0,0,0,1,0,0,0,3,1,6,1,2,TRUE,0.166666666666667,2020,2020-2021
MD,2021-02-28,inter-ucx,0,0,0,0,0,0,0,0,0,1,0,1,0,0,TRUE,0,2020,2020-2021
MD,2021-02-28,inter-ui,28,66,14,9,2,4,1,2,2,165,48,341,76,142,TRUE,0.222873900293255,2020,2020-2021
MD,2021-02-28,intra-total,1871,2719,537,155,126,107,92,82,80,5826,2332,13927,4203,6922,TRUE,0.301787894018812,2020,2020-2021
MD,2021-02-28,intra-ucfe,4,10,6,1,1,1,2,1,0,30,3,59,7,17,TRUE,0.11864406779661,2020,2020-2021
MD,2021-02-28,intra-ucx,0,0,0,1,0,1,0,0,0,3,0,5,0,0,TRUE,0,2020,2020-2021
MD,2021-02-28,intra-ui,1867,2709,531,153,125,105,90,81,80,5793,2329,13863,4196,6905,TRUE,0.302676188415206,2020,2020-2021
MD,2021-03-31,inter-total,31,37,2,1,3,6,7,5,3,235,30,360,61,98,TRUE,0.169444444444444,2020,2020-2021
MD,2021-03-31,inter-ucfe,0,0,0,0,0,1,1,0,0,2,1,5,1,1,TRUE,0.2,2020,2020-2021
MD,2021-03-31,inter-ucx,0,0,0,0,0,0,0,0,0,1,0,1,0,0,TRUE,0,2020,2020-2021
MD,2021-03-31,inter-ui,31,37,2,1,3,5,6,5,3,232,29,354,60,97,TRUE,0.169491525423729,2020,2020-2021
MD,2021-03-31,intra-total,1268,1032,185,90,86,85,125,136,146,7411,1291,11855,2559,3591,TRUE,0.215858287642345,2020,2020-2021
MD,2021-03-31,intra-ucfe,2,3,6,2,2,1,1,0,0,36,3,56,5,8,TRUE,0.0892857142857143,2020,2020-2021
MD,2021-03-31,intra-ucx,0,0,0,0,0,0,0,0,0,1,0,1,0,0,TRUE,0,2020,2020-2021
MD,2021-03-31,intra-ui,1266,1029,179,88,84,84,124,136,146,7374,1288,11798,2554,3583,TRUE,0.216477369045601,2020,2020-2021
MD,2021-04-30,inter-total,32,20,4,2,1,3,1,5,1,115,51,235,83,103,TRUE,0.353191489361702,2020,2020-2021
MD,2021-04-30,inter-ucfe,0,0,0,0,0,0,0,0,0,2,0,2,0,0,TRUE,0,2020,2020-2021
MD,2021-04-30,inter-ucx,0,0,0,0,0,0,0,0,0,0,0,0,0,0,TRUE,0,2020,2020-2021
MD,2021-04-30,inter-ui,32,20,4,2,1,3,1,5,1,113,51,233,83,103,TRUE,0.356223175965665,2020,2020-2021
MD,2021-04-30,intra-total,1613,920,144,82,45,43,47,53,61,3084,1631,7723,3244,4164,TRUE,0.420044024342872,2020,2020-2021
MD,2021-04-30,intra-ucfe,2,1,0,4,0,0,0,1,0,15,2,25,4,5,TRUE,0.16,2020,2020-2021
MD,2021-04-30,intra-ucx,1,0,0,0,0,0,0,0,0,10,0,11,1,1,TRUE,0.0909090909090909,2020,2020-2021
MD,2021-04-30,intra-ui,1610,919,144,78,45,43,47,52,61,3059,1629,7687,3239,4158,TRUE,0.421360738909848,2020,2020-2021
MD,2021-05-31,inter-total,9,13,3,4,1,4,1,0,2,50,23,110,32,45,TRUE,0.290909090909091,2020,2020-2021
MD,2021-05-31,inter-ucfe,0,0,0,0,0,0,0,0,0,2,0,2,0,0,TRUE,0,2020,2020-2021
MD,2021-05-31,inter-ucx,0,0,0,0,0,0,0,0,0,0,0,0,0,0,TRUE,0,2020,2020-2021
MD,2021-05-31,inter-ui,9,13,3,4,1,4,1,0,2,48,23,108,32,45,TRUE,0.296296296296296,2020,2020-2021
MD,2021-05-31,intra-total,932,790,170,65,78,70,36,49,31,980,1056,4257,1988,2778,TRUE,0.466995536762979,2020,2020-2021
MD,2021-05-31,intra-ucfe,0,1,0,1,0,0,0,0,1,2,2,7,2,3,TRUE,0.285714285714286,2020,2020-2021
MD,2021-05-31,intra-ucx,0,1,0,0,0,0,0,0,0,0,0,1,0,1,TRUE,0,2020,2020-2021
MD,2021-05-31,intra-ui,932,788,170,64,78,70,36,49,30,978,1054,4249,1986,2774,TRUE,0.467404095081196,2020,2020-2021
MD,2021-06-30,inter-total,15,60,9,1,1,2,1,4,0,60,54,207,69,129,TRUE,0.333333333333333,2020,2020-2021
MD,2021-06-30,inter-ucfe,0,0,0,0,0,0,0,0,0,1,0,1,0,0,TRUE,0,2020,2020-2021
MD,2021-06-30,inter-ucx,0,0,0,0,0,0,0,0,0,0,0,0,0,0,TRUE,0,2020,2020-2021
MD,2021-06-30,inter-ui,15,60,9,1,1,2,1,4,0,59,54,206,69,129,TRUE,0.33495145631068,2020,2020-2021
MD,2021-06-30,intra-total,977,2866,797,82,41,36,47,44,60,1456,2635,9041,3612,6478,TRUE,0.399513328171662,2020,2020-2021
MD,2021-06-30,intra-ucfe,1,0,1,4,1,2,1,1,0,13,0,24,1,1,TRUE,0.0416666666666667,2020,2020-2021
MD,2021-06-30,intra-ucx,2,2,0,0,0,0,0,1,3,13,1,22,3,5,TRUE,0.136363636363636,2020,2020-2021
MD,2021-06-30,intra-ui,974,2864,796,78,40,34,46,42,57,1430,2634,8995,3608,6472,TRUE,0.401111728738188,2020,2020-2021
MD,2021-07-31,inter-total,16,14,11,8,3,0,3,4,0,75,34,168,50,64,TRUE,0.297619047619048,2021,2021-2022
MD,2021-07-31,inter-ucfe,0,0,0,0,0,0,0,0,0,1,0,1,0,0,TRUE,0,2021,2021-2022
MD,2021-07-31,inter-ucx,0,0,0,0,0,0,0,0,0,0,0,0,0,0,TRUE,0,2021,2021-2022
MD,2021-07-31,inter-ui,16,14,11,8,3,0,3,4,0,74,34,167,50,64,TRUE,0.29940119760479,2021,2021-2022
MD,2021-07-31,intra-total,733,991,380,159,112,96,75,58,54,1625,995,5278,1728,2719,TRUE,0.327396741189845,2021,2021-2022
MD,2021-07-31,intra-ucfe,2,0,1,0,0,0,0,0,0,9,1,13,3,3,TRUE,0.230769230769231,2021,2021-2022
MD,2021-07-31,intra-ucx,0,1,0,1,5,1,1,5,0,7,3,24,3,4,TRUE,0.125,2021,2021-2022
MD,2021-07-31,intra-ui,731,990,379,158,107,95,74,53,54,1609,991,5241,1722,2712,TRUE,0.328563251287922,2021,2021-2022
MD,2021-08-31,inter-total,20,8,3,8,10,5,7,3,4,84,26,178,46,54,TRUE,0.258426966292135,2021,2021-2022
MD,2021-08-31,inter-ucfe,0,0,0,0,0,0,0,0,0,0,0,0,0,0,TRUE,0,2021,2021-2022
MD,2021-08-31,inter-ucx,0,0,0,0,0,0,0,0,0,0,0,0,0,0,TRUE,0,2021,2021-2022
MD,2021-08-31,inter-ui,20,8,3,8,10,5,7,3,4,84,26,178,46,54,TRUE,0.258426966292135,2021,2021-2022
MD,2021-08-31,intra-total,828,233,287,225,319,125,114,149,133,2091,794,5298,1622,1855,TRUE,0.306153265383164,2021,2021-2022
MD,2021-08-31,intra-ucfe,2,0,0,1,0,0,0,0,1,15,1,20,3,3,TRUE,0.15,2021,2021-2022
MD,2021-08-31,intra-ucx,4,2,2,4,0,2,3,1,0,13,9,40,13,15,TRUE,0.325,2021,2021-2022
MD,2021-08-31,intra-ui,822,231,285,220,319,123,111,148,132,2063,784,5238,1606,1837,TRUE,0.306605574646812,2021,2021-2022
MD,2021-09-30,inter-total,53,6,1,4,3,3,3,3,3,147,24,250,77,83,TRUE,0.308,2021,2021-2022
MD,2021-09-30,inter-ucfe,0,0,0,0,1,0,0,0,0,2,0,3,0,0,TRUE,0,2021,2021-2022
MD,2021-09-30,inter-ucx,0,0,0,0,0,0,0,0,0,0,1,1,1,1,TRUE,1,2021,2021-2022
MD,2021-09-30,inter-ui,53,6,1,4,2,3,3,3,3,145,23,246,76,82,TRUE,0.308943089430894,2021,2021-2022
MD,2021-09-30,intra-total,1191,196,74,77,80,80,68,82,81,1914,584,4427,1775,1971,TRUE,0.400948723740682,2021,2021-2022
MD,2021-09-30,intra-ucfe,14,2,1,0,2,0,0,1,0,16,2,38,16,18,TRUE,0.421052631578947,2021,2021-2022
MD,2021-09-30,intra-ucx,11,0,1,1,0,0,0,2,0,18,0,33,11,11,TRUE,0.333333333333333,2021,2021-2022
MD,2021-09-30,intra-ui,1166,194,72,76,78,80,68,79,81,1880,582,4356,1748,1942,TRUE,0.401285583103765,2021,2021-2022
MD,2021-10-31,inter-total,12,15,10,5,11,9,2,4,4,144,22,238,34,49,TRUE,0.142857142857143,2021,2021-2022
MD,2021-10-31,inter-ucfe,0,0,0,0,0,1,0,0,0,1,0,2,0,0,TRUE,0,2021,2021-2022
MD,2021-10-31,inter-ucx,0,0,0,0,0,0,0,0,0,2,0,2,0,0,TRUE,0,2021,2021-2022
MD,2021-10-31,inter-ui,12,15,10,5,11,8,2,4,4,141,22,234,34,49,TRUE,0.145299145299145,2021,2021-2022
MD,2021-10-31,intra-total,337,348,243,159,128,146,103,80,104,3035,477,5160,814,1162,TRUE,0.157751937984496,2021,2021-2022
MD,2021-10-31,intra-ucfe,8,0,2,0,3,2,1,1,0,20,1,38,9,9,TRUE,0.236842105263158,2021,2021-2022
MD,2021-10-31,intra-ucx,5,2,1,0,3,1,3,1,1,14,2,33,7,9,TRUE,0.212121212121212,2021,2021-2022
MD,2021-10-31,intra-ui,324,346,240,159,122,143,99,78,103,3001,474,5089,798,1144,TRUE,0.156808803301238,2021,2021-2022
MD,2021-11-30,inter-total,16,4,4,5,3,2,2,7,11,174,16,244,32,36,TRUE,0.131147540983607,2021,2021-2022
MD,2021-11-30,inter-ucfe,0,0,0,0,0,0,0,0,0,3,0,3,0,0,TRUE,0,2021,2021-2022
MD,2021-11-30,inter-ucx,1,0,0,0,0,0,0,0,0,2,0,3,1,1,TRUE,0.333333333333333,2021,2021-2022
MD,2021-11-30,inter-ui,15,4,4,5,3,2,2,7,11,169,16,238,31,35,TRUE,0.130252100840336,2021,2021-2022
MD,2021-11-30,intra-total,519,204,126,108,83,89,113,119,107,3005,497,4970,1016,1220,TRUE,0.204426559356137,2021,2021-2022
MD,2021-11-30,intra-ucfe,3,0,0,3,0,2,1,3,2,14,6,34,9,9,TRUE,0.264705882352941,2021,2021-2022
MD,2021-11-30,intra-ucx,4,0,1,0,1,0,1,0,0,10,2,19,6,6,TRUE,0.315789473684211,2021,2021-2022
MD,2021-11-30,intra-ui,512,204,125,105,82,87,111,116,105,2981,489,4917,1001,1205,TRUE,0.203579418344519,2021,2021-2022
MD,2021-12-31,inter-total,20,9,5,4,3,4,3,4,3,161,24,240,44,53,TRUE,0.183333333333333,2021,2021-2022
MD,2021-12-31,inter-ucfe,0,0,0,0,0,0,0,0,0,3,0,3,0,0,TRUE,0,2021,2021-2022
MD,2021-12-31,inter-ucx,0,0,0,0,0,0,0,0,0,0,0,0,0,0,TRUE,0,2021,2021-2022
MD,2021-12-31,inter-ui,20,9,5,4,3,4,3,4,3,158,24,237,44,53,TRUE,0.185654008438819,2021,2021-2022
MD,2021-12-31,intra-total,711,199,115,94,82,72,72,55,77,3145,523,5145,1234,1433,TRUE,0.239844509232264,2021,2021-2022
MD,2021-12-31,intra-ucfe,0,2,2,1,0,0,0,2,1,25,3,36,3,5,TRUE,0.0833333333333333,2021,2021-2022
MD,2021-12-31,intra-ucx,7,1,3,0,0,1,0,0,0,11,0,23,7,8,TRUE,0.304347826086957,2021,2021-2022
MD,2021-12-31,intra-ui,704,196,110,93,82,71,72,53,76,3109,520,5086,1224,1420,TRUE,0.240660637042863,2021,2021-2022
MD,2022-01-31,inter-total,31,12,8,5,6,4,3,2,1,155,23,250,54,66,TRUE,0.216,2021,2021-2022
MD,2022-01-31,inter-ucfe,0,0,0,0,0,0,0,0,0,4,0,4,0,0,TRUE,0,2021,2021-2022
MD,2022-01-31,inter-ucx,0,0,0,0,0,0,1,0,0,0,0,1,0,0,TRUE,0,2021,2021-2022
MD,2022-01-31,inter-ui,31,12,8,5,6,4,2,2,1,151,23,245,54,66,TRUE,0.220408163265306,2021,2021-2022
MD,2022-01-31,intra-total,1838,407,209,129,82,94,87,67,55,3625,1064,7657,2902,3309,TRUE,0.378999608201646,2021,2021-2022
MD,2022-01-31,intra-ucfe,4,2,0,0,0,1,1,0,0,13,2,23,6,8,TRUE,0.260869565217391,2021,2021-2022
MD,2022-01-31,intra-ucx,5,2,0,1,0,0,0,1,0,15,2,26,7,9,TRUE,0.269230769230769,2021,2021-2022
MD,2022-01-31,intra-ui,1829,403,209,128,82,93,86,66,55,3597,1060,7608,2889,3292,TRUE,0.379731861198738,2021,2021-2022
MD,2022-02-28,inter-total,29,13,6,4,5,6,2,5,3,116,26,215,55,68,TRUE,0.255813953488372,2021,2021-2022
MD,2022-02-28,inter-ucfe,0,0,0,0,0,0,0,0,0,6,0,6,0,0,TRUE,0,2021,2021-2022
MD,2022-02-28,inter-ucx,1,0,0,0,0,0,1,0,0,0,0,2,1,1,TRUE,0.5,2021,2021-2022
MD,2022-02-28,inter-ui,28,13,6,4,5,6,1,5,3,110,26,207,54,67,TRUE,0.260869565217391,2021,2021-2022
MD,2022-02-28,intra-total,1036,289,265,217,189,156,115,98,78,2334,774,5551,1810,2099,TRUE,0.326067375247703,2021,2021-2022
MD,2022-02-28,intra-ucfe,5,1,4,4,1,2,1,2,0,48,5,73,10,11,TRUE,0.136986301369863,2021,2021-2022
MD,2022-02-28,intra-ucx,8,3,2,0,0,0,1,1,1,10,1,27,9,12,TRUE,0.333333333333333,2021,2021-2022
MD,2022-02-28,intra-ui,1023,285,259,213,188,154,113,95,77,2276,768,5451,1791,2076,TRUE,0.328563566318107,2021,2021-2022
MD,2022-03-31,inter-total,9,6,4,6,4,5,5,7,6,87,13,152,22,28,TRUE,0.144736842105263,2021,2021-2022
MD,2022-03-31,inter-ucfe,0,0,0,0,0,0,0,0,0,3,0,3,0,0,TRUE,0,2021,2021-2022
MD,2022-03-31,inter-ucx,0,0,0,0,0,0,0,0,0,0,0,0,0,0,TRUE,0,2021,2021-2022
MD,2022-03-31,inter-ui,9,6,4,6,4,5,5,7,6,84,13,149,22,28,TRUE,0.147651006711409,2021,2021-2022
MD,2022-03-31,intra-total,377,322,173,114,118,116,111,169,111,1331,421,3363,798,1120,TRUE,0.23728813559322,2021,2021-2022
MD,2022-03-31,intra-ucfe,0,3,0,0,1,1,1,0,0,11,2,19,2,5,TRUE,0.105263157894737,2021,2021-2022
MD,2022-03-31,intra-ucx,4,3,0,1,0,0,1,1,0,7,1,18,5,8,TRUE,0.277777777777778,2021,2021-2022
MD,2022-03-31,intra-ui,373,316,173,113,117,115,109,168,111,1313,418,3326,791,1107,TRUE,0.237823211064342,2021,2021-2022
MD,2022-04-30,inter-total,21,12,2,3,2,0,2,4,2,44,23,115,44,56,TRUE,0.382608695652174,2021,2021-2022
MD,2022-04-30,inter-ucfe,0,0,0,0,0,0,1,0,0,2,0,3,0,0,TRUE,0,2021,2021-2022
MD,2022-04-30,inter-ucx,0,0,0,0,0,0,0,0,0,0,0,0,0,0,TRUE,0,2021,2021-2022
MD,2022-04-30,inter-ui,21,12,2,3,2,0,1,4,2,42,23,112,44,56,TRUE,0.392857142857143,2021,2021-2022
MD,2022-04-30,intra-total,399,389,118,71,58,41,42,30,29,929,424,2530,823,1212,TRUE,0.325296442687747,2021,2021-2022
MD,2022-04-30,intra-ucfe,3,1,0,1,0,1,1,1,0,13,0,21,3,4,TRUE,0.142857142857143,2021,2021-2022
MD,2022-04-30,intra-ucx,4,0,1,1,0,0,1,0,0,8,1,16,5,5,TRUE,0.3125,2021,2021-2022
MD,2022-04-30,intra-ui,392,388,117,69,58,40,40,29,29,908,423,2493,815,1203,TRUE,0.326915363016446,2021,2021-2022
MD,2022-05-31,inter-total,13,16,3,4,3,1,1,4,1,69,20,135,33,49,TRUE,0.244444444444444,2021,2021-2022
MD,2022-05-31,inter-ucfe,0,0,0,0,0,0,0,0,0,5,0,5,0,0,TRUE,0,2021,2021-2022
MD,2022-05-31,inter-ucx,0,0,0,0,0,0,0,0,0,0,0,0,0,0,TRUE,0,2021,2021-2022
MD,2022-05-31,inter-ui,13,16,3,4,3,1,1,4,1,64,20,130,33,49,TRUE,0.253846153846154,2021,2021-2022
MD,2022-05-31,intra-total,307,415,244,94,57,55,58,53,55,1560,404,3302,711,1126,TRUE,0.215324046032707,2021,2021-2022
MD,2022-05-31,intra-ucfe,2,4,3,0,1,1,1,0,1,27,3,43,5,9,TRUE,0.116279069767442,2021,2021-2022
MD,2022-05-31,intra-ucx,3,1,3,1,0,3,0,1,0,5,1,18,4,5,TRUE,0.222222222222222,2021,2021-2022
MD,2022-05-31,intra-ui,302,410,238,93,56,51,57,52,54,1528,400,3241,702,1112,TRUE,0.216599814871953,2021,2021-2022
MD,2022-06-30,inter-total,13,19,6,5,3,4,1,5,2,48,18,124,31,50,TRUE,0.25,2021,2021-2022
MD,2022-06-30,inter-ucfe,0,1,1,0,0,1,0,0,0,0,1,4,1,2,TRUE,0.25,2021,2021-2022
MD,2022-06-30,inter-ucx,0,0,0,0,0,0,0,0,0,0,0,0,0,0,TRUE,0,2021,2021-2022
MD,2022-06-30,inter-ui,13,18,5,5,3,3,1,5,2,48,17,120,30,48,TRUE,0.25,2021,2021-2022
MD,2022-06-30,intra-total,664,595,171,107,56,57,43,58,42,997,701,3491,1365,1960,TRUE,0.3910054425666,2021,2021-2022
MD,2022-06-30,intra-ucfe,11,9,1,0,1,0,1,1,0,13,17,54,28,37,TRUE,0.518518518518519,2021,2021-2022
MD,2022-06-30,intra-ucx,3,1,0,0,0,0,0,0,0,4,0,8,3,4,TRUE,0.375,2021,2021-2022
MD,2022-06-30,intra-ui,650,585,170,107,55,57,42,57,42,980,684,3429,1334,1919,TRUE,0.389034703995334,2021,2021-2022
MD,2022-07-31,inter-total,16,21,6,7,3,1,4,0,1,50,39,148,55,76,TRUE,0.371621621621622,2022,2022-2023
MD,2022-07-31,inter-ucfe,0,0,0,0,0,0,0,0,1,1,0,2,0,0,TRUE,0,2022,2022-2023
MD,2022-07-31,inter-ucx,0,0,0,0,0,0,0,0,0,1,0,1,0,0,TRUE,0,2022,2022-2023
MD,2022-07-31,inter-ui,16,21,6,7,3,1,4,0,0,48,39,145,55,76,TRUE,0.379310344827586,2022,2022-2023
MD,2022-07-31,intra-total,812,540,190,107,62,52,39,29,46,737,1179,3793,1991,2531,TRUE,0.524914315844978,2022,2022-2023
MD,2022-07-31,intra-ucfe,1,1,2,2,1,3,0,0,0,12,1,23,2,3,TRUE,0.0869565217391304,2022,2022-2023
MD,2022-07-31,intra-ucx,7,1,1,1,1,0,1,1,0,5,1,19,8,9,TRUE,0.421052631578947,2022,2022-2023
MD,2022-07-31,intra-ui,804,538,187,104,60,49,38,28,46,720,1177,3751,1981,2519,TRUE,0.52812583311117,2022,2022-2023
MD,2022-08-31,inter-total,35,14,7,8,1,2,5,5,0,56,21,154,56,70,TRUE,0.363636363636364,2022,2022-2023
MD,2022-08-31,inter-ucfe,0,0,0,0,0,0,0,0,0,3,0,3,0,0,TRUE,0,2022,2022-2023
MD,2022-08-31,inter-ucx,1,0,0,0,0,0,0,0,0,0,1,2,2,2,TRUE,1,2022,2022-2023
MD,2022-08-31,inter-ui,34,14,7,8,1,2,5,5,0,53,20,149,54,68,TRUE,0.36241610738255,2022,2022-2023
MD,2022-08-31,intra-total,787,535,189,137,98,95,75,52,47,817,824,3656,1611,2146,TRUE,0.440645514223195,2022,2022-2023
MD,2022-08-31,intra-ucfe,2,1,0,0,0,0,0,1,0,12,0,16,2,3,TRUE,0.125,2022,2022-2023
MD,2022-08-31,intra-ucx,2,1,1,0,3,0,0,1,0,7,0,15,2,3,TRUE,0.133333333333333,2022,2022-2023
MD,2022-08-31,intra-ui,783,533,188,137,95,95,75,50,47,798,824,3625,1607,2140,TRUE,0.443310344827586,2022,2022-2023
MD,2022-09-30,inter-total,17,9,11,6,2,3,4,1,4,58,29,144,46,55,TRUE,0.319444444444444,2022,2022-2023
MD,2022-09-30,inter-ucfe,0,0,0,0,0,0,0,0,1,1,0,2,0,0,TRUE,0,2022,2022-2023
MD,2022-09-30,inter-ucx,0,0,0,0,0,0,0,0,0,0,0,0,0,0,TRUE,0,2022,2022-2023
MD,2022-09-30,inter-ui,17,9,11,6,2,3,4,1,3,57,29,142,46,55,TRUE,0.323943661971831,2022,2022-2023
MD,2022-09-30,intra-total,470,330,120,87,84,74,78,57,65,895,637,2897,1107,1437,TRUE,0.382119433897135,2022,2022-2023
MD,2022-09-30,intra-ucfe,0,0,1,1,0,2,1,2,1,12,1,21,1,1,TRUE,0.0476190476190476,2022,2022-2023
MD,2022-09-30,intra-ucx,3,0,0,0,1,0,0,0,0,4,0,8,3,3,TRUE,0.375,2022,2022-2023
MD,2022-09-30,intra-ui,467,330,119,86,83,72,77,55,64,879,636,2868,1103,1433,TRUE,0.384588563458856,2022,2022-2023
MD,2022-10-31,inter-total,24,15,5,6,3,4,5,7,4,85,23,181,47,62,TRUE,0.259668508287293,2022,2022-2023
MD,2022-10-31,inter-ucfe,1,0,0,0,0,0,0,0,0,0,0,1,1,1,TRUE,1,2022,2022-2023
MD,2022-10-31,inter-ucx,0,0,0,0,0,0,0,0,0,0,1,1,1,1,TRUE,1,2022,2022-2023
MD,2022-10-31,inter-ui,23,15,5,6,3,4,5,7,4,85,22,179,45,60,TRUE,0.251396648044693,2022,2022-2023
MD,2022-10-31,intra-total,654,394,142,97,77,66,64,62,67,1217,626,3466,1280,1674,TRUE,0.36930178880554,2022,2022-2023
MD,2022-10-31,intra-ucfe,1,2,1,0,1,1,1,1,1,20,3,32,4,6,TRUE,0.125,2022,2022-2023
MD,2022-10-31,intra-ucx,4,0,3,0,1,1,0,0,0,4,2,15,6,6,TRUE,0.4,2022,2022-2023
MD,2022-10-31,intra-ui,649,392,138,97,75,64,63,61,66,1193,621,3419,1270,1662,TRUE,0.371453641415619,2022,2022-2023
MD,2022-11-30,inter-total,23,11,9,9,5,6,9,5,1,110,41,229,64,75,TRUE,0.279475982532751,2022,2022-2023
MD,2022-11-30,inter-ucfe,0,0,1,0,0,0,0,0,0,1,0,2,0,0,TRUE,0,2022,2022-2023
MD,2022-11-30,inter-ucx,0,0,0,0,0,0,0,0,0,0,0,0,0,0,TRUE,0,2022,2022-2023
MD,2022-11-30,inter-ui,23,11,8,9,5,6,9,5,1,109,41,227,64,75,TRUE,0.281938325991189,2022,2022-2023
MD,2022-11-30,intra-total,896,499,298,217,145,131,152,112,106,1912,1077,5545,1973,2472,TRUE,0.355816050495942,2022,2022-2023
MD,2022-11-30,intra-ucfe,2,5,2,1,1,0,1,0,2,19,0,33,2,7,TRUE,0.0606060606060606,2022,2022-2023
MD,2022-11-30,intra-ucx,8,1,2,2,2,1,0,0,1,6,1,24,9,10,TRUE,0.375,2022,2022-2023
MD,2022-11-30,intra-ui,886,493,294,214,142,130,151,112,103,1887,1076,5488,1962,2455,TRUE,0.357507288629738,2022,2022-2023
MD,2022-12-31,inter-total,42,18,14,5,11,6,5,6,2,56,39,204,81,99,TRUE,0.397058823529412,2022,2022-2023
MD,2022-12-31,inter-ucfe,0,1,0,0,0,1,0,0,0,2,0,4,0,1,TRUE,0,2022,2022-2023
MD,2022-12-31,inter-ucx,0,0,0,0,0,0,0,0,0,0,0,0,0,0,TRUE,0,2022,2022-2023
MD,2022-12-31,inter-ui,42,17,14,5,11,5,5,6,2,54,39,200,81,98,TRUE,0.405,2022,2022-2023
MD,2022-12-31,intra-total,1520,453,336,254,176,124,82,80,56,1137,1106,5324,2626,3079,TRUE,0.493238166791886,2022,2022-2023
MD,2022-12-31,intra-ucfe,2,2,2,0,1,1,2,0,0,13,1,24,3,5,TRUE,0.125,2022,2022-2023
MD,2022-12-31,intra-ucx,11,1,1,1,0,2,1,0,0,5,2,24,13,14,TRUE,0.541666666666667,2022,2022-2023
MD,2022-12-31,intra-ui,1507,450,333,253,175,121,79,80,56,1119,1103,5276,2610,3060,TRUE,0.494692949203942,2022,2022-2023
MD,2023-01-31,inter-total,36,23,19,10,2,7,4,3,0,50,27,181,63,86,TRUE,0.348066298342541,2022,2022-2023
MD,2023-01-31,inter-ucfe,0,0,0,0,0,0,0,0,0,3,0,3,0,0,TRUE,0,2022,2022-2023
MD,2023-01-31,inter-ucx,0,0,0,0,0,0,0,0,0,2,0,2,0,0,TRUE,0,2022,2022-2023
MD,2023-01-31,inter-ui,36,23,19,10,2,7,4,3,0,45,27,176,63,86,TRUE,0.357954545454545,2022,2022-2023
MD,2023-01-31,intra-total,2148,801,359,210,107,94,72,51,42,1103,1497,6484,3645,4446,TRUE,0.562152991980259,2022,2022-2023
MD,2023-01-31,intra-ucfe,3,2,0,0,1,0,2,0,0,18,0,26,3,5,TRUE,0.115384615384615,2022,2022-2023
MD,2023-01-31,intra-ucx,7,0,1,1,1,0,0,1,0,15,2,28,9,9,TRUE,0.321428571428571,2022,2022-2023
MD,2023-01-31,intra-ui,2138,799,358,209,105,94,70,50,42,1070,1495,6430,3633,4432,TRUE,0.565007776049767,2022,2022-2023
MD,2023-02-28,inter-total,23,19,12,7,5,5,2,3,3,69,28,176,51,70,TRUE,0.289772727272727,2022,2022-2023
MD,2023-02-28,inter-ucfe,0,0,0,0,0,0,0,0,0,0,0,0,0,0,TRUE,0,2022,2022-2023
MD,2023-02-28,inter-ucx,1,1,0,0,0,0,0,0,0,1,0,3,1,2,TRUE,0.333333333333333,2022,2022-2023
MD,2023-02-28,inter-ui,22,18,12,7,5,5,2,3,3,68,28,173,50,68,TRUE,0.289017341040462,2022,2022-2023
MD,2023-02-28,intra-total,796,595,386,233,143,82,73,57,54,1273,1159,4851,1955,2550,TRUE,0.403009688723974,2022,2022-2023
MD,2023-02-28,intra-ucfe,0,1,0,2,0,0,1,2,0,13,3,22,3,4,TRUE,0.136363636363636,2022,2022-2023
MD,2023-02-28,intra-ucx,3,1,1,1,0,0,0,0,0,5,2,13,5,6,TRUE,0.384615384615385,2022,2022-2023
MD,2023-02-28,intra-ui,793,593,385,230,143,82,72,55,54,1255,1154,4816,1947,2540,TRUE,0.404277408637874,2022,2022-2023
MD,2023-03-31,inter-total,28,12,16,7,7,3,5,4,5,53,31,171,59,71,TRUE,0.345029239766082,2022,2022-2023
MD,2023-03-31,inter-ucfe,0,0,0,0,0,0,0,0,0,2,0,2,0,0,TRUE,0,2022,2022-2023
MD,2023-03-31,inter-ucx,0,0,0,0,0,0,0,0,0,0,0,0,0,0,TRUE,0,2022,2022-2023
MD,2023-03-31,inter-ui,28,12,16,7,7,3,5,4,5,51,31,169,59,71,TRUE,0.349112426035503,2022,2022-2023
MD,2023-03-31,intra-total,793,570,324,170,128,111,97,83,75,716,1029,4096,1822,2392,TRUE,0.44482421875,2022,2022-2023
MD,2023-03-31,intra-ucfe,0,2,1,1,1,0,0,0,1,9,0,15,0,2,TRUE,0,2022,2022-2023
MD,2023-03-31,intra-ucx,3,1,1,1,0,0,0,1,0,2,2,11,5,6,TRUE,0.454545454545455,2022,2022-2023
MD,2023-03-31,intra-ui,790,567,322,168,127,111,97,82,74,705,1027,4070,1817,2384,TRUE,0.446437346437346,2022,2022-2023
MD,2023-04-30,inter-total,25,12,6,4,1,1,2,0,1,30,26,108,51,63,TRUE,0.472222222222222,2022,2022-2023
MD,2023-04-30,inter-ucfe,0,0,0,0,0,0,0,0,0,2,0,2,0,0,TRUE,0,2022,2022-2023
MD,2023-04-30,inter-ucx,0,0,0,0,0,0,0,0,0,0,0,0,0,0,TRUE,0,2022,2022-2023
MD,2023-04-30,inter-ui,25,12,6,4,1,1,2,0,1,28,26,106,51,63,TRUE,0.481132075471698,2022,2022-2023
MD,2023-04-30,intra-total,895,505,137,94,46,42,42,31,41,407,857,3097,1752,2257,TRUE,0.565708750403617,2022,2022-2023
MD,2023-04-30,intra-ucfe,1,4,0,0,0,0,0,0,0,6,1,12,2,6,TRUE,0.166666666666667,2022,2022-2023
MD,2023-04-30,intra-ucx,3,2,1,0,1,0,1,0,0,4,1,13,4,6,TRUE,0.307692307692308,2022,2022-2023
MD,2023-04-30,intra-ui,891,499,136,94,45,42,41,31,41,397,855,3072,1746,2245,TRUE,0.568359375,2022,2022-2023
MD,2023-05-31,inter-total,29,22,9,4,0,1,1,0,1,25,33,125,62,84,TRUE,0.496,2022,2022-2023
MD,2023-05-31,inter-ucfe,0,0,0,0,0,0,0,0,0,0,0,0,0,0,TRUE,0,2022,2022-2023
MD,2023-05-31,inter-ucx,0,0,0,0,0,0,0,0,0,0,0,0,0,0,TRUE,0,2022,2022-2023
MD,2023-05-31,inter-ui,29,22,9,4,0,1,1,0,1,25,33,125,62,84,TRUE,0.496,2022,2022-2023
MD,2023-05-31,intra-total,781,729,209,85,41,38,32,22,19,520,910,3386,1691,2420,TRUE,0.499409332545777,2022,2022-2023
MD,2023-05-31,intra-ucfe,2,3,0,1,1,1,1,0,0,7,4,20,6,9,TRUE,0.3,2022,2022-2023
MD,2023-05-31,intra-ucx,12,1,0,0,0,0,0,0,0,6,2,21,14,15,TRUE,0.666666666666667,2022,2022-2023
MD,2023-05-31,intra-ui,767,725,209,84,40,37,31,22,19,507,904,3345,1671,2396,TRUE,0.499551569506726,2022,2022-2023
MD,2023-06-30,inter-total,32,23,9,3,1,1,1,0,3,18,46,137,78,101,TRUE,0.569343065693431,2022,2022-2023
MD,2023-06-30,inter-ucfe,0,0,0,0,0,0,0,0,0,1,0,1,0,0,TRUE,0,2022,2022-2023
MD,2023-06-30,inter-ucx,0,0,0,0,0,0,0,0,0,0,0,0,0,0,TRUE,0,2022,2022-2023
MD,2023-06-30,inter-ui,32,23,9,3,1,1,1,0,3,17,46,136,78,101,TRUE,0.573529411764706,2022,2022-2023
MD,2023-06-30,intra-total,1289,675,181,54,59,41,34,26,22,416,1090,3887,2379,3054,TRUE,0.612040133779264,2022,2022-2023
MD,2023-06-30,intra-ucfe,2,2,1,0,0,0,0,1,0,6,2,14,4,6,TRUE,0.285714285714286,2022,2022-2023
MD,2023-06-30,intra-ucx,14,0,0,1,1,0,0,0,0,2,5,23,19,19,TRUE,0.826086956521739,2022,2022-2023
MD,2023-06-30,intra-ui,1273,673,180,53,58,41,34,25,22,408,1083,3850,2356,3029,TRUE,0.611948051948052,2022,2022-2023
MD,2023-07-31,inter-total,49,28,6,5,4,2,5,1,1,19,42,162,91,119,TRUE,0.561728395061729,2023,2023-2024
MD,2023-07-31,inter-ucfe,0,0,0,0,0,0,1,0,0,1,0,2,0,0,TRUE,0,2023,2023-2024
MD,2023-07-31,inter-ucx,0,0,0,0,0,0,0,0,0,0,0,0,0,0,TRUE,0,2023,2023-2024
MD,2023-07-31,inter-ui,49,28,6,5,4,2,4,1,1,18,42,160,91,119,TRUE,0.56875,2023,2023-2024
MD,2023-07-31,intra-total,1371,854,295,128,49,43,36,39,30,470,1029,4344,2400,3254,TRUE,0.552486187845304,2023,2023-2024
MD,2023-07-31,intra-ucfe,1,2,0,0,0,0,0,1,1,9,3,17,4,6,TRUE,0.235294117647059,2023,2023-2024
MD,2023-07-31,intra-ucx,9,2,1,1,0,0,0,2,0,3,2,20,11,13,TRUE,0.55,2023,2023-2024
MD,2023-07-31,intra-ui,1361,850,294,127,49,43,36,36,29,458,1024,4307,2385,3235,TRUE,0.553749709774785,2023,2023-2024
MD,2023-08-31,inter-total,12,27,3,8,2,3,2,0,1,39,40,137,52,79,TRUE,0.37956204379562,2023,2023-2024
MD,2023-08-31,inter-ucfe,0,0,0,0,0,0,0,0,0,0,0,0,0,0,TRUE,0,2023,2023-2024
MD,2023-08-31,inter-ucx,0,0,0,0,0,0,0,0,0,0,0,0,0,0,TRUE,0,2023,2023-2024
MD,2023-08-31,inter-ui,12,27,3,8,2,3,2,0,1,39,40,137,52,79,TRUE,0.37956204379562,2023,2023-2024
MD,2023-08-31,intra-total,978,826,305,103,72,53,55,47,31,917,990,4377,1968,2794,TRUE,0.449623029472241,2023,2023-2024
MD,2023-08-31,intra-ucfe,1,2,0,1,1,0,0,0,1,9,2,17,3,5,TRUE,0.176470588235294,2023,2023-2024
MD,2023-08-31,intra-ucx,5,3,1,1,0,0,0,0,0,2,4,16,9,12,TRUE,0.5625,2023,2023-2024
MD,2023-08-31,intra-ui,972,821,304,101,71,53,55,47,30,906,984,4344,1956,2777,TRUE,0.450276243093923,2023,2023-2024
MD,2023-09-30,inter-total,14,23,11,4,2,1,3,4,2,33,22,119,36,59,TRUE,0.302521008403361,2023,2023-2024
MD,2023-09-30,inter-ucfe,0,0,0,0,0,0,0,0,0,0,0,0,0,0,TRUE,0,2023,2023-2024
MD,2023-09-30,inter-ucx,0,0,0,0,0,0,0,0,0,0,0,0,0,0,TRUE,0,2023,2023-2024
MD,2023-09-30,inter-ui,14,23,11,4,2,1,3,4,2,33,22,119,36,59,TRUE,0.302521008403361,2023,2023-2024
MD,2023-09-30,intra-total,552,863,247,116,64,51,61,46,36,600,691,3327,1243,2106,TRUE,0.37360985873159,2023,2023-2024
MD,2023-09-30,intra-ucfe,0,2,2,0,0,0,0,2,0,11,1,18,1,3,TRUE,0.0555555555555556,2023,2023-2024
MD,2023-09-30,intra-ucx,9,3,1,0,0,0,0,0,0,6,6,25,15,18,TRUE,0.6,2023,2023-2024
MD,2023-09-30,intra-ui,543,858,244,116,64,51,61,44,36,583,684,3284,1227,2085,TRUE,0.373629719853837,2023,2023-2024
MD,2023-10-31,inter-total,19,26,11,5,4,3,3,2,4,34,29,140,48,74,TRUE,0.342857142857143,2023,2023-2024
MD,2023-10-31,inter-ucfe,0,0,0,0,0,0,0,0,0,0,0,0,0,0,TRUE,0,2023,2023-2024
MD,2023-10-31,inter-ucx,0,0,0,0,0,0,0,0,0,0,1,1,1,1,TRUE,1,2023,2023-2024
MD,2023-10-31,inter-ui,19,26,11,5,4,3,3,2,4,34,28,139,47,73,TRUE,0.338129496402878,2023,2023-2024
MD,2023-10-31,intra-total,684,871,278,91,53,49,53,57,54,933,797,3920,1481,2352,TRUE,0.37780612244898,2023,2023-2024
MD,2023-10-31,intra-ucfe,1,1,1,3,1,0,3,0,0,10,0,20,1,2,TRUE,0.05,2023,2023-2024
MD,2023-10-31,intra-ucx,9,0,2,0,0,1,0,0,0,1,6,19,15,15,TRUE,0.789473684210526,2023,2023-2024
MD,2023-10-31,intra-ui,674,870,275,88,52,48,50,57,54,922,791,3881,1465,2335,TRUE,0.377480030919866,2023,2023-2024
MD,2023-11-30,inter-total,11,18,11,7,5,2,5,2,3,39,28,131,39,57,TRUE,0.297709923664122,2023,2023-2024
MD,2023-11-30,inter-ucfe,0,0,1,0,0,0,0,0,0,1,0,2,0,0,TRUE,0,2023,2023-2024
MD,2023-11-30,inter-ucx,0,0,0,0,0,0,0,0,0,1,0,1,0,0,TRUE,0,2023,2023-2024
MD,2023-11-30,inter-ui,11,18,10,7,5,2,5,2,3,37,28,128,39,57,TRUE,0.3046875,2023,2023-2024
MD,2023-11-30,intra-total,769,807,326,82,50,55,40,37,32,841,960,3999,1729,2536,TRUE,0.432358089522381,2023,2023-2024
MD,2023-11-30,intra-ucfe,0,2,0,1,0,1,0,0,1,5,0,10,0,2,TRUE,0,2023,2023-2024
MD,2023-11-30,intra-ucx,5,4,4,0,0,0,0,1,1,0,4,19,9,13,TRUE,0.473684210526316,2023,2023-2024
MD,2023-11-30,intra-ui,764,801,322,81,50,54,40,36,30,836,956,3970,1720,2521,TRUE,0.433249370277078,2023,2023-2024
MD,2023-12-31,inter-total,27,28,18,1,2,0,3,2,4,45,34,164,61,89,TRUE,0.371951219512195,2023,2023-2024
MD,2023-12-31,inter-ucfe,0,0,0,0,0,0,0,0,0,0,0,0,0,0,TRUE,0,2023,2023-2024
MD,2023-12-31,inter-ucx,0,0,0,0,0,0,0,0,0,0,1,1,1,1,TRUE,1,2023,2023-2024
MD,2023-12-31,inter-ui,27,28,18,1,2,0,3,2,4,45,33,163,60,88,TRUE,0.368098159509202,2023,2023-2024
MD,2023-12-31,intra-total,1070,860,307,105,71,54,55,52,43,832,833,4282,1903,2763,TRUE,0.444418496029893,2023,2023-2024
MD,2023-12-31,intra-ucfe,1,2,1,2,0,0,3,2,1,4,2,18,3,5,TRUE,0.166666666666667,2023,2023-2024
MD,2023-12-31,intra-ucx,7,3,1,0,0,0,0,0,0,1,2,14,9,12,TRUE,0.642857142857143,2023,2023-2024
MD,2023-12-31,intra-ui,1062,855,305,103,71,54,52,50,42,827,829,4250,1891,2746,TRUE,0.444941176470588,2023,2023-2024
MD,2024-01-31,inter-total,25,37,12,12,5,1,1,2,3,40,34,172,59,96,TRUE,0.343023255813954,2023,2023-2024
MD,2024-01-31,inter-ucfe,0,0,0,0,0,0,0,0,0,0,0,0,0,0,TRUE,0,2023,2023-2024
MD,2024-01-31,inter-ucx,1,0,0,0,0,0,0,0,0,0,0,1,1,1,TRUE,1,2023,2023-2024
MD,2024-01-31,inter-ui,24,37,12,12,5,1,1,2,3,40,34,171,58,95,TRUE,0.339181286549708,2023,2023-2024
MD,2024-01-31,intra-total,2307,1047,386,149,91,71,55,46,38,891,1498,6579,3805,4852,TRUE,0.578355373157015,2023,2023-2024
MD,2024-01-31,intra-ucfe,0,1,0,0,0,2,1,0,2,17,1,24,1,2,TRUE,0.0416666666666667,2023,2023-2024
MD,2024-01-31,intra-ucx,9,4,2,0,0,0,0,0,0,3,1,19,10,14,TRUE,0.526315789473684,2023,2023-2024
MD,2024-01-31,intra-ui,2298,1042,384,149,91,69,54,46,36,871,1496,6536,3794,4836,TRUE,0.580477356181151,2023,2023-2024
MD,2024-02-29,inter-total,25,24,14,4,2,2,4,2,3,42,18,140,43,67,TRUE,0.307142857142857,2023,2023-2024
MD,2024-02-29,inter-ucfe,0,0,0,0,0,0,0,0,0,0,0,0,0,0,TRUE,0,2023,2023-2024
MD,2024-02-29,inter-ucx,0,0,0,0,0,0,0,0,0,1,0,1,0,0,TRUE,0,2023,2023-2024
MD,2024-02-29,inter-ui,25,24,14,4,2,2,4,2,3,41,18,139,43,67,TRUE,0.309352517985612,2023,2023-2024
MD,2024-02-29,intra-total,1173,900,353,155,95,69,55,40,50,887,998,4775,2171,3071,TRUE,0.454659685863874,2023,2023-2024
MD,2024-02-29,intra-ucfe,1,2,0,2,1,0,0,0,0,5,2,13,3,5,TRUE,0.230769230769231,2023,2023-2024
MD,2024-02-29,intra-ucx,13,2,1,1,0,0,0,0,0,3,3,23,16,18,TRUE,0.695652173913044,2023,2023-2024
MD,2024-02-29,intra-ui,1159,896,352,152,94,69,55,40,50,879,993,4739,2152,3048,TRUE,0.45410424140114,2023,2023-2024
MD,2024-03-31,inter-total,18,28,14,6,5,1,2,3,3,51,26,157,44,72,TRUE,0.280254777070064,2023,2023-2024
MD,2024-03-31,inter-ucfe,0,0,1,0,0,0,0,0,0,0,0,1,0,0,TRUE,0,2023,2023-2024
MD,2024-03-31,inter-ucx,0,0,0,0,0,0,0,0,0,2,0,2,0,0,TRUE,0,2023,2023-2024
MD,2024-03-31,inter-ui,18,28,13,6,5,1,2,3,3,49,26,154,44,72,TRUE,0.285714285714286,2023,2023-2024
MD,2024-03-31,intra-total,608,809,387,162,89,67,71,49,38,890,673,3843,1281,2090,TRUE,0.333333333333333,2023,2023-2024
MD,2024-03-31,intra-ucfe,1,2,0,1,0,0,0,0,0,7,2,13,3,5,TRUE,0.230769230769231,2023,2023-2024
MD,2024-03-31,intra-ucx,3,0,1,0,0,0,0,0,0,4,4,12,7,7,TRUE,0.583333333333333,2023,2023-2024
MD,2024-03-31,intra-ui,604,807,386,161,89,67,71,49,38,879,667,3818,1271,2078,TRUE,0.332896804609743,2023,2023-2024
MD,2024-04-30,inter-total,30,29,14,7,3,0,2,4,3,40,22,154,52,81,TRUE,0.337662337662338,2023,2023-2024
MD,2024-04-30,inter-ucfe,0,0,0,0,0,0,0,0,0,2,0,2,0,0,TRUE,0,2023,2023-2024
MD,2024-04-30,inter-ucx,0,0,0,0,0,0,0,0,0,0,0,0,0,0,TRUE,0,2023,2023-2024
MD,2024-04-30,inter-ui,30,29,14,7,3,0,2,4,3,38,22,152,52,81,TRUE,0.342105263157895,2023,2023-2024
MD,2024-04-30,intra-total,1038,858,462,152,98,59,54,52,49,1009,1224,5055,2262,3120,TRUE,0.447477744807122,2023,2023-2024
MD,2024-04-30,intra-ucfe,0,1,4,1,2,2,2,0,0,9,2,23,2,3,TRUE,0.0869565217391304,2023,2023-2024
MD,2024-04-30,intra-ucx,10,2,2,1,1,0,0,0,0,2,6,24,16,18,TRUE,0.666666666666667,2023,2023-2024
MD,2024-04-30,intra-ui,1028,855,456,150,95,57,52,52,49,998,1216,5008,2244,3099,TRUE,0.448083067092652,2023,2023-2024
MD,2024-05-31,inter-total,20,29,6,5,3,4,2,1,1,42,31,144,51,80,TRUE,0.354166666666667,2023,2023-2024
MD,2024-05-31,inter-ucfe,0,0,0,0,0,0,0,0,0,1,0,1,0,0,TRUE,0,2023,2023-2024
MD,2024-05-31,inter-ucx,0,0,0,0,0,0,0,0,0,0,0,0,0,0,TRUE,0,2023,2023-2024
MD,2024-05-31,inter-ui,20,29,6,5,3,4,2,1,1,41,31,143,51,80,TRUE,0.356643356643357,2023,2023-2024
MD,2024-05-31,intra-total,757,874,332,136,78,66,49,64,47,926,865,4194,1622,2496,TRUE,0.386742966142108,2023,2023-2024
MD,2024-05-31,intra-ucfe,2,1,2,0,1,1,0,1,0,11,0,19,2,3,TRUE,0.105263157894737,2023,2023-2024
MD,2024-05-31,intra-ucx,6,2,1,2,0,0,0,0,0,5,3,19,9,11,TRUE,0.473684210526316,2023,2023-2024
MD,2024-05-31,intra-ui,749,871,329,134,77,65,49,63,47,910,862,4156,1611,2482,TRUE,0.387632338787296,2023,2023-2024
MD,2024-06-30,inter-total,24,32,6,2,3,2,3,2,1,38,24,137,48,80,TRUE,0.35036496350365,2023,2023-2024
MD,2024-06-30,inter-ucfe,0,0,0,0,0,0,0,0,0,0,0,0,0,0,TRUE,0,2023,2023-2024
MD,2024-06-30,inter-ucx,0,0,0,0,0,0,0,0,0,0,0,0,0,0,TRUE,0,2023,2023-2024
MD,2024-06-30,inter-ui,24,32,6,2,3,2,3,2,1,38,24,137,48,80,TRUE,0.35036496350365,2023,2023-2024
MD,2024-06-30,intra-total,1330,811,259,104,53,63,57,46,77,801,871,4472,2201,3012,TRUE,0.492173524150268,2023,2023-2024
MD,2024-06-30,intra-ucfe,2,0,0,1,0,0,1,0,1,7,1,13,3,3,TRUE,0.230769230769231,2023,2023-2024
MD,2024-06-30,intra-ucx,8,2,0,1,0,1,0,0,1,2,5,20,13,15,TRUE,0.65,2023,2023-2024
MD,2024-06-30,intra-ui,1320,809,259,102,53,62,56,46,75,792,865,4439,2185,2994,TRUE,0.492227979274611,2023,2023-2024
MD,2024-07-31,inter-total,28,36,11,5,9,2,4,4,1,40,45,185,73,109,TRUE,0.394594594594595,2024,2024-2025
MD,2024-07-31,inter-ucfe,0,0,0,0,1,0,0,0,1,2,0,4,0,0,TRUE,0,2024,2024-2025
MD,2024-07-31,inter-ucx,0,0,0,0,0,0,0,0,0,0,0,0,0,0,TRUE,0,2024,2024-2025
MD,2024-07-31,inter-ui,28,36,11,5,8,2,4,4,0,38,45,181,73,109,TRUE,0.403314917127072,2024,2024-2025
MD,2024-07-31,intra-total,1355,1119,356,197,129,99,92,57,53,880,1300,5637,2655,3774,TRUE,0.470995210218201,2024,2024-2025
MD,2024-07-31,intra-ucfe,1,0,0,0,1,2,1,0,2,16,3,26,4,4,TRUE,0.153846153846154,2024,2024-2025
MD,2024-07-31,intra-ucx,8,2,0,0,0,1,0,1,0,3,8,23,16,18,TRUE,0.695652173913044,2024,2024-2025
MD,2024-07-31,intra-ui,1346,1117,356,197,128,96,91,56,51,861,1289,5588,2635,3752,TRUE,0.471546170365068,2024,2024-2025
MD,2024-08-31,inter-total,19,23,15,6,6,4,4,5,3,49,36,170,55,78,TRUE,0.323529411764706,2024,2024-2025
MD,2024-08-31,inter-ucfe,0,0,0,0,0,0,0,0,0,1,0,1,0,0,TRUE,0,2024,2024-2025
MD,2024-08-31,inter-ucx,0,0,0,0,0,0,0,0,0,0,0,0,0,0,TRUE,0,2024,2024-2025
MD,2024-08-31,inter-ui,19,23,15,6,6,4,4,5,3,48,36,169,55,78,TRUE,0.325443786982249,2024,2024-2025
MD,2024-08-31,intra-total,1060,889,258,123,64,74,110,69,62,957,1155,4821,2215,3104,TRUE,0.459448247251608,2024,2024-2025
MD,2024-08-31,intra-ucfe,1,3,2,0,0,1,1,2,2,8,0,20,1,4,TRUE,0.05,2024,2024-2025
MD,2024-08-31,intra-ucx,6,4,0,0,0,0,0,0,0,5,6,21,12,16,TRUE,0.571428571428571,2024,2024-2025
MD,2024-08-31,intra-ui,1053,882,256,123,64,73,109,67,60,944,1149,4780,2202,3084,TRUE,0.460669456066946,2024,2024-2025
MD,2024-09-30,inter-total,20,22,13,2,4,2,2,0,0,50,37,152,57,79,TRUE,0.375,2024,2024-2025
MD,2024-09-30,inter-ucfe,0,0,0,0,0,0,0,0,0,1,0,1,0,0,TRUE,0,2024,2024-2025
MD,2024-09-30,inter-ucx,0,0,0,0,0,0,0,0,0,0,0,0,0,0,TRUE,0,2024,2024-2025
MD,2024-09-30,inter-ui,20,22,13,2,4,2,2,0,0,49,37,151,57,79,TRUE,0.377483443708609,2024,2024-2025
MD,2024-09-30,intra-total,690,702,201,104,46,42,52,42,57,1167,965,4068,1655,2357,TRUE,0.406833824975418,2024,2024-2025
MD,2024-09-30,intra-ucfe,2,3,0,0,0,0,1,0,1,12,2,21,4,7,TRUE,0.19047619047619,2024,2024-2025
MD,2024-09-30,intra-ucx,6,0,3,1,1,0,0,0,1,1,4,17,10,10,TRUE,0.588235294117647,2024,2024-2025
MD,2024-09-30,intra-ui,682,699,198,103,45,42,51,42,55,1154,959,4030,1641,2340,TRUE,0.407196029776675,2024,2024-2025
MD,2024-10-31,inter-total,29,22,6,3,0,3,1,1,4,45,41,155,70,92,TRUE,0.451612903225806,2024,2024-2025
MD,2024-10-31,inter-ucfe,1,0,0,0,0,0,0,0,0,1,0,2,1,1,TRUE,0.5,2024,2024-2025
MD,2024-10-31,inter-ucx,0,0,0,0,0,0,0,0,0,0,0,0,0,0,TRUE,0,2024,2024-2025
MD,2024-10-31,inter-ui,28,22,6,3,0,3,1,1,4,44,41,153,69,91,TRUE,0.450980392156863,2024,2024-2025
MD,2024-10-31,intra-total,950,591,206,101,70,61,47,49,62,1278,1163,4578,2113,2704,TRUE,0.461555264307558,2024,2024-2025
MD,2024-10-31,intra-ucfe,0,1,1,1,1,1,0,0,0,12,1,18,1,2,TRUE,0.0555555555555556,2024,2024-2025
MD,2024-10-31,intra-ucx,7,4,1,1,0,1,0,0,0,7,4,25,11,15,TRUE,0.44,2024,2024-2025
MD,2024-10-31,intra-ui,943,586,204,99,69,59,47,49,62,1259,1158,4535,2101,2687,TRUE,0.463285556780595,2024,2024-2025
MD,2024-11-30,inter-total,33,26,7,5,5,2,4,0,2,38,25,147,58,84,TRUE,0.394557823129252,2024,2024-2025
MD,2024-11-30,inter-ucfe,0,0,0,1,0,0,0,0,1,1,0,3,0,0,TRUE,0,2024,2024-2025
MD,2024-11-30,inter-ucx,0,0,0,0,0,0,0,0,0,0,0,0,0,0,TRUE,0,2024,2024-2025
MD,2024-11-30,inter-ui,33,26,7,4,5,2,4,0,1,37,25,144,58,84,TRUE,0.402777777777778,2024,2024-2025
MD,2024-11-30,intra-total,828,468,163,95,66,45,35,40,44,841,883,3508,1711,2179,TRUE,0.487742303306728,2024,2024-2025
MD,2024-11-30,intra-ucfe,1,1,1,0,2,1,0,0,0,5,1,12,2,3,TRUE,0.166666666666667,2024,2024-2025
MD,2024-11-30,intra-ucx,6,0,2,0,0,0,0,0,0,7,9,24,15,15,TRUE,0.625,2024,2024-2025
MD,2024-11-30,intra-ui,821,467,160,95,64,44,35,40,44,829,873,3472,1694,2161,TRUE,0.487903225806452,2024,2024-2025
ME,2019-01-31,inter-total,116,13,7,2,0,1,0,1,0,0,22,162,138,151,FALSE,0.932098765432099,2018,2018-2019
ME,2019-01-31,inter-ucfe,4,1,1,0,0,0,0,1,0,0,0,7,4,5,FALSE,0.714285714285714,2018,2018-2019
ME,2019-01-31,inter-ucx,0,0,0,0,0,0,0,0,0,0,0,0,0,0,FALSE,0,2018,2018-2019
ME,2019-01-31,inter-ui,112,12,6,2,0,1,0,0,0,0,22,155,134,146,FALSE,0.941935483870968,2018,2018-2019
ME,2019-01-31,intra-total,2022,298,106,42,10,12,8,7,2,8,633,3148,2655,2953,FALSE,0.938055908513342,2018,2018-2019
ME,2019-01-31,intra-ucfe,14,20,0,0,0,0,0,0,0,1,33,68,47,67,FALSE,0.985294117647059,2018,2018-2019
ME,2019-01-31,intra-ucx,1,1,0,0,0,0,0,0,0,0,2,4,3,4,FALSE,1,2018,2018-2019
ME,2019-01-31,intra-ui,2007,277,106,42,10,12,8,7,2,7,598,3076,2605,2882,FALSE,0.936931079323797,2018,2018-2019
ME,2019-02-28,inter-total,57,9,12,2,1,2,0,1,0,0,22,106,79,88,FALSE,0.830188679245283,2018,2018-2019
ME,2019-02-28,inter-ucfe,1,0,0,0,0,0,0,1,0,0,0,2,1,1,FALSE,0.5,2018,2018-2019
ME,2019-02-28,inter-ucx,0,0,0,0,0,0,0,0,0,0,0,0,0,0,FALSE,0,2018,2018-2019
ME,2019-02-28,inter-ui,56,9,12,2,1,2,0,0,0,0,22,104,78,87,FALSE,0.836538461538462,2018,2018-2019
ME,2019-02-28,intra-total,1280,243,139,46,27,15,12,10,4,19,317,2112,1597,1840,FALSE,0.871212121212121,2018,2018-2019
ME,2019-02-28,intra-ucfe,4,0,2,0,0,0,0,0,0,1,0,7,4,4,FALSE,0.571428571428571,2018,2018-2019
ME,2019-02-28,intra-ucx,2,0,0,0,0,0,0,0,0,0,0,2,2,2,FALSE,1,2018,2018-2019
ME,2019-02-28,intra-ui,1274,243,137,46,27,15,12,10,4,18,317,2103,1591,1834,FALSE,0.87208749405611,2018,2018-2019
ME,2019-03-31,inter-total,37,10,4,1,0,2,0,0,0,0,13,67,50,60,FALSE,0.895522388059702,2018,2018-2019
ME,2019-03-31,inter-ucfe,0,0,0,0,0,0,0,0,0,0,0,0,0,0,FALSE,0,2018,2018-2019
ME,2019-03-31,inter-ucx,0,0,0,0,0,0,0,0,0,0,0,0,0,0,FALSE,0,2018,2018-2019
ME,2019-03-31,inter-ui,37,10,4,1,0,2,0,0,0,0,13,67,50,60,FALSE,0.895522388059702,2018,2018-2019
ME,2019-03-31,intra-total,883,148,59,24,12,8,7,8,5,20,337,1511,1220,1368,FALSE,0.905360688285903,2018,2018-2019
ME,2019-03-31,intra-ucfe,5,1,0,1,0,0,0,0,0,0,1,8,6,7,FALSE,0.875,2018,2018-2019
ME,2019-03-31,intra-ucx,1,1,0,0,0,0,0,0,0,0,0,2,1,2,FALSE,1,2018,2018-2019
ME,2019-03-31,intra-ui,877,146,59,23,12,8,7,8,5,20,336,1501,1213,1359,FALSE,0.905396402398401,2018,2018-2019
ME,2019-04-30,inter-total,45,6,4,0,0,0,0,0,0,1,9,65,54,60,FALSE,0.923076923076923,2018,2018-2019
ME,2019-04-30,inter-ucfe,0,0,0,0,0,0,0,0,0,0,0,0,0,0,FALSE,0,2018,2018-2019
ME,2019-04-30,inter-ucx,0,0,0,0,0,0,0,0,0,0,0,0,0,0,FALSE,0,2018,2018-2019
ME,2019-04-30,inter-ui,45,6,4,0,0,0,0,0,0,1,9,65,54,60,FALSE,0.923076923076923,2018,2018-2019
ME,2019-04-30,intra-total,1145,62,19,12,3,5,0,8,8,31,274,1567,1419,1481,FALSE,0.945118059987237,2018,2018-2019
ME,2019-04-30,intra-ucfe,2,0,1,0,0,0,0,0,0,2,0,5,2,2,FALSE,0.4,2018,2018-2019
ME,2019-04-30,intra-ucx,1,1,0,0,0,0,0,0,0,0,1,3,2,3,FALSE,1,2018,2018-2019
ME,2019-04-30,intra-ui,1142,61,18,12,3,5,0,8,8,29,273,1559,1415,1476,FALSE,0.946760744066709,2018,2018-2019
ME,2019-05-31,inter-total,35,3,0,1,0,0,0,1,0,3,6,49,41,44,FALSE,0.897959183673469,2018,2018-2019
ME,2019-05-31,inter-ucfe,0,0,0,0,0,0,0,0,0,0,0,0,0,0,FALSE,0,2018,2018-2019
ME,2019-05-31,inter-ucx,0,0,0,0,0,0,0,0,0,0,0,0,0,0,FALSE,0,2018,2018-2019
ME,2019-05-31,inter-ui,35,3,0,1,0,0,0,1,0,3,6,49,41,44,FALSE,0.897959183673469,2018,2018-2019
ME,2019-05-31,intra-total,723,60,25,15,6,6,8,5,4,24,193,1069,916,976,FALSE,0.913002806361085,2018,2018-2019
ME,2019-05-31,intra-ucfe,0,0,0,0,1,0,0,0,0,0,1,2,1,1,FALSE,0.5,2018,2018-2019
ME,2019-05-31,intra-ucx,1,1,1,0,0,0,0,0,0,0,1,4,2,3,FALSE,0.75,2018,2018-2019
ME,2019-05-31,intra-ui,722,59,24,15,5,6,8,5,4,24,191,1063,913,972,FALSE,0.914393226716839,2018,2018-2019
ME,2019-06-30,inter-total,9,2,0,0,1,0,0,0,0,1,3,16,12,14,FALSE,0.875,2018,2018-2019
ME,2019-06-30,inter-ucfe,0,0,0,0,0,0,0,0,0,0,0,0,0,0,FALSE,0,2018,2018-2019
ME,2019-06-30,inter-ucx,0,0,0,0,0,0,0,0,0,0,0,0,0,0,FALSE,0,2018,2018-2019
ME,2019-06-30,inter-ui,9,2,0,0,1,0,0,0,0,1,3,16,12,14,FALSE,0.875,2018,2018-2019
ME,2019-06-30,intra-total,454,42,16,1,0,6,6,6,3,9,159,702,613,655,FALSE,0.933048433048433,2018,2018-2019
ME,2019-06-30,intra-ucfe,0,0,0,0,0,0,0,0,0,0,1,1,1,1,FALSE,1,2018,2018-2019
ME,2019-06-30,intra-ucx,3,0,0,0,0,0,0,0,0,0,0,3,3,3,FALSE,1,2018,2018-2019
ME,2019-06-30,intra-ui,451,42,16,1,0,6,6,6,3,9,158,698,609,651,FALSE,0.932664756446991,2018,2018-2019
ME,2019-07-31,inter-total,9,2,1,2,0,0,0,1,0,0,4,19,13,15,FALSE,0.789473684210526,2019,2019-2020
ME,2019-07-31,inter-ucfe,0,0,0,0,0,0,0,0,0,0,0,0,0,0,FALSE,0,2019,2019-2020
ME,2019-07-31,inter-ucx,0,0,0,0,0,0,0,0,0,0,0,0,0,0,FALSE,0,2019,2019-2020
ME,2019-07-31,inter-ui,9,2,1,2,0,0,0,1,0,0,4,19,13,15,FALSE,0.789473684210526,2019,2019-2020
ME,2019-07-31,intra-total,711,83,24,4,4,3,2,3,2,7,304,1147,1015,1098,FALSE,0.957279860505667,2019,2019-2020
ME,2019-07-31,intra-ucfe,0,1,1,0,0,0,0,0,0,0,1,3,1,2,FALSE,0.666666666666667,2019,2019-2020
ME,2019-07-31,intra-ucx,3,0,0,0,0,0,0,0,0,0,1,4,4,4,FALSE,1,2019,2019-2020
ME,2019-07-31,intra-ui,708,82,23,4,4,3,2,3,2,7,302,1140,1010,1092,FALSE,0.957894736842105,2019,2019-2020
ME,2019-08-31,inter-total,7,1,0,1,0,1,1,0,0,0,3,14,10,11,FALSE,0.785714285714286,2019,2019-2020
ME,2019-08-31,inter-ucfe,0,0,0,0,0,0,0,0,0,0,0,0,0,0,FALSE,0,2019,2019-2020
ME,2019-08-31,inter-ucx,0,0,0,0,0,0,0,0,0,0,0,0,0,0,FALSE,0,2019,2019-2020
ME,2019-08-31,inter-ui,7,1,0,1,0,1,1,0,0,0,3,14,10,11,FALSE,0.785714285714286,2019,2019-2020
ME,2019-08-31,intra-total,433,64,22,13,14,6,3,1,2,3,182,743,615,679,FALSE,0.913862718707941,2019,2019-2020
ME,2019-08-31,intra-ucfe,0,2,0,0,0,0,0,0,0,0,3,5,3,5,FALSE,1,2019,2019-2020
ME,2019-08-31,intra-ucx,0,0,0,0,0,0,0,0,0,0,0,0,0,0,FALSE,0,2019,2019-2020
ME,2019-08-31,intra-ui,433,62,22,13,14,6,3,1,2,3,179,738,612,674,FALSE,0.913279132791328,2019,2019-2020
ME,2019-09-30,inter-total,11,1,2,0,0,0,0,0,0,0,2,16,13,14,FALSE,0.875,2019,2019-2020
ME,2019-09-30,inter-ucfe,0,0,0,0,0,0,0,0,0,0,0,0,0,0,FALSE,0,2019,2019-2020
ME,2019-09-30,inter-ucx,0,0,0,0,0,0,0,0,0,0,0,0,0,0,FALSE,0,2019,2019-2020
ME,2019-09-30,inter-ui,11,1,2,0,0,0,0,0,0,0,2,16,13,14,FALSE,0.875,2019,2019-2020
ME,2019-09-30,intra-total,400,63,16,9,5,4,3,4,1,4,167,676,567,630,FALSE,0.931952662721893,2019,2019-2020
ME,2019-09-30,intra-ucfe,1,1,1,0,0,0,0,0,0,1,0,4,1,2,FALSE,0.5,2019,2019-2020
ME,2019-09-30,intra-ucx,3,1,0,0,0,0,0,0,0,0,0,4,3,4,FALSE,1,2019,2019-2020
ME,2019-09-30,intra-ui,396,61,15,9,5,4,3,4,1,3,167,668,563,624,FALSE,0.934131736526946,2019,2019-2020
ME,2019-10-31,inter-total,5,2,0,1,0,0,0,0,0,1,4,13,9,11,FALSE,0.846153846153846,2019,2019-2020
ME,2019-10-31,inter-ucfe,0,0,0,0,0,0,0,0,0,0,0,0,0,0,FALSE,0,2019,2019-2020
ME,2019-10-31,inter-ucx,0,0,0,0,0,0,0,0,0,0,0,0,0,0,FALSE,0,2019,2019-2020
ME,2019-10-31,inter-ui,5,2,0,1,0,0,0,0,0,1,4,13,9,11,FALSE,0.846153846153846,2019,2019-2020
ME,2019-10-31,intra-total,518,80,30,13,11,3,2,2,1,9,207,876,725,805,FALSE,0.918949771689498,2019,2019-2020
ME,2019-10-31,intra-ucfe,0,0,1,1,0,0,0,0,0,0,1,3,1,1,FALSE,0.333333333333333,2019,2019-2020
ME,2019-10-31,intra-ucx,1,1,0,0,1,0,0,0,0,0,0,3,1,2,FALSE,0.666666666666667,2019,2019-2020
ME,2019-10-31,intra-ui,517,79,29,12,10,3,2,2,1,9,206,870,723,802,FALSE,0.92183908045977,2019,2019-2020
ME,2019-11-30,inter-total,26,7,1,1,0,2,0,0,0,0,6,43,32,39,FALSE,0.906976744186047,2019,2019-2020
ME,2019-11-30,inter-ucfe,2,1,0,0,0,0,0,0,0,0,0,3,2,3,FALSE,1,2019,2019-2020
ME,2019-11-30,inter-ucx,0,0,0,0,0,0,0,0,0,0,0,0,0,0,FALSE,0,2019,2019-2020
ME,2019-11-30,inter-ui,24,6,1,1,0,2,0,0,0,0,6,40,30,36,FALSE,0.9,2019,2019-2020
ME,2019-11-30,intra-total,921,70,37,14,7,6,1,2,2,4,243,1307,1164,1234,FALSE,0.944146901300689,2019,2019-2020
ME,2019-11-30,intra-ucfe,6,0,0,0,0,0,0,0,0,0,3,9,9,9,FALSE,1,2019,2019-2020
ME,2019-11-30,intra-ucx,0,0,0,0,0,0,0,0,0,0,1,1,1,1,FALSE,1,2019,2019-2020
ME,2019-11-30,intra-ui,915,70,37,14,7,6,1,2,2,4,239,1297,1154,1224,FALSE,0.943716268311488,2019,2019-2020
ME,2019-12-31,inter-total,36,2,2,0,0,1,0,0,0,0,1,42,37,39,FALSE,0.928571428571429,2019,2019-2020
ME,2019-12-31,inter-ucfe,1,0,0,0,0,0,0,0,0,0,0,1,1,1,FALSE,1,2019,2019-2020
ME,2019-12-31,inter-ucx,0,0,0,0,0,0,0,0,0,0,0,0,0,0,FALSE,0,2019,2019-2020
ME,2019-12-31,inter-ui,35,2,2,0,0,1,0,0,0,0,1,41,36,38,FALSE,0.926829268292683,2019,2019-2020
ME,2019-12-31,intra-total,1981,109,27,11,8,7,3,5,0,8,381,2540,2362,2471,FALSE,0.972834645669291,2019,2019-2020
ME,2019-12-31,intra-ucfe,10,1,1,0,0,0,0,0,0,0,4,16,14,15,FALSE,0.9375,2019,2019-2020
ME,2019-12-31,intra-ucx,1,1,0,0,0,0,0,0,0,0,0,2,1,2,FALSE,1,2019,2019-2020
ME,2019-12-31,intra-ui,1970,107,26,11,8,7,3,5,0,8,377,2522,2347,2454,FALSE,0.973037272006344,2019,2019-2020
ME,2020-01-31,inter-total,34,3,1,1,0,1,1,0,0,1,5,47,39,42,FALSE,0.893617021276596,2019,2019-2020
ME,2020-01-31,inter-ucfe,1,1,0,0,0,0,0,0,0,0,0,2,1,2,FALSE,1,2019,2019-2020
ME,2020-01-31,inter-ucx,0,0,0,0,0,0,0,0,0,0,0,0,0,0,FALSE,0,2019,2019-2020
ME,2020-01-31,inter-ui,33,2,1,1,0,1,1,0,0,1,5,45,38,40,FALSE,0.888888888888889,2019,2019-2020
ME,2020-01-31,intra-total,2425,346,87,34,23,12,5,5,4,3,671,3615,3096,3442,FALSE,0.952143845089903,2019,2019-2020
ME,2020-01-31,intra-ucfe,9,0,1,0,0,0,0,2,0,0,2,14,11,11,FALSE,0.785714285714286,2019,2019-2020
ME,2020-01-31,intra-ucx,2,0,0,0,0,0,0,0,0,0,0,2,2,2,FALSE,1,2019,2019-2020
ME,2020-01-31,intra-ui,2414,346,86,34,23,12,5,3,4,3,669,3599,3083,3429,FALSE,0.952764656849125,2019,2019-2020
ME,2020-02-29,inter-total,19,2,0,3,0,1,0,0,0,1,7,33,26,28,FALSE,0.848484848484848,2019,2019-2020
ME,2020-02-29,inter-ucfe,1,0,0,0,0,0,0,0,0,0,0,1,1,1,FALSE,1,2019,2019-2020
ME,2020-02-29,inter-ucx,0,0,0,0,0,0,0,0,0,0,0,0,0,0,FALSE,0,2019,2019-2020
ME,2020-02-29,inter-ui,18,2,0,3,0,1,0,0,0,1,7,32,25,27,FALSE,0.84375,2019,2019-2020
ME,2020-02-29,intra-total,1597,130,47,28,23,11,10,7,3,2,357,2215,1954,2084,FALSE,0.940857787810384,2019,2019-2020
ME,2020-02-29,intra-ucfe,3,0,1,0,0,0,0,0,0,0,2,6,5,5,FALSE,0.833333333333333,2019,2019-2020
ME,2020-02-29,intra-ucx,0,0,0,0,0,0,1,0,0,0,0,1,0,0,FALSE,0,2019,2019-2020
ME,2020-02-29,intra-ui,1594,130,46,28,23,11,9,7,3,2,355,2208,1949,2079,FALSE,0.941576086956522,2019,2019-2020
ME,2020-03-31,inter-total,26,1,0,0,0,0,0,0,0,0,6,33,32,33,FALSE,1,2019,2019-2020
ME,2020-03-31,inter-ucfe,0,0,0,0,0,0,0,0,0,0,0,0,0,0,FALSE,0,2019,2019-2020
ME,2020-03-31,inter-ucx,0,0,0,0,0,0,0,0,0,0,0,0,0,0,FALSE,0,2019,2019-2020
ME,2020-03-31,inter-ui,26,1,0,0,0,0,0,0,0,0,6,33,32,33,FALSE,1,2019,2019-2020
ME,2020-03-31,intra-total,15238,82,19,16,14,15,3,8,9,16,2526,17946,17764,17846,FALSE,0.994427727627327,2019,2019-2020
ME,2020-03-31,intra-ucfe,1,0,0,0,0,0,0,0,0,0,5,6,6,6,FALSE,1,2019,2019-2020
ME,2020-03-31,intra-ucx,6,0,0,0,0,0,0,0,0,0,0,6,6,6,FALSE,1,2019,2019-2020
ME,2020-03-31,intra-ui,15231,82,19,16,14,15,3,8,9,16,2521,17934,17752,17834,FALSE,0.99442399910784,2019,2019-2020
ME,2020-04-30,inter-total,86,14,14,10,1,0,0,0,0,1,23,149,109,123,FALSE,0.825503355704698,2019,2019-2020
ME,2020-04-30,inter-ucfe,0,0,0,0,0,0,0,0,0,0,0,0,0,0,FALSE,0,2019,2019-2020
ME,2020-04-30,inter-ucx,0,0,0,0,0,0,0,0,0,0,0,0,0,0,FALSE,0,2019,2019-2020
ME,2020-04-30,inter-ui,86,14,14,10,1,0,0,0,0,1,23,149,109,123,FALSE,0.825503355704698,2019,2019-2020
ME,2020-04-30,intra-total,31516,4200,2393,1220,379,17,7,2,1,9,9203,48947,40719,44919,FALSE,0.917706907471347,2019,2019-2020
ME,2020-04-30,intra-ucfe,0,2,0,2,2,0,0,0,0,0,3,9,3,5,FALSE,0.555555555555556,2019,2019-2020
ME,2020-04-30,intra-ucx,0,1,3,0,1,0,0,0,0,0,1,6,1,2,FALSE,0.333333333333333,2019,2019-2020
ME,2020-04-30,intra-ui,31516,4197,2390,1218,376,17,7,2,1,9,9199,48932,40715,44912,FALSE,0.917845172892994,2019,2019-2020
ME,2020-05-31,inter-total,29,10,17,15,12,27,14,22,21,7,16,190,45,55,FALSE,0.289473684210526,2019,2019-2020
ME,2020-05-31,inter-ucfe,0,0,0,0,0,0,0,0,0,0,0,0,0,0,FALSE,0,2019,2019-2020
ME,2020-05-31,inter-ucx,1,0,0,0,0,0,0,0,0,0,0,1,1,1,FALSE,1,2019,2019-2020
ME,2020-05-31,inter-ui,28,10,17,15,12,27,14,22,21,7,16,189,44,54,FALSE,0.285714285714286,2019,2019-2020
ME,2020-05-31,intra-total,5113,1648,2475,2378,2510,2547,2117,3459,2969,1486,2063,28765,7176,8824,FALSE,0.306761689553277,2019,2019-2020
ME,2020-05-31,intra-ucfe,2,1,2,0,1,3,0,0,0,0,0,9,2,3,FALSE,0.333333333333333,2019,2019-2020
ME,2020-05-31,intra-ucx,2,0,4,1,1,1,0,0,0,0,1,10,3,3,FALSE,0.3,2019,2019-2020
ME,2020-05-31,intra-ui,5109,1647,2469,2377,2508,2543,2117,3459,2969,1486,2062,28746,7171,8818,FALSE,0.306755722535309,2019,2019-2020
ME,2020-06-30,inter-total,6,10,9,0,2,2,5,4,6,27,9,80,15,25,FALSE,0.3125,2019,2019-2020
ME,2020-06-30,inter-ucfe,0,0,0,0,0,0,0,0,0,1,0,1,0,0,FALSE,0,2019,2019-2020
ME,2020-06-30,inter-ucx,0,0,0,0,0,0,0,0,0,0,0,0,0,0,FALSE,0,2019,2019-2020
ME,2020-06-30,inter-ui,6,10,9,0,2,2,5,4,6,26,9,79,15,25,FALSE,0.316455696202532,2019,2019-2020
ME,2020-06-30,intra-total,1503,1019,314,186,187,249,337,604,1153,2602,1491,9645,2994,4013,FALSE,0.416070502851218,2019,2019-2020
ME,2020-06-30,intra-ucfe,0,0,2,0,1,1,0,0,0,5,2,11,2,2,FALSE,0.181818181818182,2019,2019-2020
ME,2020-06-30,intra-ucx,4,1,1,0,0,0,0,1,0,0,0,7,4,5,FALSE,0.714285714285714,2019,2019-2020
ME,2020-06-30,intra-ui,1499,1018,311,186,186,248,337,603,1153,2597,1489,9627,2988,4006,FALSE,0.41612132543887,2019,2019-2020
ME,2020-07-31,inter-total,7,3,3,0,1,1,1,1,2,23,9,51,16,19,FALSE,0.372549019607843,2020,2020-2021
ME,2020-07-31,inter-ucfe,0,0,0,0,0,0,0,0,0,0,0,0,0,0,FALSE,0,2020,2020-2021
ME,2020-07-31,inter-ucx,0,0,0,0,0,0,0,0,0,0,0,0,0,0,FALSE,0,2020,2020-2021
ME,2020-07-31,inter-ui,7,3,3,0,1,1,1,1,2,23,9,51,16,19,FALSE,0.372549019607843,2020,2020-2021
ME,2020-07-31,intra-total,1440,856,421,268,186,157,133,221,169,3765,1222,8838,2662,3518,FALSE,0.398053858338991,2020,2020-2021
ME,2020-07-31,intra-ucfe,0,1,0,1,0,0,1,0,1,2,0,6,0,1,FALSE,0.166666666666667,2020,2020-2021
ME,2020-07-31,intra-ucx,1,1,2,0,0,0,0,1,0,0,0,5,1,2,FALSE,0.4,2020,2020-2021
ME,2020-07-31,intra-ui,1439,854,419,267,186,157,132,220,168,3763,1222,8827,2661,3515,FALSE,0.398210037385295,2020,2020-2021
ME,2020-08-31,inter-total,7,3,1,4,0,0,2,3,1,28,4,53,11,14,FALSE,0.264150943396226,2020,2020-2021
ME,2020-08-31,inter-ucfe,0,0,0,0,0,0,0,0,0,0,0,0,0,0,FALSE,0,2020,2020-2021
ME,2020-08-31,inter-ucx,0,0,0,0,0,0,0,0,0,0,0,0,0,0,FALSE,0,2020,2020-2021
ME,2020-08-31,inter-ui,7,3,1,4,0,0,2,3,1,28,4,53,11,14,FALSE,0.264150943396226,2020,2020-2021
ME,2020-08-31,intra-total,595,328,196,235,267,296,282,165,141,1988,455,4948,1050,1378,FALSE,0.278496362166532,2020,2020-2021
ME,2020-08-31,intra-ucfe,0,0,0,1,0,0,0,0,0,2,2,5,2,2,FALSE,0.4,2020,2020-2021
ME,2020-08-31,intra-ucx,2,2,0,1,0,0,1,1,0,3,0,10,2,4,FALSE,0.4,2020,2020-2021
ME,2020-08-31,intra-ui,593,326,196,233,267,296,281,164,141,1983,453,4933,1046,1372,FALSE,0.278126900466248,2020,2020-2021
ME,2020-09-30,inter-total,8,5,5,0,0,1,1,0,1,16,2,39,10,15,FALSE,0.384615384615385,2020,2020-2021
ME,2020-09-30,inter-ucfe,0,0,0,0,0,0,0,0,0,0,0,0,0,0,FALSE,0,2020,2020-2021
ME,2020-09-30,inter-ucx,0,0,0,0,0,0,0,0,0,0,0,0,0,0,FALSE,0,2020,2020-2021
ME,2020-09-30,inter-ui,8,5,5,0,0,1,1,0,1,16,2,39,10,15,FALSE,0.384615384615385,2020,2020-2021
ME,2020-09-30,intra-total,475,280,112,92,61,61,39,52,52,488,530,2242,1005,1285,FALSE,0.573148974130241,2020,2020-2021
ME,2020-09-30,intra-ucfe,0,0,0,0,0,0,0,2,0,3,0,5,0,0,FALSE,0,2020,2020-2021
ME,2020-09-30,intra-ucx,1,1,0,0,1,0,0,0,1,2,1,7,2,3,FALSE,0.428571428571429,2020,2020-2021
ME,2020-09-30,intra-ui,474,279,112,92,60,61,39,50,51,483,529,2230,1003,1282,FALSE,0.574887892376682,2020,2020-2021
ME,2020-10-31,inter-total,10,3,2,2,2,1,0,1,0,5,5,31,15,18,FALSE,0.580645161290323,2020,2020-2021
ME,2020-10-31,inter-ucfe,0,0,0,0,0,0,0,0,0,0,0,0,0,0,FALSE,0,2020,2020-2021
ME,2020-10-31,inter-ucx,0,0,0,0,0,0,0,0,0,0,0,0,0,0,FALSE,0,2020,2020-2021
ME,2020-10-31,inter-ui,10,3,2,2,2,1,0,1,0,5,5,31,15,18,FALSE,0.580645161290323,2020,2020-2021
ME,2020-10-31,intra-total,437,252,113,68,48,27,16,7,9,286,435,1698,872,1124,FALSE,0.661955241460542,2020,2020-2021
ME,2020-10-31,intra-ucfe,0,2,3,1,1,0,0,0,0,3,1,11,1,3,FALSE,0.272727272727273,2020,2020-2021
ME,2020-10-31,intra-ucx,0,0,0,0,0,0,0,0,0,0,0,0,0,0,FALSE,0,2020,2020-2021
ME,2020-10-31,intra-ui,437,250,110,67,47,27,16,7,9,283,434,1687,871,1121,FALSE,0.664493183165382,2020,2020-2021
ME,2020-11-30,inter-total,9,10,2,1,3,0,0,0,0,4,10,39,19,29,FALSE,0.743589743589744,2020,2020-2021
ME,2020-11-30,inter-ucfe,0,0,0,0,0,0,0,0,0,0,0,0,0,0,FALSE,0,2020,2020-2021
ME,2020-11-30,inter-ucx,0,0,0,0,0,0,0,0,0,0,0,0,0,0,FALSE,0,2020,2020-2021
ME,2020-11-30,inter-ui,9,10,2,1,3,0,0,0,0,4,10,39,19,29,FALSE,0.743589743589744,2020,2020-2021
ME,2020-11-30,intra-total,599,232,93,55,28,25,14,7,7,179,545,1784,1144,1376,FALSE,0.771300448430493,2020,2020-2021
ME,2020-11-30,intra-ucfe,1,0,1,3,3,2,1,0,1,0,4,16,5,5,FALSE,0.3125,2020,2020-2021
ME,2020-11-30,intra-ucx,0,0,0,0,0,0,0,0,0,1,0,1,0,0,FALSE,0,2020,2020-2021
ME,2020-11-30,intra-ui,598,232,92,52,25,23,13,7,6,178,541,1767,1139,1371,FALSE,0.775891341256367,2020,2020-2021
ME,2020-12-31,inter-total,5,6,6,7,0,1,1,1,0,7,8,42,13,19,FALSE,0.452380952380952,2020,2020-2021
ME,2020-12-31,inter-ucfe,0,0,0,0,0,1,0,0,0,0,0,1,0,0,FALSE,0,2020,2020-2021
ME,2020-12-31,inter-ucx,0,0,0,0,0,0,0,0,0,0,0,0,0,0,FALSE,0,2020,2020-2021
ME,2020-12-31,inter-ui,5,6,6,7,0,0,1,1,0,7,8,41,13,19,FALSE,0.463414634146342,2020,2020-2021
ME,2020-12-31,intra-total,1362,440,207,108,59,38,44,25,13,173,998,3467,2360,2800,FALSE,0.807614652437266,2020,2020-2021
ME,2020-12-31,intra-ucfe,10,2,2,1,2,0,0,1,0,2,2,22,12,14,FALSE,0.636363636363636,2020,2020-2021
ME,2020-12-31,intra-ucx,0,1,0,0,0,0,0,1,0,0,0,2,0,1,FALSE,0.5,2020,2020-2021
ME,2020-12-31,intra-ui,1352,437,205,107,57,38,44,23,13,171,996,3443,2348,2785,FALSE,0.808887598024978,2020,2020-2021
ME,2021-01-31,inter-total,7,5,8,6,5,3,1,3,1,8,9,56,16,21,FALSE,0.375,2020,2020-2021
ME,2021-01-31,inter-ucfe,0,0,0,1,0,0,0,0,0,0,0,1,0,0,FALSE,0,2020,2020-2021
ME,2021-01-31,inter-ucx,0,0,0,0,0,0,0,0,0,0,0,0,0,0,FALSE,0,2020,2020-2021
ME,2021-01-31,inter-ui,7,5,8,5,5,3,1,3,1,8,9,55,16,21,FALSE,0.381818181818182,2020,2020-2021
ME,2021-01-31,intra-total,1650,562,233,128,87,54,35,17,20,139,1122,4047,2772,3334,FALSE,0.823820113664443,2020,2020-2021
ME,2021-01-31,intra-ucfe,2,2,2,1,0,0,1,1,1,4,1,15,3,5,FALSE,0.333333333333333,2020,2020-2021
ME,2021-01-31,intra-ucx,0,0,1,0,0,2,0,0,1,10,1,15,1,1,FALSE,0.0666666666666667,2020,2020-2021
ME,2021-01-31,intra-ui,1648,560,230,127,87,52,34,16,18,125,1120,4017,2768,3328,FALSE,0.828478964401295,2020,2020-2021
ME,2021-02-28,inter-total,9,5,7,7,2,4,6,3,0,11,2,56,11,16,FALSE,0.285714285714286,2020,2020-2021
ME,2021-02-28,inter-ucfe,0,0,0,0,0,1,0,0,0,1,1,3,1,1,FALSE,0.333333333333333,2020,2020-2021
ME,2021-02-28,inter-ucx,0,0,0,0,0,0,0,0,0,0,0,0,0,0,FALSE,0,2020,2020-2021
ME,2021-02-28,inter-ui,9,5,7,7,2,3,6,3,0,10,1,53,10,15,FALSE,0.283018867924528,2020,2020-2021
ME,2021-02-28,intra-total,999,407,249,166,132,101,54,42,31,160,682,3023,1681,2088,FALSE,0.690704598081376,2020,2020-2021
ME,2021-02-28,intra-ucfe,5,6,0,0,0,0,1,1,1,2,1,17,6,12,FALSE,0.705882352941177,2020,2020-2021
ME,2021-02-28,intra-ucx,1,0,0,0,1,0,0,0,0,2,0,4,1,1,FALSE,0.25,2020,2020-2021
ME,2021-02-28,intra-ui,993,401,249,166,131,101,53,41,30,156,681,3002,1674,2075,FALSE,0.691205862758161,2020,2020-2021
ME,2021-03-31,inter-total,11,7,6,1,3,2,2,2,0,11,2,47,13,20,FALSE,0.425531914893617,2020,2020-2021
ME,2021-03-31,inter-ucfe,0,0,0,0,0,0,1,0,0,1,0,2,0,0,FALSE,0,2020,2020-2021
ME,2021-03-31,inter-ucx,0,0,0,0,0,0,0,0,0,0,0,0,0,0,FALSE,0,2020,2020-2021
ME,2021-03-31,inter-ui,11,7,6,1,3,2,1,2,0,10,2,45,13,20,FALSE,0.444444444444444,2020,2020-2021
ME,2021-03-31,intra-total,2791,267,139,106,64,45,38,34,37,162,546,4229,3337,3604,FALSE,0.852210924568456,2020,2020-2021
ME,2021-03-31,intra-ucfe,0,0,1,1,0,0,0,0,3,2,0,7,0,0,FALSE,0,2020,2020-2021
ME,2021-03-31,intra-ucx,0,0,0,0,0,0,0,0,0,3,0,3,0,0,FALSE,0,2020,2020-2021
ME,2021-03-31,intra-ui,2791,267,138,105,64,45,38,34,34,157,546,4219,3337,3604,FALSE,0.854230860393458,2020,2020-2021
ME,2021-04-30,inter-total,11,4,2,5,0,2,4,2,0,8,5,43,16,20,FALSE,0.465116279069768,2020,2020-2021
ME,2021-04-30,inter-ucfe,0,0,0,0,0,0,0,0,0,0,0,0,0,0,FALSE,0,2020,2020-2021
ME,2021-04-30,inter-ucx,0,0,0,0,0,0,0,0,0,0,0,0,0,0,FALSE,0,2020,2020-2021
ME,2021-04-30,inter-ui,11,4,2,5,0,2,4,2,0,8,5,43,16,20,FALSE,0.465116279069768,2020,2020-2021
ME,2021-04-30,intra-total,1870,387,214,107,59,42,33,18,23,174,643,3570,2513,2900,FALSE,0.812324929971989,2020,2020-2021
ME,2021-04-30,intra-ucfe,1,0,0,1,1,1,0,1,0,1,0,6,1,1,FALSE,0.166666666666667,2020,2020-2021
ME,2021-04-30,intra-ucx,2,0,0,0,0,0,0,0,0,0,0,2,2,2,FALSE,1,2020,2020-2021
ME,2021-04-30,intra-ui,1867,387,214,106,58,41,33,17,23,173,643,3562,2510,2897,FALSE,0.813307130825379,2020,2020-2021
ME,2021-05-31,inter-total,5,3,0,3,2,4,0,0,1,7,3,28,8,11,FALSE,0.392857142857143,2020,2020-2021
ME,2021-05-31,inter-ucfe,0,0,0,0,0,0,0,0,0,0,0,0,0,0,FALSE,0,2020,2020-2021
ME,2021-05-31,inter-ucx,0,0,0,0,0,0,0,0,0,0,0,0,0,0,FALSE,0,2020,2020-2021
ME,2021-05-31,inter-ui,5,3,0,3,2,4,0,0,1,7,3,28,8,11,FALSE,0.392857142857143,2020,2020-2021
ME,2021-05-31,intra-total,581,256,172,143,103,75,51,39,15,167,392,1994,973,1229,FALSE,0.616349047141424,2020,2020-2021
ME,2021-05-31,intra-ucfe,2,0,0,1,1,0,1,0,0,2,0,7,2,2,FALSE,0.285714285714286,2020,2020-2021
ME,2021-05-31,intra-ucx,1,1,0,0,0,0,0,0,0,0,0,2,1,2,FALSE,1,2020,2020-2021
ME,2021-05-31,intra-ui,578,255,172,142,102,75,50,39,15,165,392,1985,970,1225,FALSE,0.617128463476071,2020,2020-2021
ME,2021-06-30,inter-total,6,4,2,1,2,3,3,0,0,7,4,32,10,14,FALSE,0.4375,2020,2020-2021
ME,2021-06-30,inter-ucfe,0,0,0,0,0,0,0,0,0,0,0,0,0,0,FALSE,0,2020,2020-2021
ME,2021-06-30,inter-ucx,0,0,0,0,0,0,0,0,0,0,0,0,0,0,FALSE,0,2020,2020-2021
ME,2021-06-30,inter-ui,6,4,2,1,2,3,3,0,0,7,4,32,10,14,FALSE,0.4375,2020,2020-2021
ME,2021-06-30,intra-total,664,254,158,107,105,81,68,59,55,242,379,2172,1043,1297,FALSE,0.597145488029466,2020,2020-2021
ME,2021-06-30,intra-ucfe,0,0,0,2,1,1,2,0,0,1,0,7,0,0,FALSE,0,2020,2020-2021
ME,2021-06-30,intra-ucx,2,2,1,0,0,0,0,0,0,1,1,7,3,5,FALSE,0.714285714285714,2020,2020-2021
ME,2021-06-30,intra-ui,662,252,157,105,104,80,66,59,55,240,378,2158,1040,1292,FALSE,0.59870250231696,2020,2020-2021
ME,2021-07-31,inter-total,4,6,2,2,1,0,0,1,1,7,7,31,11,17,FALSE,0.548387096774194,2021,2021-2022
ME,2021-07-31,inter-ucfe,0,0,0,0,0,0,0,0,0,0,0,0,0,0,FALSE,0,2021,2021-2022
ME,2021-07-31,inter-ucx,0,0,0,0,0,0,0,0,0,0,0,0,0,0,FALSE,0,2021,2021-2022
ME,2021-07-31,inter-ui,4,6,2,2,1,0,0,1,1,7,7,31,11,17,FALSE,0.548387096774194,2021,2021-2022
ME,2021-07-31,intra-total,689,259,138,75,45,55,39,28,27,184,496,2035,1185,1444,FALSE,0.70958230958231,2021,2021-2022
ME,2021-07-31,intra-ucfe,0,0,2,2,1,1,1,0,0,1,1,9,1,1,FALSE,0.111111111111111,2021,2021-2022
ME,2021-07-31,intra-ucx,2,0,1,0,0,0,0,0,0,0,0,3,2,2,FALSE,0.666666666666667,2021,2021-2022
ME,2021-07-31,intra-ui,687,259,135,73,44,54,38,28,27,183,495,2023,1182,1441,FALSE,0.712308452792882,2021,2021-2022
ME,2021-08-31,inter-total,9,2,3,1,1,0,0,1,0,9,3,29,12,14,FALSE,0.482758620689655,2021,2021-2022
ME,2021-08-31,inter-ucfe,0,0,0,0,0,0,0,0,0,0,0,0,0,0,FALSE,0,2021,2021-2022
ME,2021-08-31,inter-ucx,0,0,0,0,0,0,0,0,0,0,0,0,0,0,FALSE,0,2021,2021-2022
ME,2021-08-31,inter-ui,9,2,3,1,1,0,0,1,0,9,3,29,12,14,FALSE,0.482758620689655,2021,2021-2022
ME,2021-08-31,intra-total,347,111,73,70,81,54,55,22,22,419,214,1468,561,672,FALSE,0.457765667574932,2021,2021-2022
ME,2021-08-31,intra-ucfe,1,1,1,0,0,0,0,1,0,1,1,6,2,3,FALSE,0.5,2021,2021-2022
ME,2021-08-31,intra-ucx,1,1,0,0,0,0,0,1,0,3,0,6,1,2,FALSE,0.333333333333333,2021,2021-2022
ME,2021-08-31,intra-ui,345,109,72,70,81,54,55,20,22,415,213,1456,558,667,FALSE,0.458104395604396,2021,2021-2022
ME,2021-09-30,inter-total,11,0,1,0,2,0,0,0,0,5,4,23,15,15,FALSE,0.652173913043478,2021,2021-2022
ME,2021-09-30,inter-ucfe,0,0,0,0,0,0,0,0,0,0,0,0,0,0,FALSE,0,2021,2021-2022
ME,2021-09-30,inter-ucx,0,0,0,0,0,0,0,0,0,0,0,0,0,0,FALSE,0,2021,2021-2022
ME,2021-09-30,inter-ui,11,0,1,0,2,0,0,0,0,5,4,23,15,15,FALSE,0.652173913043478,2021,2021-2022
ME,2021-09-30,intra-total,1171,78,40,30,18,22,9,16,15,282,171,1852,1342,1420,FALSE,0.766738660907127,2021,2021-2022
ME,2021-09-30,intra-ucfe,0,0,0,1,0,0,0,0,0,1,0,2,0,0,FALSE,0,2021,2021-2022
ME,2021-09-30,intra-ucx,1,0,0,0,0,0,0,0,0,2,0,3,1,1,FALSE,0.333333333333333,2021,2021-2022
ME,2021-09-30,intra-ui,1170,78,40,29,18,22,9,16,15,279,171,1847,1341,1419,FALSE,0.768272874932323,2021,2021-2022
ME,2021-10-31,inter-total,5,3,2,0,0,0,1,0,0,3,2,16,7,10,FALSE,0.625,2021,2021-2022
ME,2021-10-31,inter-ucfe,0,0,0,0,0,0,0,0,0,0,0,0,0,0,FALSE,0,2021,2021-2022
ME,2021-10-31,inter-ucx,0,0,0,0,0,0,0,0,0,0,0,0,0,0,FALSE,0,2021,2021-2022
ME,2021-10-31,inter-ui,5,3,2,0,0,0,1,0,0,3,2,16,7,10,FALSE,0.625,2021,2021-2022
ME,2021-10-31,intra-total,289,56,40,23,13,16,8,1,7,81,116,650,405,461,FALSE,0.709230769230769,2021,2021-2022
ME,2021-10-31,intra-ucfe,2,0,0,0,0,0,0,0,0,2,0,4,2,2,FALSE,0.5,2021,2021-2022
ME,2021-10-31,intra-ucx,1,1,1,1,0,0,0,0,0,0,0,4,1,2,FALSE,0.5,2021,2021-2022
ME,2021-10-31,intra-ui,286,55,39,22,13,16,8,1,7,79,116,642,402,457,FALSE,0.71183800623053,2021,2021-2022
ME,2021-11-30,inter-total,21,9,2,1,1,0,1,0,0,8,7,50,28,37,FALSE,0.74,2021,2021-2022
ME,2021-11-30,inter-ucfe,3,0,1,0,0,0,0,0,0,0,0,4,3,3,FALSE,0.75,2021,2021-2022
ME,2021-11-30,inter-ucx,0,0,0,0,0,0,0,0,0,0,0,0,0,0,FALSE,0,2021,2021-2022
ME,2021-11-30,inter-ui,18,9,1,1,1,0,1,0,0,8,7,46,25,34,FALSE,0.739130434782609,2021,2021-2022
ME,2021-11-30,intra-total,717,102,47,17,19,10,14,12,9,97,261,1305,978,1080,FALSE,0.827586206896552,2021,2021-2022
ME,2021-11-30,intra-ucfe,3,0,1,0,1,0,0,0,0,0,2,7,5,5,FALSE,0.714285714285714,2021,2021-2022
ME,2021-11-30,intra-ucx,0,0,0,0,0,0,0,0,0,0,0,0,0,0,FALSE,0,2021,2021-2022
ME,2021-11-30,intra-ui,714,102,46,17,18,10,14,12,9,97,259,1298,973,1075,FALSE,0.828197226502311,2021,2021-2022
ME,2021-12-31,inter-total,25,6,2,3,1,1,0,1,0,0,14,53,39,45,FALSE,0.849056603773585,2021,2021-2022
ME,2021-12-31,inter-ucfe,0,0,0,0,0,0,0,0,0,0,2,2,2,2,FALSE,1,2021,2021-2022
ME,2021-12-31,inter-ucx,0,0,0,0,0,0,0,0,0,0,0,0,0,0,FALSE,0,2021,2021-2022
ME,2021-12-31,inter-ui,25,6,2,3,1,1,0,1,0,0,12,51,37,43,FALSE,0.843137254901961,2021,2021-2022
ME,2021-12-31,intra-total,1208,132,65,28,24,14,8,7,9,92,349,1936,1557,1689,FALSE,0.872417355371901,2021,2021-2022
ME,2021-12-31,intra-ucfe,3,3,2,1,0,0,0,0,0,1,3,13,6,9,FALSE,0.692307692307692,2021,2021-2022
ME,2021-12-31,intra-ucx,1,0,0,0,0,0,0,0,0,0,0,1,1,1,FALSE,1,2021,2021-2022
ME,2021-12-31,intra-ui,1204,129,63,27,24,14,8,7,9,91,346,1922,1550,1679,FALSE,0.873569198751301,2021,2021-2022
ME,2022-01-31,inter-total,27,10,3,1,1,0,0,1,0,3,9,55,36,46,FALSE,0.836363636363636,2021,2021-2022
ME,2022-01-31,inter-ucfe,0,0,0,0,0,0,0,0,0,0,0,0,0,0,FALSE,0,2021,2021-2022
ME,2022-01-31,inter-ucx,0,0,0,0,0,0,0,0,0,0,0,0,0,0,FALSE,0,2021,2021-2022
ME,2022-01-31,inter-ui,27,10,3,1,1,0,0,1,0,3,9,55,36,46,FALSE,0.836363636363636,2021,2021-2022
ME,2022-01-31,intra-total,2016,205,90,46,24,16,8,7,6,91,569,3078,2585,2790,FALSE,0.906432748538012,2021,2021-2022
ME,2022-01-31,intra-ucfe,7,0,1,0,0,0,0,0,0,1,3,12,10,10,FALSE,0.833333333333333,2021,2021-2022
ME,2022-01-31,intra-ucx,2,1,0,0,0,0,0,0,0,0,0,3,2,3,FALSE,1,2021,2021-2022
ME,2022-01-31,intra-ui,2007,204,89,46,24,16,8,7,6,90,566,3063,2573,2777,FALSE,0.906627489389487,2021,2021-2022
ME,2022-02-28,inter-total,11,5,3,4,2,1,0,0,0,2,8,36,19,24,FALSE,0.666666666666667,2021,2021-2022
ME,2022-02-28,inter-ucfe,0,0,0,0,0,0,0,0,0,0,0,0,0,0,FALSE,0,2021,2021-2022
ME,2022-02-28,inter-ucx,0,0,0,0,0,0,0,0,0,0,1,1,1,1,FALSE,1,2021,2021-2022
ME,2022-02-28,inter-ui,11,5,3,4,2,1,0,0,0,2,7,35,18,23,FALSE,0.657142857142857,2021,2021-2022
ME,2022-02-28,intra-total,938,154,98,61,31,26,16,11,6,78,327,1746,1265,1419,FALSE,0.812714776632302,2021,2021-2022
ME,2022-02-28,intra-ucfe,5,1,0,1,0,0,0,0,0,0,1,8,6,7,FALSE,0.875,2021,2021-2022
ME,2022-02-28,intra-ucx,0,0,1,0,1,0,0,0,0,0,0,2,0,0,FALSE,0,2021,2021-2022
ME,2022-02-28,intra-ui,933,153,97,60,30,26,16,11,6,78,326,1736,1259,1412,FALSE,0.813364055299539,2021,2021-2022
ME,2022-03-31,inter-total,14,1,2,0,1,1,2,0,0,11,7,39,21,22,FALSE,0.564102564102564,2021,2021-2022
ME,2022-03-31,inter-ucfe,0,0,0,0,0,0,0,0,0,0,0,0,0,0,FALSE,0,2021,2021-2022
ME,2022-03-31,inter-ucx,0,0,0,0,0,0,0,0,0,0,0,0,0,0,FALSE,0,2021,2021-2022
ME,2022-03-31,inter-ui,14,1,2,0,1,1,2,0,0,11,7,39,21,22,FALSE,0.564102564102564,2021,2021-2022
ME,2022-03-31,intra-total,736,106,74,31,19,17,13,12,7,161,247,1423,983,1089,FALSE,0.765284609978918,2021,2021-2022
ME,2022-03-31,intra-ucfe,2,1,1,1,0,2,0,0,0,0,2,9,4,5,FALSE,0.555555555555556,2021,2021-2022
ME,2022-03-31,intra-ucx,2,1,1,0,0,0,0,0,0,0,0,4,2,3,FALSE,0.75,2021,2021-2022
ME,2022-03-31,intra-ui,732,104,72,30,19,15,13,12,7,161,245,1410,977,1081,FALSE,0.766666666666667,2021,2021-2022
ME,2022-04-30,inter-total,15,2,2,0,1,0,1,0,0,5,3,29,18,20,FALSE,0.689655172413793,2021,2021-2022
ME,2022-04-30,inter-ucfe,0,0,0,0,0,0,0,0,0,0,0,0,0,0,FALSE,0,2021,2021-2022
ME,2022-04-30,inter-ucx,0,0,0,0,0,0,0,0,0,0,0,0,0,0,FALSE,0,2021,2021-2022
ME,2022-04-30,inter-ui,15,2,2,0,1,0,1,0,0,5,3,29,18,20,FALSE,0.689655172413793,2021,2021-2022
ME,2022-04-30,intra-total,1073,68,31,19,6,6,5,4,4,72,251,1539,1324,1392,FALSE,0.90448343079922,2021,2021-2022
ME,2022-04-30,intra-ucfe,3,0,0,0,0,0,0,0,0,1,2,6,5,5,FALSE,0.833333333333333,2021,2021-2022
ME,2022-04-30,intra-ucx,0,1,0,0,0,0,0,0,0,0,2,3,2,3,FALSE,1,2021,2021-2022
ME,2022-04-30,intra-ui,1070,67,31,19,6,6,5,4,4,71,247,1530,1317,1384,FALSE,0.904575163398693,2021,2021-2022
ME,2022-05-31,inter-total,7,4,2,0,0,0,0,0,0,0,6,19,13,17,FALSE,0.894736842105263,2021,2021-2022
ME,2022-05-31,inter-ucfe,0,0,0,0,0,0,0,0,0,0,0,0,0,0,FALSE,0,2021,2021-2022
ME,2022-05-31,inter-ucx,0,0,0,0,0,0,0,0,0,0,0,0,0,0,FALSE,0,2021,2021-2022
ME,2022-05-31,inter-ui,7,4,2,0,0,0,0,0,0,0,6,19,13,17,FALSE,0.894736842105263,2021,2021-2022
ME,2022-05-31,intra-total,701,54,39,9,15,6,7,3,3,47,172,1056,873,927,FALSE,0.877840909090909,2021,2021-2022
ME,2022-05-31,intra-ucfe,1,2,0,0,0,0,0,1,0,0,0,4,1,3,FALSE,0.75,2021,2021-2022
ME,2022-05-31,intra-ucx,0,0,1,1,0,0,0,0,0,0,2,4,2,2,FALSE,0.5,2021,2021-2022
ME,2022-05-31,intra-ui,700,52,38,8,15,6,7,2,3,47,170,1048,870,922,FALSE,0.879770992366412,2021,2021-2022
ME,2022-06-30,inter-total,18,4,0,0,2,2,1,0,0,3,2,32,20,24,FALSE,0.75,2021,2021-2022
ME,2022-06-30,inter-ucfe,0,0,0,0,0,0,0,0,0,0,0,0,0,0,FALSE,0,2021,2021-2022
ME,2022-06-30,inter-ucx,0,0,0,0,0,0,0,0,0,0,0,0,0,0,FALSE,0,2021,2021-2022
ME,2022-06-30,inter-ui,18,4,0,0,2,2,1,0,0,3,2,32,20,24,FALSE,0.75,2021,2021-2022
ME,2022-06-30,intra-total,499,50,21,5,7,7,5,8,4,55,150,811,649,699,FALSE,0.86189889025894,2021,2021-2022
ME,2022-06-30,intra-ucfe,0,1,0,0,1,0,0,0,0,0,0,2,0,1,FALSE,0.5,2021,2021-2022
ME,2022-06-30,intra-ucx,0,0,0,0,0,0,0,0,0,0,0,0,0,0,FALSE,0,2021,2021-2022
ME,2022-06-30,intra-ui,499,49,21,5,6,7,5,8,4,55,150,809,649,698,FALSE,0.862793572311496,2021,2021-2022
ME,2022-07-31,inter-total,10,3,1,0,0,0,0,0,1,2,2,19,12,15,FALSE,0.789473684210526,2022,2022-2023
ME,2022-07-31,inter-ucfe,0,0,0,0,0,0,0,0,0,0,0,0,0,0,FALSE,0,2022,2022-2023
ME,2022-07-31,inter-ucx,0,0,0,0,0,0,0,0,0,0,0,0,0,0,FALSE,0,2022,2022-2023
ME,2022-07-31,inter-ui,10,3,1,0,0,0,0,0,1,2,2,19,12,15,FALSE,0.789473684210526,2022,2022-2023
ME,2022-07-31,intra-total,696,56,22,11,13,11,7,12,7,49,197,1081,893,949,FALSE,0.877890841813136,2022,2022-2023
ME,2022-07-31,intra-ucfe,0,0,0,0,0,0,0,1,0,0,1,2,1,1,FALSE,0.5,2022,2022-2023
ME,2022-07-31,intra-ucx,0,0,0,0,0,0,0,0,0,0,1,1,1,1,FALSE,1,2022,2022-2023
ME,2022-07-31,intra-ui,696,56,22,11,13,11,7,11,7,49,195,1078,891,947,FALSE,0.87847866419295,2022,2022-2023
ME,2022-08-31,inter-total,5,3,1,0,0,0,0,0,0,2,2,13,7,10,FALSE,0.769230769230769,2022,2022-2023
ME,2022-08-31,inter-ucfe,0,0,0,0,0,0,0,0,0,0,0,0,0,0,FALSE,0,2022,2022-2023
ME,2022-08-31,inter-ucx,0,0,0,0,0,0,0,0,0,0,0,0,0,0,FALSE,0,2022,2022-2023
ME,2022-08-31,inter-ui,5,3,1,0,0,0,0,0,0,2,2,13,7,10,FALSE,0.769230769230769,2022,2022-2023
ME,2022-08-31,intra-total,509,64,29,18,12,8,5,3,5,24,149,826,658,722,FALSE,0.87409200968523,2022,2022-2023
ME,2022-08-31,intra-ucfe,1,0,0,0,0,0,0,0,0,1,1,3,2,2,FALSE,0.666666666666667,2022,2022-2023
ME,2022-08-31,intra-ucx,1,0,1,1,0,0,0,0,0,1,0,4,1,1,FALSE,0.25,2022,2022-2023
ME,2022-08-31,intra-ui,507,64,28,17,12,8,5,3,5,22,148,819,655,719,FALSE,0.877899877899878,2022,2022-2023
ME,2022-09-30,inter-total,3,2,3,0,1,1,0,0,0,2,6,18,9,11,FALSE,0.611111111111111,2022,2022-2023
ME,2022-09-30,inter-ucfe,0,0,0,0,0,0,0,0,0,1,0,1,0,0,FALSE,0,2022,2022-2023
ME,2022-09-30,inter-ucx,0,0,0,0,0,0,0,0,0,0,0,0,0,0,FALSE,0,2022,2022-2023
ME,2022-09-30,inter-ui,3,2,3,0,1,1,0,0,0,1,6,17,9,11,FALSE,0.647058823529412,2022,2022-2023
ME,2022-09-30,intra-total,276,44,33,21,10,7,3,6,4,22,131,557,407,451,FALSE,0.809694793536804,2022,2022-2023
ME,2022-09-30,intra-ucfe,0,0,0,1,0,0,0,0,0,1,1,3,1,1,FALSE,0.333333333333333,2022,2022-2023
ME,2022-09-30,intra-ucx,0,0,0,0,0,0,0,0,0,0,0,0,0,0,FALSE,0,2022,2022-2023
ME,2022-09-30,intra-ui,276,44,33,20,10,7,3,6,4,21,130,554,406,450,FALSE,0.812274368231047,2022,2022-2023
ME,2022-10-31,inter-total,14,3,4,1,0,1,0,0,0,2,5,30,19,22,FALSE,0.733333333333333,2022,2022-2023
ME,2022-10-31,inter-ucfe,2,0,0,0,0,0,0,0,0,0,0,2,2,2,FALSE,1,2022,2022-2023
ME,2022-10-31,inter-ucx,0,0,0,0,0,0,0,0,0,0,0,0,0,0,FALSE,0,2022,2022-2023
ME,2022-10-31,inter-ui,12,3,4,1,0,1,0,0,0,2,5,28,17,20,FALSE,0.714285714285714,2022,2022-2023
ME,2022-10-31,intra-total,355,66,30,22,17,9,5,1,1,15,152,673,507,573,FALSE,0.851411589895988,2022,2022-2023
ME,2022-10-31,intra-ucfe,1,0,0,0,2,0,0,0,0,0,1,4,2,2,FALSE,0.5,2022,2022-2023
ME,2022-10-31,intra-ucx,1,0,0,0,0,0,0,0,0,1,0,2,1,1,FALSE,0.5,2022,2022-2023
ME,2022-10-31,intra-ui,353,66,30,22,15,9,5,1,1,14,151,667,504,570,FALSE,0.854572713643178,2022,2022-2023
ME,2022-11-30,inter-total,54,9,1,1,2,0,1,0,0,1,20,89,74,83,FALSE,0.932584269662921,2022,2022-2023
ME,2022-11-30,inter-ucfe,5,0,0,0,0,0,0,0,0,0,2,7,7,7,FALSE,1,2022,2022-2023
ME,2022-11-30,inter-ucx,0,0,0,0,0,0,0,0,0,0,0,0,0,0,FALSE,0,2022,2022-2023
ME,2022-11-30,inter-ui,49,9,1,1,2,0,1,0,0,1,18,82,67,76,FALSE,0.926829268292683,2022,2022-2023
ME,2022-11-30,intra-total,778,61,47,24,5,6,8,2,3,13,240,1187,1018,1079,FALSE,0.909014321819713,2022,2022-2023
ME,2022-11-30,intra-ucfe,3,0,0,0,0,0,0,0,0,1,2,6,5,5,FALSE,0.833333333333333,2022,2022-2023
ME,2022-11-30,intra-ucx,1,1,0,1,0,1,1,0,0,0,0,5,1,2,FALSE,0.4,2022,2022-2023
ME,2022-11-30,intra-ui,774,60,47,23,5,5,7,2,3,12,238,1176,1012,1072,FALSE,0.91156462585034,2022,2022-2023
ME,2022-12-31,inter-total,70,14,12,6,2,4,1,0,0,1,24,134,94,108,FALSE,0.805970149253731,2022,2022-2023
ME,2022-12-31,inter-ucfe,1,0,0,1,0,0,0,0,0,0,1,3,2,2,FALSE,0.666666666666667,2022,2022-2023
ME,2022-12-31,inter-ucx,0,0,0,0,0,0,0,0,0,0,0,0,0,0,FALSE,0,2022,2022-2023
ME,2022-12-31,inter-ui,69,14,12,5,2,4,1,0,0,1,23,131,92,106,FALSE,0.809160305343512,2022,2022-2023
ME,2022-12-31,intra-total,1277,119,58,39,20,16,13,6,2,19,364,1933,1641,1760,FALSE,0.91050181065701,2022,2022-2023
ME,2022-12-31,intra-ucfe,3,2,0,2,0,0,1,0,0,1,1,10,4,6,FALSE,0.6,2022,2022-2023
ME,2022-12-31,intra-ucx,1,0,1,0,0,1,0,0,0,0,0,3,1,1,FALSE,0.333333333333333,2022,2022-2023
ME,2022-12-31,intra-ui,1273,117,57,37,20,15,12,6,2,18,363,1920,1636,1753,FALSE,0.913020833333333,2022,2022-2023
ME,2023-01-31,inter-total,93,18,7,5,5,2,1,3,0,2,24,160,117,135,FALSE,0.84375,2022,2022-2023
ME,2023-01-31,inter-ucfe,0,1,0,1,0,0,1,1,0,0,0,4,0,1,FALSE,0.25,2022,2022-2023
ME,2023-01-31,inter-ucx,0,0,0,0,0,0,0,0,0,0,0,0,0,0,FALSE,0,2022,2022-2023
ME,2023-01-31,inter-ui,93,17,7,4,5,2,0,2,0,2,24,156,117,134,FALSE,0.858974358974359,2022,2022-2023
ME,2023-01-31,intra-total,2229,177,89,50,30,24,12,5,3,41,504,3164,2733,2910,FALSE,0.919721871049305,2022,2022-2023
ME,2023-01-31,intra-ucfe,2,2,2,1,1,1,0,0,0,1,3,13,5,7,FALSE,0.538461538461538,2022,2022-2023
ME,2023-01-31,intra-ucx,0,1,0,0,0,0,0,0,0,0,1,2,1,2,FALSE,1,2022,2022-2023
ME,2023-01-31,intra-ui,2227,174,87,49,29,23,12,5,3,40,500,3149,2727,2901,FALSE,0.921244839631629,2022,2022-2023
ME,2023-02-28,inter-total,50,18,14,11,6,2,2,6,0,5,11,125,61,79,FALSE,0.632,2022,2022-2023
ME,2023-02-28,inter-ucfe,1,0,0,0,1,0,1,2,0,1,1,7,2,2,FALSE,0.285714285714286,2022,2022-2023
ME,2023-02-28,inter-ucx,0,0,0,0,0,0,0,0,0,0,0,0,0,0,FALSE,0,2022,2022-2023
ME,2023-02-28,inter-ui,49,18,14,11,5,2,1,4,0,4,10,118,59,77,FALSE,0.652542372881356,2022,2022-2023
ME,2023-02-28,intra-total,1076,153,87,50,34,13,10,7,8,29,351,1818,1427,1580,FALSE,0.869086908690869,2022,2022-2023
ME,2023-02-28,intra-ucfe,1,1,0,0,1,0,1,1,0,1,3,9,4,5,FALSE,0.555555555555556,2022,2022-2023
ME,2023-02-28,intra-ucx,0,0,1,0,0,0,0,0,0,0,0,1,0,0,FALSE,0,2022,2022-2023
ME,2023-02-28,intra-ui,1075,152,86,50,33,13,9,6,8,28,348,1808,1423,1575,FALSE,0.871128318584071,2022,2022-2023
ME,2023-03-31,inter-total,34,8,3,2,2,3,1,3,0,2,15,73,49,57,FALSE,0.780821917808219,2022,2022-2023
ME,2023-03-31,inter-ucfe,0,0,0,0,0,0,0,0,0,0,1,1,1,1,FALSE,1,2022,2022-2023
ME,2023-03-31,inter-ucx,0,0,0,0,0,0,0,0,0,0,0,0,0,0,FALSE,0,2022,2022-2023
ME,2023-03-31,inter-ui,34,8,3,2,2,3,1,3,0,2,14,72,48,56,FALSE,0.777777777777778,2022,2022-2023
ME,2023-03-31,intra-total,1124,135,67,31,26,13,12,11,6,35,358,1818,1482,1617,FALSE,0.88943894389439,2022,2022-2023
ME,2023-03-31,intra-ucfe,0,2,0,0,0,0,0,0,0,3,1,6,1,3,FALSE,0.5,2022,2022-2023
ME,2023-03-31,intra-ucx,0,1,0,0,0,0,0,0,0,0,0,1,0,1,FALSE,1,2022,2022-2023
ME,2023-03-31,intra-ui,1124,132,67,31,26,13,12,11,6,32,357,1811,1481,1613,FALSE,0.890668139149641,2022,2022-2023
ME,2023-04-30,inter-total,34,5,5,2,3,0,1,0,0,2,12,64,46,51,FALSE,0.796875,2022,2022-2023
ME,2023-04-30,inter-ucfe,0,0,0,0,0,0,0,0,0,0,0,0,0,0,FALSE,0,2022,2022-2023
ME,2023-04-30,inter-ucx,0,0,0,0,0,0,0,0,0,0,0,0,0,0,FALSE,0,2022,2022-2023
ME,2023-04-30,inter-ui,34,5,5,2,3,0,1,0,0,2,12,64,46,51,FALSE,0.796875,2022,2022-2023
ME,2023-04-30,intra-total,1162,138,49,41,16,12,12,5,4,20,302,1761,1464,1602,FALSE,0.909710391822828,2022,2022-2023
ME,2023-04-30,intra-ucfe,0,0,0,0,0,0,0,0,0,1,2,3,2,2,FALSE,0.666666666666667,2022,2022-2023
ME,2023-04-30,intra-ucx,1,0,0,0,0,0,0,0,0,0,0,1,1,1,FALSE,1,2022,2022-2023
ME,2023-04-30,intra-ui,1161,138,49,41,16,12,12,5,4,19,300,1757,1461,1599,FALSE,0.910073989755265,2022,2022-2023
ME,2023-05-31,inter-total,22,10,7,5,2,1,0,1,0,1,16,65,38,48,FALSE,0.738461538461539,2022,2022-2023
ME,2023-05-31,inter-ucfe,0,0,0,0,0,0,0,0,0,0,0,0,0,0,FALSE,0,2022,2022-2023
ME,2023-05-31,inter-ucx,0,0,0,0,0,0,0,0,0,0,0,0,0,0,FALSE,0,2022,2022-2023
ME,2023-05-31,inter-ui,22,10,7,5,2,1,0,1,0,1,16,65,38,48,FALSE,0.738461538461539,2022,2022-2023
ME,2023-05-31,intra-total,834,119,66,34,22,10,14,7,7,32,287,1432,1121,1240,FALSE,0.865921787709497,2022,2022-2023
ME,2023-05-31,intra-ucfe,1,0,1,0,1,0,0,0,0,0,0,3,1,1,FALSE,0.333333333333333,2022,2022-2023
ME,2023-05-31,intra-ucx,1,1,0,0,0,0,0,0,0,0,1,3,2,3,FALSE,1,2022,2022-2023
ME,2023-05-31,intra-ui,832,118,65,34,21,10,14,7,7,32,286,1426,1118,1236,FALSE,0.866760168302945,2022,2022-2023
ME,2023-06-30,inter-total,25,6,3,1,0,0,0,0,1,4,3,43,28,34,FALSE,0.790697674418605,2022,2022-2023
ME,2023-06-30,inter-ucfe,0,0,0,0,0,0,0,0,0,0,0,0,0,0,FALSE,0,2022,2022-2023
ME,2023-06-30,inter-ucx,1,0,0,0,0,0,0,0,0,0,0,1,1,1,FALSE,1,2022,2022-2023
ME,2023-06-30,inter-ui,24,6,3,1,0,0,0,0,1,4,3,42,27,33,FALSE,0.785714285714286,2022,2022-2023
ME,2023-06-30,intra-total,582,56,38,23,14,10,5,16,0,31,200,975,782,838,FALSE,0.85948717948718,2022,2022-2023
ME,2023-06-30,intra-ucfe,1,0,0,1,1,0,0,0,0,0,1,4,2,2,FALSE,0.5,2022,2022-2023
ME,2023-06-30,intra-ucx,0,0,0,0,0,0,0,0,0,0,0,0,0,0,FALSE,0,2022,2022-2023
ME,2023-06-30,intra-ui,581,56,38,22,13,10,5,16,0,31,199,971,780,836,FALSE,0.86096807415036,2022,2022-2023
ME,2023-07-31,inter-total,17,2,3,3,1,0,0,1,0,1,9,37,26,28,FALSE,0.756756756756757,2023,2023-2024
ME,2023-07-31,inter-ucfe,0,0,0,0,0,0,0,0,0,0,0,0,0,0,FALSE,0,2023,2023-2024
ME,2023-07-31,inter-ucx,0,0,0,0,0,0,0,0,0,0,0,0,0,0,FALSE,0,2023,2023-2024
ME,2023-07-31,inter-ui,17,2,3,3,1,0,0,1,0,1,9,37,26,28,FALSE,0.756756756756757,2023,2023-2024
ME,2023-07-31,intra-total,793,75,27,27,12,3,5,3,2,11,263,1221,1056,1131,FALSE,0.926289926289926,2023,2023-2024
ME,2023-07-31,intra-ucfe,0,1,0,0,0,0,0,0,0,0,1,2,1,2,FALSE,1,2023,2023-2024
ME,2023-07-31,intra-ucx,0,0,0,0,0,0,0,0,0,0,0,0,0,0,FALSE,0,2023,2023-2024
ME,2023-07-31,intra-ui,793,74,27,27,12,3,5,3,2,11,262,1219,1055,1129,FALSE,0.92616899097621,2023,2023-2024
ME,2023-08-31,inter-total,17,8,1,4,0,1,1,0,1,0,9,42,26,34,FALSE,0.80952380952381,2023,2023-2024
ME,2023-08-31,inter-ucfe,0,0,0,1,0,0,0,0,0,0,0,1,0,0,FALSE,0,2023,2023-2024
ME,2023-08-31,inter-ucx,0,0,0,0,0,0,0,0,0,0,0,0,0,0,FALSE,0,2023,2023-2024
ME,2023-08-31,inter-ui,17,8,1,3,0,1,1,0,1,0,9,41,26,34,FALSE,0.829268292682927,2023,2023-2024
ME,2023-08-31,intra-total,526,76,40,13,5,12,6,6,0,25,182,891,708,784,FALSE,0.879910213243547,2023,2023-2024
ME,2023-08-31,intra-ucfe,0,0,0,0,0,1,0,0,0,0,0,1,0,0,FALSE,0,2023,2023-2024
ME,2023-08-31,intra-ucx,3,0,0,0,0,0,0,0,0,0,0,3,3,3,FALSE,1,2023,2023-2024
ME,2023-08-31,intra-ui,523,76,40,13,5,11,6,6,0,25,182,887,705,781,FALSE,0.880496054114994,2023,2023-2024
ME,2023-09-30,inter-total,18,4,1,2,1,0,0,0,0,2,10,38,28,32,FALSE,0.842105263157895,2023,2023-2024
ME,2023-09-30,inter-ucfe,0,0,0,0,0,0,0,0,0,0,0,0,0,0,FALSE,0,2023,2023-2024
ME,2023-09-30,inter-ucx,0,0,0,0,0,0,0,0,0,0,0,0,0,0,FALSE,0,2023,2023-2024
ME,2023-09-30,inter-ui,18,4,1,2,1,0,0,0,0,2,10,38,28,32,FALSE,0.842105263157895,2023,2023-2024
ME,2023-09-30,intra-total,446,57,21,25,10,7,9,4,1,16,185,781,631,688,FALSE,0.880921895006402,2023,2023-2024
ME,2023-09-30,intra-ucfe,0,2,1,0,0,0,0,0,0,0,0,3,0,2,FALSE,0.666666666666667,2023,2023-2024
ME,2023-09-30,intra-ucx,0,0,0,0,0,0,0,0,0,0,3,3,3,3,FALSE,1,2023,2023-2024
ME,2023-09-30,intra-ui,446,55,20,25,10,7,9,4,1,16,182,775,628,683,FALSE,0.881290322580645,2023,2023-2024
ME,2023-10-31,inter-total,33,8,6,2,0,0,0,0,0,3,14,66,47,55,FALSE,0.833333333333333,2023,2023-2024
ME,2023-10-31,inter-ucfe,1,0,0,0,0,0,0,0,0,0,0,1,1,1,FALSE,1,2023,2023-2024
ME,2023-10-31,inter-ucx,0,0,0,0,0,0,0,0,0,0,0,0,0,0,FALSE,0,2023,2023-2024
ME,2023-10-31,inter-ui,32,8,6,2,0,0,0,0,0,3,14,65,46,54,FALSE,0.830769230769231,2023,2023-2024
ME,2023-10-31,intra-total,492,87,31,23,14,10,4,2,1,14,235,913,727,814,FALSE,0.891566265060241,2023,2023-2024
ME,2023-10-31,intra-ucfe,1,1,0,1,0,0,1,0,0,0,2,6,3,4,FALSE,0.666666666666667,2023,2023-2024
ME,2023-10-31,intra-ucx,0,0,0,0,0,0,0,0,0,0,0,0,0,0,FALSE,0,2023,2023-2024
ME,2023-10-31,intra-ui,491,86,31,22,14,10,3,2,1,14,233,907,724,810,FALSE,0.893054024255788,2023,2023-2024
ME,2023-11-30,inter-total,83,9,9,4,0,0,1,0,0,3,28,137,111,120,FALSE,0.875912408759124,2023,2023-2024
ME,2023-11-30,inter-ucfe,3,0,1,0,0,0,0,0,0,0,0,4,3,3,FALSE,0.75,2023,2023-2024
ME,2023-11-30,inter-ucx,0,0,0,0,0,0,0,0,0,0,0,0,0,0,FALSE,0,2023,2023-2024
ME,2023-11-30,inter-ui,80,9,8,4,0,0,1,0,0,3,28,133,108,117,FALSE,0.879699248120301,2023,2023-2024
ME,2023-11-30,intra-total,950,83,31,18,16,10,6,1,1,19,293,1428,1243,1326,FALSE,0.928571428571429,2023,2023-2024
ME,2023-11-30,intra-ucfe,3,0,2,0,0,0,0,0,0,0,2,7,5,5,FALSE,0.714285714285714,2023,2023-2024
ME,2023-11-30,intra-ucx,1,0,0,0,0,0,0,0,0,0,0,1,1,1,FALSE,1,2023,2023-2024
ME,2023-11-30,intra-ui,946,83,29,18,16,10,6,1,1,19,291,1420,1237,1320,FALSE,0.929577464788732,2023,2023-2024
ME,2023-12-31,inter-total,89,5,5,5,1,0,0,1,0,2,24,132,113,118,FALSE,0.893939393939394,2023,2023-2024
ME,2023-12-31,inter-ucfe,1,1,0,0,0,0,0,0,0,0,1,3,2,3,FALSE,1,2023,2023-2024
ME,2023-12-31,inter-ucx,0,0,0,0,0,0,0,0,0,0,0,0,0,0,FALSE,0,2023,2023-2024
ME,2023-12-31,inter-ui,88,4,5,5,1,0,0,1,0,2,23,129,111,115,FALSE,0.891472868217054,2023,2023-2024
ME,2023-12-31,intra-total,1542,88,37,19,14,11,7,2,1,10,368,2099,1910,1998,FALSE,0.951881848499285,2023,2023-2024
ME,2023-12-31,intra-ucfe,7,0,0,0,0,0,0,0,0,0,0,7,7,7,FALSE,1,2023,2023-2024
ME,2023-12-31,intra-ucx,0,0,0,0,0,0,0,0,0,0,2,2,2,2,FALSE,1,2023,2023-2024
ME,2023-12-31,intra-ui,1535,88,37,19,14,11,7,2,1,10,366,2090,1901,1989,FALSE,0.951674641148325,2023,2023-2024
ME,2024-01-31,inter-total,134,15,7,4,3,5,2,0,2,3,35,210,169,184,FALSE,0.876190476190476,2023,2023-2024
ME,2024-01-31,inter-ucfe,0,1,0,0,0,0,0,0,0,0,0,1,0,1,FALSE,1,2023,2023-2024
ME,2024-01-31,inter-ucx,0,0,0,0,0,0,0,0,0,0,0,0,0,0,FALSE,0,2023,2023-2024
ME,2024-01-31,inter-ui,134,14,7,4,3,5,2,0,2,3,35,209,169,183,FALSE,0.875598086124402,2023,2023-2024
ME,2024-01-31,intra-total,2442,133,48,33,30,12,13,6,5,24,554,3300,2996,3129,FALSE,0.948181818181818,2023,2023-2024
ME,2024-01-31,intra-ucfe,1,0,0,0,0,0,0,0,0,0,2,3,3,3,FALSE,1,2023,2023-2024
ME,2024-01-31,intra-ucx,0,0,0,0,0,0,0,0,0,0,2,2,2,2,FALSE,1,2023,2023-2024
ME,2024-01-31,intra-ui,2441,133,48,33,30,12,13,6,5,24,550,3295,2991,3124,FALSE,0.948103186646434,2023,2023-2024
ME,2024-02-29,inter-total,47,19,8,6,1,0,1,0,0,3,16,101,63,82,FALSE,0.811881188118812,2023,2023-2024
ME,2024-02-29,inter-ucfe,2,0,0,0,0,0,0,0,0,0,0,2,2,2,FALSE,1,2023,2023-2024
ME,2024-02-29,inter-ucx,0,1,0,0,0,0,0,0,0,0,0,1,0,1,FALSE,1,2023,2023-2024
ME,2024-02-29,inter-ui,45,18,8,6,1,0,1,0,0,3,16,98,61,79,FALSE,0.806122448979592,2023,2023-2024
ME,2024-02-29,intra-total,1359,135,58,38,28,22,7,9,5,24,380,2065,1739,1874,FALSE,0.907506053268765,2023,2023-2024
ME,2024-02-29,intra-ucfe,4,1,0,0,1,0,0,0,0,0,0,6,4,5,FALSE,0.833333333333333,2023,2023-2024
ME,2024-02-29,intra-ucx,2,1,0,1,0,0,0,0,0,0,0,4,2,3,FALSE,0.75,2023,2023-2024
ME,2024-02-29,intra-ui,1353,133,58,37,27,22,7,9,5,24,380,2055,1733,1866,FALSE,0.908029197080292,2023,2023-2024
ME,2024-03-31,inter-total,38,7,3,8,2,0,2,0,1,7,12,80,50,57,FALSE,0.7125,2023,2023-2024
ME,2024-03-31,inter-ucfe,0,0,0,0,0,0,0,0,0,0,0,0,0,0,FALSE,0,2023,2023-2024
ME,2024-03-31,inter-ucx,0,0,0,0,0,0,0,0,0,0,0,0,0,0,FALSE,0,2023,2023-2024
ME,2024-03-31,inter-ui,38,7,3,8,2,0,2,0,1,7,12,80,50,57,FALSE,0.7125,2023,2023-2024
ME,2024-03-31,intra-total,940,109,47,28,19,22,16,6,10,21,332,1550,1272,1381,FALSE,0.890967741935484,2023,2023-2024
ME,2024-03-31,intra-ucfe,0,1,1,0,1,0,0,0,0,0,2,5,2,3,FALSE,0.6,2023,2023-2024
ME,2024-03-31,intra-ucx,0,0,0,0,0,0,0,0,0,0,0,0,0,0,FALSE,0,2023,2023-2024
ME,2024-03-31,intra-ui,940,108,46,28,18,22,16,6,10,21,330,1545,1270,1378,FALSE,0.891909385113269,2023,2023-2024
ME,2024-04-30,inter-total,34,4,3,0,1,1,1,1,0,1,13,59,47,51,FALSE,0.864406779661017,2023,2023-2024
ME,2024-04-30,inter-ucfe,0,0,0,0,0,0,0,0,0,0,0,0,0,0,FALSE,0,2023,2023-2024
ME,2024-04-30,inter-ucx,0,0,0,0,0,0,0,0,0,0,0,0,0,0,FALSE,0,2023,2023-2024
ME,2024-04-30,inter-ui,34,4,3,0,1,1,1,1,0,1,13,59,47,51,FALSE,0.864406779661017,2023,2023-2024
ME,2024-04-30,intra-total,1113,116,31,23,13,16,4,3,4,18,329,1670,1442,1558,FALSE,0.932934131736527,2023,2023-2024
ME,2024-04-30,intra-ucfe,0,0,0,0,0,0,0,0,0,0,1,1,1,1,FALSE,1,2023,2023-2024
ME,2024-04-30,intra-ucx,0,1,0,0,0,0,0,0,0,0,0,1,0,1,FALSE,1,2023,2023-2024
ME,2024-04-30,intra-ui,1113,115,31,23,13,16,4,3,4,18,328,1668,1441,1556,FALSE,0.932853717026379,2023,2023-2024
ME,2024-05-31,inter-total,23,5,5,3,0,0,0,0,0,1,13,50,36,41,FALSE,0.82,2023,2023-2024
ME,2024-05-31,inter-ucfe,0,0,0,0,0,0,0,0,0,0,0,0,0,0,FALSE,0,2023,2023-2024
ME,2024-05-31,inter-ucx,0,0,0,0,0,0,0,0,0,0,0,0,0,0,FALSE,0,2023,2023-2024
ME,2024-05-31,inter-ui,23,5,5,3,0,0,0,0,0,1,13,50,36,41,FALSE,0.82,2023,2023-2024
ME,2024-05-31,intra-total,813,96,34,17,16,8,5,5,1,15,272,1282,1085,1181,FALSE,0.921216848673947,2023,2023-2024
ME,2024-05-31,intra-ucfe,1,0,1,1,0,0,0,0,0,0,0,3,1,1,FALSE,0.333333333333333,2023,2023-2024
ME,2024-05-31,intra-ucx,1,0,0,0,0,0,0,0,0,0,1,2,2,2,FALSE,1,2023,2023-2024
ME,2024-05-31,intra-ui,811,96,33,16,16,8,5,5,1,15,271,1277,1082,1178,FALSE,0.92247454972592,2023,2023-2024
ME,2024-06-30,inter-total,25,3,1,0,1,0,2,2,0,1,5,40,30,33,FALSE,0.825,2023,2023-2024
ME,2024-06-30,inter-ucfe,0,0,0,0,0,0,0,0,0,0,0,0,0,0,FALSE,0,2023,2023-2024
ME,2024-06-30,inter-ucx,0,0,0,0,0,0,0,0,0,0,0,0,0,0,FALSE,0,2023,2023-2024
ME,2024-06-30,inter-ui,25,3,1,0,1,0,2,2,0,1,5,40,30,33,FALSE,0.825,2023,2023-2024
ME,2024-06-30,intra-total,555,56,26,26,11,9,4,6,3,11,196,903,751,807,FALSE,0.893687707641196,2023,2023-2024
ME,2024-06-30,intra-ucfe,0,2,0,0,0,0,0,0,0,0,1,3,1,3,FALSE,1,2023,2023-2024
ME,2024-06-30,intra-ucx,0,0,0,0,0,0,0,0,0,0,0,0,0,0,FALSE,0,2023,2023-2024
ME,2024-06-30,intra-ui,555,54,26,26,11,9,4,6,3,11,195,900,750,804,FALSE,0.893333333333333,2023,2023-2024
ME,2024-07-31,inter-total,18,11,5,0,0,1,0,0,0,0,16,51,34,45,FALSE,0.882352941176471,2024,2024-2025
ME,2024-07-31,inter-ucfe,0,0,0,0,0,0,0,0,0,0,0,0,0,0,FALSE,0,2024,2024-2025
ME,2024-07-31,inter-ucx,0,0,0,0,0,0,0,0,0,0,0,0,0,0,FALSE,0,2024,2024-2025
ME,2024-07-31,inter-ui,18,11,5,0,0,1,0,0,0,0,16,51,34,45,FALSE,0.882352941176471,2024,2024-2025
ME,2024-07-31,intra-total,903,96,30,19,21,7,9,4,4,17,263,1373,1166,1262,FALSE,0.919155134741442,2024,2024-2025
ME,2024-07-31,intra-ucfe,2,0,0,0,0,0,0,0,0,0,0,2,2,2,FALSE,1,2024,2024-2025
ME,2024-07-31,intra-ucx,1,0,0,0,0,0,0,0,0,0,1,2,2,2,FALSE,1,2024,2024-2025
ME,2024-07-31,intra-ui,900,96,30,19,21,7,9,4,4,17,262,1369,1162,1258,FALSE,0.918918918918919,2024,2024-2025
ME,2024-08-31,inter-total,17,7,6,0,1,1,2,0,0,2,11,47,28,35,FALSE,0.74468085106383,2024,2024-2025
ME,2024-08-31,inter-ucfe,1,0,0,0,0,0,0,0,0,0,0,1,1,1,FALSE,1,2024,2024-2025
ME,2024-08-31,inter-ucx,0,0,0,0,0,0,0,0,0,0,1,1,1,1,FALSE,1,2024,2024-2025
ME,2024-08-31,inter-ui,16,7,6,0,1,1,2,0,0,2,10,45,26,33,FALSE,0.733333333333333,2024,2024-2025
ME,2024-08-31,intra-total,554,57,22,25,11,6,7,4,0,15,198,899,752,809,FALSE,0.899888765294772,2024,2024-2025
ME,2024-08-31,intra-ucfe,2,1,0,1,0,0,0,0,0,0,0,4,2,3,FALSE,0.75,2024,2024-2025
ME,2024-08-31,intra-ucx,2,0,0,0,0,0,0,0,0,0,0,2,2,2,FALSE,1,2024,2024-2025
ME,2024-08-31,intra-ui,550,56,22,24,11,6,7,4,0,15,198,893,748,804,FALSE,0.9003359462486,2024,2024-2025
ME,2024-09-30,inter-total,21,6,2,1,4,0,0,0,0,1,16,51,37,43,FALSE,0.843137254901961,2024,2024-2025
ME,2024-09-30,inter-ucfe,0,0,1,0,0,0,0,0,0,0,0,1,0,0,FALSE,0,2024,2024-2025
ME,2024-09-30,inter-ucx,0,0,0,0,0,0,0,0,0,0,0,0,0,0,FALSE,0,2024,2024-2025
ME,2024-09-30,inter-ui,21,6,1,1,4,0,0,0,0,1,16,50,37,43,FALSE,0.86,2024,2024-2025
ME,2024-09-30,intra-total,520,52,24,8,17,13,5,4,2,9,212,866,732,784,FALSE,0.905311778290993,2024,2024-2025
ME,2024-09-30,intra-ucfe,0,0,1,0,0,0,0,0,0,0,2,3,2,2,FALSE,0.666666666666667,2024,2024-2025
ME,2024-09-30,intra-ucx,2,0,0,0,0,0,0,0,0,0,0,2,2,2,FALSE,1,2024,2024-2025
ME,2024-09-30,intra-ui,518,52,23,8,17,13,5,4,2,9,210,861,728,780,FALSE,0.905923344947735,2024,2024-2025
ME,2024-10-31,inter-total,30,6,3,2,1,1,0,0,0,0,9,52,39,45,FALSE,0.865384615384615,2024,2024-2025
ME,2024-10-31,inter-ucfe,1,0,0,0,0,0,0,0,0,0,0,1,1,1,FALSE,1,2024,2024-2025
ME,2024-10-31,inter-ucx,1,0,0,0,0,0,0,0,0,0,0,1,1,1,FALSE,1,2024,2024-2025
ME,2024-10-31,inter-ui,28,6,3,2,1,1,0,0,0,0,9,50,37,43,FALSE,0.86,2024,2024-2025
ME,2024-10-31,intra-total,555,64,30,19,10,10,8,5,5,8,261,975,816,880,FALSE,0.902564102564103,2024,2024-2025
ME,2024-10-31,intra-ucfe,2,1,0,0,0,0,0,0,0,0,1,4,3,4,FALSE,1,2024,2024-2025
ME,2024-10-31,intra-ucx,0,0,0,0,0,0,0,0,0,0,0,0,0,0,FALSE,0,2024,2024-2025
ME,2024-10-31,intra-ui,553,63,30,19,10,10,8,5,5,8,260,971,813,876,FALSE,0.90216271884655,2024,2024-2025
ME,2024-11-30,inter-total,79,8,1,0,2,0,0,0,0,0,26,116,105,113,FALSE,0.974137931034483,2024,2024-2025
ME,2024-11-30,inter-ucfe,1,0,0,0,0,0,0,0,0,0,2,3,3,3,FALSE,1,2024,2024-2025
ME,2024-11-30,inter-ucx,0,0,0,0,0,0,0,0,0,0,0,0,0,0,FALSE,0,2024,2024-2025
ME,2024-11-30,inter-ui,78,8,1,0,2,0,0,0,0,0,24,113,102,110,FALSE,0.973451327433628,2024,2024-2025
ME,2024-11-30,intra-total,953,71,21,16,8,6,5,1,4,12,313,1410,1266,1337,FALSE,0.94822695035461,2024,2024-2025
ME,2024-11-30,intra-ucfe,5,1,1,0,0,0,0,0,0,0,0,7,5,6,FALSE,0.857142857142857,2024,2024-2025
ME,2024-11-30,intra-ucx,1,0,0,0,0,0,0,0,0,0,0,1,1,1,FALSE,1,2024,2024-2025
ME,2024-11-30,intra-ui,947,70,20,16,8,6,5,1,4,12,313,1402,1260,1330,FALSE,0.948644793152639,2024,2024-2025
ME,2024-12-31,inter-total,115,20,13,5,4,1,1,0,0,2,35,196,150,170,FALSE,0.86734693877551,2024,2024-2025
ME,2024-12-31,inter-ucfe,0,1,1,0,0,0,0,0,0,0,1,3,1,2,FALSE,0.666666666666667,2024,2024-2025
ME,2024-12-31,inter-ucx,0,0,0,0,0,0,0,0,0,0,0,0,0,0,FALSE,0,2024,2024-2025
ME,2024-12-31,inter-ui,115,19,12,5,4,1,1,0,0,2,34,193,149,168,FALSE,0.870466321243523,2024,2024-2025
ME,2024-12-31,intra-total,1817,143,46,29,16,13,2,4,2,14,501,2587,2318,2461,FALSE,0.951294936219559,2024,2024-2025
ME,2024-12-31,intra-ucfe,3,0,1,0,0,1,0,0,0,0,1,6,4,4,FALSE,0.666666666666667,2024,2024-2025
ME,2024-12-31,intra-ucx,4,0,0,0,0,0,0,0,0,0,1,5,5,5,FALSE,1,2024,2024-2025
ME,2024-12-31,intra-ui,1810,143,45,29,16,12,2,4,2,14,499,2576,2309,2452,FALSE,0.951863354037267,2024,2024-2025
MI,2019-01-31,inter-total,2,82,28,18,16,9,4,4,0,9,220,392,222,304,TRUE,0.566326530612245,2018,2018-2019
MI,2019-01-31,inter-ucfe,0,0,1,1,0,0,0,0,0,1,0,3,0,0,TRUE,0,2018,2018-2019
MI,2019-01-31,inter-ucx,0,0,0,0,0,0,0,0,0,0,0,0,0,0,TRUE,0,2018,2018-2019
MI,2019-01-31,inter-ui,2,82,27,17,16,9,4,4,0,8,220,389,222,304,TRUE,0.570694087403599,2018,2018-2019
MI,2019-01-31,intra-total,972,7867,2597,987,463,237,173,77,75,315,27277,41040,28249,36116,TRUE,0.688328460038986,2018,2018-2019
MI,2019-01-31,intra-ucfe,1,37,30,2,3,0,0,0,1,0,20,94,21,58,TRUE,0.223404255319149,2018,2018-2019
MI,2019-01-31,intra-ucx,3,3,1,2,1,0,0,0,0,0,12,22,15,18,TRUE,0.681818181818182,2018,2018-2019
MI,2019-01-31,intra-ui,968,7827,2566,983,459,237,173,77,74,315,27245,40924,28213,36040,TRUE,0.689399863160981,2018,2018-2019
MI,2019-02-28,inter-total,3,50,44,11,18,9,5,3,2,16,84,245,87,137,TRUE,0.355102040816327,2018,2018-2019
MI,2019-02-28,inter-ucfe,0,0,2,0,0,0,0,0,0,0,0,2,0,0,TRUE,0,2018,2018-2019
MI,2019-02-28,inter-ucx,0,0,0,0,0,0,0,0,0,0,0,0,0,0,TRUE,0,2018,2018-2019
MI,2019-02-28,inter-ui,3,50,42,11,18,9,5,3,2,16,84,243,87,137,TRUE,0.358024691358025,2018,2018-2019
MI,2019-02-28,intra-total,523,3171,1858,994,874,572,401,189,121,342,9702,18747,10225,13396,TRUE,0.545420600629434,2018,2018-2019
MI,2019-02-28,intra-ucfe,0,9,21,5,2,3,1,1,1,4,5,52,5,14,TRUE,0.0961538461538462,2018,2018-2019
MI,2019-02-28,intra-ucx,1,2,2,0,0,1,0,0,0,0,7,13,8,10,TRUE,0.615384615384615,2018,2018-2019
MI,2019-02-28,intra-ui,522,3160,1835,989,872,568,400,188,120,338,9690,18682,10212,13372,TRUE,0.546622417300075,2018,2018-2019
MI,2019-03-31,inter-total,6,21,16,8,6,3,4,3,4,9,45,125,51,72,TRUE,0.408,2018,2018-2019
MI,2019-03-31,inter-ucfe,0,0,0,0,0,0,1,0,1,1,0,3,0,0,TRUE,0,2018,2018-2019
MI,2019-03-31,inter-ucx,0,0,0,0,0,0,0,0,0,0,0,0,0,0,TRUE,0,2018,2018-2019
MI,2019-03-31,inter-ui,6,21,16,8,6,3,3,3,3,8,45,122,51,72,TRUE,0.418032786885246,2018,2018-2019
MI,2019-03-31,intra-total,891,1745,811,423,296,257,238,175,134,521,5880,11371,6771,8516,TRUE,0.595462140532935,2018,2018-2019
MI,2019-03-31,intra-ucfe,0,1,4,3,1,2,1,1,1,1,5,20,5,6,TRUE,0.25,2018,2018-2019
MI,2019-03-31,intra-ucx,0,2,0,1,0,0,0,0,0,1,7,11,7,9,TRUE,0.636363636363636,2018,2018-2019
MI,2019-03-31,intra-ui,891,1742,807,419,295,255,237,174,133,519,5868,11340,6759,8501,TRUE,0.596031746031746,2018,2018-2019
MI,2019-04-30,inter-total,3,34,17,4,6,3,2,4,4,7,98,182,101,135,TRUE,0.554945054945055,2018,2018-2019
MI,2019-04-30,inter-ucfe,0,0,0,0,0,0,0,0,0,0,0,0,0,0,TRUE,0,2018,2018-2019
MI,2019-04-30,inter-ucx,0,0,0,0,0,0,0,0,0,0,0,0,0,0,TRUE,0,2018,2018-2019
MI,2019-04-30,inter-ui,3,34,17,4,6,3,2,4,4,7,98,182,101,135,TRUE,0.554945054945055,2018,2018-2019
MI,2019-04-30,intra-total,296,1523,704,384,294,247,251,106,111,488,5530,9934,5826,7349,TRUE,0.586470706663982,2018,2018-2019
MI,2019-04-30,intra-ucfe,1,4,5,3,1,1,0,2,0,4,5,26,6,10,TRUE,0.230769230769231,2018,2018-2019
MI,2019-04-30,intra-ucx,3,1,2,1,0,0,0,0,0,0,13,20,16,17,TRUE,0.8,2018,2018-2019
MI,2019-04-30,intra-ui,292,1518,697,380,293,246,251,104,111,484,5512,9888,5804,7322,TRUE,0.586974110032362,2018,2018-2019
MI,2019-05-31,inter-total,8,22,13,6,5,3,3,2,1,9,83,155,91,113,TRUE,0.587096774193548,2018,2018-2019
MI,2019-05-31,inter-ucfe,0,0,0,0,0,0,0,0,0,0,0,0,0,0,TRUE,0,2018,2018-2019
MI,2019-05-31,inter-ucx,0,0,0,0,0,0,0,0,0,0,0,0,0,0,TRUE,0,2018,2018-2019
MI,2019-05-31,inter-ui,8,22,13,6,5,3,3,2,1,9,83,155,91,113,TRUE,0.587096774193548,2018,2018-2019
MI,2019-05-31,intra-total,800,1519,639,304,238,156,118,200,108,372,5923,10377,6723,8242,TRUE,0.647875108412836,2018,2018-2019
MI,2019-05-31,intra-ucfe,0,5,1,1,0,0,1,0,0,0,3,11,3,8,TRUE,0.272727272727273,2018,2018-2019
MI,2019-05-31,intra-ucx,1,1,2,0,0,0,0,0,0,0,9,13,10,11,TRUE,0.769230769230769,2018,2018-2019
MI,2019-05-31,intra-ui,799,1513,636,303,238,156,117,200,108,372,5911,10353,6710,8223,TRUE,0.648121317492514,2018,2018-2019
MI,2019-06-30,inter-total,1,36,14,5,8,3,0,1,1,13,56,138,57,93,TRUE,0.41304347826087,2018,2018-2019
MI,2019-06-30,inter-ucfe,0,0,0,0,1,0,0,0,0,0,0,1,0,0,TRUE,0,2018,2018-2019
MI,2019-06-30,inter-ucx,0,0,1,0,0,0,0,0,0,0,1,2,1,1,TRUE,0.5,2018,2018-2019
MI,2019-06-30,inter-ui,1,36,13,5,7,3,0,1,1,13,55,135,56,92,TRUE,0.414814814814815,2018,2018-2019
MI,2019-06-30,intra-total,348,1463,588,303,248,205,90,112,71,409,5216,9053,5564,7027,TRUE,0.614602894068265,2018,2018-2019
MI,2019-06-30,intra-ucfe,0,3,1,1,1,1,0,0,0,0,6,13,6,9,TRUE,0.461538461538462,2018,2018-2019
MI,2019-06-30,intra-ucx,1,1,0,1,0,0,0,0,0,1,2,6,3,4,TRUE,0.5,2018,2018-2019
MI,2019-06-30,intra-ui,347,1459,587,301,247,204,90,112,71,408,5208,9034,5555,7014,TRUE,0.614899269426611,2018,2018-2019
MI,2019-07-31,inter-total,2,28,14,9,7,9,1,1,2,4,75,152,77,105,TRUE,0.506578947368421,2019,2019-2020
MI,2019-07-31,inter-ucfe,0,1,0,1,0,0,0,0,0,0,1,3,1,2,TRUE,0.333333333333333,2019,2019-2020
MI,2019-07-31,inter-ucx,0,0,0,0,0,0,0,0,0,0,0,0,0,0,TRUE,0,2019,2019-2020
MI,2019-07-31,inter-ui,2,27,14,8,7,9,1,1,2,4,74,149,76,103,TRUE,0.51006711409396,2019,2019-2020
MI,2019-07-31,intra-total,1272,3104,1065,508,331,232,150,96,77,379,13983,21197,15255,18359,TRUE,0.719677312827287,2019,2019-2020
MI,2019-07-31,intra-ucfe,0,9,3,2,2,1,0,0,0,1,1,19,1,10,TRUE,0.0526315789473684,2019,2019-2020
MI,2019-07-31,intra-ucx,1,3,0,1,0,0,1,1,0,0,9,16,10,13,TRUE,0.625,2019,2019-2020
MI,2019-07-31,intra-ui,1271,3092,1062,505,329,231,149,95,77,378,13973,21162,15244,18336,TRUE,0.720347793214252,2019,2019-2020
MI,2019-08-31,inter-total,3,19,14,10,4,6,2,0,1,4,38,101,41,60,TRUE,0.405940594059406,2019,2019-2020
MI,2019-08-31,inter-ucfe,0,0,0,0,0,0,0,0,0,0,0,0,0,0,TRUE,0,2019,2019-2020
MI,2019-08-31,inter-ucx,0,0,0,0,0,0,0,0,0,0,0,0,0,0,TRUE,0,2019,2019-2020
MI,2019-08-31,inter-ui,3,19,14,10,4,6,2,0,1,4,38,101,41,60,TRUE,0.405940594059406,2019,2019-2020
MI,2019-08-31,intra-total,355,1917,869,526,326,267,232,126,75,395,4257,9345,4612,6529,TRUE,0.493525949705725,2019,2019-2020
MI,2019-08-31,intra-ucfe,0,0,3,0,1,1,0,0,0,1,2,8,2,2,TRUE,0.25,2019,2019-2020
MI,2019-08-31,intra-ucx,1,3,0,1,1,0,0,0,1,0,5,12,6,9,TRUE,0.5,2019,2019-2020
MI,2019-08-31,intra-ui,354,1914,866,525,324,266,232,126,74,394,4250,9325,4604,6518,TRUE,0.49372654155496,2019,2019-2020
MI,2019-09-30,inter-total,4,23,8,3,3,3,2,2,2,7,26,83,30,53,TRUE,0.36144578313253,2019,2019-2020
MI,2019-09-30,inter-ucfe,0,0,0,0,0,0,0,0,0,0,0,0,0,0,TRUE,0,2019,2019-2020
MI,2019-09-30,inter-ucx,0,0,0,0,0,0,0,0,0,0,0,0,0,0,TRUE,0,2019,2019-2020
MI,2019-09-30,inter-ui,4,23,8,3,3,3,2,2,2,7,26,83,30,53,TRUE,0.36144578313253,2019,2019-2020
MI,2019-09-30,intra-total,224,1439,668,352,209,155,121,113,112,424,4139,7956,4363,5802,TRUE,0.548391151332328,2019,2019-2020
MI,2019-09-30,intra-ucfe,1,3,1,1,0,1,1,0,0,0,3,11,4,7,TRUE,0.363636363636364,2019,2019-2020
MI,2019-09-30,intra-ucx,1,2,0,0,0,0,0,0,0,0,6,9,7,9,TRUE,0.777777777777778,2019,2019-2020
MI,2019-09-30,intra-ui,222,1434,667,351,209,154,120,113,112,424,4130,7936,4352,5786,TRUE,0.548387096774194,2019,2019-2020
MI,2019-10-31,inter-total,6,30,9,2,2,2,1,1,0,11,85,149,91,121,TRUE,0.610738255033557,2019,2019-2020
MI,2019-10-31,inter-ucfe,0,0,0,0,0,0,0,0,0,1,0,1,0,0,TRUE,0,2019,2019-2020
MI,2019-10-31,inter-ucx,0,0,0,0,0,0,0,0,0,0,0,0,0,0,TRUE,0,2019,2019-2020
MI,2019-10-31,inter-ui,6,30,9,2,2,2,1,1,0,10,85,148,91,121,TRUE,0.614864864864865,2019,2019-2020
MI,2019-10-31,intra-total,953,2887,808,372,210,136,98,94,67,505,11157,17287,12110,14997,TRUE,0.700526407126743,2019,2019-2020
MI,2019-10-31,intra-ucfe,1,5,3,0,1,0,0,0,0,1,8,19,9,14,TRUE,0.473684210526316,2019,2019-2020
MI,2019-10-31,intra-ucx,1,2,0,0,0,0,1,0,0,0,14,18,15,17,TRUE,0.833333333333333,2019,2019-2020
MI,2019-10-31,intra-ui,951,2880,805,372,209,136,97,94,67,504,11135,17250,12086,14966,TRUE,0.70063768115942,2019,2019-2020
MI,2019-11-30,inter-total,7,43,16,6,3,0,1,0,1,1,178,256,185,228,TRUE,0.72265625,2019,2019-2020
MI,2019-11-30,inter-ucfe,0,3,0,0,0,0,0,0,0,0,0,3,0,3,TRUE,0,2019,2019-2020
MI,2019-11-30,inter-ucx,0,0,0,0,0,0,0,0,0,0,0,0,0,0,TRUE,0,2019,2019-2020
MI,2019-11-30,inter-ui,7,40,16,6,3,0,1,0,1,1,178,253,185,225,TRUE,0.731225296442688,2019,2019-2020
MI,2019-11-30,intra-total,391,2142,709,337,185,138,99,65,44,266,8206,12582,8597,10739,TRUE,0.683277698299158,2019,2019-2020
MI,2019-11-30,intra-ucfe,0,16,10,1,1,0,2,0,0,0,5,35,5,21,TRUE,0.142857142857143,2019,2019-2020
MI,2019-11-30,intra-ucx,2,2,1,0,0,0,0,0,0,0,8,13,10,12,TRUE,0.769230769230769,2019,2019-2020
MI,2019-11-30,intra-ui,389,2124,698,336,184,138,97,65,44,266,8193,12534,8582,10706,TRUE,0.68469762246689,2019,2019-2020
MI,2019-12-31,inter-total,10,91,31,18,7,1,6,2,0,3,279,448,289,380,TRUE,0.645089285714286,2019,2019-2020
MI,2019-12-31,inter-ucfe,0,2,1,2,1,0,0,0,0,0,0,6,0,2,TRUE,0,2019,2019-2020
MI,2019-12-31,inter-ucx,0,0,0,0,0,0,0,1,0,0,0,1,0,0,TRUE,0,2019,2019-2020
MI,2019-12-31,inter-ui,10,89,30,16,6,1,6,1,0,3,279,441,289,378,TRUE,0.655328798185941,2019,2019-2020
MI,2019-12-31,intra-total,650,3844,1025,421,216,116,71,55,52,258,16083,22791,16733,20577,TRUE,0.734193321925321,2019,2019-2020
MI,2019-12-31,intra-ucfe,0,21,10,5,2,0,0,0,0,1,10,49,10,31,TRUE,0.204081632653061,2019,2019-2020
MI,2019-12-31,intra-ucx,3,3,1,0,0,0,0,0,0,0,8,15,11,14,TRUE,0.733333333333333,2019,2019-2020
MI,2019-12-31,intra-ui,647,3820,1014,416,214,116,71,55,52,257,16065,22727,16712,20532,TRUE,0.735336824041888,2019,2019-2020
MI,2020-01-31,inter-total,5,64,37,20,12,5,1,6,2,8,256,416,261,325,TRUE,0.627403846153846,2019,2019-2020
MI,2020-01-31,inter-ucfe,0,0,0,1,1,0,0,0,0,0,1,3,1,1,TRUE,0.333333333333333,2019,2019-2020
MI,2020-01-31,inter-ucx,0,0,0,1,0,0,0,0,0,0,0,1,0,0,TRUE,0,2019,2019-2020
MI,2020-01-31,inter-ui,5,64,37,18,11,5,1,6,2,8,255,412,260,324,TRUE,0.631067961165049,2019,2019-2020
MI,2020-01-31,intra-total,2087,6098,2118,851,295,165,107,64,44,283,29937,42049,32024,38122,TRUE,0.761587671526077,2019,2019-2020
MI,2020-01-31,intra-ucfe,0,15,13,1,3,1,1,0,0,0,10,44,10,25,TRUE,0.227272727272727,2019,2019-2020
MI,2020-01-31,intra-ucx,4,1,1,0,1,0,1,0,1,0,11,20,15,16,TRUE,0.75,2019,2019-2020
MI,2020-01-31,intra-ui,2083,6082,2104,850,291,164,105,64,43,283,29916,41985,31999,38081,TRUE,0.762153149934501,2019,2019-2020
MI,2020-02-29,inter-total,8,44,22,10,6,5,3,3,1,5,93,200,101,145,TRUE,0.505,2019,2019-2020
MI,2020-02-29,inter-ucfe,0,1,1,0,0,0,0,0,0,0,0,2,0,1,TRUE,0,2019,2019-2020
MI,2020-02-29,inter-ucx,0,0,0,0,0,0,0,0,0,0,0,0,0,0,TRUE,0,2019,2019-2020
MI,2020-02-29,inter-ui,8,43,21,10,6,5,3,3,1,5,93,198,101,144,TRUE,0.51010101010101,2019,2019-2020
MI,2020-02-29,intra-total,500,3148,1357,562,367,203,122,99,49,247,9659,16313,10159,13307,TRUE,0.622754858088641,2019,2019-2020
MI,2020-02-29,intra-ucfe,1,9,9,5,2,0,1,1,0,0,9,37,10,19,TRUE,0.27027027027027,2019,2019-2020
MI,2020-02-29,intra-ucx,0,2,2,0,0,0,0,0,0,1,8,13,8,10,TRUE,0.615384615384615,2019,2019-2020
MI,2020-02-29,intra-ui,499,3137,1346,557,365,203,121,98,49,246,9642,16263,10141,13278,TRUE,0.62356268831089,2019,2019-2020
MI,2020-03-31,inter-total,10,20,13,5,6,4,0,2,3,8,72,143,82,102,TRUE,0.573426573426573,2019,2019-2020
MI,2020-03-31,inter-ucfe,0,0,0,0,0,0,0,0,0,0,0,0,0,0,TRUE,0,2019,2019-2020
MI,2020-03-31,inter-ucx,1,0,0,0,0,0,0,0,0,0,0,1,1,1,TRUE,1,2019,2019-2020
MI,2020-03-31,inter-ui,9,20,13,5,6,4,0,2,3,8,72,142,81,101,TRUE,0.570422535211268,2019,2019-2020
MI,2020-03-31,intra-total,1579,1881,689,305,153,115,125,72,77,394,21487,26877,23066,24947,TRUE,0.858205900956208,2019,2019-2020
MI,2020-03-31,intra-ucfe,1,4,3,4,1,1,1,1,1,0,7,24,8,12,TRUE,0.333333333333333,2019,2019-2020
MI,2020-03-31,intra-ucx,5,4,0,0,0,0,1,0,0,0,7,17,12,16,TRUE,0.705882352941177,2019,2019-2020
MI,2020-03-31,intra-ui,1573,1873,686,301,152,114,123,71,76,394,21473,26836,23046,24919,TRUE,0.858771799075868,2019,2019-2020
MI,2020-04-30,inter-total,439,445,175,71,29,4,2,1,1,3,2424,3594,2863,3308,TRUE,0.796605453533667,2019,2019-2020
MI,2020-04-30,inter-ucfe,0,0,0,0,0,0,0,0,0,0,0,0,0,0,TRUE,0,2019,2019-2020
MI,2020-04-30,inter-ucx,0,0,0,0,0,0,0,0,0,0,0,0,0,0,TRUE,0,2019,2019-2020
MI,2020-04-30,inter-ui,439,445,175,71,29,4,2,1,1,3,2424,3594,2863,3308,TRUE,0.796605453533667,2019,2019-2020
MI,2020-04-30,intra-total,58970,60032,31896,18159,6430,418,150,89,45,343,401931,578463,460901,520933,TRUE,0.796768332633202,2019,2019-2020
MI,2020-04-30,intra-ucfe,3,4,3,0,1,1,1,1,0,0,16,30,19,23,TRUE,0.633333333333333,2019,2019-2020
MI,2020-04-30,intra-ucx,0,3,3,3,1,0,0,0,0,0,8,18,8,11,TRUE,0.444444444444444,2019,2019-2020
MI,2020-04-30,intra-ui,58967,60025,31890,18156,6428,417,149,88,45,343,401907,578415,460874,520899,TRUE,0.796787773484436,2019,2019-2020
MI,2020-05-31,inter-total,163,233,214,273,390,323,178,78,30,4,1048,2934,1211,1444,TRUE,0.412747102931152,2019,2019-2020
MI,2020-05-31,inter-ucfe,0,0,0,0,0,0,0,0,0,0,0,0,0,0,TRUE,0,2019,2019-2020
MI,2020-05-31,inter-ucx,0,0,0,0,0,0,1,0,0,0,0,1,0,0,TRUE,0,2019,2019-2020
MI,2020-05-31,inter-ui,163,233,214,273,390,323,177,78,30,4,1048,2933,1211,1444,TRUE,0.412887828162291,2019,2019-2020
MI,2020-05-31,intra-total,11256,18654,23659,33074,44843,34813,16774,7338,2260,477,75421,268569,86677,105331,TRUE,0.322736428999624,2019,2019-2020
MI,2020-05-31,intra-ucfe,0,1,5,1,6,7,4,1,1,0,1,27,1,2,TRUE,0.037037037037037,2019,2019-2020
MI,2020-05-31,intra-ucx,0,0,1,2,4,5,6,5,1,0,2,26,2,2,TRUE,0.0769230769230769,2019,2019-2020
MI,2020-05-31,intra-ui,11256,18653,23653,33071,44833,34801,16764,7332,2258,477,75418,268516,86674,105327,TRUE,0.322788958572301,2019,2019-2020
MI,2020-06-30,inter-total,38,49,63,72,67,73,93,98,112,241,271,1177,309,358,TRUE,0.262531860662702,2019,2019-2020
MI,2020-06-30,inter-ucfe,0,0,0,0,0,0,0,0,0,0,0,0,0,0,TRUE,0,2019,2019-2020
MI,2020-06-30,inter-ucx,0,0,0,0,0,0,0,0,0,0,0,0,0,0,TRUE,0,2019,2019-2020
MI,2020-06-30,inter-ui,38,49,63,72,67,73,93,98,112,241,271,1177,309,358,TRUE,0.262531860662702,2019,2019-2020
MI,2020-06-30,intra-total,3582,4246,4857,4495,3750,4140,6310,7927,7050,18644,24815,89816,28397,32643,TRUE,0.316168611383272,2019,2019-2020
MI,2020-06-30,intra-ucfe,1,1,0,0,0,0,0,2,2,7,0,13,1,2,TRUE,0.0769230769230769,2019,2019-2020
MI,2020-06-30,intra-ucx,0,0,0,0,0,0,1,3,5,29,2,40,2,2,TRUE,0.05,2019,2019-2020
MI,2020-06-30,intra-ui,3581,4245,4857,4495,3750,4140,6309,7922,7043,18608,24813,89763,28394,32639,TRUE,0.316321869812729,2019,2019-2020
MI,2020-07-31,inter-total,32,54,46,29,20,21,44,35,29,314,188,812,220,274,TRUE,0.270935960591133,2020,2020-2021
MI,2020-07-31,inter-ucfe,0,0,0,0,0,0,0,0,0,1,0,1,0,0,TRUE,0,2020,2020-2021
MI,2020-07-31,inter-ucx,0,0,0,0,0,0,0,0,0,0,0,0,0,0,TRUE,0,2020,2020-2021
MI,2020-07-31,inter-ui,32,54,46,29,20,21,44,35,29,313,188,811,220,274,TRUE,0.271270036991369,2020,2020-2021
MI,2020-07-31,intra-total,3547,3655,2298,1839,1963,1881,2608,2228,1550,18485,23112,63166,26659,30314,TRUE,0.422046670677263,2020,2020-2021
MI,2020-07-31,intra-ucfe,0,2,2,0,2,0,0,1,1,25,2,35,2,4,TRUE,0.0571428571428571,2020,2020-2021
MI,2020-07-31,intra-ucx,0,0,1,2,1,1,0,1,1,36,2,45,2,2,TRUE,0.0444444444444444,2020,2020-2021
MI,2020-07-31,intra-ui,3547,3653,2295,1837,1960,1880,2608,2226,1548,18424,23108,63086,26655,30308,TRUE,0.42251846685477,2020,2020-2021
MI,2020-08-31,inter-total,19,25,15,12,13,17,14,17,22,335,146,635,165,190,TRUE,0.259842519685039,2020,2020-2021
MI,2020-08-31,inter-ucfe,0,0,1,0,0,0,0,0,0,0,0,1,0,0,TRUE,0,2020,2020-2021
MI,2020-08-31,inter-ucx,0,0,0,0,0,0,0,0,0,0,0,0,0,0,TRUE,0,2020,2020-2021
MI,2020-08-31,inter-ui,19,25,14,12,13,17,14,17,22,335,146,634,165,190,TRUE,0.260252365930599,2020,2020-2021
MI,2020-08-31,intra-total,1472,1431,915,747,728,872,1049,1334,995,18209,10432,38184,11904,13335,TRUE,0.311753614079196,2020,2020-2021
MI,2020-08-31,intra-ucfe,1,2,0,0,1,1,0,2,1,11,2,21,3,5,TRUE,0.142857142857143,2020,2020-2021
MI,2020-08-31,intra-ucx,2,1,0,0,1,0,0,2,0,6,1,13,3,4,TRUE,0.230769230769231,2020,2020-2021
MI,2020-08-31,intra-ui,1469,1428,915,747,726,871,1049,1330,994,18192,10429,38150,11898,13326,TRUE,0.311874180865007,2020,2020-2021
MI,2020-09-30,inter-total,12,17,8,5,3,5,12,12,18,205,115,412,127,144,TRUE,0.308252427184466,2020,2020-2021
MI,2020-09-30,inter-ucfe,0,0,0,0,0,0,1,0,0,0,0,1,0,0,TRUE,0,2020,2020-2021
MI,2020-09-30,inter-ucx,0,0,0,0,0,0,0,0,0,1,0,1,0,0,TRUE,0,2020,2020-2021
MI,2020-09-30,inter-ui,12,17,8,5,3,5,11,12,18,204,115,410,127,144,TRUE,0.309756097560976,2020,2020-2021
MI,2020-09-30,intra-total,1491,1019,558,316,330,341,455,669,845,9197,8439,23660,9930,10949,TRUE,0.419695688926458,2020,2020-2021
MI,2020-09-30,intra-ucfe,1,1,0,0,1,0,0,1,2,7,3,16,4,5,TRUE,0.25,2020,2020-2021
MI,2020-09-30,intra-ucx,0,2,0,0,1,0,0,0,1,6,5,15,5,7,TRUE,0.333333333333333,2020,2020-2021
MI,2020-09-30,intra-ui,1490,1016,558,316,328,341,455,668,842,9184,8431,23629,9921,10937,TRUE,0.419865419611494,2020,2020-2021
MI,2020-10-31,inter-total,5,33,12,9,10,8,8,16,12,146,82,341,87,120,TRUE,0.255131964809384,2020,2020-2021
MI,2020-10-31,inter-ucfe,0,0,0,0,0,0,0,0,0,0,0,0,0,0,TRUE,0,2020,2020-2021
MI,2020-10-31,inter-ucx,0,0,0,0,0,0,0,0,0,0,0,0,0,0,TRUE,0,2020,2020-2021
MI,2020-10-31,inter-ui,5,33,12,9,10,8,8,16,12,146,82,341,87,120,TRUE,0.255131964809384,2020,2020-2021
MI,2020-10-31,intra-total,738,1525,912,609,569,509,433,514,409,8064,5214,19496,5952,7477,TRUE,0.305293393516619,2020,2020-2021
MI,2020-10-31,intra-ucfe,0,0,0,1,1,1,0,0,0,9,0,12,0,0,TRUE,0,2020,2020-2021
MI,2020-10-31,intra-ucx,0,0,0,0,1,0,0,3,2,7,2,15,2,2,TRUE,0.133333333333333,2020,2020-2021
MI,2020-10-31,intra-ui,738,1525,912,608,567,508,433,511,407,8048,5212,19469,5950,7475,TRUE,0.305614053110072,2020,2020-2021
MI,2020-11-30,inter-total,6,71,21,14,8,5,4,15,5,121,120,390,126,197,TRUE,0.323076923076923,2020,2020-2021
MI,2020-11-30,inter-ucfe,0,0,0,0,0,0,0,0,0,0,0,0,0,0,TRUE,0,2020,2020-2021
MI,2020-11-30,inter-ucx,0,0,0,0,0,0,0,0,0,0,0,0,0,0,TRUE,0,2020,2020-2021
MI,2020-11-30,inter-ui,6,71,21,14,8,5,4,15,5,121,120,390,126,197,TRUE,0.323076923076923,2020,2020-2021
MI,2020-11-30,intra-total,476,3461,1187,584,361,315,379,458,645,5163,8371,21400,8847,12308,TRUE,0.413411214953271,2020,2020-2021
MI,2020-11-30,intra-ucfe,1,5,11,5,3,1,0,1,0,14,3,44,4,9,TRUE,0.0909090909090909,2020,2020-2021
MI,2020-11-30,intra-ucx,1,1,0,0,0,1,0,0,0,8,1,12,2,3,TRUE,0.166666666666667,2020,2020-2021
MI,2020-11-30,intra-ui,474,3455,1176,579,358,313,379,457,645,5141,8367,21344,8841,12296,TRUE,0.414214767616192,2020,2020-2021
MI,2020-12-31,inter-total,6,48,22,15,18,13,4,8,3,82,120,339,126,174,TRUE,0.371681415929204,2020,2020-2021
MI,2020-12-31,inter-ucfe,0,0,1,0,0,0,0,2,0,0,1,4,1,1,TRUE,0.25,2020,2020-2021
MI,2020-12-31,inter-ucx,0,0,0,0,0,0,0,0,0,0,0,0,0,0,TRUE,0,2020,2020-2021
MI,2020-12-31,inter-ui,6,48,21,15,18,13,4,6,3,82,119,335,125,173,TRUE,0.373134328358209,2020,2020-2021
MI,2020-12-31,intra-total,958,4141,2013,998,858,780,556,410,229,3829,14642,29414,15600,19741,TRUE,0.530359692663358,2020,2020-2021
MI,2020-12-31,intra-ucfe,1,5,7,9,5,3,4,3,1,15,5,58,6,11,TRUE,0.103448275862069,2020,2020-2021
MI,2020-12-31,intra-ucx,0,2,0,1,1,0,0,0,0,7,0,11,0,2,TRUE,0,2020,2020-2021
MI,2020-12-31,intra-ui,957,4134,2006,988,852,777,552,407,228,3807,14637,29345,15594,19728,TRUE,0.531402283182825,2020,2020-2021
MI,2021-01-31,inter-total,5,28,18,12,7,11,8,14,3,70,59,235,64,92,TRUE,0.272340425531915,2020,2020-2021
MI,2021-01-31,inter-ucfe,0,0,0,0,0,0,0,0,0,1,0,1,0,0,TRUE,0,2020,2020-2021
MI,2021-01-31,inter-ucx,0,0,0,0,0,0,0,0,0,0,0,0,0,0,TRUE,0,2020,2020-2021
MI,2021-01-31,inter-ui,5,28,18,12,7,11,8,14,3,69,59,234,64,92,TRUE,0.273504273504274,2020,2020-2021
MI,2021-01-31,intra-total,1013,4835,2319,876,764,914,687,459,356,2787,19384,34394,20397,25232,TRUE,0.593039483630866,2020,2020-2021
MI,2021-01-31,intra-ucfe,0,4,6,3,1,5,4,2,3,18,3,49,3,7,TRUE,0.0612244897959184,2020,2020-2021
MI,2021-01-31,intra-ucx,0,2,3,0,1,1,0,0,0,9,2,18,2,4,TRUE,0.111111111111111,2020,2020-2021
MI,2021-01-31,intra-ui,1013,4829,2310,873,762,908,683,457,353,2760,19379,34327,20392,25221,TRUE,0.594051329856964,2020,2020-2021
MI,2021-02-28,inter-total,5,16,23,34,50,51,17,24,14,59,9,302,14,30,TRUE,0.0463576158940397,2020,2020-2021
MI,2021-02-28,inter-ucfe,0,0,0,0,0,0,1,0,0,0,0,1,0,0,TRUE,0,2020,2020-2021
MI,2021-02-28,inter-ucx,0,0,0,0,0,0,0,0,0,0,0,0,0,0,TRUE,0,2020,2020-2021
MI,2021-02-28,inter-ui,5,16,23,34,50,51,16,24,14,59,9,301,14,30,TRUE,0.0465116279069768,2020,2020-2021
MI,2021-02-28,intra-total,918,2174,1551,1268,993,1243,877,559,369,2624,7301,19877,8219,10393,TRUE,0.413492981838306,2020,2020-2021
MI,2021-02-28,intra-ucfe,0,1,9,3,0,1,1,0,1,22,1,39,1,2,TRUE,0.0256410256410256,2020,2020-2021
MI,2021-02-28,intra-ucx,0,2,0,1,0,0,0,0,0,5,0,8,0,2,TRUE,0,2020,2020-2021
MI,2021-02-28,intra-ui,918,2171,1542,1264,993,1242,876,559,368,2597,7300,19830,8218,10389,TRUE,0.414422592032274,2020,2020-2021
MI,2021-03-31,inter-total,9,14,12,14,10,21,15,11,12,132,17,267,26,40,TRUE,0.0973782771535581,2020,2020-2021
MI,2021-03-31,inter-ucfe,0,0,0,0,1,0,0,0,0,0,0,1,0,0,TRUE,0,2020,2020-2021
MI,2021-03-31,inter-ucx,0,0,0,0,0,0,0,0,0,0,0,0,0,0,TRUE,0,2020,2020-2021
MI,2021-03-31,inter-ui,9,14,12,14,9,21,15,11,12,132,17,266,26,40,TRUE,0.0977443609022556,2020,2020-2021
MI,2021-03-31,intra-total,925,1679,1227,683,483,625,773,585,414,4871,4140,16405,5065,6744,TRUE,0.308747333130143,2020,2020-2021
MI,2021-03-31,intra-ucfe,0,2,1,1,0,1,2,2,2,36,2,49,2,4,TRUE,0.0408163265306122,2020,2020-2021
MI,2021-03-31,intra-ucx,0,1,1,0,0,0,1,1,0,10,1,15,1,2,TRUE,0.0666666666666667,2020,2020-2021
MI,2021-03-31,intra-ui,925,1676,1225,682,483,624,770,582,412,4825,4137,16341,5062,6738,TRUE,0.309772963710911,2020,2020-2021
MI,2021-04-30,inter-total,41,33,24,4,4,4,2,2,5,55,69,243,110,143,TRUE,0.452674897119342,2020,2020-2021
MI,2021-04-30,inter-ucfe,0,0,0,0,0,0,0,0,0,0,0,0,0,0,TRUE,0,2020,2020-2021
MI,2021-04-30,inter-ucx,0,0,0,0,0,0,0,0,0,0,0,0,0,0,TRUE,0,2020,2020-2021
MI,2021-04-30,inter-ui,41,33,24,4,4,4,2,2,5,55,69,243,110,143,TRUE,0.452674897119342,2020,2020-2021
MI,2021-04-30,intra-total,4432,2831,1282,566,237,172,113,152,137,2597,14277,26796,18709,21540,TRUE,0.698201224063293,2020,2020-2021
MI,2021-04-30,intra-ucfe,0,2,3,0,0,0,0,0,0,15,1,21,1,3,TRUE,0.0476190476190476,2020,2020-2021
MI,2021-04-30,intra-ucx,1,1,0,0,0,0,0,0,0,5,1,8,2,3,TRUE,0.25,2020,2020-2021
MI,2021-04-30,intra-ui,4431,2828,1279,566,237,172,113,152,137,2577,14275,26767,18706,21534,TRUE,0.698845593454627,2020,2020-2021
MI,2021-05-31,inter-total,7,9,29,43,4,5,2,1,0,63,52,215,59,68,TRUE,0.274418604651163,2020,2020-2021
MI,2021-05-31,inter-ucfe,0,0,0,0,0,0,0,0,0,0,0,0,0,0,TRUE,0,2020,2020-2021
MI,2021-05-31,inter-ucx,0,0,0,0,0,0,0,0,0,0,0,0,0,0,TRUE,0,2020,2020-2021
MI,2021-05-31,inter-ui,7,9,29,43,4,5,2,1,0,63,52,215,59,68,TRUE,0.274418604651163,2020,2020-2021
MI,2021-05-31,intra-total,2234,3652,3461,2595,781,331,169,88,72,2688,16619,32690,18853,22505,TRUE,0.576720709697155,2020,2020-2021
MI,2021-05-31,intra-ucfe,0,1,1,0,2,0,1,0,0,12,0,17,0,1,TRUE,0,2020,2020-2021
MI,2021-05-31,intra-ucx,2,1,0,0,0,0,0,0,0,7,1,11,3,4,TRUE,0.272727272727273,2020,2020-2021
MI,2021-05-31,intra-ui,2232,3650,3460,2595,779,331,168,88,72,2669,16618,32662,18850,22500,TRUE,0.577123262506889,2020,2020-2021
MI,2021-06-30,inter-total,9,2,7,28,38,23,11,4,1,44,63,230,72,74,TRUE,0.31304347826087,2020,2020-2021
MI,2021-06-30,inter-ucfe,0,0,0,0,0,0,0,0,0,0,0,0,0,0,TRUE,0,2020,2020-2021
MI,2021-06-30,inter-ucx,0,0,0,0,0,0,0,0,0,0,0,0,0,0,TRUE,0,2020,2020-2021
MI,2021-06-30,inter-ui,9,2,7,28,38,23,11,4,1,44,63,230,72,74,TRUE,0.31304347826087,2020,2020-2021
MI,2021-06-30,intra-total,1259,1108,548,1552,2779,1803,1300,717,467,2362,5959,19854,7218,8326,TRUE,0.363553943789665,2020,2020-2021
MI,2021-06-30,intra-ucfe,0,0,0,0,0,0,2,1,1,9,0,13,0,0,TRUE,0,2020,2020-2021
MI,2021-06-30,intra-ucx,0,2,1,1,1,1,1,1,1,12,0,21,0,2,TRUE,0,2020,2020-2021
MI,2021-06-30,intra-ui,1259,1106,547,1551,2778,1802,1297,715,465,2341,5959,19820,7218,8324,TRUE,0.364177598385469,2020,2020-2021
MI,2021-07-31,inter-total,0,2,21,15,28,15,8,4,0,46,8,147,8,10,TRUE,0.054421768707483,2021,2021-2022
MI,2021-07-31,inter-ucfe,0,0,0,0,0,0,0,0,0,0,0,0,0,0,TRUE,0,2021,2021-2022
MI,2021-07-31,inter-ucx,0,0,0,0,0,0,0,0,0,0,0,0,0,0,TRUE,0,2021,2021-2022
MI,2021-07-31,inter-ui,0,2,21,15,28,15,8,4,0,46,8,147,8,10,TRUE,0.054421768707483,2021,2021-2022
MI,2021-07-31,intra-total,617,731,603,707,801,614,450,375,407,3387,7631,16323,8248,8979,TRUE,0.505299270967347,2021,2021-2022
MI,2021-07-31,intra-ucfe,0,0,1,1,0,1,0,0,0,8,0,11,0,0,TRUE,0,2021,2021-2022
MI,2021-07-31,intra-ucx,0,2,0,0,1,0,0,2,0,7,0,12,0,2,TRUE,0,2021,2021-2022
MI,2021-07-31,intra-ui,617,729,602,706,800,613,450,373,407,3372,7631,16300,8248,8977,TRUE,0.50601226993865,2021,2021-2022
MI,2021-08-31,inter-total,3,4,13,17,12,2,2,0,0,38,43,134,46,50,TRUE,0.343283582089552,2021,2021-2022
MI,2021-08-31,inter-ucfe,0,0,0,0,0,0,0,0,0,1,0,1,0,0,TRUE,0,2021,2021-2022
MI,2021-08-31,inter-ucx,0,0,0,0,0,0,0,0,0,0,0,0,0,0,TRUE,0,2021,2021-2022
MI,2021-08-31,inter-ui,3,4,13,17,12,2,2,0,0,37,43,133,46,50,TRUE,0.345864661654135,2021,2021-2022
MI,2021-08-31,intra-total,368,1809,1224,833,633,336,210,148,103,2375,8472,16511,8840,10649,TRUE,0.535400641996245,2021,2021-2022
MI,2021-08-31,intra-ucfe,0,0,0,1,0,0,0,0,0,10,0,11,0,0,TRUE,0,2021,2021-2022
MI,2021-08-31,intra-ucx,0,1,1,0,0,0,0,0,0,5,2,9,2,3,TRUE,0.222222222222222,2021,2021-2022
MI,2021-08-31,intra-ui,368,1808,1223,832,633,336,210,148,103,2360,8470,16491,8838,10646,TRUE,0.535928688375478,2021,2021-2022
MI,2021-09-30,inter-total,1,0,2,3,1,13,22,26,4,56,2,130,3,3,TRUE,0.0230769230769231,2021,2021-2022
MI,2021-09-30,inter-ucfe,0,0,0,0,0,0,0,0,0,1,0,1,0,0,TRUE,0,2021,2021-2022
MI,2021-09-30,inter-ucx,0,0,0,0,0,0,0,0,0,0,0,0,0,0,TRUE,0,2021,2021-2022
MI,2021-09-30,inter-ui,1,0,2,3,1,13,22,26,4,55,2,129,3,3,TRUE,0.0232558139534884,2021,2021-2022
MI,2021-09-30,intra-total,464,703,276,222,263,672,1422,1442,831,2931,4054,13280,4518,5221,TRUE,0.340210843373494,2021,2021-2022
MI,2021-09-30,intra-ucfe,0,1,0,0,0,0,1,0,0,16,1,19,1,2,TRUE,0.0526315789473684,2021,2021-2022
MI,2021-09-30,intra-ucx,0,0,0,0,0,0,0,2,1,12,4,19,4,4,TRUE,0.210526315789474,2021,2021-2022
MI,2021-09-30,intra-ui,464,702,276,222,263,672,1421,1440,830,2903,4049,13242,4513,5215,TRUE,0.340809545385893,2021,2021-2022
MI,2021-10-31,inter-total,1,3,0,2,7,2,2,1,2,46,7,73,8,11,TRUE,0.10958904109589,2021,2021-2022
MI,2021-10-31,inter-ucfe,0,0,0,0,0,0,0,0,0,0,0,0,0,0,TRUE,0,2021,2021-2022
MI,2021-10-31,inter-ucx,0,0,0,0,0,0,0,0,0,0,1,1,1,1,TRUE,1,2021,2021-2022
MI,2021-10-31,inter-ui,1,3,0,2,7,2,2,1,2,46,6,72,7,10,TRUE,0.0972222222222222,2021,2021-2022
MI,2021-10-31,intra-total,253,552,392,175,259,225,213,184,170,2923,3482,8828,3735,4287,TRUE,0.423085636610784,2021,2021-2022
MI,2021-10-31,intra-ucfe,0,1,1,1,1,1,0,0,0,6,0,11,0,1,TRUE,0,2021,2021-2022
MI,2021-10-31,intra-ucx,2,0,0,1,0,0,1,1,0,2,1,8,3,3,TRUE,0.375,2021,2021-2022
MI,2021-10-31,intra-ui,251,551,391,173,258,224,212,183,170,2915,3481,8809,3732,4283,TRUE,0.423657622885685,2021,2021-2022
MI,2021-11-30,inter-total,0,1,2,1,1,1,1,0,2,42,12,63,12,13,TRUE,0.19047619047619,2021,2021-2022
MI,2021-11-30,inter-ucfe,0,0,0,0,0,0,0,0,0,0,0,0,0,0,TRUE,0,2021,2021-2022
MI,2021-11-30,inter-ucx,0,0,0,0,0,0,0,0,0,0,0,0,0,0,TRUE,0,2021,2021-2022
MI,2021-11-30,inter-ui,0,1,2,1,1,1,1,0,2,42,12,63,12,13,TRUE,0.19047619047619,2021,2021-2022
MI,2021-11-30,intra-total,302,725,197,114,110,101,98,79,72,2116,4200,8114,4502,5227,TRUE,0.55484348040424,2021,2021-2022
MI,2021-11-30,intra-ucfe,0,3,9,3,1,0,1,0,0,5,0,22,0,3,TRUE,0,2021,2021-2022
MI,2021-11-30,intra-ucx,3,0,0,1,0,0,0,0,0,0,2,6,5,5,TRUE,0.833333333333333,2021,2021-2022
MI,2021-11-30,intra-ui,299,722,188,110,109,101,97,79,72,2111,4198,8086,4497,5219,TRUE,0.556146425921346,2021,2021-2022
MI,2021-12-31,inter-total,0,8,6,10,3,1,3,4,0,98,5,138,5,13,TRUE,0.036231884057971,2021,2021-2022
MI,2021-12-31,inter-ucfe,0,1,2,2,0,0,0,0,0,2,2,9,2,3,TRUE,0.222222222222222,2021,2021-2022
MI,2021-12-31,inter-ucx,0,0,0,0,0,0,0,0,0,0,0,0,0,0,TRUE,0,2021,2021-2022
MI,2021-12-31,inter-ui,0,7,4,8,3,1,3,4,0,96,3,129,3,10,TRUE,0.0232558139534884,2021,2021-2022
MI,2021-12-31,intra-total,228,1309,353,184,177,115,107,119,86,3400,6060,12138,6288,7597,TRUE,0.518042511122096,2021,2021-2022
MI,2021-12-31,intra-ucfe,0,4,13,2,2,1,1,1,0,7,2,33,2,6,TRUE,0.0606060606060606,2021,2021-2022
MI,2021-12-31,intra-ucx,0,0,0,1,0,0,0,1,1,1,0,4,0,0,TRUE,0,2021,2021-2022
MI,2021-12-31,intra-ui,228,1305,340,181,175,114,106,117,85,3392,6058,12101,6286,7591,TRUE,0.519461201553591,2021,2021-2022
MI,2022-01-31,inter-total,1,11,5,3,7,8,9,17,19,140,9,229,10,21,TRUE,0.0436681222707424,2021,2021-2022
MI,2022-01-31,inter-ucfe,0,0,0,0,0,0,0,1,0,0,0,1,0,0,TRUE,0,2021,2021-2022
MI,2022-01-31,inter-ucx,0,0,0,0,0,0,0,0,0,1,0,1,0,0,TRUE,0,2021,2021-2022
MI,2022-01-31,inter-ui,1,11,5,3,7,8,9,16,19,139,9,227,10,21,TRUE,0.0440528634361234,2021,2021-2022
MI,2022-01-31,intra-total,299,2229,680,422,317,259,266,394,519,4904,9213,19502,9512,11741,TRUE,0.487744846682392,2021,2021-2022
MI,2022-01-31,intra-ucfe,2,2,3,2,1,3,0,0,3,19,2,37,4,6,TRUE,0.108108108108108,2021,2021-2022
MI,2022-01-31,intra-ucx,0,0,1,0,0,0,0,0,0,7,2,10,2,2,TRUE,0.2,2021,2021-2022
MI,2022-01-31,intra-ui,297,2227,676,420,316,256,266,394,516,4878,9209,19455,9506,11733,TRUE,0.488614751991776,2021,2021-2022
MI,2022-02-28,inter-total,10,9,16,28,44,24,18,16,3,58,17,243,27,36,TRUE,0.111111111111111,2021,2021-2022
MI,2022-02-28,inter-ucfe,0,0,0,0,0,0,1,0,0,0,0,1,0,0,TRUE,0,2021,2021-2022
MI,2022-02-28,inter-ucx,0,0,0,0,0,0,0,0,0,0,0,0,0,0,TRUE,0,2021,2021-2022
MI,2022-02-28,inter-ui,10,9,16,28,44,24,17,16,3,58,17,242,27,36,TRUE,0.111570247933884,2021,2021-2022
MI,2022-02-28,intra-total,2005,936,756,1111,1751,1211,1081,659,328,2807,4595,17240,6600,7536,TRUE,0.382830626450116,2021,2021-2022
MI,2022-02-28,intra-ucfe,0,1,6,2,1,1,0,1,0,12,3,27,3,4,TRUE,0.111111111111111,2021,2021-2022
MI,2022-02-28,intra-ucx,0,0,0,1,0,1,0,0,0,2,2,6,2,2,TRUE,0.333333333333333,2021,2021-2022
MI,2022-02-28,intra-ui,2005,935,750,1108,1750,1209,1081,658,328,2793,4590,17207,6595,7530,TRUE,0.383274248852211,2021,2021-2022
MI,2022-03-31,inter-total,1,16,13,9,3,3,10,6,5,78,30,174,31,47,TRUE,0.17816091954023,2021,2021-2022
MI,2022-03-31,inter-ucfe,0,0,1,0,0,0,0,0,0,2,0,3,0,0,TRUE,0,2021,2021-2022
MI,2022-03-31,inter-ucx,0,0,0,0,0,0,0,0,0,0,0,0,0,0,TRUE,0,2021,2021-2022
MI,2022-03-31,inter-ui,1,16,12,9,3,3,10,6,5,76,30,171,31,47,TRUE,0.181286549707602,2021,2021-2022
MI,2022-03-31,intra-total,194,965,492,292,237,201,229,228,230,2603,2552,8223,2746,3711,TRUE,0.333941383923142,2021,2021-2022
MI,2022-03-31,intra-ucfe,0,0,0,1,0,0,1,0,1,7,0,10,0,0,TRUE,0,2021,2021-2022
MI,2022-03-31,intra-ucx,0,0,0,0,0,0,0,1,0,2,1,4,1,1,TRUE,0.25,2021,2021-2022
MI,2022-03-31,intra-ui,194,965,492,291,237,201,228,227,229,2594,2551,8209,2745,3710,TRUE,0.334389085150445,2021,2021-2022
MI,2022-04-30,inter-total,7,9,5,1,2,0,1,1,0,57,75,158,82,91,TRUE,0.518987341772152,2021,2021-2022
MI,2022-04-30,inter-ucfe,0,0,0,0,0,0,0,0,0,1,0,1,0,0,TRUE,0,2021,2021-2022
MI,2022-04-30,inter-ucx,0,0,0,0,0,0,0,0,0,0,0,0,0,0,TRUE,0,2021,2021-2022
MI,2022-04-30,inter-ui,7,9,5,1,2,0,1,1,0,56,75,157,82,91,TRUE,0.522292993630573,2021,2021-2022
MI,2022-04-30,intra-total,468,608,135,87,60,50,48,46,44,2446,6188,10180,6656,7264,TRUE,0.653831041257367,2021,2021-2022
MI,2022-04-30,intra-ucfe,0,0,1,0,1,1,0,2,0,8,3,16,3,3,TRUE,0.1875,2021,2021-2022
MI,2022-04-30,intra-ucx,0,2,0,0,1,0,1,0,0,3,1,8,1,3,TRUE,0.125,2021,2021-2022
MI,2022-04-30,intra-ui,468,606,134,87,58,49,47,44,44,2435,6184,10156,6652,7258,TRUE,0.654982276486806,2021,2021-2022
MI,2022-05-31,inter-total,11,12,9,3,1,1,1,1,1,71,29,140,40,52,TRUE,0.285714285714286,2021,2021-2022
MI,2022-05-31,inter-ucfe,0,0,0,0,0,0,0,0,0,0,0,0,0,0,TRUE,0,2021,2021-2022
MI,2022-05-31,inter-ucx,0,0,0,0,0,0,0,0,0,0,0,0,0,0,TRUE,0,2021,2021-2022
MI,2022-05-31,inter-ui,11,12,9,3,1,1,1,1,1,71,29,140,40,52,TRUE,0.285714285714286,2021,2021-2022
MI,2022-05-31,intra-total,2514,768,360,148,99,72,57,70,184,2529,5318,12119,7832,8600,TRUE,0.646257942074429,2021,2021-2022
MI,2022-05-31,intra-ucfe,0,2,0,0,1,0,0,0,0,8,0,11,0,2,TRUE,0,2021,2021-2022
MI,2022-05-31,intra-ucx,0,0,1,1,0,0,0,0,0,2,3,7,3,3,TRUE,0.428571428571429,2021,2021-2022
MI,2022-05-31,intra-ui,2514,766,359,147,98,72,57,70,184,2519,5315,12101,7829,8595,TRUE,0.64697132468391,2021,2021-2022
MI,2022-06-30,inter-total,3,5,5,2,2,0,0,3,0,49,51,120,54,59,TRUE,0.45,2021,2021-2022
MI,2022-06-30,inter-ucfe,0,0,0,0,0,0,0,0,0,0,0,0,0,0,TRUE,0,2021,2021-2022
MI,2022-06-30,inter-ucx,0,0,0,0,0,0,0,0,0,0,0,0,0,0,TRUE,0,2021,2021-2022
MI,2022-06-30,inter-ui,3,5,5,2,2,0,0,3,0,49,51,120,54,59,TRUE,0.45,2021,2021-2022
MI,2022-06-30,intra-total,288,522,193,119,98,75,75,122,74,1744,3176,6486,3464,3986,TRUE,0.534073388837496,2021,2021-2022
MI,2022-06-30,intra-ucfe,0,0,1,0,1,1,0,0,1,6,2,12,2,2,TRUE,0.166666666666667,2021,2021-2022
MI,2022-06-30,intra-ucx,1,1,0,0,0,0,0,1,0,2,0,5,1,2,TRUE,0.2,2021,2021-2022
MI,2022-06-30,intra-ui,287,521,192,119,97,74,75,121,73,1736,3174,6469,3461,3982,TRUE,0.535013139588808,2021,2021-2022
MI,2022-07-31,inter-total,2,7,4,14,3,1,2,0,1,56,38,128,40,47,TRUE,0.3125,2022,2022-2023
MI,2022-07-31,inter-ucfe,0,0,0,0,0,0,0,0,0,1,0,1,0,0,TRUE,0,2022,2022-2023
MI,2022-07-31,inter-ucx,0,0,0,0,0,0,0,0,0,1,0,1,0,0,TRUE,0,2022,2022-2023
MI,2022-07-31,inter-ui,2,7,4,14,3,1,2,0,1,54,38,126,40,47,TRUE,0.317460317460317,2022,2022-2023
MI,2022-07-31,intra-total,943,970,378,307,138,97,81,89,76,2104,5788,10971,6731,7701,TRUE,0.613526570048309,2022,2022-2023
MI,2022-07-31,intra-ucfe,0,1,2,0,0,0,0,0,0,6,0,9,0,1,TRUE,0,2022,2022-2023
MI,2022-07-31,intra-ucx,0,1,0,1,0,0,0,0,0,0,1,3,1,2,TRUE,0.333333333333333,2022,2022-2023
MI,2022-07-31,intra-ui,943,968,376,306,138,97,81,89,76,2098,5787,10959,6730,7698,TRUE,0.614107126562643,2022,2022-2023
MI,2022-08-31,inter-total,1,15,10,9,4,7,4,3,2,59,15,129,16,31,TRUE,0.124031007751938,2022,2022-2023
MI,2022-08-31,inter-ucfe,0,0,0,0,0,0,0,0,0,0,0,0,0,0,TRUE,0,2022,2022-2023
MI,2022-08-31,inter-ucx,0,0,0,0,0,0,0,0,0,0,1,1,1,1,TRUE,1,2022,2022-2023
MI,2022-08-31,inter-ui,1,15,10,9,4,7,4,3,2,59,14,128,15,30,TRUE,0.1171875,2022,2022-2023
MI,2022-08-31,intra-total,247,812,648,569,264,156,138,68,64,2593,3267,8826,3514,4326,TRUE,0.398141853614321,2022,2022-2023
MI,2022-08-31,intra-ucfe,0,2,3,2,2,0,2,0,0,2,3,16,3,5,TRUE,0.1875,2022,2022-2023
MI,2022-08-31,intra-ucx,1,0,0,0,0,0,0,0,0,3,2,6,3,3,TRUE,0.5,2022,2022-2023
MI,2022-08-31,intra-ui,246,810,645,567,262,156,136,68,64,2588,3262,8804,3508,4318,TRUE,0.398455247614721,2022,2022-2023
MI,2022-09-30,inter-total,3,5,5,3,5,0,1,3,1,47,15,88,18,23,TRUE,0.204545454545455,2022,2022-2023
MI,2022-09-30,inter-ucfe,0,0,0,0,0,0,0,0,0,0,0,0,0,0,TRUE,0,2022,2022-2023
MI,2022-09-30,inter-ucx,0,0,0,0,0,0,0,0,0,0,0,0,0,0,TRUE,0,2022,2022-2023
MI,2022-09-30,inter-ui,3,5,5,3,5,0,1,3,1,47,15,88,18,23,TRUE,0.204545454545455,2022,2022-2023
MI,2022-09-30,intra-total,259,509,274,177,100,79,105,87,82,2085,6565,10322,6824,7333,TRUE,0.66111218756055,2022,2022-2023
MI,2022-09-30,intra-ucfe,0,1,0,1,0,0,1,0,0,6,1,10,1,2,TRUE,0.1,2022,2022-2023
MI,2022-09-30,intra-ucx,0,0,0,0,0,0,0,0,0,2,2,4,2,2,TRUE,0.5,2022,2022-2023
MI,2022-09-30,intra-ui,259,508,274,176,100,79,104,87,82,2077,6562,10308,6821,7329,TRUE,0.661719053162592,2022,2022-2023
MI,2022-10-31,inter-total,3,8,3,4,6,6,4,2,0,48,43,127,46,54,TRUE,0.362204724409449,2022,2022-2023
MI,2022-10-31,inter-ucfe,0,0,0,0,0,0,0,0,0,2,0,2,0,0,TRUE,0,2022,2022-2023
MI,2022-10-31,inter-ucx,0,0,0,0,0,0,0,0,0,0,0,0,0,0,TRUE,0,2022,2022-2023
MI,2022-10-31,inter-ui,3,8,3,4,6,6,4,2,0,46,43,125,46,54,TRUE,0.368,2022,2022-2023
MI,2022-10-31,intra-total,543,646,322,186,142,94,66,63,88,2120,3261,7531,3804,4450,TRUE,0.505112202894702,2022,2022-2023
MI,2022-10-31,intra-ucfe,0,3,3,0,1,0,0,0,0,4,5,16,5,8,TRUE,0.3125,2022,2022-2023
MI,2022-10-31,intra-ucx,2,1,1,0,0,0,1,0,0,0,3,8,5,6,TRUE,0.625,2022,2022-2023
MI,2022-10-31,intra-ui,541,642,318,186,141,94,65,63,88,2116,3253,7507,3794,4436,TRUE,0.505394964699614,2022,2022-2023
MI,2022-11-30,inter-total,0,22,15,7,7,5,1,3,1,113,41,215,41,63,TRUE,0.190697674418605,2022,2022-2023
MI,2022-11-30,inter-ucfe,0,1,2,0,0,0,0,0,0,1,0,4,0,1,TRUE,0,2022,2022-2023
MI,2022-11-30,inter-ucx,0,0,0,0,0,0,0,0,0,0,0,0,0,0,TRUE,0,2022,2022-2023
MI,2022-11-30,inter-ui,0,21,13,7,7,5,1,3,1,112,41,211,41,62,TRUE,0.194312796208531,2022,2022-2023
MI,2022-11-30,intra-total,205,997,392,228,395,292,229,170,123,1153,4369,8553,4574,5571,TRUE,0.534783117034959,2022,2022-2023
MI,2022-11-30,intra-ucfe,0,9,8,1,0,0,0,0,0,3,6,27,6,15,TRUE,0.222222222222222,2022,2022-2023
MI,2022-11-30,intra-ucx,1,0,1,0,0,0,0,0,1,0,0,3,1,1,TRUE,0.333333333333333,2022,2022-2023
MI,2022-11-30,intra-ui,204,988,383,227,395,292,229,170,122,1150,4363,8523,4567,5555,TRUE,0.535844186319371,2022,2022-2023
MI,2022-12-31,inter-total,3,37,25,20,13,8,8,4,3,34,46,201,49,86,TRUE,0.243781094527363,2022,2022-2023
MI,2022-12-31,inter-ucfe,0,0,2,1,0,1,0,0,0,0,0,4,0,0,TRUE,0,2022,2022-2023
MI,2022-12-31,inter-ucx,0,0,0,0,0,0,0,0,0,0,0,0,0,0,TRUE,0,2022,2022-2023
MI,2022-12-31,inter-ui,3,37,23,19,13,7,8,4,3,34,46,197,49,86,TRUE,0.248730964467005,2022,2022-2023
MI,2022-12-31,intra-total,355,1732,854,568,328,184,138,79,62,1218,7964,13482,8319,10051,TRUE,0.61704494882065,2022,2022-2023
MI,2022-12-31,intra-ucfe,1,3,10,4,2,2,0,0,0,2,3,27,4,7,TRUE,0.148148148148148,2022,2022-2023
MI,2022-12-31,intra-ucx,0,1,1,0,0,0,0,0,0,1,2,5,2,3,TRUE,0.4,2022,2022-2023
MI,2022-12-31,intra-ui,354,1728,843,564,326,182,138,79,62,1215,7959,13450,8313,10041,TRUE,0.618066914498141,2022,2022-2023
MI,2023-01-31,inter-total,4,64,48,36,28,20,15,18,10,52,88,383,92,156,TRUE,0.240208877284595,2022,2022-2023
MI,2023-01-31,inter-ucfe,0,0,0,0,0,0,0,0,0,0,0,0,0,0,TRUE,0,2022,2022-2023
MI,2023-01-31,inter-ucx,0,0,0,0,0,0,0,0,0,0,0,0,0,0,TRUE,0,2022,2022-2023
MI,2023-01-31,inter-ui,4,64,48,36,28,20,15,18,10,52,88,383,92,156,TRUE,0.240208877284595,2022,2022-2023
MI,2023-01-31,intra-total,481,4398,1963,1210,645,449,332,166,132,1400,13679,24855,14160,18558,TRUE,0.569704284852142,2022,2022-2023
MI,2023-01-31,intra-ucfe,0,3,9,2,0,0,1,0,0,3,1,19,1,4,TRUE,0.0526315789473684,2022,2022-2023
MI,2023-01-31,intra-ucx,0,0,2,0,0,0,1,0,0,1,1,5,1,1,TRUE,0.2,2022,2022-2023
MI,2023-01-31,intra-ui,481,4395,1952,1208,645,449,330,166,132,1396,13677,24831,14158,18553,TRUE,0.570174378800693,2022,2022-2023
MI,2023-02-28,inter-total,9,44,23,17,17,6,7,5,0,30,88,246,97,141,TRUE,0.394308943089431,2022,2022-2023
MI,2023-02-28,inter-ucfe,0,0,1,0,0,0,0,0,0,0,0,1,0,0,TRUE,0,2022,2022-2023
MI,2023-02-28,inter-ucx,0,0,0,0,0,0,0,0,0,0,0,0,0,0,TRUE,0,2022,2022-2023
MI,2023-02-28,inter-ui,9,44,22,17,17,6,7,5,0,30,88,245,97,141,TRUE,0.395918367346939,2022,2022-2023
MI,2023-02-28,intra-total,855,1506,827,614,340,166,139,82,53,1418,7577,13577,8432,9938,TRUE,0.621050305663991,2022,2022-2023
MI,2023-02-28,intra-ucfe,1,1,6,8,0,0,0,1,0,2,2,21,3,4,TRUE,0.142857142857143,2022,2022-2023
MI,2023-02-28,intra-ucx,1,1,1,0,0,0,0,0,0,0,3,6,4,5,TRUE,0.666666666666667,2022,2022-2023
MI,2023-02-28,intra-ui,853,1504,820,606,340,166,139,81,53,1416,7572,13550,8425,9929,TRUE,0.621771217712177,2022,2022-2023
MI,2023-03-31,inter-total,2,27,14,9,12,8,1,2,3,46,46,170,48,75,TRUE,0.282352941176471,2022,2022-2023
MI,2023-03-31,inter-ucfe,0,0,0,0,0,0,0,0,0,0,0,0,0,0,TRUE,0,2022,2022-2023
MI,2023-03-31,inter-ucx,0,0,0,0,0,0,0,0,0,0,0,0,0,0,TRUE,0,2022,2022-2023
MI,2023-03-31,inter-ui,2,27,14,9,12,8,1,2,3,46,46,170,48,75,TRUE,0.282352941176471,2022,2022-2023
MI,2023-03-31,intra-total,406,1244,622,341,207,118,121,98,113,1618,3985,8873,4391,5635,TRUE,0.494872083849882,2022,2022-2023
MI,2023-03-31,intra-ucfe,0,2,1,0,0,0,0,1,0,1,1,6,1,3,TRUE,0.166666666666667,2022,2022-2023
MI,2023-03-31,intra-ucx,0,0,2,1,0,0,0,0,0,0,1,4,1,1,TRUE,0.25,2022,2022-2023
MI,2023-03-31,intra-ui,406,1242,619,340,207,118,121,97,113,1617,3983,8863,4389,5631,TRUE,0.495204783933206,2022,2022-2023
MI,2023-04-30,inter-total,1,16,4,7,6,4,2,1,2,17,33,93,34,50,TRUE,0.365591397849462,2022,2022-2023
MI,2023-04-30,inter-ucfe,0,0,0,0,0,0,0,0,0,0,0,0,0,0,TRUE,0,2022,2022-2023
MI,2023-04-30,inter-ucx,0,0,0,0,0,0,0,0,0,0,0,0,0,0,TRUE,0,2022,2022-2023
MI,2023-04-30,inter-ui,1,16,4,7,6,4,2,1,2,17,33,93,34,50,TRUE,0.365591397849462,2022,2022-2023
MI,2023-04-30,intra-total,261,1071,401,222,121,81,57,46,62,749,4395,7466,4656,5727,TRUE,0.623627109563354,2022,2022-2023
MI,2023-04-30,intra-ucfe,0,0,2,0,0,0,0,0,0,0,1,3,1,1,TRUE,0.333333333333333,2022,2022-2023
MI,2023-04-30,intra-ucx,0,0,0,0,1,0,0,1,0,1,0,3,0,0,TRUE,0,2022,2022-2023
MI,2023-04-30,intra-ui,261,1071,399,222,120,81,57,45,62,748,4394,7460,4655,5726,TRUE,0.623994638069705,2022,2022-2023
MI,2023-05-31,inter-total,23,23,10,4,5,1,2,2,1,19,26,116,49,72,TRUE,0.422413793103448,2022,2022-2023
MI,2023-05-31,inter-ucfe,0,0,0,0,0,0,0,0,0,0,0,0,0,0,TRUE,0,2022,2022-2023
MI,2023-05-31,inter-ucx,0,0,0,0,0,0,0,0,0,0,0,0,0,0,TRUE,0,2022,2022-2023
MI,2023-05-31,inter-ui,23,23,10,4,5,1,2,2,1,19,26,116,49,72,TRUE,0.422413793103448,2022,2022-2023
MI,2023-05-31,intra-total,1166,1039,482,217,146,79,43,35,22,617,3632,7478,4798,5837,TRUE,0.641615405188553,2022,2022-2023
MI,2023-05-31,intra-ucfe,0,1,0,0,0,0,0,0,0,1,1,3,1,2,TRUE,0.333333333333333,2022,2022-2023
MI,2023-05-31,intra-ucx,0,1,1,0,0,0,0,0,0,3,0,5,0,1,TRUE,0,2022,2022-2023
MI,2023-05-31,intra-ui,1166,1037,481,217,146,79,43,35,22,613,3631,7470,4797,5834,TRUE,0.642168674698795,2022,2022-2023
MI,2023-06-30,inter-total,2,11,9,2,3,2,2,1,1,17,18,68,20,31,TRUE,0.294117647058824,2022,2022-2023
MI,2023-06-30,inter-ucfe,0,0,0,0,0,0,0,0,0,0,0,0,0,0,TRUE,0,2022,2022-2023
MI,2023-06-30,inter-ucx,0,0,0,0,0,0,0,0,0,0,0,0,0,0,TRUE,0,2022,2022-2023
MI,2023-06-30,inter-ui,2,11,9,2,3,2,2,1,1,17,18,68,20,31,TRUE,0.294117647058824,2022,2022-2023
MI,2023-06-30,intra-total,277,832,427,279,182,129,75,47,27,663,2745,5683,3022,3854,TRUE,0.531761393630125,2022,2022-2023
MI,2023-06-30,intra-ucfe,0,0,0,0,0,1,0,0,0,1,0,2,0,0,TRUE,0,2022,2022-2023
MI,2023-06-30,intra-ucx,1,1,1,1,1,0,0,0,0,0,1,6,2,3,TRUE,0.333333333333333,2022,2022-2023
MI,2023-06-30,intra-ui,276,831,426,278,181,128,75,47,27,662,2744,5675,3020,3851,TRUE,0.53215859030837,2022,2022-2023
MI,2023-07-31,inter-total,1,10,19,15,8,2,6,1,1,18,27,108,28,38,TRUE,0.259259259259259,2023,2023-2024
MI,2023-07-31,inter-ucfe,0,0,0,0,0,0,0,0,0,1,0,1,0,0,TRUE,0,2023,2023-2024
MI,2023-07-31,inter-ucx,0,0,0,0,0,0,0,0,0,0,0,0,0,0,TRUE,0,2023,2023-2024
MI,2023-07-31,inter-ui,1,10,19,15,8,2,6,1,1,17,27,107,28,38,TRUE,0.261682242990654,2023,2023-2024
MI,2023-07-31,intra-total,476,1627,717,414,241,142,93,73,71,805,8109,12768,8585,10212,TRUE,0.672384085213033,2023,2023-2024
MI,2023-07-31,intra-ucfe,0,1,0,1,0,0,0,0,0,2,0,4,0,1,TRUE,0,2023,2023-2024
MI,2023-07-31,intra-ucx,0,0,1,0,0,1,0,0,0,2,2,6,2,2,TRUE,0.333333333333333,2023,2023-2024
MI,2023-07-31,intra-ui,476,1626,716,413,241,141,93,73,71,801,8107,12758,8583,10209,TRUE,0.672754350211632,2023,2023-2024
MI,2023-08-31,inter-total,3,13,6,10,13,7,3,2,2,20,12,91,15,28,TRUE,0.164835164835165,2023,2023-2024
MI,2023-08-31,inter-ucfe,0,0,0,0,0,0,0,0,0,0,0,0,0,0,TRUE,0,2023,2023-2024
MI,2023-08-31,inter-ucx,0,0,0,0,0,0,0,0,0,0,0,0,0,0,TRUE,0,2023,2023-2024
MI,2023-08-31,inter-ui,3,13,6,10,13,7,3,2,2,20,12,91,15,28,TRUE,0.164835164835165,2023,2023-2024
MI,2023-08-31,intra-total,333,832,525,524,514,306,219,110,62,613,2771,6809,3104,3936,TRUE,0.455867234542517,2023,2023-2024
MI,2023-08-31,intra-ucfe,0,1,1,0,0,0,0,0,0,0,0,2,0,1,TRUE,0,2023,2023-2024
MI,2023-08-31,intra-ucx,1,1,0,0,0,0,0,0,0,0,3,5,4,5,TRUE,0.8,2023,2023-2024
MI,2023-08-31,intra-ui,332,830,524,524,514,306,219,110,62,613,2768,6802,3100,3930,TRUE,0.455748309320788,2023,2023-2024
MI,2023-09-30,inter-total,3,15,13,11,8,7,1,3,2,20,54,137,57,72,TRUE,0.416058394160584,2023,2023-2024
MI,2023-09-30,inter-ucfe,0,0,0,0,0,0,0,0,0,0,0,0,0,0,TRUE,0,2023,2023-2024
MI,2023-09-30,inter-ucx,0,0,0,0,0,0,0,0,0,0,0,0,0,0,TRUE,0,2023,2023-2024
MI,2023-09-30,inter-ui,3,15,13,11,8,7,1,3,2,20,54,137,57,72,TRUE,0.416058394160584,2023,2023-2024
MI,2023-09-30,intra-total,258,861,546,333,249,151,180,92,126,657,2830,6283,3088,3949,TRUE,0.491484959414293,2023,2023-2024
MI,2023-09-30,intra-ucfe,0,1,3,1,0,0,0,0,0,2,0,7,0,1,TRUE,0,2023,2023-2024
MI,2023-09-30,intra-ucx,0,1,1,0,0,0,0,0,0,0,0,2,0,1,TRUE,0,2023,2023-2024
MI,2023-09-30,intra-ui,258,859,542,332,249,151,180,92,126,655,2830,6274,3088,3947,TRUE,0.492189990436723,2023,2023-2024
MI,2023-10-31,inter-total,9,23,9,8,4,4,2,5,0,23,43,130,52,75,TRUE,0.4,2023,2023-2024
MI,2023-10-31,inter-ucfe,0,0,0,0,0,0,0,0,0,0,0,0,0,0,TRUE,0,2023,2023-2024
MI,2023-10-31,inter-ucx,0,0,0,0,0,0,0,0,0,0,0,0,0,0,TRUE,0,2023,2023-2024
MI,2023-10-31,inter-ui,9,23,9,8,4,4,2,5,0,23,43,130,52,75,TRUE,0.4,2023,2023-2024
MI,2023-10-31,intra-total,657,1403,564,303,148,96,79,74,40,1390,5602,10356,6259,7662,TRUE,0.604383932020085,2023,2023-2024
MI,2023-10-31,intra-ucfe,0,3,0,0,1,0,0,0,0,1,3,8,3,6,TRUE,0.375,2023,2023-2024
MI,2023-10-31,intra-ucx,1,1,0,0,1,0,0,0,0,0,2,5,3,4,TRUE,0.6,2023,2023-2024
MI,2023-10-31,intra-ui,656,1399,564,303,146,96,79,74,40,1389,5597,10343,6253,7652,TRUE,0.604563472880209,2023,2023-2024
MI,2023-11-30,inter-total,6,45,35,16,4,8,2,3,0,21,89,229,95,140,TRUE,0.414847161572052,2023,2023-2024
MI,2023-11-30,inter-ucfe,0,0,0,0,0,0,0,0,0,0,1,1,1,1,TRUE,1,2023,2023-2024
MI,2023-11-30,inter-ucx,0,0,0,0,0,0,0,0,0,0,0,0,0,0,TRUE,0,2023,2023-2024
MI,2023-11-30,inter-ui,6,45,35,16,4,8,2,3,0,21,88,228,94,139,TRUE,0.412280701754386,2023,2023-2024
MI,2023-11-30,intra-total,660,2271,967,624,283,162,125,59,30,999,7149,13329,7809,10080,TRUE,0.585865406257034,2023,2023-2024
MI,2023-11-30,intra-ucfe,0,6,8,1,1,0,0,1,0,1,2,20,2,8,TRUE,0.1,2023,2023-2024
MI,2023-11-30,intra-ucx,1,0,1,0,0,0,0,0,0,1,1,4,2,2,TRUE,0.5,2023,2023-2024
MI,2023-11-30,intra-ui,659,2265,958,623,282,162,125,58,30,997,7146,13305,7805,10070,TRUE,0.586621570838031,2023,2023-2024
MI,2023-12-31,inter-total,5,33,20,9,4,6,3,4,0,17,143,244,148,181,TRUE,0.60655737704918,2023,2023-2024
MI,2023-12-31,inter-ucfe,0,0,1,0,0,0,0,0,0,2,0,3,0,0,TRUE,0,2023,2023-2024
MI,2023-12-31,inter-ucx,0,0,0,0,0,0,0,0,0,0,0,0,0,0,TRUE,0,2023,2023-2024
MI,2023-12-31,inter-ui,5,33,19,9,4,6,3,4,0,15,143,241,148,181,TRUE,0.614107883817427,2023,2023-2024
MI,2023-12-31,intra-total,534,1755,655,383,261,172,124,113,77,1037,10365,15476,10899,12654,TRUE,0.704251744636857,2023,2023-2024
MI,2023-12-31,intra-ucfe,0,12,11,5,1,0,0,0,0,0,0,29,0,12,TRUE,0,2023,2023-2024
MI,2023-12-31,intra-ucx,0,0,0,1,0,1,0,0,0,1,3,6,3,3,TRUE,0.5,2023,2023-2024
MI,2023-12-31,intra-ui,534,1743,644,377,260,171,124,113,77,1036,10362,15441,10896,12639,TRUE,0.70565377890033,2023,2023-2024
MI,2024-01-31,inter-total,8,63,16,8,12,2,5,4,2,35,174,329,182,245,TRUE,0.553191489361702,2023,2023-2024
MI,2024-01-31,inter-ucfe,0,0,0,0,0,0,0,0,0,0,0,0,0,0,TRUE,0,2023,2023-2024
MI,2024-01-31,inter-ucx,0,0,0,0,0,0,0,0,0,0,0,0,0,0,TRUE,0,2023,2023-2024
MI,2024-01-31,inter-ui,8,63,16,8,12,2,5,4,2,35,174,329,182,245,TRUE,0.553191489361702,2023,2023-2024
MI,2024-01-31,intra-total,1629,5021,1134,517,321,200,117,69,151,1168,17071,27398,18700,23721,TRUE,0.682531571647566,2023,2023-2024
MI,2024-01-31,intra-ucfe,0,2,9,2,2,0,0,0,1,2,2,20,2,4,TRUE,0.1,2023,2023-2024
MI,2024-01-31,intra-ucx,1,1,1,0,0,0,0,0,0,0,5,8,6,7,TRUE,0.75,2023,2023-2024
MI,2024-01-31,intra-ui,1628,5018,1124,515,319,200,117,69,150,1166,17064,27370,18692,23710,TRUE,0.682937522835221,2023,2023-2024
MI,2024-02-29,inter-total,8,26,15,8,4,3,4,4,1,23,131,227,139,165,TRUE,0.612334801762115,2023,2023-2024
MI,2024-02-29,inter-ucfe,0,0,0,0,0,0,0,0,0,0,0,0,0,0,TRUE,0,2023,2023-2024
MI,2024-02-29,inter-ucx,0,0,0,0,0,0,0,0,0,0,0,0,0,0,TRUE,0,2023,2023-2024
MI,2024-02-29,inter-ui,8,26,15,8,4,3,4,4,1,23,131,227,139,165,TRUE,0.612334801762115,2023,2023-2024
MI,2024-02-29,intra-total,891,1571,831,406,257,164,116,89,59,1003,9265,14652,10156,11727,TRUE,0.693147693147693,2023,2023-2024
MI,2024-02-29,intra-ucfe,0,2,4,2,1,0,0,0,0,2,3,14,3,5,TRUE,0.214285714285714,2023,2023-2024
MI,2024-02-29,intra-ucx,0,1,0,0,0,0,0,0,0,1,3,5,3,4,TRUE,0.6,2023,2023-2024
MI,2024-02-29,intra-ui,891,1568,827,404,256,164,116,89,59,1000,9259,14633,10150,11718,TRUE,0.693637668284016,2023,2023-2024
MI,2024-03-31,inter-total,4,12,7,7,4,6,1,1,1,11,50,104,54,66,TRUE,0.519230769230769,2023,2023-2024
MI,2024-03-31,inter-ucfe,0,0,0,0,0,0,0,0,0,0,0,0,0,0,TRUE,0,2023,2023-2024
MI,2024-03-31,inter-ucx,0,0,0,0,0,0,0,0,0,0,0,0,0,0,TRUE,0,2023,2023-2024
MI,2024-03-31,inter-ui,4,12,7,7,4,6,1,1,1,11,50,104,54,66,TRUE,0.519230769230769,2023,2023-2024
MI,2024-03-31,intra-total,386,1140,492,301,224,196,123,77,77,968,5262,9246,5648,6788,TRUE,0.610858749729613,2023,2023-2024
MI,2024-03-31,intra-ucfe,0,1,0,1,0,0,0,1,1,4,0,8,0,1,TRUE,0,2023,2023-2024
MI,2024-03-31,intra-ucx,1,1,0,0,0,0,0,0,0,0,3,5,4,5,TRUE,0.8,2023,2023-2024
MI,2024-03-31,intra-ui,385,1138,492,300,224,196,123,76,76,964,5259,9233,5644,6782,TRUE,0.611285605978555,2023,2023-2024
MI,2024-04-30,inter-total,3,20,10,2,2,2,3,2,2,19,50,115,53,73,TRUE,0.460869565217391,2023,2023-2024
MI,2024-04-30,inter-ucfe,0,0,0,0,0,0,0,0,0,0,0,0,0,0,TRUE,0,2023,2023-2024
MI,2024-04-30,inter-ucx,0,0,0,0,0,0,0,0,0,0,0,0,0,0,TRUE,0,2023,2023-2024
MI,2024-04-30,inter-ui,3,20,10,2,2,2,3,2,2,19,50,115,53,73,TRUE,0.460869565217391,2023,2023-2024
MI,2024-04-30,intra-total,340,890,540,262,186,116,88,43,45,809,4113,7432,4453,5343,TRUE,0.599165769644779,2023,2023-2024
MI,2024-04-30,intra-ucfe,0,0,3,2,1,0,0,1,0,4,0,11,0,0,TRUE,0,2023,2023-2024
MI,2024-04-30,intra-ucx,0,2,0,1,0,1,0,0,0,1,0,5,0,2,TRUE,0,2023,2023-2024
MI,2024-04-30,intra-ui,340,888,537,259,185,115,88,42,45,804,4113,7416,4453,5341,TRUE,0.600458468176915,2023,2023-2024
MI,2024-05-31,inter-total,27,11,7,1,6,4,1,1,0,23,43,124,70,81,TRUE,0.564516129032258,2023,2023-2024
MI,2024-05-31,inter-ucfe,0,0,0,0,0,0,0,0,0,0,0,0,0,0,TRUE,0,2023,2023-2024
MI,2024-05-31,inter-ucx,0,0,0,0,0,0,0,0,0,0,0,0,0,0,TRUE,0,2023,2023-2024
MI,2024-05-31,inter-ui,27,11,7,1,6,4,1,1,0,23,43,124,70,81,TRUE,0.564516129032258,2023,2023-2024
MI,2024-05-31,intra-total,1361,1032,572,324,219,116,84,56,39,978,4124,8905,5485,6517,TRUE,0.615946097697923,2023,2023-2024
MI,2024-05-31,intra-ucfe,0,3,0,2,0,0,0,0,0,2,0,7,0,3,TRUE,0,2023,2023-2024
MI,2024-05-31,intra-ucx,4,3,1,1,0,0,0,0,0,1,2,12,6,9,TRUE,0.5,2023,2023-2024
MI,2024-05-31,intra-ui,1357,1026,571,321,219,116,84,56,39,975,4122,8886,5479,6505,TRUE,0.616587891064596,2023,2023-2024
MI,2024-06-30,inter-total,2,17,17,5,3,5,1,0,1,4,34,89,36,53,TRUE,0.404494382022472,2023,2023-2024
MI,2024-06-30,inter-ucfe,0,0,0,0,0,0,0,0,0,0,0,0,0,0,TRUE,0,2023,2023-2024
MI,2024-06-30,inter-ucx,0,0,0,0,0,0,0,0,0,0,0,0,0,0,TRUE,0,2023,2023-2024
MI,2024-06-30,inter-ui,2,17,17,5,3,5,1,0,1,4,34,89,36,53,TRUE,0.404494382022472,2023,2023-2024
MI,2024-06-30,intra-total,381,1080,388,226,138,91,59,54,27,668,4199,7311,4580,5660,TRUE,0.626453289563671,2023,2023-2024
MI,2024-06-30,intra-ucfe,0,2,0,0,0,2,0,0,1,3,0,8,0,2,TRUE,0,2023,2023-2024
MI,2024-06-30,intra-ucx,0,1,1,0,0,0,0,0,0,2,5,9,5,6,TRUE,0.555555555555556,2023,2023-2024
MI,2024-06-30,intra-ui,381,1077,387,226,138,89,59,54,26,663,4194,7294,4575,5652,TRUE,0.627227858513847,2023,2023-2024
MI,2024-07-31,inter-total,10,20,12,5,4,2,3,1,0,13,78,148,88,108,TRUE,0.594594594594595,2024,2024-2025
MI,2024-07-31,inter-ucfe,0,0,0,0,0,0,0,0,0,0,0,0,0,0,TRUE,0,2024,2024-2025
MI,2024-07-31,inter-ucx,0,1,0,0,0,0,0,0,0,0,0,1,0,1,TRUE,0,2024,2024-2025
MI,2024-07-31,inter-ui,10,19,12,5,4,2,3,1,0,13,78,147,88,107,TRUE,0.598639455782313,2024,2024-2025
MI,2024-07-31,intra-total,1864,2623,872,286,209,92,84,58,56,911,18106,25161,19970,22593,TRUE,0.793688645125393,2024,2024-2025
MI,2024-07-31,intra-ucfe,0,0,3,0,0,1,0,0,0,3,3,10,3,3,TRUE,0.3,2024,2024-2025
MI,2024-07-31,intra-ucx,0,0,0,1,0,0,0,0,0,0,5,6,5,5,TRUE,0.833333333333333,2024,2024-2025
MI,2024-07-31,intra-ui,1864,2623,869,285,209,91,84,58,56,908,18098,25145,19962,22585,TRUE,0.793875521972559,2024,2024-2025
MI,2024-08-31,inter-total,7,9,8,7,3,1,2,2,1,10,34,84,41,50,TRUE,0.488095238095238,2024,2024-2025
MI,2024-08-31,inter-ucfe,0,0,0,0,0,0,0,0,0,1,0,1,0,0,TRUE,0,2024,2024-2025
MI,2024-08-31,inter-ucx,0,0,0,0,0,0,0,0,0,0,0,0,0,0,TRUE,0,2024,2024-2025
MI,2024-08-31,inter-ui,7,9,8,7,3,1,2,2,1,9,34,83,41,50,TRUE,0.493975903614458,2024,2024-2025
MI,2024-08-31,intra-total,398,1444,1047,643,376,267,154,75,81,945,4285,9715,4683,6127,TRUE,0.482038085434895,2024,2024-2025
MI,2024-08-31,intra-ucfe,0,1,1,0,0,0,1,0,0,1,0,4,0,1,TRUE,0,2024,2024-2025
MI,2024-08-31,intra-ucx,0,2,0,0,0,0,0,1,0,0,0,3,0,2,TRUE,0,2024,2024-2025
MI,2024-08-31,intra-ui,398,1441,1046,643,376,267,153,74,81,944,4285,9708,4683,6124,TRUE,0.48238566131026,2024,2024-2025
MI,2024-09-30,inter-total,3,22,11,9,3,0,0,0,1,16,53,118,56,78,TRUE,0.474576271186441,2024,2024-2025
MI,2024-09-30,inter-ucfe,0,0,1,0,0,0,0,0,0,0,0,1,0,0,TRUE,0,2024,2024-2025
MI,2024-09-30,inter-ucx,0,0,0,0,0,0,0,0,0,0,0,0,0,0,TRUE,0,2024,2024-2025
MI,2024-09-30,inter-ui,3,22,10,9,3,0,0,0,1,16,53,117,56,78,TRUE,0.478632478632479,2024,2024-2025
MI,2024-09-30,intra-total,307,1083,591,259,154,75,72,101,88,878,4009,7617,4316,5399,TRUE,0.566627281081791,2024,2024-2025
MI,2024-09-30,intra-ucfe,0,2,0,0,0,0,1,0,1,0,0,4,0,2,TRUE,0,2024,2024-2025
MI,2024-09-30,intra-ucx,0,1,0,1,0,0,0,0,0,1,5,8,5,6,TRUE,0.625,2024,2024-2025
MI,2024-09-30,intra-ui,307,1080,591,258,154,75,71,101,87,877,4004,7605,4311,5391,TRUE,0.566863905325444,2024,2024-2025
MI,2024-10-31,inter-total,5,21,15,1,6,1,2,1,0,12,116,180,121,142,TRUE,0.672222222222222,2024,2024-2025
MI,2024-10-31,inter-ucfe,0,0,0,0,0,0,0,0,0,0,0,0,0,0,TRUE,0,2024,2024-2025
MI,2024-10-31,inter-ucx,0,0,1,0,0,0,0,0,0,0,0,1,0,0,TRUE,0,2024,2024-2025
MI,2024-10-31,inter-ui,5,21,14,1,6,1,2,1,0,12,116,179,121,142,TRUE,0.675977653631285,2024,2024-2025
MI,2024-10-31,intra-total,737,1770,606,257,139,76,45,41,53,677,11405,15806,12142,13912,TRUE,0.768189295204353,2024,2024-2025
MI,2024-10-31,intra-ucfe,0,2,2,0,1,0,1,1,1,0,5,13,5,7,TRUE,0.384615384615385,2024,2024-2025
MI,2024-10-31,intra-ucx,1,1,0,0,0,0,0,0,0,0,2,4,3,4,TRUE,0.75,2024,2024-2025
MI,2024-10-31,intra-ui,736,1767,604,257,138,76,44,40,52,677,11398,15789,12134,13901,TRUE,0.768509721958326,2024,2024-2025
MI,2024-11-30,inter-total,9,33,13,3,4,1,1,2,0,7,122,195,131,164,TRUE,0.671794871794872,2024,2024-2025
MI,2024-11-30,inter-ucfe,0,0,0,0,0,0,0,0,0,1,0,1,0,0,TRUE,0,2024,2024-2025
MI,2024-11-30,inter-ucx,0,0,0,0,0,0,0,0,0,0,0,0,0,0,TRUE,0,2024,2024-2025
MI,2024-11-30,inter-ui,9,33,13,3,4,1,1,2,0,6,122,194,131,164,TRUE,0.675257731958763,2024,2024-2025
MI,2024-11-30,intra-total,606,1509,560,336,153,94,45,27,27,405,7271,11033,7877,9386,TRUE,0.713949061905193,2024,2024-2025
MI,2024-11-30,intra-ucfe,0,12,5,1,0,0,1,0,0,2,9,30,9,21,TRUE,0.3,2024,2024-2025
MI,2024-11-30,intra-ucx,1,0,0,0,0,0,0,0,0,0,0,1,1,1,TRUE,1,2024,2024-2025
MI,2024-11-30,intra-ui,605,1497,555,335,153,94,44,27,27,403,7262,11002,7867,9364,TRUE,0.715051808762043,2024,2024-2025
MI,2024-12-31,inter-total,5,32,17,8,8,2,1,1,0,11,161,246,166,198,TRUE,0.67479674796748,2024,2024-2025
MI,2024-12-31,inter-ucfe,0,0,0,0,1,0,0,0,0,2,1,4,1,1,TRUE,0.25,2024,2024-2025
MI,2024-12-31,inter-ucx,0,0,0,0,0,0,0,0,0,0,0,0,0,0,TRUE,0,2024,2024-2025
MI,2024-12-31,inter-ui,5,32,17,8,7,2,1,1,0,9,160,242,165,197,TRUE,0.681818181818182,2024,2024-2025
MI,2024-12-31,intra-total,645,2357,689,282,157,88,56,42,38,583,14132,19069,14777,17134,TRUE,0.774922649326132,2024,2024-2025
MI,2024-12-31,intra-ucfe,0,20,8,1,0,1,1,0,0,2,7,40,7,27,TRUE,0.175,2024,2024-2025
MI,2024-12-31,intra-ucx,0,1,0,0,0,0,0,0,0,1,3,5,3,4,TRUE,0.6,2024,2024-2025
MI,2024-12-31,intra-ui,645,2336,681,281,157,87,55,42,38,580,14122,19024,14767,17103,TRUE,0.776230025231287,2024,2024-2025
MN,2019-01-31,inter-total,1056,30,13,4,0,1,0,0,0,0,104,1208,1160,1190,FALSE,0.985099337748344,2018,2018-2019
MN,2019-01-31,inter-ucfe,4,0,0,0,0,0,0,0,0,0,1,5,5,5,FALSE,1,2018,2018-2019
MN,2019-01-31,inter-ucx,0,0,0,0,0,0,0,0,0,0,0,0,0,0,FALSE,0,2018,2018-2019
MN,2019-01-31,inter-ui,1052,30,13,4,0,1,0,0,0,0,103,1203,1155,1185,FALSE,0.985037406483791,2018,2018-2019
MN,2019-01-31,intra-total,19124,703,228,32,9,1,2,0,0,0,2259,22358,21383,22086,FALSE,0.987834332230074,2018,2018-2019
MN,2019-01-31,intra-ucfe,204,13,3,0,0,0,0,0,0,0,77,297,281,294,FALSE,0.98989898989899,2018,2018-2019
MN,2019-01-31,intra-ucx,4,1,0,0,0,0,0,0,0,0,1,6,5,6,FALSE,1,2018,2018-2019
MN,2019-01-31,intra-ui,18916,689,225,32,9,1,2,0,0,0,2181,22055,21097,21786,FALSE,0.987803219224666,2018,2018-2019
MN,2019-02-28,inter-total,472,22,12,2,1,0,0,0,0,0,70,579,542,564,FALSE,0.974093264248705,2018,2018-2019
MN,2019-02-28,inter-ucfe,1,0,0,0,0,0,0,0,0,0,0,1,1,1,FALSE,1,2018,2018-2019
MN,2019-02-28,inter-ucx,1,0,0,0,0,0,0,0,0,0,0,1,1,1,FALSE,1,2018,2018-2019
MN,2019-02-28,inter-ui,470,22,12,2,1,0,0,0,0,0,70,577,540,562,FALSE,0.974003466204506,2018,2018-2019
MN,2019-02-28,intra-total,8463,541,172,27,7,1,0,0,0,1,1512,10724,9975,10516,FALSE,0.980604252144722,2018,2018-2019
MN,2019-02-28,intra-ucfe,4,0,0,0,1,1,0,0,0,0,1,7,5,5,FALSE,0.714285714285714,2018,2018-2019
MN,2019-02-28,intra-ucx,8,0,0,0,0,0,0,0,0,0,1,9,9,9,FALSE,1,2018,2018-2019
MN,2019-02-28,intra-ui,8451,541,172,27,6,0,0,0,0,1,1510,10708,9961,10502,FALSE,0.980762047067613,2018,2018-2019
MN,2019-03-31,inter-total,292,13,6,1,0,0,0,0,0,0,52,364,344,357,FALSE,0.980769230769231,2018,2018-2019
MN,2019-03-31,inter-ucfe,0,0,0,0,0,0,0,0,0,0,0,0,0,0,FALSE,0,2018,2018-2019
MN,2019-03-31,inter-ucx,0,0,0,0,0,0,0,0,0,0,0,0,0,0,FALSE,0,2018,2018-2019
MN,2019-03-31,inter-ui,292,13,6,1,0,0,0,0,0,0,52,364,344,357,FALSE,0.980769230769231,2018,2018-2019
MN,2019-03-31,intra-total,5309,410,145,30,3,5,1,2,0,2,1081,6988,6390,6800,FALSE,0.973096737263881,2018,2018-2019
MN,2019-03-31,intra-ucfe,2,1,1,0,0,0,0,0,0,0,4,8,6,7,FALSE,0.875,2018,2018-2019
MN,2019-03-31,intra-ucx,4,1,0,0,0,0,1,0,0,0,3,9,7,8,FALSE,0.888888888888889,2018,2018-2019
MN,2019-03-31,intra-ui,5303,408,144,30,3,5,0,2,0,2,1074,6971,6377,6785,FALSE,0.97331803184622,2018,2018-2019
MN,2019-04-30,inter-total,242,18,6,1,0,0,0,0,0,0,34,301,276,294,FALSE,0.976744186046512,2018,2018-2019
MN,2019-04-30,inter-ucfe,0,0,0,0,0,0,0,0,0,0,0,0,0,0,FALSE,0,2018,2018-2019
MN,2019-04-30,inter-ucx,0,0,0,0,0,0,0,0,0,0,0,0,0,0,FALSE,0,2018,2018-2019
MN,2019-04-30,inter-ui,242,18,6,1,0,0,0,0,0,0,34,301,276,294,FALSE,0.976744186046512,2018,2018-2019
MN,2019-04-30,intra-total,4526,423,140,20,4,0,0,0,0,1,1100,6214,5626,6049,FALSE,0.973447055037013,2018,2018-2019
MN,2019-04-30,intra-ucfe,3,0,0,0,0,0,0,0,0,0,3,6,6,6,FALSE,1,2018,2018-2019
MN,2019-04-30,intra-ucx,10,0,0,0,0,0,0,0,0,0,2,12,12,12,FALSE,1,2018,2018-2019
MN,2019-04-30,intra-ui,4513,423,140,20,4,0,0,0,0,1,1095,6196,5608,6031,FALSE,0.973369916074887,2018,2018-2019
MN,2019-05-31,inter-total,210,10,7,1,0,1,0,0,0,0,35,264,245,255,FALSE,0.965909090909091,2018,2018-2019
MN,2019-05-31,inter-ucfe,0,0,0,0,0,0,0,0,0,0,0,0,0,0,FALSE,0,2018,2018-2019
MN,2019-05-31,inter-ucx,0,0,0,0,0,0,0,0,0,0,0,0,0,0,FALSE,0,2018,2018-2019
MN,2019-05-31,inter-ui,210,10,7,1,0,1,0,0,0,0,35,264,245,255,FALSE,0.965909090909091,2018,2018-2019
MN,2019-05-31,intra-total,3530,303,110,12,3,0,0,0,0,1,900,4859,4430,4733,FALSE,0.974068738423544,2018,2018-2019
MN,2019-05-31,intra-ucfe,2,1,0,0,0,0,0,0,0,0,0,3,2,3,FALSE,1,2018,2018-2019
MN,2019-05-31,intra-ucx,11,1,0,0,0,0,0,0,0,0,3,15,14,15,FALSE,1,2018,2018-2019
MN,2019-05-31,intra-ui,3517,301,110,12,3,0,0,0,0,1,897,4841,4414,4715,FALSE,0.973972319768643,2018,2018-2019
MN,2019-06-30,inter-total,172,7,2,1,0,0,0,0,1,0,27,210,199,206,FALSE,0.980952380952381,2018,2018-2019
MN,2019-06-30,inter-ucfe,0,0,0,0,0,0,0,0,0,0,0,0,0,0,FALSE,0,2018,2018-2019
MN,2019-06-30,inter-ucx,0,0,0,0,0,0,0,0,0,0,0,0,0,0,FALSE,0,2018,2018-2019
MN,2019-06-30,inter-ui,172,7,2,1,0,0,0,0,1,0,27,210,199,206,FALSE,0.980952380952381,2018,2018-2019
MN,2019-06-30,intra-total,4019,312,104,17,4,0,0,0,0,0,909,5365,4928,5240,FALSE,0.976700838769804,2018,2018-2019
MN,2019-06-30,intra-ucfe,2,1,0,0,0,0,0,0,0,0,0,3,2,3,FALSE,1,2018,2018-2019
MN,2019-06-30,intra-ucx,9,0,0,0,0,0,0,0,0,0,0,9,9,9,FALSE,1,2018,2018-2019
MN,2019-06-30,intra-ui,4008,311,104,17,4,0,0,0,0,0,909,5353,4917,5228,FALSE,0.976648608257052,2018,2018-2019
MN,2019-07-31,inter-total,186,14,6,0,0,0,0,0,0,1,51,258,237,251,FALSE,0.972868217054264,2019,2019-2020
MN,2019-07-31,inter-ucfe,0,0,0,0,0,0,0,0,0,0,0,0,0,0,FALSE,0,2019,2019-2020
MN,2019-07-31,inter-ucx,0,0,0,0,0,0,0,0,0,0,0,0,0,0,FALSE,0,2019,2019-2020
MN,2019-07-31,inter-ui,186,14,6,0,0,0,0,0,0,1,51,258,237,251,FALSE,0.972868217054264,2019,2019-2020
MN,2019-07-31,intra-total,4497,471,136,29,5,2,1,0,0,1,1153,6295,5650,6121,FALSE,0.972359015091342,2019,2019-2020
MN,2019-07-31,intra-ucfe,1,3,0,0,1,0,0,0,0,0,1,6,2,5,FALSE,0.833333333333333,2019,2019-2020
MN,2019-07-31,intra-ucx,4,1,1,0,0,0,0,0,0,0,2,8,6,7,FALSE,0.875,2019,2019-2020
MN,2019-07-31,intra-ui,4492,467,135,29,4,2,1,0,0,1,1150,6281,5642,6109,FALSE,0.972615825505493,2019,2019-2020
MN,2019-08-31,inter-total,134,11,2,0,0,0,0,0,0,0,32,179,166,177,FALSE,0.988826815642458,2019,2019-2020
MN,2019-08-31,inter-ucfe,0,0,0,0,0,0,0,0,0,0,0,0,0,0,FALSE,0,2019,2019-2020
MN,2019-08-31,inter-ucx,0,0,0,0,0,0,0,0,0,0,0,0,0,0,FALSE,0,2019,2019-2020
MN,2019-08-31,inter-ui,134,11,2,0,0,0,0,0,0,0,32,179,166,177,FALSE,0.988826815642458,2019,2019-2020
MN,2019-08-31,intra-total,2668,317,127,16,9,0,0,0,0,0,879,4016,3547,3864,FALSE,0.962151394422311,2019,2019-2020
MN,2019-08-31,intra-ucfe,1,0,0,0,0,0,0,0,0,0,1,2,2,2,FALSE,1,2019,2019-2020
MN,2019-08-31,intra-ucx,8,1,0,0,0,0,0,0,0,0,4,13,12,13,FALSE,1,2019,2019-2020
MN,2019-08-31,intra-ui,2659,316,127,16,9,0,0,0,0,0,874,4001,3533,3849,FALSE,0.962009497625594,2019,2019-2020
MN,2019-09-30,inter-total,133,9,4,1,0,0,0,1,0,1,31,180,164,173,FALSE,0.961111111111111,2019,2019-2020
MN,2019-09-30,inter-ucfe,0,0,0,0,0,0,0,0,0,0,0,0,0,0,FALSE,0,2019,2019-2020
MN,2019-09-30,inter-ucx,0,0,0,0,0,0,0,0,0,0,0,0,0,0,FALSE,0,2019,2019-2020
MN,2019-09-30,inter-ui,133,9,4,1,0,0,0,1,0,1,31,180,164,173,FALSE,0.961111111111111,2019,2019-2020
MN,2019-09-30,intra-total,2539,303,106,18,4,0,0,0,0,0,769,3739,3308,3611,FALSE,0.965766247659802,2019,2019-2020
MN,2019-09-30,intra-ucfe,2,0,1,0,0,0,0,0,0,0,2,5,4,4,FALSE,0.8,2019,2019-2020
MN,2019-09-30,intra-ucx,9,1,0,0,0,0,0,0,0,0,1,11,10,11,FALSE,1,2019,2019-2020
MN,2019-09-30,intra-ui,2528,302,105,18,4,0,0,0,0,0,766,3723,3294,3596,FALSE,0.965887724952995,2019,2019-2020
MN,2019-10-31,inter-total,194,5,3,3,0,0,0,0,0,0,57,262,251,256,FALSE,0.977099236641221,2019,2019-2020
MN,2019-10-31,inter-ucfe,1,0,0,0,0,0,0,0,0,0,0,1,1,1,FALSE,1,2019,2019-2020
MN,2019-10-31,inter-ucx,0,0,0,0,0,0,0,0,0,0,0,0,0,0,FALSE,0,2019,2019-2020
MN,2019-10-31,inter-ui,193,5,3,3,0,0,0,0,0,0,57,261,250,255,FALSE,0.977011494252874,2019,2019-2020
MN,2019-10-31,intra-total,3746,330,114,24,6,2,0,0,0,0,908,5130,4654,4984,FALSE,0.971539961013645,2019,2019-2020
MN,2019-10-31,intra-ucfe,5,1,0,0,0,0,0,0,0,0,0,6,5,6,FALSE,1,2019,2019-2020
MN,2019-10-31,intra-ucx,9,1,1,0,0,0,0,0,0,0,4,15,13,14,FALSE,0.933333333333333,2019,2019-2020
MN,2019-10-31,intra-ui,3732,328,113,24,6,2,0,0,0,0,904,5109,4636,4964,FALSE,0.971618712076727,2019,2019-2020
MN,2019-11-30,inter-total,840,21,5,1,1,0,0,0,0,0,78,946,918,939,FALSE,0.992600422832981,2019,2019-2020
MN,2019-11-30,inter-ucfe,0,0,0,0,0,0,0,0,0,0,0,0,0,0,FALSE,0,2019,2019-2020
MN,2019-11-30,inter-ucx,0,0,0,0,0,0,0,0,0,0,0,0,0,0,FALSE,0,2019,2019-2020
MN,2019-11-30,inter-ui,840,21,5,1,1,0,0,0,0,0,78,946,918,939,FALSE,0.992600422832981,2019,2019-2020
MN,2019-11-30,intra-total,7616,355,108,27,5,0,0,0,0,0,1098,9209,8714,9069,FALSE,0.984797480725377,2019,2019-2020
MN,2019-11-30,intra-ucfe,11,2,1,0,1,0,0,0,0,0,1,16,12,14,FALSE,0.875,2019,2019-2020
MN,2019-11-30,intra-ucx,3,0,1,0,0,0,0,0,0,0,1,5,4,4,FALSE,0.8,2019,2019-2020
MN,2019-11-30,intra-ui,7602,353,106,27,4,0,0,0,0,0,1096,9188,8698,9051,FALSE,0.985089246843709,2019,2019-2020
MN,2019-12-31,inter-total,1096,24,14,3,1,1,0,0,0,0,147,1286,1243,1267,FALSE,0.985225505443235,2019,2019-2020
MN,2019-12-31,inter-ucfe,1,0,0,0,0,0,0,0,0,0,1,2,2,2,FALSE,1,2019,2019-2020
MN,2019-12-31,inter-ucx,0,0,0,0,0,0,0,0,0,0,0,0,0,0,FALSE,0,2019,2019-2020
MN,2019-12-31,inter-ui,1095,24,14,3,1,1,0,0,0,0,146,1284,1241,1265,FALSE,0.985202492211838,2019,2019-2020
MN,2019-12-31,intra-total,17021,610,204,23,2,2,0,0,0,0,1922,19784,18943,19553,FALSE,0.988323898099474,2019,2019-2020
MN,2019-12-31,intra-ucfe,21,2,0,0,0,0,0,0,0,0,2,25,23,25,FALSE,1,2019,2019-2020
MN,2019-12-31,intra-ucx,4,0,0,0,0,0,0,0,0,0,2,6,6,6,FALSE,1,2019,2019-2020
MN,2019-12-31,intra-ui,16996,608,204,23,2,2,0,0,0,0,1918,19753,18914,19522,FALSE,0.988305573836886,2019,2019-2020
MN,2020-01-31,inter-total,1035,32,15,3,0,0,0,0,0,0,128,1213,1163,1195,FALSE,0.985160758450124,2019,2019-2020
MN,2020-01-31,inter-ucfe,0,1,0,0,0,0,0,0,0,0,0,1,0,1,FALSE,1,2019,2019-2020
MN,2020-01-31,inter-ucx,1,0,0,0,0,0,0,0,0,0,0,1,1,1,FALSE,1,2019,2019-2020
MN,2020-01-31,inter-ui,1034,31,15,3,0,0,0,0,0,0,128,1211,1162,1193,FALSE,0.985136251032205,2019,2019-2020
MN,2020-01-31,intra-total,16830,705,233,34,6,4,1,0,0,1,2142,19956,18972,19677,FALSE,0.986019242333133,2019,2019-2020
MN,2020-01-31,intra-ucfe,16,2,1,0,0,0,0,0,0,0,8,27,24,26,FALSE,0.962962962962963,2019,2019-2020
MN,2020-01-31,intra-ucx,9,1,0,0,0,0,0,0,0,0,2,12,11,12,FALSE,1,2019,2019-2020
MN,2020-01-31,intra-ui,16805,702,232,34,6,4,1,0,0,1,2132,19917,18937,19639,FALSE,0.98604207460963,2019,2019-2020
MN,2020-02-29,inter-total,563,25,5,0,1,0,0,0,0,0,72,666,635,660,FALSE,0.990990990990991,2019,2019-2020
MN,2020-02-29,inter-ucfe,2,0,0,0,0,0,0,0,0,0,0,2,2,2,FALSE,1,2019,2019-2020
MN,2020-02-29,inter-ucx,0,0,0,0,0,0,0,0,0,0,0,0,0,0,FALSE,0,2019,2019-2020
MN,2020-02-29,inter-ui,561,25,5,0,1,0,0,0,0,0,72,664,633,658,FALSE,0.990963855421687,2019,2019-2020
MN,2020-02-29,intra-total,8101,528,179,37,9,1,0,0,0,1,1310,10166,9411,9939,FALSE,0.977670666928979,2019,2019-2020
MN,2020-02-29,intra-ucfe,7,1,1,0,0,0,0,0,0,0,1,10,8,9,FALSE,0.9,2019,2019-2020
MN,2020-02-29,intra-ucx,5,0,0,0,0,0,0,0,0,0,8,13,13,13,FALSE,1,2019,2019-2020
MN,2020-02-29,intra-ui,8089,527,178,37,9,1,0,0,0,1,1301,10143,9390,9917,FALSE,0.977718623681357,2019,2019-2020
MN,2020-03-31,inter-total,216,28,5,1,1,0,1,0,0,0,40,292,256,284,FALSE,0.972602739726027,2019,2019-2020
MN,2020-03-31,inter-ucfe,0,0,0,0,0,0,0,0,0,0,0,0,0,0,FALSE,0,2019,2019-2020
MN,2020-03-31,inter-ucx,0,0,0,0,0,0,0,0,0,0,0,0,0,0,FALSE,0,2019,2019-2020
MN,2020-03-31,inter-ui,216,28,5,1,1,0,1,0,0,0,40,292,256,284,FALSE,0.972602739726027,2019,2019-2020
MN,2020-03-31,intra-total,4386,552,190,29,6,2,1,0,0,0,1021,6187,5407,5959,FALSE,0.963148537255536,2019,2019-2020
MN,2020-03-31,intra-ucfe,5,1,0,0,0,0,0,0,0,0,2,8,7,8,FALSE,1,2019,2019-2020
MN,2020-03-31,intra-ucx,8,1,0,0,0,0,0,0,0,0,0,9,8,9,FALSE,1,2019,2019-2020
MN,2020-03-31,intra-ui,4373,550,190,29,6,2,1,0,0,0,1019,6170,5392,5942,FALSE,0.963047001620746,2019,2019-2020
MN,2020-04-30,inter-total,92,7,0,1,1,0,0,0,0,0,35,136,127,134,FALSE,0.985294117647059,2019,2019-2020
MN,2020-04-30,inter-ucfe,0,0,0,0,0,0,0,0,0,0,0,0,0,0,FALSE,0,2019,2019-2020
MN,2020-04-30,inter-ucx,0,0,0,0,0,0,0,0,0,0,0,0,0,0,FALSE,0,2019,2019-2020
MN,2020-04-30,inter-ui,92,7,0,1,1,0,0,0,0,0,35,136,127,134,FALSE,0.985294117647059,2019,2019-2020
MN,2020-04-30,intra-total,2143,231,89,38,10,3,0,0,0,0,538,3052,2681,2912,FALSE,0.954128440366972,2019,2019-2020
MN,2020-04-30,intra-ucfe,0,1,0,0,0,0,0,0,0,0,1,2,1,2,FALSE,1,2019,2019-2020
MN,2020-04-30,intra-ucx,0,0,0,0,0,0,0,0,0,0,0,0,0,0,FALSE,0,2019,2019-2020
MN,2020-04-30,intra-ui,2143,230,89,38,10,3,0,0,0,0,537,3050,2680,2910,FALSE,0.954098360655738,2019,2019-2020
MN,2020-05-31,inter-total,33,5,3,1,1,0,0,0,0,0,17,60,50,55,FALSE,0.916666666666667,2019,2019-2020
MN,2020-05-31,inter-ucfe,0,0,0,0,0,0,0,0,0,0,0,0,0,0,FALSE,0,2019,2019-2020
MN,2020-05-31,inter-ucx,0,0,0,0,0,0,0,0,0,0,0,0,0,0,FALSE,0,2019,2019-2020
MN,2020-05-31,inter-ui,33,5,3,1,1,0,0,0,0,0,17,60,50,55,FALSE,0.916666666666667,2019,2019-2020
MN,2020-05-31,intra-total,630,78,35,32,16,15,6,5,3,2,140,962,770,848,FALSE,0.881496881496882,2019,2019-2020
MN,2020-05-31,intra-ucfe,0,0,0,1,0,0,0,0,0,0,0,1,0,0,FALSE,0,2019,2019-2020
MN,2020-05-31,intra-ucx,0,0,0,0,0,0,0,0,0,0,0,0,0,0,FALSE,0,2019,2019-2020
MN,2020-05-31,intra-ui,630,78,35,31,16,15,6,5,3,2,140,961,770,848,FALSE,0.882414151925078,2019,2019-2020
MN,2020-06-30,inter-total,11,5,3,2,2,0,0,0,2,2,3,30,14,19,FALSE,0.633333333333333,2019,2019-2020
MN,2020-06-30,inter-ucfe,0,0,0,0,0,0,0,0,0,0,0,0,0,0,FALSE,0,2019,2019-2020
MN,2020-06-30,inter-ucx,0,0,0,0,0,0,0,0,0,0,0,0,0,0,FALSE,0,2019,2019-2020
MN,2020-06-30,inter-ui,11,5,3,2,2,0,0,0,2,2,3,30,14,19,FALSE,0.633333333333333,2019,2019-2020
MN,2020-06-30,intra-total,345,35,25,9,2,7,6,5,2,3,72,511,417,452,FALSE,0.88454011741683,2019,2019-2020
MN,2020-06-30,intra-ucfe,0,0,0,0,0,0,0,0,0,0,0,0,0,0,FALSE,0,2019,2019-2020
MN,2020-06-30,intra-ucx,0,0,0,0,0,0,0,0,0,0,0,0,0,0,FALSE,0,2019,2019-2020
MN,2020-06-30,intra-ui,345,35,25,9,2,7,6,5,2,3,72,511,417,452,FALSE,0.88454011741683,2019,2019-2020
MN,2020-07-31,inter-total,16,6,1,1,0,1,0,0,2,1,5,33,21,27,FALSE,0.818181818181818,2020,2020-2021
MN,2020-07-31,inter-ucfe,0,0,0,0,0,0,0,0,0,0,0,0,0,0,FALSE,0,2020,2020-2021
MN,2020-07-31,inter-ucx,0,0,0,0,0,0,0,0,0,0,0,0,0,0,FALSE,0,2020,2020-2021
MN,2020-07-31,inter-ui,16,6,1,1,0,1,0,0,2,1,5,33,21,27,FALSE,0.818181818181818,2020,2020-2021
MN,2020-07-31,intra-total,302,35,17,9,10,15,5,3,4,4,38,442,340,375,FALSE,0.84841628959276,2020,2020-2021
MN,2020-07-31,intra-ucfe,0,0,0,0,0,0,0,0,0,0,0,0,0,0,FALSE,0,2020,2020-2021
MN,2020-07-31,intra-ucx,0,0,0,0,0,0,0,0,0,0,0,0,0,0,FALSE,0,2020,2020-2021
MN,2020-07-31,intra-ui,302,35,17,9,10,15,5,3,4,4,38,442,340,375,FALSE,0.84841628959276,2020,2020-2021
MN,2020-08-31,inter-total,11,6,8,1,0,0,1,0,0,3,1,31,12,18,FALSE,0.580645161290323,2020,2020-2021
MN,2020-08-31,inter-ucfe,0,0,0,0,0,0,0,0,0,0,0,0,0,0,FALSE,0,2020,2020-2021
MN,2020-08-31,inter-ucx,0,0,0,0,0,0,0,0,0,0,0,0,0,0,FALSE,0,2020,2020-2021
MN,2020-08-31,inter-ui,11,6,8,1,0,0,1,0,0,3,1,31,12,18,FALSE,0.580645161290323,2020,2020-2021
MN,2020-08-31,intra-total,150,15,24,3,3,5,2,3,3,6,38,252,188,203,FALSE,0.805555555555556,2020,2020-2021
MN,2020-08-31,intra-ucfe,1,0,0,0,0,0,0,0,0,0,0,1,1,1,FALSE,1,2020,2020-2021
MN,2020-08-31,intra-ucx,0,0,0,0,0,0,0,0,0,0,0,0,0,0,FALSE,0,2020,2020-2021
MN,2020-08-31,intra-ui,149,15,24,3,3,5,2,3,3,6,38,251,187,202,FALSE,0.804780876494024,2020,2020-2021
MN,2020-09-30,inter-total,8,0,4,2,0,0,1,1,0,2,2,20,10,10,FALSE,0.5,2020,2020-2021
MN,2020-09-30,inter-ucfe,0,0,0,0,0,0,0,0,0,0,0,0,0,0,FALSE,0,2020,2020-2021
MN,2020-09-30,inter-ucx,0,0,0,0,0,0,0,0,0,0,0,0,0,0,FALSE,0,2020,2020-2021
MN,2020-09-30,inter-ui,8,0,4,2,0,0,1,1,0,2,2,20,10,10,FALSE,0.5,2020,2020-2021
MN,2020-09-30,intra-total,132,15,11,3,5,4,3,3,1,3,16,196,148,163,FALSE,0.831632653061224,2020,2020-2021
MN,2020-09-30,intra-ucfe,0,0,0,0,0,0,0,0,0,0,0,0,0,0,FALSE,0,2020,2020-2021
MN,2020-09-30,intra-ucx,0,0,0,0,0,0,0,0,0,0,0,0,0,0,FALSE,0,2020,2020-2021
MN,2020-09-30,intra-ui,132,15,11,3,5,4,3,3,1,3,16,196,148,163,FALSE,0.831632653061224,2020,2020-2021
MN,2020-10-31,inter-total,5,1,2,1,0,0,0,0,0,2,1,12,6,7,FALSE,0.583333333333333,2020,2020-2021
MN,2020-10-31,inter-ucfe,0,0,0,0,0,0,0,0,0,0,0,0,0,0,FALSE,0,2020,2020-2021
MN,2020-10-31,inter-ucx,0,0,0,0,0,0,0,0,0,0,0,0,0,0,FALSE,0,2020,2020-2021
MN,2020-10-31,inter-ui,5,1,2,1,0,0,0,0,0,2,1,12,6,7,FALSE,0.583333333333333,2020,2020-2021
MN,2020-10-31,intra-total,105,16,10,1,1,1,0,2,1,5,32,174,137,153,FALSE,0.879310344827586,2020,2020-2021
MN,2020-10-31,intra-ucfe,0,0,0,0,0,0,0,0,0,0,0,0,0,0,FALSE,0,2020,2020-2021
MN,2020-10-31,intra-ucx,0,0,0,0,0,0,0,0,0,0,0,0,0,0,FALSE,0,2020,2020-2021
MN,2020-10-31,intra-ui,105,16,10,1,1,1,0,2,1,5,32,174,137,153,FALSE,0.879310344827586,2020,2020-2021
MN,2020-11-30,inter-total,14,2,1,2,1,0,1,0,0,0,4,25,18,20,FALSE,0.8,2020,2020-2021
MN,2020-11-30,inter-ucfe,0,0,0,0,0,0,0,0,0,0,0,0,0,0,FALSE,0,2020,2020-2021
MN,2020-11-30,inter-ucx,0,0,0,0,0,0,0,0,0,0,0,0,0,0,FALSE,0,2020,2020-2021
MN,2020-11-30,inter-ui,14,2,1,2,1,0,1,0,0,0,4,25,18,20,FALSE,0.8,2020,2020-2021
MN,2020-11-30,intra-total,153,25,12,3,3,1,0,0,0,1,42,240,195,220,FALSE,0.916666666666667,2020,2020-2021
MN,2020-11-30,intra-ucfe,2,1,0,0,0,0,0,0,0,0,2,5,4,5,FALSE,1,2020,2020-2021
MN,2020-11-30,intra-ucx,0,0,0,0,0,0,0,0,0,0,0,0,0,0,FALSE,0,2020,2020-2021
MN,2020-11-30,intra-ui,151,24,12,3,3,1,0,0,0,1,40,235,191,215,FALSE,0.914893617021277,2020,2020-2021
MN,2020-12-31,inter-total,10,2,1,0,0,0,0,0,0,1,6,20,16,18,FALSE,0.9,2020,2020-2021
MN,2020-12-31,inter-ucfe,0,0,0,0,0,0,0,0,0,0,0,0,0,0,FALSE,0,2020,2020-2021
MN,2020-12-31,inter-ucx,0,0,0,0,0,0,0,0,0,0,0,0,0,0,FALSE,0,2020,2020-2021
MN,2020-12-31,inter-ui,10,2,1,0,0,0,0,0,0,1,6,20,16,18,FALSE,0.9,2020,2020-2021
MN,2020-12-31,intra-total,234,27,20,3,2,0,1,0,0,3,49,339,283,310,FALSE,0.914454277286136,2020,2020-2021
MN,2020-12-31,intra-ucfe,3,0,0,0,0,0,0,0,0,0,3,6,6,6,FALSE,1,2020,2020-2021
MN,2020-12-31,intra-ucx,0,0,1,0,0,0,0,0,0,0,0,1,0,0,FALSE,0,2020,2020-2021
MN,2020-12-31,intra-ui,231,27,19,3,2,0,1,0,0,3,46,332,277,304,FALSE,0.91566265060241,2020,2020-2021
MN,2021-01-31,inter-total,374,3,0,1,1,0,0,1,0,1,34,415,408,411,FALSE,0.990361445783133,2020,2020-2021
MN,2021-01-31,inter-ucfe,0,0,0,0,0,0,0,0,0,0,0,0,0,0,FALSE,0,2020,2020-2021
MN,2021-01-31,inter-ucx,0,0,0,0,0,0,0,0,0,0,0,0,0,0,FALSE,0,2020,2020-2021
MN,2021-01-31,inter-ui,374,3,0,1,1,0,0,1,0,1,34,415,408,411,FALSE,0.990361445783133,2020,2020-2021
MN,2021-01-31,intra-total,7229,13,7,2,0,1,4,0,0,0,396,7652,7625,7638,FALSE,0.998170412963931,2020,2020-2021
MN,2021-01-31,intra-ucfe,6,0,0,1,0,0,0,0,0,0,3,10,9,9,FALSE,0.9,2020,2020-2021
MN,2021-01-31,intra-ucx,5,0,0,0,0,0,0,0,0,0,1,6,6,6,FALSE,1,2020,2020-2021
MN,2021-01-31,intra-ui,7218,13,7,1,0,1,4,0,0,0,392,7636,7610,7623,FALSE,0.998297537977999,2020,2020-2021
MN,2021-02-28,inter-total,481,24,19,4,2,0,1,0,0,1,50,582,531,555,FALSE,0.95360824742268,2020,2020-2021
MN,2021-02-28,inter-ucfe,1,0,0,0,0,0,0,0,0,0,0,1,1,1,FALSE,1,2020,2020-2021
MN,2021-02-28,inter-ucx,0,0,0,0,0,0,0,0,0,0,0,0,0,0,FALSE,0,2020,2020-2021
MN,2021-02-28,inter-ui,480,24,19,4,2,0,1,0,0,1,50,581,530,554,FALSE,0.953528399311532,2020,2020-2021
MN,2021-02-28,intra-total,9763,593,374,145,36,1,1,0,2,5,1082,12002,10845,11438,FALSE,0.953007832027995,2020,2020-2021
MN,2021-02-28,intra-ucfe,13,1,1,1,0,0,0,0,0,0,8,24,21,22,FALSE,0.916666666666667,2020,2020-2021
MN,2021-02-28,intra-ucx,4,3,0,0,0,0,0,0,0,0,4,11,8,11,FALSE,1,2020,2020-2021
MN,2021-02-28,intra-ui,9746,589,373,144,36,1,1,0,2,5,1070,11967,10816,11405,FALSE,0.953037519846244,2020,2020-2021
MN,2021-03-31,inter-total,450,45,25,12,11,2,1,0,0,2,62,610,512,557,FALSE,0.913114754098361,2020,2020-2021
MN,2021-03-31,inter-ucfe,0,0,0,0,0,0,0,0,0,0,1,1,1,1,FALSE,1,2020,2020-2021
MN,2021-03-31,inter-ucx,0,0,0,0,0,0,0,0,0,0,0,0,0,0,FALSE,0,2020,2020-2021
MN,2021-03-31,inter-ui,450,45,25,12,11,2,1,0,0,2,61,609,511,556,FALSE,0.912972085385879,2020,2020-2021
MN,2021-03-31,intra-total,11697,661,579,331,183,89,25,15,6,11,1025,14622,12722,13383,FALSE,0.915264669675831,2020,2020-2021
MN,2021-03-31,intra-ucfe,9,2,0,2,1,0,0,1,0,0,3,18,12,14,FALSE,0.777777777777778,2020,2020-2021
MN,2021-03-31,intra-ucx,6,1,1,0,0,0,0,0,0,0,4,12,10,11,FALSE,0.916666666666667,2020,2020-2021
MN,2021-03-31,intra-ui,11682,658,578,329,182,89,25,14,6,11,1018,14592,12700,13358,FALSE,0.915433114035088,2020,2020-2021
MN,2021-04-30,inter-total,506,59,32,9,4,3,1,2,0,3,81,700,587,646,FALSE,0.922857142857143,2020,2020-2021
MN,2021-04-30,inter-ucfe,0,0,0,0,0,0,0,0,0,0,0,0,0,0,FALSE,0,2020,2020-2021
MN,2021-04-30,inter-ucx,0,0,0,0,0,0,0,0,0,0,0,0,0,0,FALSE,0,2020,2020-2021
MN,2021-04-30,inter-ui,506,59,32,9,4,3,1,2,0,3,81,700,587,646,FALSE,0.922857142857143,2020,2020-2021
MN,2021-04-30,intra-total,16868,814,530,352,238,118,48,31,12,21,1563,20595,18431,19245,FALSE,0.934450109249818,2020,2020-2021
MN,2021-04-30,intra-ucfe,16,1,0,1,1,1,0,2,0,0,0,22,16,17,FALSE,0.772727272727273,2020,2020-2021
MN,2021-04-30,intra-ucx,3,0,0,1,0,0,0,0,0,0,1,5,4,4,FALSE,0.8,2020,2020-2021
MN,2021-04-30,intra-ui,16849,813,530,350,237,117,48,29,12,21,1562,20568,18411,19224,FALSE,0.93465577596266,2020,2020-2021
MN,2021-05-31,inter-total,310,27,27,9,8,2,3,2,0,5,45,438,355,382,FALSE,0.872146118721461,2020,2020-2021
MN,2021-05-31,inter-ucfe,1,0,0,0,0,0,0,0,0,0,0,1,1,1,FALSE,1,2020,2020-2021
MN,2021-05-31,inter-ucx,0,0,0,0,0,0,0,0,0,0,0,0,0,0,FALSE,0,2020,2020-2021
MN,2021-05-31,inter-ui,309,27,27,9,8,2,3,2,0,5,45,437,354,381,FALSE,0.871853546910755,2020,2020-2021
MN,2021-05-31,intra-total,8959,821,507,449,487,277,104,55,13,20,1332,13024,10291,11112,FALSE,0.853194103194103,2020,2020-2021
MN,2021-05-31,intra-ucfe,8,2,3,1,0,1,0,0,0,0,5,20,13,15,FALSE,0.75,2020,2020-2021
MN,2021-05-31,intra-ucx,5,3,1,0,0,0,0,0,0,0,0,9,5,8,FALSE,0.888888888888889,2020,2020-2021
MN,2021-05-31,intra-ui,8946,816,503,448,487,276,104,55,13,20,1327,12995,10273,11089,FALSE,0.85332820315506,2020,2020-2021
MN,2021-06-30,inter-total,170,45,17,9,10,8,6,1,2,3,40,311,210,255,FALSE,0.819935691318328,2020,2020-2021
MN,2021-06-30,inter-ucfe,0,0,0,0,0,1,0,0,0,1,0,2,0,0,FALSE,0,2020,2020-2021
MN,2021-06-30,inter-ucx,0,0,0,0,0,0,0,0,0,0,0,0,0,0,FALSE,0,2020,2020-2021
MN,2021-06-30,inter-ui,170,45,17,9,10,7,6,1,2,2,40,309,210,255,FALSE,0.825242718446602,2020,2020-2021
MN,2021-06-30,intra-total,6863,719,570,463,492,306,125,79,32,62,1248,10959,8111,8830,FALSE,0.805730449858564,2020,2020-2021
MN,2021-06-30,intra-ucfe,5,1,2,0,0,1,1,0,1,0,1,12,6,7,FALSE,0.583333333333333,2020,2020-2021
MN,2021-06-30,intra-ucx,3,1,2,0,0,0,0,0,0,0,1,7,4,5,FALSE,0.714285714285714,2020,2020-2021
MN,2021-06-30,intra-ui,6855,717,566,463,492,305,124,79,31,62,1246,10940,8101,8818,FALSE,0.806032906764168,2020,2020-2021
MN,2021-07-31,inter-total,124,16,12,6,7,2,2,3,2,4,34,212,158,174,FALSE,0.820754716981132,2021,2021-2022
MN,2021-07-31,inter-ucfe,0,0,0,0,0,0,0,0,0,0,0,0,0,0,FALSE,0,2021,2021-2022
MN,2021-07-31,inter-ucx,0,0,0,0,0,0,0,0,0,0,0,0,0,0,FALSE,0,2021,2021-2022
MN,2021-07-31,inter-ui,124,16,12,6,7,2,2,3,2,4,34,212,158,174,FALSE,0.820754716981132,2021,2021-2022
MN,2021-07-31,intra-total,4502,729,505,283,184,101,47,43,24,63,1296,7777,5798,6527,FALSE,0.839269641249839,2021,2021-2022
MN,2021-07-31,intra-ucfe,1,4,0,4,0,0,0,1,0,1,3,14,4,8,FALSE,0.571428571428571,2021,2021-2022
MN,2021-07-31,intra-ucx,4,2,0,1,0,0,0,0,0,0,4,11,8,10,FALSE,0.909090909090909,2021,2021-2022
MN,2021-07-31,intra-ui,4497,723,505,278,184,101,47,42,24,62,1289,7752,5786,6509,FALSE,0.839654282765738,2021,2021-2022
MN,2021-08-31,inter-total,197,23,19,5,1,1,0,0,2,4,57,309,254,277,FALSE,0.896440129449838,2021,2021-2022
MN,2021-08-31,inter-ucfe,0,0,0,0,0,0,0,0,0,0,0,0,0,0,FALSE,0,2021,2021-2022
MN,2021-08-31,inter-ucx,0,0,0,0,0,0,0,0,0,0,0,0,0,0,FALSE,0,2021,2021-2022
MN,2021-08-31,inter-ui,197,23,19,5,1,1,0,0,2,4,57,309,254,277,FALSE,0.896440129449838,2021,2021-2022
MN,2021-08-31,intra-total,4292,737,387,148,77,63,52,22,24,72,1235,7109,5527,6264,FALSE,0.881136587424392,2021,2021-2022
MN,2021-08-31,intra-ucfe,8,1,2,0,0,0,0,0,0,0,2,13,10,11,FALSE,0.846153846153846,2021,2021-2022
MN,2021-08-31,intra-ucx,7,0,1,1,0,0,0,0,0,0,3,12,10,10,FALSE,0.833333333333333,2021,2021-2022
MN,2021-08-31,intra-ui,4277,736,384,147,77,63,52,22,24,72,1230,7084,5507,6243,FALSE,0.881281761716544,2021,2021-2022
MN,2021-09-30,inter-total,456,18,11,4,3,0,0,2,1,2,78,575,534,552,FALSE,0.96,2021,2021-2022
MN,2021-09-30,inter-ucfe,0,0,0,0,0,0,0,0,0,0,0,0,0,0,FALSE,0,2021,2021-2022
MN,2021-09-30,inter-ucx,0,0,0,0,0,0,0,0,0,0,0,0,0,0,FALSE,0,2021,2021-2022
MN,2021-09-30,inter-ui,456,18,11,4,3,0,0,2,1,2,78,575,534,552,FALSE,0.96,2021,2021-2022
MN,2021-09-30,intra-total,14767,768,392,150,57,39,24,17,8,103,1871,18196,16638,17406,FALSE,0.956583864585623,2021,2021-2022
MN,2021-09-30,intra-ucfe,31,1,0,0,0,1,0,0,0,1,3,37,34,35,FALSE,0.945945945945946,2021,2021-2022
MN,2021-09-30,intra-ucx,8,1,0,0,0,0,0,0,0,0,3,12,11,12,FALSE,1,2021,2021-2022
MN,2021-09-30,intra-ui,14728,766,392,150,57,38,24,17,8,102,1865,18147,16593,17359,FALSE,0.956576844657519,2021,2021-2022
MN,2021-10-31,inter-total,319,31,8,2,0,0,1,2,0,3,80,446,399,430,FALSE,0.964125560538117,2021,2021-2022
MN,2021-10-31,inter-ucfe,0,0,0,0,0,0,0,0,0,0,0,0,0,0,FALSE,0,2021,2021-2022
MN,2021-10-31,inter-ucx,1,0,0,0,0,0,0,0,0,0,0,1,1,1,FALSE,1,2021,2021-2022
MN,2021-10-31,inter-ui,318,31,8,2,0,0,1,2,0,3,80,445,398,429,FALSE,0.964044943820225,2021,2021-2022
MN,2021-10-31,intra-total,3157,765,256,91,57,21,23,6,4,118,1237,5735,4394,5159,FALSE,0.899564080209242,2021,2021-2022
MN,2021-10-31,intra-ucfe,6,1,1,2,2,1,1,0,0,0,4,18,10,11,FALSE,0.611111111111111,2021,2021-2022
MN,2021-10-31,intra-ucx,9,3,1,0,1,0,0,0,0,0,2,16,11,14,FALSE,0.875,2021,2021-2022
MN,2021-10-31,intra-ui,3142,761,254,89,54,20,22,6,4,118,1231,5701,4373,5134,FALSE,0.900543764251886,2021,2021-2022
MN,2021-11-30,inter-total,1001,47,8,3,0,3,2,1,1,5,138,1209,1139,1186,FALSE,0.980976013234078,2021,2021-2022
MN,2021-11-30,inter-ucfe,2,0,0,0,0,0,0,0,0,1,2,5,4,4,FALSE,0.8,2021,2021-2022
MN,2021-11-30,inter-ucx,0,0,0,0,0,0,0,0,0,0,0,0,0,0,FALSE,0,2021,2021-2022
MN,2021-11-30,inter-ui,999,47,8,3,0,3,2,1,1,4,136,1204,1135,1182,FALSE,0.981727574750831,2021,2021-2022
MN,2021-11-30,intra-total,7836,569,237,74,34,38,17,11,3,82,1337,10238,9173,9742,FALSE,0.951553037702676,2021,2021-2022
MN,2021-11-30,intra-ucfe,16,3,0,0,0,2,0,0,0,1,6,28,22,25,FALSE,0.892857142857143,2021,2021-2022
MN,2021-11-30,intra-ucx,7,4,0,0,0,1,0,0,0,0,2,14,9,13,FALSE,0.928571428571429,2021,2021-2022
MN,2021-11-30,intra-ui,7813,562,237,74,34,35,17,11,3,81,1329,10196,9142,9704,FALSE,0.951745782659867,2021,2021-2022
MN,2021-12-31,inter-total,1078,89,21,13,4,0,0,1,0,4,260,1470,1338,1427,FALSE,0.970748299319728,2021,2021-2022
MN,2021-12-31,inter-ucfe,2,1,0,0,0,0,0,0,0,0,0,3,2,3,FALSE,1,2021,2021-2022
MN,2021-12-31,inter-ucx,0,0,0,0,0,0,0,0,0,0,0,0,0,0,FALSE,0,2021,2021-2022
MN,2021-12-31,inter-ui,1076,88,21,13,4,0,0,1,0,4,260,1467,1336,1424,FALSE,0.970688479890934,2021,2021-2022
MN,2021-12-31,intra-total,13968,862,304,82,45,19,12,1,3,31,2266,17593,16234,17096,FALSE,0.971750127891775,2021,2021-2022
MN,2021-12-31,intra-ucfe,14,3,1,0,1,0,1,0,0,1,3,24,17,20,FALSE,0.833333333333333,2021,2021-2022
MN,2021-12-31,intra-ucx,8,0,0,0,0,0,0,0,0,0,1,9,9,9,FALSE,1,2021,2021-2022
MN,2021-12-31,intra-ui,13946,859,303,82,44,19,11,1,3,30,2262,17560,16208,17067,FALSE,0.971924829157175,2021,2021-2022
MN,2022-01-31,inter-total,995,67,31,7,5,3,0,4,0,5,238,1355,1233,1300,FALSE,0.959409594095941,2021,2021-2022
MN,2022-01-31,inter-ucfe,0,0,0,0,0,0,0,0,0,0,1,1,1,1,FALSE,1,2021,2021-2022
MN,2022-01-31,inter-ucx,0,0,0,0,0,0,0,0,0,0,0,0,0,0,FALSE,0,2021,2021-2022
MN,2022-01-31,inter-ui,995,67,31,7,5,3,0,4,0,5,237,1354,1232,1299,FALSE,0.959379615952733,2021,2021-2022
MN,2022-01-31,intra-total,15611,938,344,88,48,26,20,8,7,39,2425,19554,18036,18974,FALSE,0.970338549657359,2021,2021-2022
MN,2022-01-31,intra-ucfe,14,3,1,0,0,0,0,0,0,0,1,19,15,18,FALSE,0.947368421052632,2021,2021-2022
MN,2022-01-31,intra-ucx,5,3,0,1,0,0,0,0,0,0,4,13,9,12,FALSE,0.923076923076923,2021,2021-2022
MN,2022-01-31,intra-ui,15592,932,343,87,48,26,20,8,7,39,2420,19522,18012,18944,FALSE,0.97039237783014,2021,2021-2022
MN,2022-02-28,inter-total,507,33,20,13,1,3,2,2,2,9,96,688,603,636,FALSE,0.924418604651163,2021,2021-2022
MN,2022-02-28,inter-ucfe,1,0,0,0,0,0,0,0,0,0,0,1,1,1,FALSE,1,2021,2021-2022
MN,2022-02-28,inter-ucx,0,0,0,0,0,0,0,0,0,0,0,0,0,0,FALSE,0,2021,2021-2022
MN,2022-02-28,inter-ui,506,33,20,13,1,3,2,2,2,9,96,687,602,635,FALSE,0.924308588064047,2021,2021-2022
MN,2022-02-28,intra-total,6820,677,286,112,59,28,25,21,11,39,1557,9635,8377,9054,FALSE,0.939699014011417,2021,2021-2022
MN,2022-02-28,intra-ucfe,8,1,0,0,0,0,0,0,0,0,4,13,12,13,FALSE,1,2021,2021-2022
MN,2022-02-28,intra-ucx,4,0,0,0,0,0,0,0,0,1,0,5,4,4,FALSE,0.8,2021,2021-2022
MN,2022-02-28,intra-ui,6808,676,286,112,59,28,25,21,11,38,1553,9617,8361,9037,FALSE,0.939690132057814,2021,2021-2022
MN,2022-03-31,inter-total,361,36,14,4,4,4,3,2,1,8,72,509,433,469,FALSE,0.921414538310412,2021,2021-2022
MN,2022-03-31,inter-ucfe,0,0,0,0,0,0,0,0,0,0,0,0,0,0,FALSE,0,2021,2021-2022
MN,2022-03-31,inter-ucx,0,0,0,0,0,0,0,0,0,0,0,0,0,0,FALSE,0,2021,2021-2022
MN,2022-03-31,inter-ui,361,36,14,4,4,4,3,2,1,8,72,509,433,469,FALSE,0.921414538310412,2021,2021-2022
MN,2022-03-31,intra-total,5526,617,227,70,38,22,19,16,6,27,1234,7802,6760,7377,FALSE,0.945526788003076,2021,2021-2022
MN,2022-03-31,intra-ucfe,4,2,0,1,1,0,0,0,0,0,1,9,5,7,FALSE,0.777777777777778,2021,2021-2022
MN,2022-03-31,intra-ucx,8,2,1,0,0,0,0,1,0,0,2,14,10,12,FALSE,0.857142857142857,2021,2021-2022
MN,2022-03-31,intra-ui,5514,613,226,69,37,22,19,15,6,27,1231,7779,6745,7358,FALSE,0.945879933153362,2021,2021-2022
MN,2022-04-30,inter-total,280,20,3,3,2,0,0,1,2,1,55,367,335,355,FALSE,0.967302452316076,2021,2021-2022
MN,2022-04-30,inter-ucfe,0,0,0,0,0,0,0,0,0,0,0,0,0,0,FALSE,0,2021,2021-2022
MN,2022-04-30,inter-ucx,0,0,0,0,0,0,0,0,0,0,0,0,0,0,FALSE,0,2021,2021-2022
MN,2022-04-30,inter-ui,280,20,3,3,2,0,0,1,2,1,55,367,335,355,FALSE,0.967302452316076,2021,2021-2022
MN,2022-04-30,intra-total,4403,439,180,55,31,17,20,8,7,24,1052,6236,5455,5894,FALSE,0.945157152020526,2021,2021-2022
MN,2022-04-30,intra-ucfe,8,1,1,0,1,0,0,0,1,0,1,13,9,10,FALSE,0.769230769230769,2021,2021-2022
MN,2022-04-30,intra-ucx,11,1,0,0,0,0,0,0,0,0,7,19,18,19,FALSE,1,2021,2021-2022
MN,2022-04-30,intra-ui,4384,437,179,55,30,17,20,8,6,24,1044,6204,5428,5865,FALSE,0.945357833655706,2021,2021-2022
MN,2022-05-31,inter-total,205,16,9,1,4,1,0,1,0,4,50,291,255,271,FALSE,0.93127147766323,2021,2021-2022
MN,2022-05-31,inter-ucfe,0,0,0,0,0,0,0,0,0,0,0,0,0,0,FALSE,0,2021,2021-2022
MN,2022-05-31,inter-ucx,1,0,0,0,0,0,0,0,0,0,0,1,1,1,FALSE,1,2021,2021-2022
MN,2022-05-31,inter-ui,204,16,9,1,4,1,0,1,0,4,50,290,254,270,FALSE,0.931034482758621,2021,2021-2022
MN,2022-05-31,intra-total,3277,412,168,62,36,18,11,10,6,26,895,4921,4172,4584,FALSE,0.931517984149563,2021,2021-2022
MN,2022-05-31,intra-ucfe,2,2,0,0,0,0,0,0,0,0,1,5,3,5,FALSE,1,2021,2021-2022
MN,2022-05-31,intra-ucx,4,1,0,0,0,1,0,0,0,0,5,11,9,10,FALSE,0.909090909090909,2021,2021-2022
MN,2022-05-31,intra-ui,3271,409,168,62,36,17,11,10,6,26,889,4905,4160,4569,FALSE,0.931498470948012,2021,2021-2022
MN,2022-06-30,inter-total,192,21,5,2,1,1,0,0,0,1,52,275,244,265,FALSE,0.963636363636364,2021,2021-2022
MN,2022-06-30,inter-ucfe,0,0,0,0,0,0,0,0,0,0,0,0,0,0,FALSE,0,2021,2021-2022
MN,2022-06-30,inter-ucx,0,0,0,0,0,0,0,0,0,0,0,0,0,0,FALSE,0,2021,2021-2022
MN,2022-06-30,inter-ui,192,21,5,2,1,1,0,0,0,1,52,275,244,265,FALSE,0.963636363636364,2021,2021-2022
MN,2022-06-30,intra-total,3807,519,203,74,31,20,5,10,3,44,1171,5887,4978,5497,FALSE,0.933752335654833,2021,2021-2022
MN,2022-06-30,intra-ucfe,6,1,0,0,0,0,0,0,0,0,2,9,8,9,FALSE,1,2021,2021-2022
MN,2022-06-30,intra-ucx,4,3,0,0,0,0,0,0,0,0,3,10,7,10,FALSE,1,2021,2021-2022
MN,2022-06-30,intra-ui,3797,515,203,74,31,20,5,10,3,44,1166,5868,4963,5478,FALSE,0.933537832310838,2021,2021-2022
MN,2022-07-31,inter-total,158,15,4,3,3,0,0,0,0,0,49,232,207,222,FALSE,0.956896551724138,2022,2022-2023
MN,2022-07-31,inter-ucfe,0,0,0,0,0,0,0,0,0,0,0,0,0,0,FALSE,0,2022,2022-2023
MN,2022-07-31,inter-ucx,0,0,0,0,0,0,0,0,0,0,0,0,0,0,FALSE,0,2022,2022-2023
MN,2022-07-31,inter-ui,158,15,4,3,3,0,0,0,0,0,49,232,207,222,FALSE,0.956896551724138,2022,2022-2023
MN,2022-07-31,intra-total,3041,484,208,68,48,26,12,6,3,28,1031,4955,4072,4556,FALSE,0.919475277497477,2022,2022-2023
MN,2022-07-31,intra-ucfe,1,2,0,0,0,0,0,0,0,0,0,3,1,3,FALSE,1,2022,2022-2023
MN,2022-07-31,intra-ucx,4,0,0,0,0,0,0,0,0,0,1,5,5,5,FALSE,1,2022,2022-2023
MN,2022-07-31,intra-ui,3036,482,208,68,48,26,12,6,3,28,1030,4947,4066,4548,FALSE,0.919345057610673,2022,2022-2023
MN,2022-08-31,inter-total,156,16,6,3,1,1,0,0,0,1,47,231,203,219,FALSE,0.948051948051948,2022,2022-2023
MN,2022-08-31,inter-ucfe,0,0,0,0,0,0,0,0,0,0,0,0,0,0,FALSE,0,2022,2022-2023
MN,2022-08-31,inter-ucx,0,0,0,0,0,0,0,0,0,0,0,0,0,0,FALSE,0,2022,2022-2023
MN,2022-08-31,inter-ui,156,16,6,3,1,1,0,0,0,1,47,231,203,219,FALSE,0.948051948051948,2022,2022-2023
MN,2022-08-31,intra-total,2876,440,189,58,31,26,11,8,3,34,1035,4711,3911,4351,FALSE,0.92358310337508,2022,2022-2023
MN,2022-08-31,intra-ucfe,2,1,0,0,0,0,0,0,0,0,0,3,2,3,FALSE,1,2022,2022-2023
MN,2022-08-31,intra-ucx,6,1,1,0,0,0,0,0,0,0,1,9,7,8,FALSE,0.888888888888889,2022,2022-2023
MN,2022-08-31,intra-ui,2868,438,188,58,31,26,11,8,3,34,1034,4699,3902,4340,FALSE,0.923600766120451,2022,2022-2023
MN,2022-09-30,inter-total,146,10,11,3,0,2,0,1,0,0,43,216,189,199,FALSE,0.921296296296296,2022,2022-2023
MN,2022-09-30,inter-ucfe,0,0,0,0,0,0,0,0,0,0,0,0,0,0,FALSE,0,2022,2022-2023
MN,2022-09-30,inter-ucx,0,0,0,0,0,0,0,0,0,0,0,0,0,0,FALSE,0,2022,2022-2023
MN,2022-09-30,inter-ui,146,10,11,3,0,2,0,1,0,0,43,216,189,199,FALSE,0.921296296296296,2022,2022-2023
MN,2022-09-30,intra-total,2346,417,173,62,20,17,8,8,5,27,859,3942,3205,3622,FALSE,0.918822932521563,2022,2022-2023
MN,2022-09-30,intra-ucfe,0,3,0,0,0,0,0,0,0,0,1,4,1,4,FALSE,1,2022,2022-2023
MN,2022-09-30,intra-ucx,0,1,2,0,0,0,0,0,0,0,4,7,4,5,FALSE,0.714285714285714,2022,2022-2023
MN,2022-09-30,intra-ui,2346,413,171,62,20,17,8,8,5,27,854,3931,3200,3613,FALSE,0.919104553548715,2022,2022-2023
MN,2022-10-31,inter-total,144,16,4,1,4,0,1,0,0,3,40,213,184,200,FALSE,0.938967136150235,2022,2022-2023
MN,2022-10-31,inter-ucfe,0,0,0,0,0,0,0,0,0,0,0,0,0,0,FALSE,0,2022,2022-2023
MN,2022-10-31,inter-ucx,0,0,0,0,0,0,0,0,0,0,0,0,0,0,FALSE,0,2022,2022-2023
MN,2022-10-31,inter-ui,144,16,4,1,4,0,1,0,0,3,40,213,184,200,FALSE,0.938967136150235,2022,2022-2023
MN,2022-10-31,intra-total,2376,408,167,55,19,16,4,7,1,18,859,3930,3235,3643,FALSE,0.926972010178117,2022,2022-2023
MN,2022-10-31,intra-ucfe,2,1,1,0,1,0,0,0,0,0,2,7,4,5,FALSE,0.714285714285714,2022,2022-2023
MN,2022-10-31,intra-ucx,3,1,0,0,0,0,0,0,0,0,1,5,4,5,FALSE,1,2022,2022-2023
MN,2022-10-31,intra-ui,2371,406,166,55,18,16,4,7,1,18,856,3918,3227,3633,FALSE,0.927258805513017,2022,2022-2023
MN,2022-11-30,inter-total,716,38,11,2,1,1,1,1,0,1,94,866,810,848,FALSE,0.979214780600462,2022,2022-2023
MN,2022-11-30,inter-ucfe,3,0,0,0,0,0,0,0,0,0,1,4,4,4,FALSE,1,2022,2022-2023
MN,2022-11-30,inter-ucx,0,0,0,0,0,0,0,0,0,0,0,0,0,0,FALSE,0,2022,2022-2023
MN,2022-11-30,inter-ui,713,38,11,2,1,1,1,1,0,1,93,862,806,844,FALSE,0.979118329466357,2022,2022-2023
MN,2022-11-30,intra-total,7786,549,210,65,29,19,4,3,2,21,1333,10021,9119,9668,FALSE,0.964773974653228,2022,2022-2023
MN,2022-11-30,intra-ucfe,10,1,2,0,0,0,0,0,0,0,3,16,13,14,FALSE,0.875,2022,2022-2023
MN,2022-11-30,intra-ucx,4,1,1,0,0,1,0,0,0,0,1,8,5,6,FALSE,0.75,2022,2022-2023
MN,2022-11-30,intra-ui,7772,547,207,65,29,18,4,3,2,21,1329,9997,9101,9648,FALSE,0.965089526858057,2022,2022-2023
MN,2022-12-31,inter-total,1077,71,38,7,7,1,2,0,1,0,214,1418,1291,1362,FALSE,0.960507757404795,2022,2022-2023
MN,2022-12-31,inter-ucfe,1,1,0,0,0,0,0,0,0,0,0,2,1,2,FALSE,1,2022,2022-2023
MN,2022-12-31,inter-ucx,0,0,0,0,0,0,0,0,0,0,0,0,0,0,FALSE,0,2022,2022-2023
MN,2022-12-31,inter-ui,1076,70,38,7,7,1,2,0,1,0,214,1416,1290,1360,FALSE,0.96045197740113,2022,2022-2023
MN,2022-12-31,intra-total,14223,857,318,114,46,23,10,6,7,31,2225,17860,16448,17305,FALSE,0.968924972004479,2022,2022-2023
MN,2022-12-31,intra-ucfe,17,2,1,1,1,0,0,0,0,0,6,28,23,25,FALSE,0.892857142857143,2022,2022-2023
MN,2022-12-31,intra-ucx,6,3,0,0,0,1,0,0,0,0,4,14,10,13,FALSE,0.928571428571429,2022,2022-2023
MN,2022-12-31,intra-ui,14200,852,317,113,45,22,10,6,7,31,2215,17818,16415,17267,FALSE,0.969076215063419,2022,2022-2023
MN,2023-01-31,inter-total,1066,61,28,14,15,6,6,1,1,2,206,1406,1272,1333,FALSE,0.948079658605974,2022,2022-2023
MN,2023-01-31,inter-ucfe,2,0,0,0,0,0,0,0,0,0,0,2,2,2,FALSE,1,2022,2022-2023
MN,2023-01-31,inter-ucx,0,0,0,0,0,0,0,0,0,0,0,0,0,0,FALSE,0,2022,2022-2023
MN,2023-01-31,inter-ui,1064,61,28,14,15,6,6,1,1,2,206,1404,1270,1331,FALSE,0.948005698005698,2022,2022-2023
MN,2023-01-31,intra-total,16679,995,428,137,59,41,34,12,10,29,2675,21099,19354,20349,FALSE,0.964453291625196,2022,2022-2023
MN,2023-01-31,intra-ucfe,13,2,1,0,0,0,0,0,0,0,5,21,18,20,FALSE,0.952380952380952,2022,2022-2023
MN,2023-01-31,intra-ucx,5,4,0,1,0,0,0,0,0,0,4,14,9,13,FALSE,0.928571428571429,2022,2022-2023
MN,2023-01-31,intra-ui,16661,989,427,136,59,41,34,12,10,29,2666,21064,19327,20316,FALSE,0.964489175845044,2022,2022-2023
MN,2023-02-28,inter-total,523,33,22,6,4,4,0,2,1,5,84,684,607,640,FALSE,0.935672514619883,2022,2022-2023
MN,2023-02-28,inter-ucfe,3,1,0,0,0,0,0,0,0,0,0,4,3,4,FALSE,1,2022,2022-2023
MN,2023-02-28,inter-ucx,0,0,0,0,0,0,0,0,0,0,0,0,0,0,FALSE,0,2022,2022-2023
MN,2023-02-28,inter-ui,520,32,22,6,4,4,0,2,1,5,84,680,604,636,FALSE,0.935294117647059,2022,2022-2023
MN,2023-02-28,intra-total,8002,739,302,108,59,34,16,12,7,45,1646,10970,9648,10387,FALSE,0.946855059252507,2022,2022-2023
MN,2023-02-28,intra-ucfe,5,1,1,1,0,0,1,0,0,0,3,12,8,9,FALSE,0.75,2022,2022-2023
MN,2023-02-28,intra-ucx,2,2,0,1,0,0,0,0,0,0,2,7,4,6,FALSE,0.857142857142857,2022,2022-2023
MN,2023-02-28,intra-ui,7995,736,301,106,59,34,15,12,7,45,1641,10951,9636,10372,FALSE,0.947128116153776,2022,2022-2023
MN,2023-03-31,inter-total,248,35,11,8,3,2,0,1,0,5,69,382,317,352,FALSE,0.921465968586387,2022,2022-2023
MN,2023-03-31,inter-ucfe,0,0,0,0,0,0,0,0,0,0,0,0,0,0,FALSE,0,2022,2022-2023
MN,2023-03-31,inter-ucx,0,0,0,0,0,0,0,0,0,0,0,0,0,0,FALSE,0,2022,2022-2023
MN,2023-03-31,inter-ui,248,35,11,8,3,2,0,1,0,5,69,382,317,352,FALSE,0.921465968586387,2022,2022-2023
MN,2023-03-31,intra-total,5936,689,288,96,44,25,17,13,9,31,1631,8779,7567,8256,FALSE,0.940426016630596,2022,2022-2023
MN,2023-03-31,intra-ucfe,1,0,0,0,0,0,0,0,0,0,0,1,1,1,FALSE,1,2022,2022-2023
MN,2023-03-31,intra-ucx,6,1,0,0,0,0,0,0,0,0,1,8,7,8,FALSE,1,2022,2022-2023
MN,2023-03-31,intra-ui,5929,688,288,96,44,25,17,13,9,31,1630,8770,7559,8247,FALSE,0.94036488027366,2022,2022-2023
MN,2023-04-30,inter-total,194,18,4,4,3,3,2,0,2,0,44,274,238,256,FALSE,0.934306569343066,2022,2022-2023
MN,2023-04-30,inter-ucfe,0,0,0,0,0,0,0,0,0,0,0,0,0,0,FALSE,0,2022,2022-2023
MN,2023-04-30,inter-ucx,0,0,0,0,0,0,0,0,0,0,0,0,0,0,FALSE,0,2022,2022-2023
MN,2023-04-30,inter-ui,194,18,4,4,3,3,2,0,2,0,44,274,238,256,FALSE,0.934306569343066,2022,2022-2023
MN,2023-04-30,intra-total,4470,528,222,80,29,18,6,10,4,20,1196,6583,5666,6194,FALSE,0.940908400425338,2022,2022-2023
MN,2023-04-30,intra-ucfe,1,1,0,0,0,0,0,0,0,0,1,3,2,3,FALSE,1,2022,2022-2023
MN,2023-04-30,intra-ucx,5,2,1,0,0,0,0,0,0,0,0,8,5,7,FALSE,0.875,2022,2022-2023
MN,2023-04-30,intra-ui,4464,525,221,80,29,18,6,10,4,20,1195,6572,5659,6184,FALSE,0.940961655508217,2022,2022-2023
MN,2023-05-31,inter-total,201,29,13,5,3,0,0,0,0,3,39,293,240,269,FALSE,0.918088737201365,2022,2022-2023
MN,2023-05-31,inter-ucfe,1,0,0,0,0,0,0,0,0,0,0,1,1,1,FALSE,1,2022,2022-2023
MN,2023-05-31,inter-ucx,1,0,0,0,0,0,0,0,0,0,0,1,1,1,FALSE,1,2022,2022-2023
MN,2023-05-31,inter-ui,199,29,13,5,3,0,0,0,0,3,39,291,238,267,FALSE,0.917525773195876,2022,2022-2023
MN,2023-05-31,intra-total,3798,576,247,81,31,23,12,10,6,17,1179,5980,4977,5553,FALSE,0.928595317725753,2022,2022-2023
MN,2023-05-31,intra-ucfe,2,2,0,1,0,0,0,0,0,0,1,6,3,5,FALSE,0.833333333333333,2022,2022-2023
MN,2023-05-31,intra-ucx,9,1,0,0,0,0,0,0,0,0,3,13,12,13,FALSE,1,2022,2022-2023
MN,2023-05-31,intra-ui,3787,573,247,80,31,23,12,10,6,17,1175,5961,4962,5535,FALSE,0.928535480624056,2022,2022-2023
MN,2023-06-30,inter-total,158,24,10,2,6,1,1,0,0,2,62,266,220,244,FALSE,0.917293233082707,2022,2022-2023
MN,2023-06-30,inter-ucfe,1,0,0,0,0,0,0,0,0,0,1,2,2,2,FALSE,1,2022,2022-2023
MN,2023-06-30,inter-ucx,0,0,0,0,0,0,0,0,0,0,0,0,0,0,FALSE,0,2022,2022-2023
MN,2023-06-30,inter-ui,157,24,10,2,6,1,1,0,0,2,61,264,218,242,FALSE,0.916666666666667,2022,2022-2023
MN,2023-06-30,intra-total,13489,696,254,68,40,21,9,10,3,41,2433,17064,15922,16618,FALSE,0.973863103609939,2022,2022-2023
MN,2023-06-30,intra-ucfe,1,0,0,0,0,0,0,0,0,0,4,5,5,5,FALSE,1,2022,2022-2023
MN,2023-06-30,intra-ucx,5,0,0,0,0,0,0,0,0,0,1,6,6,6,FALSE,1,2022,2022-2023
MN,2023-06-30,intra-ui,13483,696,254,68,40,21,9,10,3,41,2428,17053,15911,16607,FALSE,0.973846244062628,2022,2022-2023
MN,2023-07-31,inter-total,143,21,8,3,1,1,2,1,0,2,56,238,199,220,FALSE,0.92436974789916,2023,2023-2024
MN,2023-07-31,inter-ucfe,0,0,0,0,0,0,0,0,0,0,0,0,0,0,FALSE,0,2023,2023-2024
MN,2023-07-31,inter-ucx,1,0,0,0,0,0,0,0,0,0,0,1,1,1,FALSE,1,2023,2023-2024
MN,2023-07-31,inter-ui,142,21,8,3,1,1,2,1,0,2,56,237,198,219,FALSE,0.924050632911392,2023,2023-2024
MN,2023-07-31,intra-total,7132,1251,550,161,92,32,21,15,5,21,3193,12473,10325,11576,FALSE,0.928084662871803,2023,2023-2024
MN,2023-07-31,intra-ucfe,1,1,1,0,0,0,0,0,0,0,0,3,1,2,FALSE,0.666666666666667,2023,2023-2024
MN,2023-07-31,intra-ucx,4,2,0,0,0,0,0,0,0,0,4,10,8,10,FALSE,1,2023,2023-2024
MN,2023-07-31,intra-ui,7127,1248,549,161,92,32,21,15,5,21,3189,12460,10316,11564,FALSE,0.928089887640449,2023,2023-2024
MN,2023-08-31,inter-total,193,9,15,3,2,1,1,1,0,1,41,267,234,243,FALSE,0.910112359550562,2023,2023-2024
MN,2023-08-31,inter-ucfe,0,0,0,0,0,0,0,0,0,0,0,0,0,0,FALSE,0,2023,2023-2024
MN,2023-08-31,inter-ucx,0,0,0,0,0,0,0,0,0,0,0,0,0,0,FALSE,0,2023,2023-2024
MN,2023-08-31,inter-ui,193,9,15,3,2,1,1,1,0,1,41,267,234,243,FALSE,0.910112359550562,2023,2023-2024
MN,2023-08-31,intra-total,4970,676,332,137,95,75,43,30,21,36,1688,8103,6658,7334,FALSE,0.905096877699618,2023,2023-2024
MN,2023-08-31,intra-ucfe,2,0,0,0,0,0,0,0,0,0,3,5,5,5,FALSE,1,2023,2023-2024
MN,2023-08-31,intra-ucx,3,0,1,0,0,0,0,0,0,0,4,8,7,7,FALSE,0.875,2023,2023-2024
MN,2023-08-31,intra-ui,4965,676,331,137,95,75,43,30,21,36,1681,8090,6646,7322,FALSE,0.905067985166873,2023,2023-2024
MN,2023-09-30,inter-total,127,23,9,5,2,0,2,0,1,3,45,217,172,195,FALSE,0.898617511520737,2023,2023-2024
MN,2023-09-30,inter-ucfe,0,0,0,0,0,0,0,0,0,0,0,0,0,0,FALSE,0,2023,2023-2024
MN,2023-09-30,inter-ucx,0,0,0,0,0,0,0,0,0,0,0,0,0,0,FALSE,0,2023,2023-2024
MN,2023-09-30,inter-ui,127,23,9,5,2,0,2,0,1,3,45,217,172,195,FALSE,0.898617511520737,2023,2023-2024
MN,2023-09-30,intra-total,3057,531,246,93,39,22,18,14,13,57,1117,5207,4174,4705,FALSE,0.903591319377761,2023,2023-2024
MN,2023-09-30,intra-ucfe,1,3,0,0,0,0,0,0,0,0,2,6,3,6,FALSE,1,2023,2023-2024
MN,2023-09-30,intra-ucx,7,1,0,0,0,0,0,0,0,0,1,9,8,9,FALSE,1,2023,2023-2024
MN,2023-09-30,intra-ui,3049,527,246,93,39,22,18,14,13,57,1114,5192,4163,4690,FALSE,0.903312788906009,2023,2023-2024
MN,2023-10-31,inter-total,164,19,11,1,2,0,1,0,0,1,50,249,214,233,FALSE,0.93574297188755,2023,2023-2024
MN,2023-10-31,inter-ucfe,0,0,0,0,0,0,0,0,0,0,0,0,0,0,FALSE,0,2023,2023-2024
MN,2023-10-31,inter-ucx,0,0,0,0,0,0,0,0,0,0,0,0,0,0,FALSE,0,2023,2023-2024
MN,2023-10-31,inter-ui,164,19,11,1,2,0,1,0,0,1,50,249,214,233,FALSE,0.93574297188755,2023,2023-2024
MN,2023-10-31,intra-total,3766,532,214,72,39,27,14,11,6,32,1141,5854,4907,5439,FALSE,0.929108302015716,2023,2023-2024
MN,2023-10-31,intra-ucfe,4,0,0,0,0,0,1,0,0,0,3,8,7,7,FALSE,0.875,2023,2023-2024
MN,2023-10-31,intra-ucx,3,0,0,1,0,0,0,0,0,1,1,6,4,4,FALSE,0.666666666666667,2023,2023-2024
MN,2023-10-31,intra-ui,3759,532,214,71,39,27,13,11,6,31,1137,5840,4896,5428,FALSE,0.929452054794521,2023,2023-2024
MN,2023-11-30,inter-total,812,34,10,4,2,0,0,2,0,1,118,983,930,964,FALSE,0.980671414038657,2023,2023-2024
MN,2023-11-30,inter-ucfe,1,0,0,0,0,0,0,0,0,0,1,2,2,2,FALSE,1,2023,2023-2024
MN,2023-11-30,inter-ucx,0,0,0,0,0,0,0,0,0,0,1,1,1,1,FALSE,1,2023,2023-2024
MN,2023-11-30,inter-ui,811,34,10,4,2,0,0,2,0,1,116,980,927,961,FALSE,0.980612244897959,2023,2023-2024
MN,2023-11-30,intra-total,7798,667,246,68,40,32,11,6,3,29,1610,10510,9408,10075,FALSE,0.958610846812559,2023,2023-2024
MN,2023-11-30,intra-ucfe,5,2,2,0,0,0,0,0,0,0,5,14,10,12,FALSE,0.857142857142857,2023,2023-2024
MN,2023-11-30,intra-ucx,3,1,1,1,0,0,0,0,0,0,1,7,4,5,FALSE,0.714285714285714,2023,2023-2024
MN,2023-11-30,intra-ui,7790,664,243,67,40,32,11,6,3,29,1604,10489,9394,10058,FALSE,0.958909333587568,2023,2023-2024
MN,2023-12-31,inter-total,1064,75,37,8,5,1,1,2,0,2,197,1392,1261,1336,FALSE,0.959770114942529,2023,2023-2024
MN,2023-12-31,inter-ucfe,0,0,0,0,0,0,0,0,0,0,0,0,0,0,FALSE,0,2023,2023-2024
MN,2023-12-31,inter-ucx,0,0,0,0,0,0,0,0,0,0,0,0,0,0,FALSE,0,2023,2023-2024
MN,2023-12-31,inter-ui,1064,75,37,8,5,1,1,2,0,2,197,1392,1261,1336,FALSE,0.959770114942529,2023,2023-2024
MN,2023-12-31,intra-total,14723,835,381,120,57,26,20,5,8,22,2148,18345,16871,17706,FALSE,0.965167620605069,2023,2023-2024
MN,2023-12-31,intra-ucfe,12,0,1,0,0,0,1,0,0,0,5,19,17,17,FALSE,0.894736842105263,2023,2023-2024
MN,2023-12-31,intra-ucx,3,1,1,0,0,0,0,0,0,0,2,7,5,6,FALSE,0.857142857142857,2023,2023-2024
MN,2023-12-31,intra-ui,14708,834,379,120,57,26,19,5,8,22,2141,18319,16849,17683,FALSE,0.965281947704569,2023,2023-2024
MN,2024-01-31,inter-total,1158,63,23,17,8,4,2,4,1,2,227,1509,1385,1448,FALSE,0.959575878064944,2023,2023-2024
MN,2024-01-31,inter-ucfe,1,1,0,0,0,0,0,0,0,0,1,3,2,3,FALSE,1,2023,2023-2024
MN,2024-01-31,inter-ucx,0,0,0,0,0,0,0,0,0,0,0,0,0,0,FALSE,0,2023,2023-2024
MN,2024-01-31,inter-ui,1157,62,23,17,8,4,2,4,1,2,226,1506,1383,1445,FALSE,0.959495351925631,2023,2023-2024
MN,2024-01-31,intra-total,19307,1175,524,179,82,46,36,16,8,43,3140,24556,22447,23622,FALSE,0.96196448933051,2023,2023-2024
MN,2024-01-31,intra-ucfe,4,0,0,0,0,0,0,0,0,0,6,10,10,10,FALSE,1,2023,2023-2024
MN,2024-01-31,intra-ucx,11,2,1,0,0,0,0,0,0,0,1,15,12,14,FALSE,0.933333333333333,2023,2023-2024
MN,2024-01-31,intra-ui,19292,1173,523,179,82,46,36,16,8,43,3133,24531,22425,23598,FALSE,0.961966491378256,2023,2023-2024
MN,2024-02-29,inter-total,538,42,23,11,5,2,3,0,1,10,91,726,629,671,FALSE,0.924242424242424,2023,2023-2024
MN,2024-02-29,inter-ucfe,0,0,0,1,0,0,0,0,0,0,0,1,0,0,FALSE,0,2023,2023-2024
MN,2024-02-29,inter-ucx,0,0,0,0,0,0,0,0,0,0,0,0,0,0,FALSE,0,2023,2023-2024
MN,2024-02-29,inter-ui,538,42,23,10,5,2,3,0,1,10,91,725,629,671,FALSE,0.92551724137931,2023,2023-2024
MN,2024-02-29,intra-total,8277,814,369,156,64,34,22,15,10,57,2033,11851,10310,11124,FALSE,0.938654965825669,2023,2023-2024
MN,2024-02-29,intra-ucfe,5,1,0,0,0,0,0,0,0,0,2,8,7,8,FALSE,1,2023,2023-2024
MN,2024-02-29,intra-ucx,4,1,1,0,0,0,0,0,0,0,2,8,6,7,FALSE,0.875,2023,2023-2024
MN,2024-02-29,intra-ui,8268,812,368,156,64,34,22,15,10,57,2029,11835,10297,11109,FALSE,0.938656527249683,2023,2023-2024
MN,2024-03-31,inter-total,247,21,14,6,7,1,1,3,0,2,60,362,307,328,FALSE,0.906077348066298,2023,2023-2024
MN,2024-03-31,inter-ucfe,0,0,0,0,0,0,0,0,0,0,0,0,0,0,FALSE,0,2023,2023-2024
MN,2024-03-31,inter-ucx,0,0,0,0,0,0,0,0,0,0,0,0,0,0,FALSE,0,2023,2023-2024
MN,2024-03-31,inter-ui,247,21,14,6,7,1,1,3,0,2,60,362,307,328,FALSE,0.906077348066298,2023,2023-2024
MN,2024-03-31,intra-total,5815,652,254,103,44,22,29,13,12,34,1490,8468,7305,7957,FALSE,0.939655172413793,2023,2023-2024
MN,2024-03-31,intra-ucfe,2,0,0,0,0,0,0,0,0,0,1,3,3,3,FALSE,1,2023,2023-2024
MN,2024-03-31,intra-ucx,2,0,0,0,0,0,0,0,0,0,3,5,5,5,FALSE,1,2023,2023-2024
MN,2024-03-31,intra-ui,5811,652,254,103,44,22,29,13,12,34,1486,8460,7297,7949,FALSE,0.939598108747045,2023,2023-2024
MN,2024-04-30,inter-total,194,30,12,6,6,1,0,3,2,1,51,306,245,275,FALSE,0.898692810457516,2023,2023-2024
MN,2024-04-30,inter-ucfe,0,0,0,0,0,0,0,0,0,0,0,0,0,0,FALSE,0,2023,2023-2024
MN,2024-04-30,inter-ucx,0,0,0,0,0,0,0,0,0,0,0,0,0,0,FALSE,0,2023,2023-2024
MN,2024-04-30,inter-ui,194,30,12,6,6,1,0,3,2,1,51,306,245,275,FALSE,0.898692810457516,2023,2023-2024
MN,2024-04-30,intra-total,5368,588,212,98,39,16,17,10,4,38,1524,7914,6892,7480,FALSE,0.945160475107405,2023,2023-2024
MN,2024-04-30,intra-ucfe,5,2,0,0,0,0,0,0,0,0,3,10,8,10,FALSE,1,2023,2023-2024
MN,2024-04-30,intra-ucx,2,0,0,0,0,0,0,0,0,0,3,5,5,5,FALSE,1,2023,2023-2024
MN,2024-04-30,intra-ui,5361,586,212,98,39,16,17,10,4,38,1518,7899,6879,7465,FALSE,0.945056336245094,2023,2023-2024
MN,2024-05-31,inter-total,191,10,6,0,2,0,0,1,0,2,59,271,250,260,FALSE,0.959409594095941,2023,2023-2024
MN,2024-05-31,inter-ucfe,1,0,0,0,0,0,0,0,0,0,0,1,1,1,FALSE,1,2023,2023-2024
MN,2024-05-31,inter-ucx,0,0,0,0,0,0,0,0,0,0,0,0,0,0,FALSE,0,2023,2023-2024
MN,2024-05-31,inter-ui,190,10,6,0,2,0,0,1,0,2,59,270,249,259,FALSE,0.959259259259259,2023,2023-2024
MN,2024-05-31,intra-total,4149,507,236,78,31,22,11,6,4,27,1270,6341,5419,5926,FALSE,0.934552909635704,2023,2023-2024
MN,2024-05-31,intra-ucfe,10,4,0,1,0,0,0,0,0,0,5,20,15,19,FALSE,0.95,2023,2023-2024
MN,2024-05-31,intra-ucx,2,0,0,0,0,0,0,0,0,0,4,6,6,6,FALSE,1,2023,2023-2024
MN,2024-05-31,intra-ui,4137,503,236,77,31,22,11,6,4,27,1261,6315,5398,5901,FALSE,0.934441805225653,2023,2023-2024
MN,2024-06-30,inter-total,177,28,6,2,2,2,0,1,1,2,50,271,227,255,FALSE,0.940959409594096,2023,2023-2024
MN,2024-06-30,inter-ucfe,0,0,0,0,0,0,0,0,0,0,0,0,0,0,FALSE,0,2023,2023-2024
MN,2024-06-30,inter-ucx,0,0,0,0,0,0,0,0,0,0,0,0,0,0,FALSE,0,2023,2023-2024
MN,2024-06-30,inter-ui,177,28,6,2,2,2,0,1,1,2,50,271,227,255,FALSE,0.940959409594096,2023,2023-2024
MN,2024-06-30,intra-total,17108,634,254,83,28,11,6,6,6,34,2172,20342,19280,19914,FALSE,0.978959787631501,2023,2023-2024
MN,2024-06-30,intra-ucfe,3,1,0,0,0,0,0,0,0,0,1,5,4,5,FALSE,1,2023,2023-2024
MN,2024-06-30,intra-ucx,3,0,0,0,0,0,0,0,0,0,2,5,5,5,FALSE,1,2023,2023-2024
MN,2024-06-30,intra-ui,17102,633,254,83,28,11,6,6,6,34,2169,20332,19271,19904,FALSE,0.978949439307496,2023,2023-2024
MN,2024-07-31,inter-total,220,20,5,3,6,1,0,1,0,0,42,298,262,282,FALSE,0.946308724832215,2024,2024-2025
MN,2024-07-31,inter-ucfe,0,0,0,0,0,0,0,0,0,0,0,0,0,0,FALSE,0,2024,2024-2025
MN,2024-07-31,inter-ucx,0,0,0,0,0,0,0,0,0,0,0,0,0,0,FALSE,0,2024,2024-2025
MN,2024-07-31,inter-ui,220,20,5,3,6,1,0,1,0,0,42,298,262,282,FALSE,0.946308724832215,2024,2024-2025
MN,2024-07-31,intra-total,10710,1469,541,163,62,23,25,3,5,29,3662,16692,14372,15841,FALSE,0.949017493410017,2024,2024-2025
MN,2024-07-31,intra-ucfe,3,2,0,1,0,0,0,0,0,0,3,9,6,8,FALSE,0.888888888888889,2024,2024-2025
MN,2024-07-31,intra-ucx,3,0,2,0,0,0,0,0,0,0,9,14,12,12,FALSE,0.857142857142857,2024,2024-2025
MN,2024-07-31,intra-ui,10704,1467,539,162,62,23,25,3,5,29,3650,16669,14354,15821,FALSE,0.949127122202892,2024,2024-2025
MN,2024-08-31,inter-total,156,15,9,2,1,1,0,1,1,2,43,231,199,214,FALSE,0.926406926406927,2024,2024-2025
MN,2024-08-31,inter-ucfe,0,0,0,0,0,0,0,0,0,0,0,0,0,0,FALSE,0,2024,2024-2025
MN,2024-08-31,inter-ucx,0,0,0,0,0,0,0,0,0,0,0,0,0,0,FALSE,0,2024,2024-2025
MN,2024-08-31,inter-ui,156,15,9,2,1,1,0,1,1,2,43,231,199,214,FALSE,0.926406926406927,2024,2024-2025
MN,2024-08-31,intra-total,4910,619,263,99,53,31,20,10,8,20,1602,7635,6512,7131,FALSE,0.933988212180747,2024,2024-2025
MN,2024-08-31,intra-ucfe,3,0,2,0,0,0,0,0,0,0,1,6,4,4,FALSE,0.666666666666667,2024,2024-2025
MN,2024-08-31,intra-ucx,2,0,1,0,0,0,0,0,0,0,1,4,3,3,FALSE,0.75,2024,2024-2025
MN,2024-08-31,intra-ui,4905,619,260,99,53,31,20,10,8,20,1600,7625,6505,7124,FALSE,0.934295081967213,2024,2024-2025
MN,2024-09-30,inter-total,118,16,2,1,0,1,0,1,0,1,49,189,167,183,FALSE,0.968253968253968,2024,2024-2025
MN,2024-09-30,inter-ucfe,0,0,0,0,0,0,0,0,0,0,0,0,0,0,FALSE,0,2024,2024-2025
MN,2024-09-30,inter-ucx,0,0,0,0,0,0,0,0,0,0,0,0,0,0,FALSE,0,2024,2024-2025
MN,2024-09-30,inter-ui,118,16,2,1,0,1,0,1,0,1,49,189,167,183,FALSE,0.968253968253968,2024,2024-2025
MN,2024-09-30,intra-total,3582,521,241,66,31,19,8,3,6,23,1289,5789,4871,5392,FALSE,0.931421661772327,2024,2024-2025
MN,2024-09-30,intra-ucfe,4,3,0,0,0,0,0,0,0,0,1,8,5,8,FALSE,1,2024,2024-2025
MN,2024-09-30,intra-ucx,6,1,1,0,0,0,0,0,0,1,2,11,8,9,FALSE,0.818181818181818,2024,2024-2025
MN,2024-09-30,intra-ui,3572,517,240,66,31,19,8,3,6,22,1286,5770,4858,5375,FALSE,0.931542461005199,2024,2024-2025
MN,2024-10-31,inter-total,148,16,9,1,1,0,0,0,0,0,34,209,182,198,FALSE,0.947368421052632,2024,2024-2025
MN,2024-10-31,inter-ucfe,0,0,0,0,0,0,0,0,0,0,0,0,0,0,FALSE,0,2024,2024-2025
MN,2024-10-31,inter-ucx,0,0,0,0,0,0,0,0,0,0,0,0,0,0,FALSE,0,2024,2024-2025
MN,2024-10-31,inter-ui,148,16,9,1,1,0,0,0,0,0,34,209,182,198,FALSE,0.947368421052632,2024,2024-2025
MN,2024-10-31,intra-total,4540,598,223,90,28,11,7,6,4,17,1398,6922,5938,6536,FALSE,0.944235770008668,2024,2024-2025
MN,2024-10-31,intra-ucfe,4,2,1,0,0,0,0,0,0,0,1,8,5,7,FALSE,0.875,2024,2024-2025
MN,2024-10-31,intra-ucx,4,2,1,0,0,0,0,0,0,0,4,11,8,10,FALSE,0.909090909090909,2024,2024-2025
MN,2024-10-31,intra-ui,4532,594,221,90,28,11,7,6,4,17,1393,6903,5925,6519,FALSE,0.944372012168622,2024,2024-2025
MN,2024-11-30,inter-total,630,23,7,2,2,0,0,0,1,0,89,754,719,742,FALSE,0.984084880636605,2024,2024-2025
MN,2024-11-30,inter-ucfe,1,0,0,0,0,0,0,0,0,0,0,1,1,1,FALSE,1,2024,2024-2025
MN,2024-11-30,inter-ucx,0,0,0,0,0,0,0,0,0,0,0,0,0,0,FALSE,0,2024,2024-2025
MN,2024-11-30,inter-ui,629,23,7,2,2,0,0,0,1,0,89,753,718,741,FALSE,0.98406374501992,2024,2024-2025
MN,2024-11-30,intra-total,7216,526,209,68,24,12,11,8,5,14,1426,9519,8642,9168,FALSE,0.963126378821305,2024,2024-2025
MN,2024-11-30,intra-ucfe,4,0,0,0,0,0,0,0,0,0,3,7,7,7,FALSE,1,2024,2024-2025
MN,2024-11-30,intra-ucx,3,2,1,0,1,0,0,0,0,0,3,10,6,8,FALSE,0.8,2024,2024-2025
MN,2024-11-30,intra-ui,7209,524,208,68,23,12,11,8,5,14,1420,9502,8629,9153,FALSE,0.963270890338876,2024,2024-2025
MN,2024-12-31,inter-total,1195,59,24,8,5,3,0,0,0,1,186,1481,1381,1440,FALSE,0.972316002700878,2024,2024-2025
MN,2024-12-31,inter-ucfe,0,0,0,0,0,0,0,0,0,0,0,0,0,0,FALSE,0,2024,2024-2025
MN,2024-12-31,inter-ucx,0,0,0,0,0,0,0,0,0,0,0,0,0,0,FALSE,0,2024,2024-2025
MN,2024-12-31,inter-ui,1195,59,24,8,5,3,0,0,0,1,186,1481,1381,1440,FALSE,0.972316002700878,2024,2024-2025
MN,2024-12-31,intra-total,18856,911,358,87,27,23,8,5,5,28,2723,23031,21579,22490,FALSE,0.976509921410273,2024,2024-2025
MN,2024-12-31,intra-ucfe,11,0,0,0,0,0,0,0,0,0,3,14,14,14,FALSE,1,2024,2024-2025
MN,2024-12-31,intra-ucx,5,0,2,0,0,0,0,0,0,0,3,10,8,8,FALSE,0.8,2024,2024-2025
MN,2024-12-31,intra-ui,18840,911,356,87,27,23,8,5,5,28,2717,23007,21557,22468,FALSE,0.976572347546399,2024,2024-2025
MO,2019-01-31,inter-total,154,16,6,5,6,1,3,0,1,1,46,239,200,216,TRUE,0.836820083682008,2018,2018-2019
MO,2019-01-31,inter-ucfe,0,0,0,1,1,0,1,0,0,0,0,3,0,0,TRUE,0,2018,2018-2019
MO,2019-01-31,inter-ucx,0,0,0,0,0,0,0,0,0,0,0,0,0,0,TRUE,0,2018,2018-2019
MO,2019-01-31,inter-ui,154,16,6,4,5,1,2,0,1,1,46,236,200,216,TRUE,0.847457627118644,2018,2018-2019
MO,2019-01-31,intra-total,8373,599,215,103,55,45,41,25,16,71,2092,11635,10465,11064,TRUE,0.899441340782123,2018,2018-2019
MO,2019-01-31,intra-ucfe,37,4,3,1,0,0,0,0,1,1,14,61,51,55,TRUE,0.836065573770492,2018,2018-2019
MO,2019-01-31,intra-ucx,2,0,0,0,0,0,0,0,0,0,2,4,4,4,TRUE,1,2018,2018-2019
MO,2019-01-31,intra-ui,8334,595,212,102,55,45,41,25,15,70,2076,11570,10410,11005,TRUE,0.899740708729473,2018,2018-2019
MO,2019-02-28,inter-total,111,15,5,0,2,0,3,1,1,2,43,183,154,169,TRUE,0.841530054644809,2018,2018-2019
MO,2019-02-28,inter-ucfe,0,1,1,0,0,0,1,0,0,0,0,3,0,1,TRUE,0,2018,2018-2019
MO,2019-02-28,inter-ucx,1,0,0,0,0,0,0,0,0,0,0,1,1,1,TRUE,1,2018,2018-2019
MO,2019-02-28,inter-ui,110,14,4,0,2,0,2,1,1,2,43,179,153,167,TRUE,0.854748603351955,2018,2018-2019
MO,2019-02-28,intra-total,6007,650,207,85,71,41,33,28,15,53,1608,8798,7615,8265,TRUE,0.865537622186861,2018,2018-2019
MO,2019-02-28,intra-ucfe,4,4,3,0,3,0,0,0,0,1,1,16,5,9,TRUE,0.3125,2018,2018-2019
MO,2019-02-28,intra-ucx,4,1,0,0,0,1,0,0,0,0,5,11,9,10,TRUE,0.818181818181818,2018,2018-2019
MO,2019-02-28,intra-ui,5999,645,204,85,68,40,33,28,15,52,1602,8771,7601,8246,TRUE,0.866605860221183,2018,2018-2019
MO,2019-03-31,inter-total,66,10,7,3,5,1,3,0,2,2,19,118,85,95,TRUE,0.720338983050847,2018,2018-2019
MO,2019-03-31,inter-ucfe,3,0,1,0,0,0,0,0,0,0,0,4,3,3,TRUE,0.75,2018,2018-2019
MO,2019-03-31,inter-ucx,0,0,0,0,0,0,0,0,0,0,0,0,0,0,TRUE,0,2018,2018-2019
MO,2019-03-31,inter-ui,63,10,6,3,5,1,3,0,2,2,19,114,82,92,TRUE,0.719298245614035,2018,2018-2019
MO,2019-03-31,intra-total,2921,398,145,73,55,51,32,22,18,43,1177,4935,4098,4496,TRUE,0.830395136778116,2018,2018-2019
MO,2019-03-31,intra-ucfe,7,2,0,2,0,4,1,0,0,0,3,19,10,12,TRUE,0.526315789473684,2018,2018-2019
MO,2019-03-31,intra-ucx,3,0,0,1,0,0,0,0,0,0,1,5,4,4,TRUE,0.8,2018,2018-2019
MO,2019-03-31,intra-ui,2911,396,145,70,55,47,31,22,18,43,1173,4911,4084,4480,TRUE,0.831602524944003,2018,2018-2019
MO,2019-04-30,inter-total,62,3,6,1,3,0,1,1,1,0,14,92,76,79,TRUE,0.826086956521739,2018,2018-2019
MO,2019-04-30,inter-ucfe,0,0,0,1,0,0,0,0,0,0,0,1,0,0,TRUE,0,2018,2018-2019
MO,2019-04-30,inter-ucx,0,0,0,0,0,0,0,0,0,0,0,0,0,0,TRUE,0,2018,2018-2019
MO,2019-04-30,inter-ui,62,3,6,0,3,0,1,1,1,0,14,91,76,79,TRUE,0.835164835164835,2018,2018-2019
MO,2019-04-30,intra-total,2430,217,76,68,41,30,22,19,13,45,788,3749,3218,3435,TRUE,0.858362229927981,2018,2018-2019
MO,2019-04-30,intra-ucfe,5,4,3,1,0,1,1,0,0,2,4,21,9,13,TRUE,0.428571428571429,2018,2018-2019
MO,2019-04-30,intra-ucx,7,0,0,0,0,0,0,0,0,0,3,10,10,10,TRUE,1,2018,2018-2019
MO,2019-04-30,intra-ui,2418,213,73,67,41,29,21,19,13,43,781,3718,3199,3412,TRUE,0.860408821947284,2018,2018-2019
MO,2019-05-31,inter-total,64,9,4,0,0,1,0,1,0,0,16,95,80,89,TRUE,0.842105263157895,2018,2018-2019
MO,2019-05-31,inter-ucfe,0,1,0,0,0,0,0,0,0,0,0,1,0,1,TRUE,0,2018,2018-2019
MO,2019-05-31,inter-ucx,0,0,0,0,0,0,0,0,0,0,0,0,0,0,TRUE,0,2018,2018-2019
MO,2019-05-31,inter-ui,64,8,4,0,0,1,0,1,0,0,16,94,80,88,TRUE,0.851063829787234,2018,2018-2019
MO,2019-05-31,intra-total,2514,192,77,49,31,19,16,14,9,47,833,3801,3347,3539,TRUE,0.880557747961063,2018,2018-2019
MO,2019-05-31,intra-ucfe,2,5,1,1,0,1,0,0,0,1,2,13,4,9,TRUE,0.307692307692308,2018,2018-2019
MO,2019-05-31,intra-ucx,4,0,0,0,0,0,0,0,0,0,2,6,6,6,TRUE,1,2018,2018-2019
MO,2019-05-31,intra-ui,2508,187,76,48,31,18,16,14,9,46,829,3782,3337,3524,TRUE,0.882337387625595,2018,2018-2019
MO,2019-06-30,inter-total,58,6,2,0,2,2,2,0,0,2,22,96,80,86,TRUE,0.833333333333333,2018,2018-2019
MO,2019-06-30,inter-ucfe,0,0,0,0,0,0,0,0,0,0,0,0,0,0,TRUE,0,2018,2018-2019
MO,2019-06-30,inter-ucx,0,0,0,0,0,0,0,0,0,0,0,0,0,0,TRUE,0,2018,2018-2019
MO,2019-06-30,inter-ui,58,6,2,0,2,2,2,0,0,2,22,96,80,86,TRUE,0.833333333333333,2018,2018-2019
MO,2019-06-30,intra-total,4078,221,83,56,46,32,21,18,7,29,1248,5839,5326,5547,TRUE,0.912142490152423,2018,2018-2019
MO,2019-06-30,intra-ucfe,3,4,2,0,1,1,0,0,0,0,4,15,7,11,TRUE,0.466666666666667,2018,2018-2019
MO,2019-06-30,intra-ucx,5,1,0,0,0,0,0,0,0,0,1,7,6,7,TRUE,0.857142857142857,2018,2018-2019
MO,2019-06-30,intra-ui,4070,216,81,56,45,31,21,18,7,29,1243,5817,5313,5529,TRUE,0.913357400722022,2018,2018-2019
MO,2019-07-31,inter-total,65,19,7,2,2,0,2,0,0,5,27,129,92,111,TRUE,0.713178294573643,2019,2019-2020
MO,2019-07-31,inter-ucfe,0,0,0,0,1,0,0,0,0,1,1,3,1,1,TRUE,0.333333333333333,2019,2019-2020
MO,2019-07-31,inter-ucx,1,0,0,0,0,0,0,0,0,0,0,1,1,1,TRUE,1,2019,2019-2020
MO,2019-07-31,inter-ui,64,19,7,2,1,0,2,0,0,4,26,125,90,109,TRUE,0.72,2019,2019-2020
MO,2019-07-31,intra-total,4767,529,162,77,59,40,25,16,11,37,1400,7123,6167,6696,TRUE,0.865786887547382,2019,2019-2020
MO,2019-07-31,intra-ucfe,2,0,0,0,0,0,0,0,0,0,1,3,3,3,TRUE,1,2019,2019-2020
MO,2019-07-31,intra-ucx,9,0,0,1,0,0,0,0,0,0,2,12,11,11,TRUE,0.916666666666667,2019,2019-2020
MO,2019-07-31,intra-ui,4756,529,162,76,59,40,25,16,11,37,1397,7108,6153,6682,TRUE,0.865644344400675,2019,2019-2020
MO,2019-08-31,inter-total,65,4,1,4,7,2,0,1,1,1,34,120,99,103,TRUE,0.825,2019,2019-2020
MO,2019-08-31,inter-ucfe,1,0,1,0,1,0,0,0,1,0,1,5,2,2,TRUE,0.4,2019,2019-2020
MO,2019-08-31,inter-ucx,0,0,0,0,0,0,0,0,0,0,0,0,0,0,TRUE,0,2019,2019-2020
MO,2019-08-31,inter-ui,64,4,0,4,6,2,0,1,0,1,33,115,97,101,TRUE,0.843478260869565,2019,2019-2020
MO,2019-08-31,intra-total,2794,398,153,75,57,35,22,17,9,29,1189,4778,3983,4381,TRUE,0.83361239012139,2019,2019-2020
MO,2019-08-31,intra-ucfe,19,4,0,0,0,0,0,1,0,1,4,29,23,27,TRUE,0.793103448275862,2019,2019-2020
MO,2019-08-31,intra-ucx,7,0,0,1,0,0,0,0,0,0,0,8,7,7,TRUE,0.875,2019,2019-2020
MO,2019-08-31,intra-ui,2768,394,153,74,57,35,22,16,9,28,1185,4741,3953,4347,TRUE,0.833790339590804,2019,2019-2020
MO,2019-09-30,inter-total,59,2,6,3,1,2,3,1,0,2,17,96,76,78,TRUE,0.791666666666667,2019,2019-2020
MO,2019-09-30,inter-ucfe,0,0,0,0,0,0,1,0,0,0,0,1,0,0,TRUE,0,2019,2019-2020
MO,2019-09-30,inter-ucx,0,0,0,0,0,0,0,0,0,0,0,0,0,0,TRUE,0,2019,2019-2020
MO,2019-09-30,inter-ui,59,2,6,3,1,2,2,1,0,2,17,95,76,78,TRUE,0.8,2019,2019-2020
MO,2019-09-30,intra-total,2563,172,65,53,43,36,23,14,17,38,774,3798,3337,3509,TRUE,0.878620326487625,2019,2019-2020
MO,2019-09-30,intra-ucfe,15,3,1,0,0,0,0,1,0,0,8,28,23,26,TRUE,0.821428571428571,2019,2019-2020
MO,2019-09-30,intra-ucx,5,0,0,1,0,0,0,0,0,0,1,7,6,6,TRUE,0.857142857142857,2019,2019-2020
MO,2019-09-30,intra-ui,2543,169,64,52,43,36,23,13,17,38,765,3763,3308,3477,TRUE,0.879085835769333,2019,2019-2020
MO,2019-10-31,inter-total,73,6,4,2,3,0,2,0,0,1,15,106,88,94,TRUE,0.830188679245283,2019,2019-2020
MO,2019-10-31,inter-ucfe,1,0,0,0,0,0,0,0,0,0,0,1,1,1,TRUE,1,2019,2019-2020
MO,2019-10-31,inter-ucx,0,1,0,0,0,0,0,0,0,0,0,1,0,1,TRUE,0,2019,2019-2020
MO,2019-10-31,inter-ui,72,5,4,2,3,0,2,0,0,1,15,104,87,92,TRUE,0.836538461538462,2019,2019-2020
MO,2019-10-31,intra-total,3646,169,79,64,46,32,19,10,13,38,948,5064,4594,4763,TRUE,0.907187993680885,2019,2019-2020
MO,2019-10-31,intra-ucfe,15,4,0,2,0,0,0,0,0,0,5,26,20,24,TRUE,0.769230769230769,2019,2019-2020
MO,2019-10-31,intra-ucx,10,0,1,0,0,0,0,0,0,0,2,13,12,12,TRUE,0.923076923076923,2019,2019-2020
MO,2019-10-31,intra-ui,3621,165,78,62,46,32,19,10,13,38,941,5025,4562,4727,TRUE,0.907860696517413,2019,2019-2020
MO,2019-11-30,inter-total,69,3,2,3,2,1,0,0,0,3,18,101,87,90,TRUE,0.861386138613861,2019,2019-2020
MO,2019-11-30,inter-ucfe,0,1,1,0,0,0,0,0,0,0,0,2,0,1,TRUE,0,2019,2019-2020
MO,2019-11-30,inter-ucx,0,0,0,0,0,0,0,0,0,0,0,0,0,0,TRUE,0,2019,2019-2020
MO,2019-11-30,inter-ui,69,2,1,3,2,1,0,0,0,3,18,99,87,89,TRUE,0.878787878787879,2019,2019-2020
MO,2019-11-30,intra-total,2886,156,84,69,47,23,19,9,4,36,791,4124,3677,3833,TRUE,0.89161008729389,2019,2019-2020
MO,2019-11-30,intra-ucfe,6,1,0,2,0,0,2,1,0,0,4,16,10,11,TRUE,0.625,2019,2019-2020
MO,2019-11-30,intra-ucx,8,0,0,1,1,0,0,0,0,1,6,17,14,14,TRUE,0.823529411764706,2019,2019-2020
MO,2019-11-30,intra-ui,2872,155,84,66,46,23,17,8,4,35,781,4091,3653,3808,TRUE,0.892935712539721,2019,2019-2020
MO,2019-12-31,inter-total,91,4,1,1,3,1,0,0,0,1,29,131,120,124,TRUE,0.916030534351145,2019,2019-2020
MO,2019-12-31,inter-ucfe,1,0,0,0,0,0,0,0,0,0,1,2,2,2,TRUE,1,2019,2019-2020
MO,2019-12-31,inter-ucx,0,0,0,0,0,0,0,0,0,0,0,0,0,0,TRUE,0,2019,2019-2020
MO,2019-12-31,inter-ui,90,4,1,1,3,1,0,0,0,1,28,129,118,122,TRUE,0.914728682170543,2019,2019-2020
MO,2019-12-31,intra-total,4362,197,74,73,42,27,17,8,9,34,1049,5892,5411,5608,TRUE,0.9183638832315,2019,2019-2020
MO,2019-12-31,intra-ucfe,8,2,1,1,2,1,0,1,0,0,4,20,12,14,TRUE,0.6,2019,2019-2020
MO,2019-12-31,intra-ucx,7,0,0,0,0,0,0,0,0,0,1,8,8,8,TRUE,1,2019,2019-2020
MO,2019-12-31,intra-ui,4347,195,73,72,40,26,17,7,9,34,1044,5864,5391,5586,TRUE,0.919338335607094,2019,2019-2020
MO,2020-01-31,inter-total,146,7,4,4,1,1,1,0,0,2,36,202,182,189,TRUE,0.900990099009901,2019,2019-2020
MO,2020-01-31,inter-ucfe,0,0,0,0,0,0,0,0,0,0,0,0,0,0,TRUE,0,2019,2019-2020
MO,2020-01-31,inter-ucx,0,0,0,0,0,0,0,0,0,0,0,0,0,0,TRUE,0,2019,2019-2020
MO,2020-01-31,inter-ui,146,7,4,4,1,1,1,0,0,2,36,202,182,189,TRUE,0.900990099009901,2019,2019-2020
MO,2020-01-31,intra-total,8852,395,143,79,65,28,22,17,15,42,1710,11368,10562,10957,TRUE,0.929099225897255,2019,2019-2020
MO,2020-01-31,intra-ucfe,10,2,2,2,0,1,1,1,0,0,2,21,12,14,TRUE,0.571428571428571,2019,2019-2020
MO,2020-01-31,intra-ucx,7,0,0,0,1,0,0,0,0,0,1,9,8,8,TRUE,0.888888888888889,2019,2019-2020
MO,2020-01-31,intra-ui,8835,393,141,77,64,27,21,16,15,42,1707,11338,10542,10935,TRUE,0.929793614394073,2019,2019-2020
MO,2020-02-29,inter-total,106,10,6,0,1,2,0,0,0,1,34,160,140,150,TRUE,0.875,2019,2019-2020
MO,2020-02-29,inter-ucfe,1,0,0,0,0,0,0,0,0,0,0,1,1,1,TRUE,1,2019,2019-2020
MO,2020-02-29,inter-ucx,0,0,0,0,0,0,0,0,0,0,1,1,1,1,TRUE,1,2019,2019-2020
MO,2020-02-29,inter-ui,105,10,6,0,1,2,0,0,0,1,33,158,138,148,TRUE,0.873417721518987,2019,2019-2020
MO,2020-02-29,intra-total,5514,501,130,83,47,37,16,6,12,35,1357,7738,6871,7372,TRUE,0.887955544068235,2019,2019-2020
MO,2020-02-29,intra-ucfe,8,4,1,0,0,2,0,0,0,1,4,20,12,16,TRUE,0.6,2019,2019-2020
MO,2020-02-29,intra-ucx,6,0,0,1,0,0,0,0,0,1,3,11,9,9,TRUE,0.818181818181818,2019,2019-2020
MO,2020-02-29,intra-ui,5500,497,129,82,47,35,16,6,12,33,1350,7707,6850,7347,TRUE,0.88880238743999,2019,2019-2020
MO,2020-03-31,inter-total,123,11,1,2,5,2,3,0,4,3,88,242,211,222,TRUE,0.871900826446281,2019,2019-2020
MO,2020-03-31,inter-ucfe,0,0,1,0,0,0,0,0,0,0,1,2,1,1,TRUE,0.5,2019,2019-2020
MO,2020-03-31,inter-ucx,0,0,0,0,0,0,0,0,0,0,0,0,0,0,TRUE,0,2019,2019-2020
MO,2020-03-31,inter-ui,123,11,0,2,5,2,3,0,4,3,87,240,210,221,TRUE,0.875,2019,2019-2020
MO,2020-03-31,intra-total,9038,282,90,57,45,53,28,20,14,54,10632,20313,19670,19952,TRUE,0.968345394574903,2019,2019-2020
MO,2020-03-31,intra-ucfe,5,1,1,3,1,0,1,1,0,2,5,20,10,11,TRUE,0.5,2019,2019-2020
MO,2020-03-31,intra-ucx,6,0,0,0,0,0,0,0,0,0,0,6,6,6,TRUE,1,2019,2019-2020
MO,2020-03-31,intra-ui,9027,281,89,54,44,53,27,19,14,52,10627,20287,19654,19935,TRUE,0.968797752255139,2019,2019-2020
MO,2020-04-30,inter-total,743,127,53,14,7,2,0,0,1,2,1137,2086,1880,2007,TRUE,0.901246404602109,2019,2019-2020
MO,2020-04-30,inter-ucfe,0,0,0,0,0,1,0,0,0,0,1,2,1,1,TRUE,0.5,2019,2019-2020
MO,2020-04-30,inter-ucx,1,0,1,0,0,0,0,0,0,0,1,3,2,2,TRUE,0.666666666666667,2019,2019-2020
MO,2020-04-30,inter-ui,742,127,52,14,7,1,0,0,1,2,1135,2081,1877,2004,TRUE,0.901970206631427,2019,2019-2020
MO,2020-04-30,intra-total,60784,9756,3522,1517,388,52,18,20,11,80,93785,169933,154569,164325,TRUE,0.909587896406231,2019,2019-2020
MO,2020-04-30,intra-ucfe,10,9,1,1,0,0,0,0,0,1,14,36,24,33,TRUE,0.666666666666667,2019,2019-2020
MO,2020-04-30,intra-ucx,13,2,2,1,0,0,0,0,0,1,15,34,28,30,TRUE,0.823529411764706,2019,2019-2020
MO,2020-04-30,intra-ui,60761,9745,3519,1515,388,52,18,20,11,78,93756,169863,154517,164262,TRUE,0.909656605617468,2019,2019-2020
MO,2020-05-31,inter-total,350,86,33,32,22,25,18,9,4,3,501,1083,851,937,TRUE,0.785780240073869,2019,2019-2020
MO,2020-05-31,inter-ucfe,0,0,1,0,1,0,0,1,0,0,0,3,0,0,TRUE,0,2019,2019-2020
MO,2020-05-31,inter-ucx,0,0,0,0,0,0,0,0,0,0,0,0,0,0,TRUE,0,2019,2019-2020
MO,2020-05-31,inter-ui,350,86,32,32,21,25,18,8,4,3,501,1080,851,937,TRUE,0.787962962962963,2019,2019-2020
MO,2020-05-31,intra-total,19204,4098,1733,1709,1917,1618,1138,458,117,83,22501,54576,41705,45803,TRUE,0.764163734975081,2019,2019-2020
MO,2020-05-31,intra-ucfe,1,2,1,5,1,2,1,0,0,1,0,14,1,3,TRUE,0.0714285714285714,2019,2019-2020
MO,2020-05-31,intra-ucx,0,3,4,3,1,0,3,0,0,0,2,16,2,5,TRUE,0.125,2019,2019-2020
MO,2020-05-31,intra-ui,19203,4093,1728,1701,1915,1616,1134,458,117,82,22499,54546,41702,45795,TRUE,0.764529021376453,2019,2019-2020
MO,2020-06-30,inter-total,170,32,23,14,15,19,36,33,26,55,230,653,400,432,TRUE,0.612557427258806,2019,2019-2020
MO,2020-06-30,inter-ucfe,0,0,0,0,0,0,1,0,2,1,0,4,0,0,TRUE,0,2019,2019-2020
MO,2020-06-30,inter-ucx,0,1,1,0,0,0,0,0,0,1,0,3,0,1,TRUE,0,2019,2019-2020
MO,2020-06-30,inter-ui,170,31,22,14,15,19,35,33,24,53,230,646,400,431,TRUE,0.619195046439629,2019,2019-2020
MO,2020-06-30,intra-total,10085,1461,888,750,731,865,1185,1370,1169,1808,9151,29463,19236,20697,TRUE,0.652886671418389,2019,2019-2020
MO,2020-06-30,intra-ucfe,6,5,2,1,2,3,7,5,9,5,3,48,9,14,TRUE,0.1875,2019,2019-2020
MO,2020-06-30,intra-ucx,6,6,3,5,8,5,4,10,3,6,8,64,14,20,TRUE,0.21875,2019,2019-2020
MO,2020-06-30,intra-ui,10073,1450,883,744,721,857,1174,1355,1157,1797,9140,29351,19213,20663,TRUE,0.654594392013901,2019,2019-2020
MO,2020-07-31,inter-total,161,22,15,12,8,6,11,10,10,85,103,443,264,286,TRUE,0.595936794582393,2020,2020-2021
MO,2020-07-31,inter-ucfe,0,0,0,0,0,0,0,0,0,3,0,3,0,0,TRUE,0,2020,2020-2021
MO,2020-07-31,inter-ucx,1,1,1,0,0,1,0,0,0,0,0,4,1,2,TRUE,0.25,2020,2020-2021
MO,2020-07-31,inter-ui,160,21,14,12,8,5,11,10,10,82,103,436,263,284,TRUE,0.603211009174312,2020,2020-2021
MO,2020-07-31,intra-total,8518,712,600,439,352,321,408,463,518,3626,4719,20676,13237,13949,TRUE,0.640210872509189,2020,2020-2021
MO,2020-07-31,intra-ucfe,1,1,0,2,3,1,1,0,1,17,2,29,3,4,TRUE,0.103448275862069,2020,2020-2021
MO,2020-07-31,intra-ucx,4,5,4,3,3,2,4,3,4,8,2,42,6,11,TRUE,0.142857142857143,2020,2020-2021
MO,2020-07-31,intra-ui,8513,706,596,434,346,318,403,460,513,3601,4715,20605,13228,13934,TRUE,0.64198010191701,2020,2020-2021
MO,2020-08-31,inter-total,119,8,12,14,12,6,13,20,14,55,24,297,143,151,TRUE,0.481481481481482,2020,2020-2021
MO,2020-08-31,inter-ucfe,0,0,0,0,0,0,0,0,0,0,0,0,0,0,TRUE,0,2020,2020-2021
MO,2020-08-31,inter-ucx,0,0,0,1,0,0,1,1,0,0,0,3,0,0,TRUE,0,2020,2020-2021
MO,2020-08-31,inter-ui,119,8,12,13,12,6,12,19,14,55,24,294,143,151,TRUE,0.486394557823129,2020,2020-2021
MO,2020-08-31,intra-total,5611,613,490,597,600,491,583,631,685,1987,932,13220,6543,7156,TRUE,0.494931921331316,2020,2020-2021
MO,2020-08-31,intra-ucfe,1,1,0,0,0,0,1,0,1,4,1,9,2,3,TRUE,0.222222222222222,2020,2020-2021
MO,2020-08-31,intra-ucx,2,3,2,3,3,1,1,0,4,3,7,29,9,12,TRUE,0.310344827586207,2020,2020-2021
MO,2020-08-31,intra-ui,5608,609,488,594,597,490,581,631,680,1980,924,13182,6532,7141,TRUE,0.495524199666212,2020,2020-2021
MO,2020-09-30,inter-total,118,15,13,21,17,13,1,9,3,33,21,264,139,154,TRUE,0.526515151515152,2020,2020-2021
MO,2020-09-30,inter-ucfe,0,0,0,0,0,0,0,1,0,1,0,2,0,0,TRUE,0,2020,2020-2021
MO,2020-09-30,inter-ucx,1,0,0,0,0,0,0,0,0,1,0,2,1,1,TRUE,0.5,2020,2020-2021
MO,2020-09-30,inter-ui,117,15,13,21,17,13,1,8,3,31,21,260,138,153,TRUE,0.530769230769231,2020,2020-2021
MO,2020-09-30,intra-total,4509,541,611,691,681,571,237,313,284,1863,1006,11307,5515,6056,TRUE,0.487750950738481,2020,2020-2021
MO,2020-09-30,intra-ucfe,1,2,3,3,3,1,1,3,1,14,2,34,3,5,TRUE,0.0882352941176471,2020,2020-2021
MO,2020-09-30,intra-ucx,2,0,2,2,1,1,1,1,1,6,1,18,3,3,TRUE,0.166666666666667,2020,2020-2021
MO,2020-09-30,intra-ui,4506,539,606,686,677,569,235,309,282,1843,1003,11255,5509,6048,TRUE,0.489471346068414,2020,2020-2021
MO,2020-10-31,inter-total,89,9,6,10,11,6,3,3,2,28,11,178,100,109,TRUE,0.561797752808989,2020,2020-2021
MO,2020-10-31,inter-ucfe,0,0,0,0,0,0,0,0,0,2,0,2,0,0,TRUE,0,2020,2020-2021
MO,2020-10-31,inter-ucx,0,0,0,0,0,0,0,0,0,0,0,0,0,0,TRUE,0,2020,2020-2021
MO,2020-10-31,inter-ui,89,9,6,10,11,6,3,3,2,26,11,176,100,109,TRUE,0.568181818181818,2020,2020-2021
MO,2020-10-31,intra-total,3683,346,412,395,335,201,92,75,48,748,620,6955,4303,4649,TRUE,0.618691588785047,2020,2020-2021
MO,2020-10-31,intra-ucfe,4,0,2,0,0,0,1,0,1,12,3,23,7,7,TRUE,0.304347826086957,2020,2020-2021
MO,2020-10-31,intra-ucx,1,0,1,0,2,1,2,0,0,5,1,13,2,2,TRUE,0.153846153846154,2020,2020-2021
MO,2020-10-31,intra-ui,3678,346,409,395,333,200,89,75,47,731,616,6919,4294,4640,TRUE,0.620609914727562,2020,2020-2021
MO,2020-11-30,inter-total,82,11,10,10,10,6,4,2,3,20,24,182,106,117,TRUE,0.582417582417583,2020,2020-2021
MO,2020-11-30,inter-ucfe,0,0,0,0,0,0,0,0,0,1,0,1,0,0,TRUE,0,2020,2020-2021
MO,2020-11-30,inter-ucx,0,0,0,1,0,0,0,0,0,0,0,1,0,0,TRUE,0,2020,2020-2021
MO,2020-11-30,inter-ui,82,11,10,9,10,6,4,2,3,19,24,180,106,117,TRUE,0.588888888888889,2020,2020-2021
MO,2020-11-30,intra-total,3048,399,366,356,256,112,80,53,26,435,617,5748,3665,4064,TRUE,0.637613082811413,2020,2020-2021
MO,2020-11-30,intra-ucfe,2,2,0,0,1,0,0,0,0,10,1,16,3,5,TRUE,0.1875,2020,2020-2021
MO,2020-11-30,intra-ucx,2,0,4,0,1,0,3,1,0,5,0,16,2,2,TRUE,0.125,2020,2020-2021
MO,2020-11-30,intra-ui,3044,397,362,356,254,112,77,52,26,420,616,5716,3660,4057,TRUE,0.640307907627712,2020,2020-2021
MO,2020-12-31,inter-total,105,16,8,6,4,6,2,3,2,29,34,215,139,155,TRUE,0.646511627906977,2020,2020-2021
MO,2020-12-31,inter-ucfe,0,0,0,0,0,0,0,0,0,0,0,0,0,0,TRUE,0,2020,2020-2021
MO,2020-12-31,inter-ucx,0,0,0,0,0,0,0,0,0,0,0,0,0,0,TRUE,0,2020,2020-2021
MO,2020-12-31,inter-ui,105,16,8,6,4,6,2,3,2,29,34,215,139,155,TRUE,0.646511627906977,2020,2020-2021
MO,2020-12-31,intra-total,4038,466,228,158,155,142,67,55,59,449,1006,6823,5044,5510,TRUE,0.739264253261029,2020,2020-2021
MO,2020-12-31,intra-ucfe,0,0,0,1,2,1,0,1,2,6,1,14,1,1,TRUE,0.0714285714285714,2020,2020-2021
MO,2020-12-31,intra-ucx,3,0,0,0,0,0,0,1,1,2,1,8,4,4,TRUE,0.5,2020,2020-2021
MO,2020-12-31,intra-ui,4035,466,228,157,153,141,67,53,56,441,1004,6801,5039,5505,TRUE,0.740920452874577,2020,2020-2021
MO,2021-01-31,inter-total,158,10,13,4,3,2,1,2,2,20,27,242,185,195,TRUE,0.764462809917355,2020,2020-2021
MO,2021-01-31,inter-ucfe,0,0,0,0,0,0,0,0,0,2,0,2,0,0,TRUE,0,2020,2020-2021
MO,2021-01-31,inter-ucx,0,0,0,0,0,0,0,0,0,1,0,1,0,0,TRUE,0,2020,2020-2021
MO,2021-01-31,inter-ui,158,10,13,4,3,2,1,2,2,17,27,239,185,195,TRUE,0.774058577405858,2020,2020-2021
MO,2021-01-31,intra-total,7477,370,209,132,110,61,53,68,49,569,999,10097,8476,8846,TRUE,0.83945726453402,2020,2020-2021
MO,2021-01-31,intra-ucfe,2,0,0,0,2,3,2,7,2,19,1,38,3,3,TRUE,0.0789473684210526,2020,2020-2021
MO,2021-01-31,intra-ucx,3,0,0,0,1,1,0,5,0,3,0,13,3,3,TRUE,0.230769230769231,2020,2020-2021
MO,2021-01-31,intra-ui,7472,370,209,132,107,57,51,56,47,547,998,10046,8470,8840,TRUE,0.843121640453912,2020,2020-2021
MO,2021-02-28,inter-total,137,14,6,1,1,5,2,4,4,31,36,241,173,187,TRUE,0.717842323651452,2020,2020-2021
MO,2021-02-28,inter-ucfe,1,0,0,0,0,0,0,0,0,3,0,4,1,1,TRUE,0.25,2020,2020-2021
MO,2021-02-28,inter-ucx,0,0,0,0,0,0,0,0,0,0,0,0,0,0,TRUE,0,2020,2020-2021
MO,2021-02-28,inter-ui,136,14,6,1,1,5,2,4,4,28,36,237,172,186,TRUE,0.725738396624473,2020,2020-2021
MO,2021-02-28,intra-total,8052,387,211,171,99,100,108,166,149,722,1006,11171,9058,9445,TRUE,0.810849521081371,2020,2020-2021
MO,2021-02-28,intra-ucfe,10,1,3,2,3,4,3,6,4,21,2,59,12,13,TRUE,0.203389830508475,2020,2020-2021
MO,2021-02-28,intra-ucx,4,0,0,0,0,0,0,1,0,0,1,6,5,5,TRUE,0.833333333333333,2020,2020-2021
MO,2021-02-28,intra-ui,8038,386,208,169,96,96,105,159,145,701,1003,11106,9041,9427,TRUE,0.814064469656042,2020,2020-2021
MO,2021-03-31,inter-total,90,12,8,5,10,11,13,5,2,29,40,225,130,142,TRUE,0.577777777777778,2020,2020-2021
MO,2021-03-31,inter-ucfe,0,0,0,0,0,0,0,0,0,0,0,0,0,0,TRUE,0,2020,2020-2021
MO,2021-03-31,inter-ucx,0,0,0,0,0,0,0,0,0,0,0,0,0,0,TRUE,0,2020,2020-2021
MO,2021-03-31,inter-ui,90,12,8,5,10,11,13,5,2,29,40,225,130,142,TRUE,0.577777777777778,2020,2020-2021
MO,2021-03-31,intra-total,3825,454,368,406,476,481,424,184,154,607,1876,9255,5701,6155,TRUE,0.615991356023771,2020,2020-2021
MO,2021-03-31,intra-ucfe,3,1,2,1,0,2,1,4,4,15,1,34,4,5,TRUE,0.117647058823529,2020,2020-2021
MO,2021-03-31,intra-ucx,0,0,1,0,1,0,0,0,0,1,0,3,0,0,TRUE,0,2020,2020-2021
MO,2021-03-31,intra-ui,3822,453,365,405,475,479,423,180,150,591,1875,9218,5697,6150,TRUE,0.618029941418963,2020,2020-2021
MO,2021-04-30,inter-total,158,7,6,8,9,5,3,4,5,21,24,250,182,189,TRUE,0.728,2020,2020-2021
MO,2021-04-30,inter-ucfe,1,0,0,0,0,0,0,0,1,2,0,4,1,1,TRUE,0.25,2020,2020-2021
MO,2021-04-30,inter-ucx,0,0,0,0,0,0,0,0,0,2,0,2,0,0,TRUE,0,2020,2020-2021
MO,2021-04-30,inter-ui,157,7,6,8,9,5,3,4,4,17,24,244,181,188,TRUE,0.741803278688525,2020,2020-2021
MO,2021-04-30,intra-total,14039,288,216,385,632,380,141,63,83,383,1122,17732,15161,15449,TRUE,0.855007895330476,2020,2020-2021
MO,2021-04-30,intra-ucfe,14,0,1,1,0,2,0,2,3,16,1,40,15,15,TRUE,0.375,2020,2020-2021
MO,2021-04-30,intra-ucx,0,0,0,0,0,0,2,0,4,11,0,17,0,0,TRUE,0,2020,2020-2021
MO,2021-04-30,intra-ui,14025,288,215,384,632,378,139,61,76,356,1121,17675,15146,15434,TRUE,0.856916548797737,2020,2020-2021
MO,2021-05-31,inter-total,118,6,10,14,8,2,4,3,2,16,12,195,130,136,TRUE,0.666666666666667,2020,2020-2021
MO,2021-05-31,inter-ucfe,0,0,0,0,0,0,0,0,0,1,0,1,0,0,TRUE,0,2020,2020-2021
MO,2021-05-31,inter-ucx,0,0,0,0,0,0,0,0,0,0,0,0,0,0,TRUE,0,2020,2020-2021
MO,2021-05-31,inter-ui,118,6,10,14,8,2,4,3,2,15,12,194,130,136,TRUE,0.670103092783505,2020,2020-2021
MO,2021-05-31,intra-total,8575,479,742,634,249,120,67,53,55,373,1538,12885,10113,10592,TRUE,0.784866123399302,2020,2020-2021
MO,2021-05-31,intra-ucfe,2,0,1,0,1,2,2,0,2,9,0,19,2,2,TRUE,0.105263157894737,2020,2020-2021
MO,2021-05-31,intra-ucx,0,0,1,0,0,2,4,1,1,3,0,12,0,0,TRUE,0,2020,2020-2021
MO,2021-05-31,intra-ui,8573,479,740,634,248,116,61,52,52,361,1538,12854,10111,10590,TRUE,0.786603391940252,2020,2020-2021
MO,2021-06-30,inter-total,122,12,5,10,7,3,2,6,5,27,25,224,147,159,TRUE,0.65625,2020,2020-2021
MO,2021-06-30,inter-ucfe,0,0,0,0,0,0,0,0,1,3,0,4,0,0,TRUE,0,2020,2020-2021
MO,2021-06-30,inter-ucx,0,0,0,0,0,0,0,1,0,1,0,2,0,0,TRUE,0,2020,2020-2021
MO,2021-06-30,inter-ui,122,12,5,10,7,3,2,5,4,23,25,218,147,159,TRUE,0.674311926605505,2020,2020-2021
MO,2021-06-30,intra-total,8064,302,235,549,538,203,100,83,96,430,735,11335,8799,9101,TRUE,0.776268195853551,2020,2020-2021
MO,2021-06-30,intra-ucfe,2,0,0,1,0,1,0,1,2,17,0,24,2,2,TRUE,0.0833333333333333,2020,2020-2021
MO,2021-06-30,intra-ucx,2,0,1,0,0,1,0,2,1,3,0,10,2,2,TRUE,0.2,2020,2020-2021
MO,2021-06-30,intra-ui,8060,302,234,548,538,201,100,80,93,410,735,11301,8795,9097,TRUE,0.778249712414831,2020,2020-2021
MO,2021-07-31,inter-total,59,1,7,9,11,9,4,4,0,25,11,140,70,71,TRUE,0.5,2021,2021-2022
MO,2021-07-31,inter-ucfe,0,0,2,0,1,0,0,0,0,1,0,4,0,0,TRUE,0,2021,2021-2022
MO,2021-07-31,inter-ucx,0,0,0,0,0,0,0,1,0,1,0,2,0,0,TRUE,0,2021,2021-2022
MO,2021-07-31,inter-ui,59,1,5,9,10,9,4,3,0,23,11,134,70,71,TRUE,0.522388059701493,2021,2021-2022
MO,2021-07-31,intra-total,3660,220,300,390,460,276,146,99,77,484,543,6655,4203,4423,TRUE,0.631555221637866,2021,2021-2022
MO,2021-07-31,intra-ucfe,6,1,0,0,2,1,4,1,1,20,3,39,9,10,TRUE,0.230769230769231,2021,2021-2022
MO,2021-07-31,intra-ucx,2,2,3,1,1,3,3,1,2,5,1,24,3,5,TRUE,0.125,2021,2021-2022
MO,2021-07-31,intra-ui,3652,217,297,389,457,272,139,97,74,459,539,6592,4191,4408,TRUE,0.635770631067961,2021,2021-2022
MO,2021-08-31,inter-total,52,5,4,4,6,1,3,5,2,36,13,131,65,70,TRUE,0.49618320610687,2021,2021-2022
MO,2021-08-31,inter-ucfe,1,0,0,0,0,0,0,1,0,1,0,3,1,1,TRUE,0.333333333333333,2021,2021-2022
MO,2021-08-31,inter-ucx,0,0,0,0,0,0,0,0,0,0,0,0,0,0,TRUE,0,2021,2021-2022
MO,2021-08-31,inter-ui,51,5,4,4,6,1,3,4,2,35,13,128,64,69,TRUE,0.5,2021,2021-2022
MO,2021-08-31,intra-total,2974,468,283,169,137,82,83,38,40,554,859,5687,3833,4301,TRUE,0.673993318093898,2021,2021-2022
MO,2021-08-31,intra-ucfe,3,3,1,0,1,0,1,0,0,19,1,29,4,7,TRUE,0.137931034482759,2021,2021-2022
MO,2021-08-31,intra-ucx,1,1,1,0,0,0,0,0,0,5,2,10,3,4,TRUE,0.3,2021,2021-2022
MO,2021-08-31,intra-ui,2970,464,281,169,136,82,82,38,40,530,856,5648,3826,4290,TRUE,0.677407932011331,2021,2021-2022
MO,2021-09-30,inter-total,52,7,2,4,2,2,3,1,1,13,20,107,72,79,TRUE,0.672897196261682,2021,2021-2022
MO,2021-09-30,inter-ucfe,0,0,0,0,0,0,1,0,0,0,0,1,0,0,TRUE,0,2021,2021-2022
MO,2021-09-30,inter-ucx,0,0,0,0,0,0,0,0,0,0,0,0,0,0,TRUE,0,2021,2021-2022
MO,2021-09-30,inter-ui,52,7,2,4,2,2,2,1,1,13,20,106,72,79,TRUE,0.679245283018868,2021,2021-2022
MO,2021-09-30,intra-total,1687,249,123,62,42,19,27,21,24,419,630,3303,2317,2566,TRUE,0.701483499848623,2021,2021-2022
MO,2021-09-30,intra-ucfe,6,2,1,3,0,0,0,1,1,6,1,21,7,9,TRUE,0.333333333333333,2021,2021-2022
MO,2021-09-30,intra-ucx,1,2,4,0,1,0,0,0,0,0,1,9,2,4,TRUE,0.222222222222222,2021,2021-2022
MO,2021-09-30,intra-ui,1680,245,118,59,41,19,27,20,23,413,628,3273,2308,2553,TRUE,0.705163458600672,2021,2021-2022
MO,2021-10-31,inter-total,39,3,6,0,0,0,0,2,1,16,17,84,56,59,TRUE,0.666666666666667,2021,2021-2022
MO,2021-10-31,inter-ucfe,0,1,0,0,0,0,0,1,0,1,0,3,0,1,TRUE,0,2021,2021-2022
MO,2021-10-31,inter-ucx,0,0,0,0,0,0,0,0,0,0,0,0,0,0,TRUE,0,2021,2021-2022
MO,2021-10-31,inter-ui,39,2,6,0,0,0,0,1,1,15,17,81,56,58,TRUE,0.691358024691358,2021,2021-2022
MO,2021-10-31,intra-total,1481,200,100,47,41,22,16,4,10,373,672,2966,2153,2353,TRUE,0.725893459204316,2021,2021-2022
MO,2021-10-31,intra-ucfe,7,0,0,3,0,0,2,0,0,6,3,21,10,10,TRUE,0.476190476190476,2021,2021-2022
MO,2021-10-31,intra-ucx,7,1,0,0,0,1,0,0,0,0,2,11,9,10,TRUE,0.818181818181818,2021,2021-2022
MO,2021-10-31,intra-ui,1467,199,100,44,41,21,14,4,10,367,667,2934,2134,2333,TRUE,0.72733469665985,2021,2021-2022
MO,2021-11-30,inter-total,53,3,3,0,1,1,0,2,0,12,9,84,62,65,TRUE,0.738095238095238,2021,2021-2022
MO,2021-11-30,inter-ucfe,1,0,0,0,0,0,0,0,0,0,0,1,1,1,TRUE,1,2021,2021-2022
MO,2021-11-30,inter-ucx,0,0,0,0,0,0,0,0,0,0,0,0,0,0,TRUE,0,2021,2021-2022
MO,2021-11-30,inter-ui,52,3,3,0,1,1,0,2,0,12,9,83,61,64,TRUE,0.734939759036145,2021,2021-2022
MO,2021-11-30,intra-total,1976,165,57,33,13,12,12,10,6,463,528,3275,2504,2669,TRUE,0.764580152671756,2021,2021-2022
MO,2021-11-30,intra-ucfe,9,0,0,1,1,0,0,0,0,9,0,20,9,9,TRUE,0.45,2021,2021-2022
MO,2021-11-30,intra-ucx,2,0,1,0,1,0,0,1,0,0,1,6,3,3,TRUE,0.5,2021,2021-2022
MO,2021-11-30,intra-ui,1965,165,56,32,11,12,12,9,6,454,527,3249,2492,2657,TRUE,0.767005232379194,2021,2021-2022
MO,2021-12-31,inter-total,84,4,2,1,4,0,0,0,1,17,13,126,97,101,TRUE,0.76984126984127,2021,2021-2022
MO,2021-12-31,inter-ucfe,1,0,0,0,0,0,0,0,0,0,0,1,1,1,TRUE,1,2021,2021-2022
MO,2021-12-31,inter-ucx,0,0,0,0,0,0,0,0,0,0,0,0,0,0,TRUE,0,2021,2021-2022
MO,2021-12-31,inter-ui,83,4,2,1,4,0,0,0,1,17,13,125,96,100,TRUE,0.768,2021,2021-2022
MO,2021-12-31,intra-total,2153,222,109,40,31,28,18,8,3,456,566,3634,2719,2941,TRUE,0.74821133736929,2021,2021-2022
MO,2021-12-31,intra-ucfe,7,2,0,0,0,1,2,0,1,4,0,17,7,9,TRUE,0.411764705882353,2021,2021-2022
MO,2021-12-31,intra-ucx,1,1,0,0,0,0,0,0,0,1,0,3,1,2,TRUE,0.333333333333333,2021,2021-2022
MO,2021-12-31,intra-ui,2145,219,109,40,31,27,16,8,2,451,566,3614,2711,2930,TRUE,0.750138350857775,2021,2021-2022
MO,2022-01-31,inter-total,101,10,2,1,1,1,2,0,0,16,19,153,120,130,TRUE,0.784313725490196,2021,2021-2022
MO,2022-01-31,inter-ucfe,1,0,0,0,0,0,1,0,0,4,0,6,1,1,TRUE,0.166666666666667,2021,2021-2022
MO,2022-01-31,inter-ucx,0,0,1,0,0,0,0,0,0,0,0,1,0,0,TRUE,0,2021,2021-2022
MO,2022-01-31,inter-ui,100,10,1,1,1,1,1,0,0,12,19,146,119,129,TRUE,0.815068493150685,2021,2021-2022
MO,2022-01-31,intra-total,4438,442,203,78,42,23,11,13,10,489,1036,6785,5474,5916,TRUE,0.806779661016949,2021,2021-2022
MO,2022-01-31,intra-ucfe,8,1,3,0,0,0,0,0,1,3,0,16,8,9,TRUE,0.5,2021,2021-2022
MO,2022-01-31,intra-ucx,5,0,1,0,0,1,0,0,0,0,1,8,6,6,TRUE,0.75,2021,2021-2022
MO,2022-01-31,intra-ui,4425,441,199,78,42,22,11,13,9,486,1035,6761,5460,5901,TRUE,0.807572844253809,2021,2021-2022
MO,2022-02-28,inter-total,61,9,9,8,3,0,0,0,3,6,13,112,74,83,TRUE,0.660714285714286,2021,2021-2022
MO,2022-02-28,inter-ucfe,0,0,0,1,0,0,0,0,0,0,0,1,0,0,TRUE,0,2021,2021-2022
MO,2022-02-28,inter-ucx,1,0,0,0,0,0,0,0,0,0,0,1,1,1,TRUE,1,2021,2021-2022
MO,2022-02-28,inter-ui,60,9,9,7,3,0,0,0,3,6,13,110,73,82,TRUE,0.663636363636364,2021,2021-2022
MO,2022-02-28,intra-total,3596,487,444,263,120,43,25,13,18,254,782,6045,4378,4865,TRUE,0.724234904880066,2021,2021-2022
MO,2022-02-28,intra-ucfe,7,1,2,1,0,1,1,0,0,1,0,14,7,8,TRUE,0.5,2021,2021-2022
MO,2022-02-28,intra-ucx,2,0,0,0,0,0,0,0,0,3,0,5,2,2,TRUE,0.4,2021,2021-2022
MO,2022-02-28,intra-ui,3587,486,442,262,120,42,24,13,18,250,782,6026,4369,4855,TRUE,0.725024892134086,2021,2021-2022
MO,2022-03-31,inter-total,60,13,11,6,0,0,2,2,1,9,18,122,78,91,TRUE,0.639344262295082,2021,2021-2022
MO,2022-03-31,inter-ucfe,0,0,0,1,0,0,0,0,0,0,0,1,0,0,TRUE,0,2021,2021-2022
MO,2022-03-31,inter-ucx,0,0,0,0,0,0,0,0,0,1,0,1,0,0,TRUE,0,2021,2021-2022
MO,2022-03-31,inter-ui,60,13,11,5,0,0,2,2,1,8,18,120,78,91,TRUE,0.65,2021,2021-2022
MO,2022-03-31,intra-total,2172,510,405,199,108,66,33,36,26,198,797,4550,2969,3479,TRUE,0.652527472527473,2021,2021-2022
MO,2022-03-31,intra-ucfe,9,2,0,0,1,0,0,1,1,1,4,19,13,15,TRUE,0.68421052631579,2021,2021-2022
MO,2022-03-31,intra-ucx,5,2,0,0,0,0,0,0,0,0,0,7,5,7,TRUE,0.714285714285714,2021,2021-2022
MO,2022-03-31,intra-ui,2158,506,405,199,107,66,33,35,25,197,793,4524,2951,3457,TRUE,0.652298850574713,2021,2021-2022
MO,2022-04-30,inter-total,31,2,1,0,2,1,1,1,2,4,13,58,44,46,TRUE,0.758620689655172,2021,2021-2022
MO,2022-04-30,inter-ucfe,0,0,0,0,0,0,0,0,0,0,1,1,1,1,TRUE,1,2021,2021-2022
MO,2022-04-30,inter-ucx,0,0,0,0,0,0,0,0,0,0,0,0,0,0,TRUE,0,2021,2021-2022
MO,2022-04-30,inter-ui,31,2,1,0,2,1,1,1,2,4,12,57,43,45,TRUE,0.754385964912281,2021,2021-2022
MO,2022-04-30,intra-total,2160,173,54,44,46,29,19,25,20,192,687,3449,2847,3020,TRUE,0.825456654102639,2021,2021-2022
MO,2022-04-30,intra-ucfe,3,2,1,1,0,0,0,0,0,2,4,13,7,9,TRUE,0.538461538461538,2021,2021-2022
MO,2022-04-30,intra-ucx,2,0,0,0,0,0,0,0,0,1,1,4,3,3,TRUE,0.75,2021,2021-2022
MO,2022-04-30,intra-ui,2155,171,53,43,46,29,19,25,20,189,682,3432,2837,3008,TRUE,0.826631701631702,2021,2021-2022
MO,2022-05-31,inter-total,47,1,3,0,1,0,0,0,0,5,15,72,62,63,TRUE,0.861111111111111,2021,2021-2022
MO,2022-05-31,inter-ucfe,0,0,0,0,0,0,0,0,0,1,0,1,0,0,TRUE,0,2021,2021-2022
MO,2022-05-31,inter-ucx,0,0,0,0,0,0,0,0,0,0,0,0,0,0,TRUE,0,2021,2021-2022
MO,2022-05-31,inter-ui,47,1,3,0,1,0,0,0,0,4,15,71,62,63,TRUE,0.873239436619718,2021,2021-2022
MO,2022-05-31,intra-total,1896,217,61,32,18,10,11,12,12,140,707,3116,2603,2820,TRUE,0.835365853658537,2021,2021-2022
MO,2022-05-31,intra-ucfe,3,2,2,1,1,0,0,1,0,1,4,15,7,9,TRUE,0.466666666666667,2021,2021-2022
MO,2022-05-31,intra-ucx,3,0,0,1,1,0,0,0,0,2,3,10,6,6,TRUE,0.6,2021,2021-2022
MO,2022-05-31,intra-ui,1890,215,59,30,16,10,11,11,12,137,700,3091,2590,2805,TRUE,0.83791653186671,2021,2021-2022
MO,2022-06-30,inter-total,25,7,2,0,2,2,0,0,0,3,17,58,42,49,TRUE,0.724137931034483,2021,2021-2022
MO,2022-06-30,inter-ucfe,0,0,0,0,1,0,0,0,0,0,0,1,0,0,TRUE,0,2021,2021-2022
MO,2022-06-30,inter-ucx,0,0,0,0,0,0,0,0,0,0,0,0,0,0,TRUE,0,2021,2021-2022
MO,2022-06-30,inter-ui,25,7,2,0,1,2,0,0,0,3,17,57,42,49,TRUE,0.736842105263158,2021,2021-2022
MO,2022-06-30,intra-total,2882,387,120,40,11,12,13,4,12,137,805,4423,3687,4074,TRUE,0.833597106036627,2021,2021-2022
MO,2022-06-30,intra-ucfe,6,1,0,0,1,0,0,0,0,3,4,15,10,11,TRUE,0.666666666666667,2021,2021-2022
MO,2022-06-30,intra-ucx,9,1,1,1,0,0,0,0,0,1,1,14,10,11,TRUE,0.714285714285714,2021,2021-2022
MO,2022-06-30,intra-ui,2867,385,119,39,10,12,13,4,12,133,800,4394,3667,4052,TRUE,0.834547109695039,2021,2021-2022
MO,2022-07-31,inter-total,39,10,6,1,1,1,0,1,0,8,22,89,61,71,TRUE,0.685393258426966,2022,2022-2023
MO,2022-07-31,inter-ucfe,0,0,0,1,1,0,0,0,0,0,0,2,0,0,TRUE,0,2022,2022-2023
MO,2022-07-31,inter-ucx,0,0,0,0,0,0,0,0,0,0,0,0,0,0,TRUE,0,2022,2022-2023
MO,2022-07-31,inter-ui,39,10,6,0,0,1,0,1,0,8,22,87,61,71,TRUE,0.701149425287356,2022,2022-2023
MO,2022-07-31,intra-total,3696,543,178,69,28,16,6,15,5,209,1007,5772,4703,5246,TRUE,0.814795564795565,2022,2022-2023
MO,2022-07-31,intra-ucfe,3,3,2,0,1,1,0,1,0,1,4,16,7,10,TRUE,0.4375,2022,2022-2023
MO,2022-07-31,intra-ucx,10,0,0,0,0,0,0,0,0,0,0,10,10,10,TRUE,1,2022,2022-2023
MO,2022-07-31,intra-ui,3683,540,176,69,27,15,6,14,5,208,1003,5746,4686,5226,TRUE,0.815523842673164,2022,2022-2023
MO,2022-08-31,inter-total,43,6,2,0,1,0,1,1,0,2,22,78,65,71,TRUE,0.833333333333333,2022,2022-2023
MO,2022-08-31,inter-ucfe,1,0,0,0,0,0,0,0,0,0,0,1,1,1,TRUE,1,2022,2022-2023
MO,2022-08-31,inter-ucx,0,0,0,0,0,0,0,0,0,0,0,0,0,0,TRUE,0,2022,2022-2023
MO,2022-08-31,inter-ui,42,6,2,0,1,0,1,1,0,2,22,77,64,70,TRUE,0.831168831168831,2022,2022-2023
MO,2022-08-31,intra-total,2774,438,129,61,30,23,19,9,7,142,992,4624,3766,4204,TRUE,0.814446366782007,2022,2022-2023
MO,2022-08-31,intra-ucfe,8,0,3,0,1,0,1,2,0,0,3,18,11,11,TRUE,0.611111111111111,2022,2022-2023
MO,2022-08-31,intra-ucx,6,0,0,0,0,0,0,0,0,0,2,8,8,8,TRUE,1,2022,2022-2023
MO,2022-08-31,intra-ui,2760,438,126,61,29,23,18,7,7,142,987,4598,3747,4185,TRUE,0.814919530230535,2022,2022-2023
MO,2022-09-30,inter-total,42,5,1,1,1,0,0,1,1,6,26,84,68,73,TRUE,0.80952380952381,2022,2022-2023
MO,2022-09-30,inter-ucfe,0,0,0,0,0,0,0,0,0,0,0,0,0,0,TRUE,0,2022,2022-2023
MO,2022-09-30,inter-ucx,0,0,0,0,0,0,0,0,0,0,0,0,0,0,TRUE,0,2022,2022-2023
MO,2022-09-30,inter-ui,42,5,1,1,1,0,0,1,1,6,26,84,68,73,TRUE,0.80952380952381,2022,2022-2023
MO,2022-09-30,intra-total,1464,244,62,34,26,16,15,5,10,148,786,2810,2250,2494,TRUE,0.800711743772242,2022,2022-2023
MO,2022-09-30,intra-ucfe,7,5,1,2,1,1,2,0,1,2,1,23,8,13,TRUE,0.347826086956522,2022,2022-2023
MO,2022-09-30,intra-ucx,5,1,0,0,0,1,0,0,0,0,1,8,6,7,TRUE,0.75,2022,2022-2023
MO,2022-09-30,intra-ui,1452,238,61,32,25,14,13,5,9,146,784,2779,2236,2474,TRUE,0.804605973371717,2022,2022-2023
MO,2022-10-31,inter-total,58,4,1,0,2,1,1,1,0,9,15,92,73,77,TRUE,0.793478260869565,2022,2022-2023
MO,2022-10-31,inter-ucfe,1,0,0,0,0,0,0,0,0,1,0,2,1,1,TRUE,0.5,2022,2022-2023
MO,2022-10-31,inter-ucx,0,0,0,0,0,0,0,0,0,0,0,0,0,0,TRUE,0,2022,2022-2023
MO,2022-10-31,inter-ui,57,4,1,0,2,1,1,1,0,8,15,90,72,76,TRUE,0.8,2022,2022-2023
MO,2022-10-31,intra-total,2132,200,47,34,20,8,7,5,15,112,764,3344,2896,3096,TRUE,0.866028708133971,2022,2022-2023
MO,2022-10-31,intra-ucfe,8,3,3,0,2,0,0,0,0,2,5,23,13,16,TRUE,0.565217391304348,2022,2022-2023
MO,2022-10-31,intra-ucx,5,1,1,0,0,0,0,0,0,0,2,9,7,8,TRUE,0.777777777777778,2022,2022-2023
MO,2022-10-31,intra-ui,2119,196,43,34,18,8,7,5,15,110,757,3312,2876,3072,TRUE,0.868357487922705,2022,2022-2023
MO,2022-11-30,inter-total,50,5,0,1,0,0,1,0,0,5,17,79,67,72,TRUE,0.848101265822785,2022,2022-2023
MO,2022-11-30,inter-ucfe,0,0,0,0,0,0,0,0,0,1,0,1,0,0,TRUE,0,2022,2022-2023
MO,2022-11-30,inter-ucx,0,0,0,0,0,0,0,0,0,0,0,0,0,0,TRUE,0,2022,2022-2023
MO,2022-11-30,inter-ui,50,5,0,1,0,0,1,0,0,4,17,78,67,72,TRUE,0.858974358974359,2022,2022-2023
MO,2022-11-30,intra-total,1892,340,85,40,32,16,17,22,15,83,852,3394,2744,3084,TRUE,0.808485562757808,2022,2022-2023
MO,2022-11-30,intra-ucfe,9,1,1,2,2,0,0,1,1,1,3,21,12,13,TRUE,0.571428571428571,2022,2022-2023
MO,2022-11-30,intra-ucx,2,0,0,0,0,0,0,0,0,1,2,5,4,4,TRUE,0.8,2022,2022-2023
MO,2022-11-30,intra-ui,1881,339,84,38,30,16,17,21,14,81,847,3368,2728,3067,TRUE,0.809976247030879,2022,2022-2023
MO,2022-12-31,inter-total,76,8,5,3,0,2,2,0,1,3,12,112,88,96,TRUE,0.785714285714286,2022,2022-2023
MO,2022-12-31,inter-ucfe,0,0,0,0,0,0,0,0,0,0,0,0,0,0,TRUE,0,2022,2022-2023
MO,2022-12-31,inter-ucx,0,0,0,0,0,0,0,0,0,0,0,0,0,0,TRUE,0,2022,2022-2023
MO,2022-12-31,inter-ui,76,8,5,3,0,2,2,0,1,3,12,112,88,96,TRUE,0.785714285714286,2022,2022-2023
MO,2022-12-31,intra-total,2750,239,93,52,40,37,22,16,10,96,792,4147,3542,3781,TRUE,0.854111405835544,2022,2022-2023
MO,2022-12-31,intra-ucfe,7,6,0,0,0,0,0,0,0,0,5,18,12,18,TRUE,0.666666666666667,2022,2022-2023
MO,2022-12-31,intra-ucx,4,0,1,0,0,0,0,0,0,0,1,6,5,5,TRUE,0.833333333333333,2022,2022-2023
MO,2022-12-31,intra-ui,2739,233,92,52,40,37,22,16,10,96,786,4123,3525,3758,TRUE,0.854959980596653,2022,2022-2023
MO,2023-01-31,inter-total,114,10,6,3,0,0,2,0,2,3,18,158,132,142,TRUE,0.835443037974684,2022,2022-2023
MO,2023-01-31,inter-ucfe,0,0,0,0,0,0,0,0,0,0,0,0,0,0,TRUE,0,2022,2022-2023
MO,2023-01-31,inter-ucx,0,0,0,0,0,0,0,0,0,0,0,0,0,0,TRUE,0,2022,2022-2023
MO,2023-01-31,inter-ui,114,10,6,3,0,0,2,0,2,3,18,158,132,142,TRUE,0.835443037974684,2022,2022-2023
MO,2023-01-31,intra-total,6606,548,268,144,63,34,29,17,12,114,1241,9076,7847,8395,TRUE,0.864587924195681,2022,2022-2023
MO,2023-01-31,intra-ucfe,8,2,2,0,1,0,0,2,0,1,6,22,14,16,TRUE,0.636363636363636,2022,2022-2023
MO,2023-01-31,intra-ucx,7,0,0,0,0,0,0,0,0,0,2,9,9,9,TRUE,1,2022,2022-2023
MO,2023-01-31,intra-ui,6591,546,266,144,62,34,29,15,12,113,1233,9045,7824,8370,TRUE,0.865008291873964,2022,2022-2023
MO,2023-02-28,inter-total,63,9,3,3,5,2,2,2,0,2,14,105,77,86,TRUE,0.733333333333333,2022,2022-2023
MO,2023-02-28,inter-ucfe,0,0,0,0,0,0,0,0,0,0,0,0,0,0,TRUE,0,2022,2022-2023
MO,2023-02-28,inter-ucx,0,0,0,0,0,0,0,0,0,1,0,1,0,0,TRUE,0,2022,2022-2023
MO,2023-02-28,inter-ui,63,9,3,3,5,2,2,2,0,1,14,104,77,86,TRUE,0.740384615384615,2022,2022-2023
MO,2023-02-28,intra-total,3427,303,275,260,196,88,18,14,10,50,797,5438,4224,4527,TRUE,0.776756160353071,2022,2022-2023
MO,2023-02-28,intra-ucfe,7,1,1,0,1,0,1,0,1,1,1,14,8,9,TRUE,0.571428571428571,2022,2022-2023
MO,2023-02-28,intra-ucx,5,0,0,1,0,0,0,1,0,0,1,8,6,6,TRUE,0.75,2022,2022-2023
MO,2023-02-28,intra-ui,3415,302,274,259,195,88,17,13,9,49,795,5416,4210,4512,TRUE,0.777326440177253,2022,2022-2023
MO,2023-03-31,inter-total,45,5,9,7,7,2,0,0,0,7,9,91,54,59,TRUE,0.593406593406593,2022,2022-2023
MO,2023-03-31,inter-ucfe,0,0,0,0,0,0,0,0,0,0,0,0,0,0,TRUE,0,2022,2022-2023
MO,2023-03-31,inter-ucx,0,0,0,0,0,0,0,0,0,0,0,0,0,0,TRUE,0,2022,2022-2023
MO,2023-03-31,inter-ui,45,5,9,7,7,2,0,0,0,7,9,91,54,59,TRUE,0.593406593406593,2022,2022-2023
MO,2023-03-31,intra-total,2250,248,275,406,289,96,48,24,25,70,580,4311,2830,3078,TRUE,0.656460218046857,2022,2022-2023
MO,2023-03-31,intra-ucfe,4,1,0,2,4,0,0,1,0,0,3,15,7,8,TRUE,0.466666666666667,2022,2022-2023
MO,2023-03-31,intra-ucx,6,0,0,0,0,0,0,0,0,1,2,9,8,8,TRUE,0.888888888888889,2022,2022-2023
MO,2023-03-31,intra-ui,2240,247,275,404,285,96,48,23,25,69,575,4287,2815,3062,TRUE,0.656636342430604,2022,2022-2023
MO,2023-04-30,inter-total,40,3,5,6,0,0,5,0,0,4,13,76,53,56,TRUE,0.697368421052632,2022,2022-2023
MO,2023-04-30,inter-ucfe,0,0,0,0,0,0,0,0,0,0,0,0,0,0,TRUE,0,2022,2022-2023
MO,2023-04-30,inter-ucx,1,0,0,0,0,0,0,0,0,0,0,1,1,1,TRUE,1,2022,2022-2023
MO,2023-04-30,inter-ui,39,3,5,6,0,0,5,0,0,4,13,75,52,55,TRUE,0.693333333333333,2022,2022-2023
MO,2023-04-30,intra-total,1814,392,272,133,47,25,20,19,16,90,703,3531,2517,2909,TRUE,0.712829226847918,2022,2022-2023
MO,2023-04-30,intra-ucfe,5,2,3,0,2,0,0,0,0,1,3,16,8,10,TRUE,0.5,2022,2022-2023
MO,2023-04-30,intra-ucx,5,0,0,0,0,0,0,0,1,0,0,6,5,5,TRUE,0.833333333333333,2022,2022-2023
MO,2023-04-30,intra-ui,1804,390,269,133,45,25,20,19,15,89,700,3509,2504,2894,TRUE,0.713593616414933,2022,2022-2023
MO,2023-05-31,inter-total,47,4,3,2,1,0,0,0,0,3,12,72,59,63,TRUE,0.819444444444445,2022,2022-2023
MO,2023-05-31,inter-ucfe,0,0,0,0,0,0,0,0,0,0,1,1,1,1,TRUE,1,2022,2022-2023
MO,2023-05-31,inter-ucx,0,0,0,0,0,0,0,0,0,0,0,0,0,0,TRUE,0,2022,2022-2023
MO,2023-05-31,inter-ui,47,4,3,2,1,0,0,0,0,3,11,71,58,62,TRUE,0.816901408450704,2022,2022-2023
MO,2023-05-31,intra-total,2188,320,102,64,42,26,20,13,11,73,771,3630,2959,3279,TRUE,0.815151515151515,2022,2022-2023
MO,2023-05-31,intra-ucfe,6,3,1,2,0,1,0,0,0,0,3,16,9,12,TRUE,0.5625,2022,2022-2023
MO,2023-05-31,intra-ucx,7,1,0,0,0,0,0,0,0,1,1,10,8,9,TRUE,0.8,2022,2022-2023
MO,2023-05-31,intra-ui,2175,316,101,62,42,25,20,13,11,72,767,3604,2942,3258,TRUE,0.816315205327414,2022,2022-2023
MO,2023-06-30,inter-total,32,6,7,3,4,0,1,1,1,2,13,70,45,51,TRUE,0.642857142857143,2022,2022-2023
MO,2023-06-30,inter-ucfe,0,1,0,0,0,0,0,0,0,0,0,1,0,1,TRUE,0,2022,2022-2023
MO,2023-06-30,inter-ucx,0,0,0,0,0,0,0,0,0,0,0,0,0,0,TRUE,0,2022,2022-2023
MO,2023-06-30,inter-ui,32,5,7,3,4,0,1,1,1,2,13,69,45,50,TRUE,0.652173913043478,2022,2022-2023
MO,2023-06-30,intra-total,3022,263,263,224,93,28,13,13,10,67,692,4688,3714,3977,TRUE,0.792235494880546,2022,2022-2023
MO,2023-06-30,intra-ucfe,3,1,1,3,2,1,1,1,0,0,1,14,4,5,TRUE,0.285714285714286,2022,2022-2023
MO,2023-06-30,intra-ucx,4,1,0,0,0,0,0,0,1,0,1,7,5,6,TRUE,0.714285714285714,2022,2022-2023
MO,2023-06-30,intra-ui,3015,261,262,221,91,27,12,12,9,67,690,4667,3705,3966,TRUE,0.793871866295265,2022,2022-2023
MO,2023-07-31,inter-total,48,10,2,4,6,4,1,0,0,1,11,87,59,69,TRUE,0.67816091954023,2023,2023-2024
MO,2023-07-31,inter-ucfe,0,0,0,0,0,0,1,0,0,0,0,1,0,0,TRUE,0,2023,2023-2024
MO,2023-07-31,inter-ucx,1,0,0,0,0,0,0,0,0,0,0,1,1,1,TRUE,1,2023,2023-2024
MO,2023-07-31,inter-ui,47,10,2,4,6,4,0,0,0,1,11,85,58,68,TRUE,0.682352941176471,2023,2023-2024
MO,2023-07-31,intra-total,3459,247,166,224,404,133,20,8,10,47,692,5410,4151,4398,TRUE,0.76728280961183,2023,2023-2024
MO,2023-07-31,intra-ucfe,2,2,1,2,1,1,0,0,0,0,1,10,3,5,TRUE,0.3,2023,2023-2024
MO,2023-07-31,intra-ucx,7,0,1,0,0,0,0,0,0,0,2,10,9,9,TRUE,0.9,2023,2023-2024
MO,2023-07-31,intra-ui,3450,245,164,222,403,132,20,8,10,47,689,5390,4139,4384,TRUE,0.767903525046382,2023,2023-2024
MO,2023-08-31,inter-total,50,4,7,6,8,5,1,0,2,2,9,94,59,63,TRUE,0.627659574468085,2023,2023-2024
MO,2023-08-31,inter-ucfe,0,0,0,0,0,0,0,0,0,0,0,0,0,0,TRUE,0,2023,2023-2024
MO,2023-08-31,inter-ucx,1,0,0,0,0,0,0,0,0,0,0,1,1,1,TRUE,1,2023,2023-2024
MO,2023-08-31,inter-ui,49,4,7,6,8,5,1,0,2,2,9,93,58,62,TRUE,0.623655913978495,2023,2023-2024
MO,2023-08-31,intra-total,4007,256,261,423,333,96,34,27,21,101,754,6313,4761,5017,TRUE,0.754158086488199,2023,2023-2024
MO,2023-08-31,intra-ucfe,4,1,0,0,0,1,0,1,0,0,0,7,4,5,TRUE,0.571428571428571,2023,2023-2024
MO,2023-08-31,intra-ucx,4,0,0,0,0,0,0,0,0,0,3,7,7,7,TRUE,1,2023,2023-2024
MO,2023-08-31,intra-ui,3999,255,261,423,333,95,34,26,21,101,751,6299,4750,5005,TRUE,0.754087950468328,2023,2023-2024
MO,2023-09-30,inter-total,29,7,3,3,4,2,1,0,1,2,12,64,41,48,TRUE,0.640625,2023,2023-2024
MO,2023-09-30,inter-ucfe,0,1,0,0,0,0,0,0,0,0,0,1,0,1,TRUE,0,2023,2023-2024
MO,2023-09-30,inter-ucx,1,0,0,0,0,0,0,0,0,0,0,1,1,1,TRUE,1,2023,2023-2024
MO,2023-09-30,inter-ui,28,6,3,3,4,2,1,0,1,2,12,62,40,46,TRUE,0.645161290322581,2023,2023-2024
MO,2023-09-30,intra-total,2659,155,204,324,357,98,39,24,17,143,397,4417,3056,3211,TRUE,0.691872311523659,2023,2023-2024
MO,2023-09-30,intra-ucfe,2,1,1,0,0,2,0,0,0,1,1,8,3,4,TRUE,0.375,2023,2023-2024
MO,2023-09-30,intra-ucx,6,1,0,0,0,0,0,0,0,1,1,9,7,8,TRUE,0.777777777777778,2023,2023-2024
MO,2023-09-30,intra-ui,2651,153,203,324,357,96,39,24,17,141,395,4400,3046,3199,TRUE,0.692272727272727,2023,2023-2024
MO,2023-10-31,inter-total,41,6,5,10,3,10,4,1,3,4,7,94,48,54,TRUE,0.51063829787234,2023,2023-2024
MO,2023-10-31,inter-ucfe,0,0,0,0,0,0,0,0,0,0,0,0,0,0,TRUE,0,2023,2023-2024
MO,2023-10-31,inter-ucx,0,0,0,0,0,0,0,0,0,0,0,0,0,0,TRUE,0,2023,2023-2024
MO,2023-10-31,inter-ui,41,6,5,10,3,10,4,1,3,4,7,94,48,54,TRUE,0.51063829787234,2023,2023-2024
MO,2023-10-31,intra-total,2539,192,179,266,440,463,113,25,14,117,551,4899,3090,3282,TRUE,0.630740967544397,2023,2023-2024
MO,2023-10-31,intra-ucfe,1,2,1,1,0,1,1,0,1,0,0,8,1,3,TRUE,0.125,2023,2023-2024
MO,2023-10-31,intra-ucx,4,0,1,0,0,0,0,0,0,1,1,7,5,5,TRUE,0.714285714285714,2023,2023-2024
MO,2023-10-31,intra-ui,2534,190,177,265,440,462,112,25,13,116,550,4884,3084,3274,TRUE,0.631449631449631,2023,2023-2024
MO,2023-11-30,inter-total,73,6,8,10,4,1,2,2,0,2,22,130,95,101,TRUE,0.730769230769231,2023,2023-2024
MO,2023-11-30,inter-ucfe,0,0,0,0,0,0,0,0,0,0,0,0,0,0,TRUE,0,2023,2023-2024
MO,2023-11-30,inter-ucx,0,0,0,0,0,0,0,0,0,0,0,0,0,0,TRUE,0,2023,2023-2024
MO,2023-11-30,inter-ui,73,6,8,10,4,1,2,2,0,2,22,130,95,101,TRUE,0.730769230769231,2023,2023-2024
MO,2023-11-30,intra-total,1919,246,350,537,276,98,35,19,38,102,468,4088,2387,2633,TRUE,0.583904109589041,2023,2023-2024
MO,2023-11-30,intra-ucfe,4,0,0,4,1,1,0,0,0,1,2,13,6,6,TRUE,0.461538461538462,2023,2023-2024
MO,2023-11-30,intra-ucx,2,0,0,0,0,0,0,0,0,0,1,3,3,3,TRUE,1,2023,2023-2024
MO,2023-11-30,intra-ui,1913,246,350,533,275,97,35,19,38,101,465,4072,2378,2624,TRUE,0.583988212180747,2023,2023-2024
MO,2023-12-31,inter-total,66,5,8,7,8,3,2,0,1,2,22,124,88,93,TRUE,0.709677419354839,2023,2023-2024
MO,2023-12-31,inter-ucfe,0,0,0,0,0,0,0,0,0,0,0,0,0,0,TRUE,0,2023,2023-2024
MO,2023-12-31,inter-ucx,0,0,0,0,0,0,0,0,0,0,0,0,0,0,TRUE,0,2023,2023-2024
MO,2023-12-31,inter-ui,66,5,8,7,8,3,2,0,1,2,22,124,88,93,TRUE,0.709677419354839,2023,2023-2024
MO,2023-12-31,intra-total,2312,258,352,392,235,87,49,28,17,89,457,4276,2769,3027,TRUE,0.647567820392891,2023,2023-2024
MO,2023-12-31,intra-ucfe,1,1,0,1,1,1,1,1,0,0,1,8,2,3,TRUE,0.25,2023,2023-2024
MO,2023-12-31,intra-ucx,3,2,0,0,0,0,0,0,0,0,2,7,5,7,TRUE,0.714285714285714,2023,2023-2024
MO,2023-12-31,intra-ui,2308,255,352,391,234,86,48,27,17,89,454,4261,2762,3017,TRUE,0.648204646796527,2023,2023-2024
MO,2024-01-31,inter-total,126,13,9,5,10,8,4,0,1,4,39,219,165,178,TRUE,0.753424657534247,2023,2023-2024
MO,2024-01-31,inter-ucfe,0,0,0,0,1,0,0,0,0,0,0,1,0,0,TRUE,0,2023,2023-2024
MO,2024-01-31,inter-ucx,0,0,0,0,0,0,0,0,0,0,0,0,0,0,TRUE,0,2023,2023-2024
MO,2024-01-31,inter-ui,126,13,9,5,9,8,4,0,1,4,39,218,165,178,TRUE,0.756880733944954,2023,2023-2024
MO,2024-01-31,intra-total,6650,312,308,325,387,217,55,42,28,104,1314,9742,7964,8276,TRUE,0.817491274892219,2023,2023-2024
MO,2024-01-31,intra-ucfe,3,2,0,1,1,2,1,1,0,1,2,14,5,7,TRUE,0.357142857142857,2023,2023-2024
MO,2024-01-31,intra-ucx,0,1,0,0,0,1,0,0,0,0,1,3,1,2,TRUE,0.333333333333333,2023,2023-2024
MO,2024-01-31,intra-ui,6647,309,308,324,386,214,54,41,28,103,1311,9725,7958,8267,TRUE,0.818303341902314,2023,2023-2024
MO,2024-02-29,inter-total,67,11,15,15,5,4,2,0,0,3,13,135,80,91,TRUE,0.592592592592593,2023,2023-2024
MO,2024-02-29,inter-ucfe,0,0,0,0,0,1,0,0,0,0,1,2,1,1,TRUE,0.5,2023,2023-2024
MO,2024-02-29,inter-ucx,0,0,0,0,0,0,0,0,0,0,0,0,0,0,TRUE,0,2023,2023-2024
MO,2024-02-29,inter-ui,67,11,15,15,5,3,2,0,0,3,12,133,79,90,TRUE,0.593984962406015,2023,2023-2024
MO,2024-02-29,intra-total,3553,491,559,743,426,135,27,26,23,84,751,6818,4304,4795,TRUE,0.631270167204459,2023,2023-2024
MO,2024-02-29,intra-ucfe,1,0,1,1,3,0,0,0,0,0,2,8,3,3,TRUE,0.375,2023,2023-2024
MO,2024-02-29,intra-ucx,3,1,1,1,0,0,0,0,0,0,3,9,6,7,TRUE,0.666666666666667,2023,2023-2024
MO,2024-02-29,intra-ui,3549,490,557,741,423,135,27,26,23,84,746,6801,4295,4785,TRUE,0.631524775768269,2023,2023-2024
MO,2024-03-31,inter-total,36,9,6,5,4,1,3,2,0,2,17,85,53,62,TRUE,0.623529411764706,2023,2023-2024
MO,2024-03-31,inter-ucfe,0,0,0,0,0,0,0,0,0,0,0,0,0,0,TRUE,0,2023,2023-2024
MO,2024-03-31,inter-ucx,0,0,0,0,0,0,0,0,0,0,0,0,0,0,TRUE,0,2023,2023-2024
MO,2024-03-31,inter-ui,36,9,6,5,4,1,3,2,0,2,17,85,53,62,TRUE,0.623529411764706,2023,2023-2024
MO,2024-03-31,intra-total,2711,488,465,295,110,68,51,41,28,62,899,5218,3610,4098,TRUE,0.691835952472212,2023,2023-2024
MO,2024-03-31,intra-ucfe,3,4,2,1,0,1,0,0,0,0,2,13,5,9,TRUE,0.384615384615385,2023,2023-2024
MO,2024-03-31,intra-ucx,4,1,1,0,0,0,0,0,0,0,1,7,5,6,TRUE,0.714285714285714,2023,2023-2024
MO,2024-03-31,intra-ui,2704,483,462,294,110,67,51,41,28,62,896,5198,3600,4083,TRUE,0.692574066948827,2023,2023-2024
MO,2024-04-30,inter-total,45,3,7,2,1,3,1,1,1,2,22,88,67,70,TRUE,0.761363636363636,2023,2023-2024
MO,2024-04-30,inter-ucfe,0,0,0,0,0,0,0,0,0,1,0,1,0,0,TRUE,0,2023,2023-2024
MO,2024-04-30,inter-ucx,1,0,0,0,0,0,0,0,0,0,0,1,1,1,TRUE,1,2023,2023-2024
MO,2024-04-30,inter-ui,44,3,7,2,1,3,1,1,1,1,22,86,66,69,TRUE,0.767441860465116,2023,2023-2024
MO,2024-04-30,intra-total,2550,204,81,78,45,37,39,31,22,53,862,4002,3412,3616,TRUE,0.852573713143428,2023,2023-2024
MO,2024-04-30,intra-ucfe,6,3,2,0,0,0,0,0,0,0,0,11,6,9,TRUE,0.545454545454545,2023,2023-2024
MO,2024-04-30,intra-ucx,3,0,0,0,0,0,0,0,0,0,2,5,5,5,TRUE,1,2023,2023-2024
MO,2024-04-30,intra-ui,2541,201,79,78,45,37,39,31,22,53,860,3986,3401,3602,TRUE,0.853236327145008,2023,2023-2024
MO,2024-05-31,inter-total,56,6,0,3,1,2,1,0,0,1,16,86,72,78,TRUE,0.837209302325582,2023,2023-2024
MO,2024-05-31,inter-ucfe,0,0,0,0,0,0,0,0,0,0,0,0,0,0,TRUE,0,2023,2023-2024
MO,2024-05-31,inter-ucx,0,0,0,0,0,0,0,0,0,0,0,0,0,0,TRUE,0,2023,2023-2024
MO,2024-05-31,inter-ui,56,6,0,3,1,2,1,0,0,1,16,86,72,78,TRUE,0.837209302325582,2023,2023-2024
MO,2024-05-31,intra-total,2427,204,93,71,36,27,18,8,5,39,846,3774,3273,3477,TRUE,0.86724960254372,2023,2023-2024
MO,2024-05-31,intra-ucfe,4,4,1,0,1,2,0,0,0,0,4,16,8,12,TRUE,0.5,2023,2023-2024
MO,2024-05-31,intra-ucx,3,0,0,0,0,0,0,0,0,0,2,5,5,5,TRUE,1,2023,2023-2024
MO,2024-05-31,intra-ui,2420,200,92,71,35,25,18,8,5,39,840,3753,3260,3460,TRUE,0.868638422595257,2023,2023-2024
MO,2024-06-30,inter-total,44,3,4,0,2,0,1,0,0,2,15,71,59,62,TRUE,0.830985915492958,2023,2023-2024
MO,2024-06-30,inter-ucfe,0,0,0,0,0,0,0,0,0,0,1,1,1,1,TRUE,1,2023,2023-2024
MO,2024-06-30,inter-ucx,0,0,0,0,0,0,0,0,0,0,0,0,0,0,TRUE,0,2023,2023-2024
MO,2024-06-30,inter-ui,44,3,4,0,2,0,1,0,0,2,14,70,58,61,TRUE,0.828571428571429,2023,2023-2024
MO,2024-06-30,intra-total,3030,355,102,56,50,30,15,11,7,49,968,4673,3998,4353,TRUE,0.855553177830088,2023,2023-2024
MO,2024-06-30,intra-ucfe,2,1,0,0,0,0,0,0,0,1,0,4,2,3,TRUE,0.5,2023,2023-2024
MO,2024-06-30,intra-ucx,8,1,0,0,0,0,0,0,0,0,0,9,8,9,TRUE,0.888888888888889,2023,2023-2024
MO,2024-06-30,intra-ui,3020,353,102,56,50,30,15,11,7,48,968,4660,3988,4341,TRUE,0.855793991416309,2023,2023-2024
MO,2024-07-31,inter-total,36,16,16,4,1,2,0,1,1,1,13,91,49,65,TRUE,0.538461538461538,2024,2024-2025
MO,2024-07-31,inter-ucfe,0,1,0,0,0,0,0,0,0,0,0,1,0,1,TRUE,0,2024,2024-2025
MO,2024-07-31,inter-ucx,0,0,0,0,0,0,0,0,0,0,0,0,0,0,TRUE,0,2024,2024-2025
MO,2024-07-31,inter-ui,36,15,16,4,1,2,0,1,1,1,13,90,49,64,TRUE,0.544444444444444,2024,2024-2025
MO,2024-07-31,intra-total,4327,648,528,147,68,43,22,19,8,57,828,6695,5155,5803,TRUE,0.769977595220314,2024,2024-2025
MO,2024-07-31,intra-ucfe,1,2,1,1,1,1,0,1,0,0,2,10,3,5,TRUE,0.3,2024,2024-2025
MO,2024-07-31,intra-ucx,4,0,2,0,0,0,0,0,0,0,3,9,7,7,TRUE,0.777777777777778,2024,2024-2025
MO,2024-07-31,intra-ui,4322,646,525,146,67,42,22,18,8,57,823,6676,5145,5791,TRUE,0.770671060515279,2024,2024-2025
MO,2024-08-31,inter-total,44,17,5,5,2,0,2,0,0,2,23,100,67,84,TRUE,0.67,2024,2024-2025
MO,2024-08-31,inter-ucfe,0,0,0,0,0,0,0,0,0,2,1,3,1,1,TRUE,0.333333333333333,2024,2024-2025
MO,2024-08-31,inter-ucx,0,0,0,0,0,0,0,0,0,0,0,0,0,0,TRUE,0,2024,2024-2025
MO,2024-08-31,inter-ui,44,17,5,5,2,0,2,0,0,0,22,97,66,83,TRUE,0.680412371134021,2024,2024-2025
MO,2024-08-31,intra-total,2240,811,373,129,71,46,35,16,5,44,1118,4888,3358,4169,TRUE,0.686988543371522,2024,2024-2025
MO,2024-08-31,intra-ucfe,4,3,1,1,1,0,1,0,1,0,3,15,7,10,TRUE,0.466666666666667,2024,2024-2025
MO,2024-08-31,intra-ucx,2,1,0,0,0,0,0,0,0,0,1,4,3,4,TRUE,0.75,2024,2024-2025
MO,2024-08-31,intra-ui,2234,807,372,128,70,46,34,16,4,44,1114,4869,3348,4155,TRUE,0.687615526802218,2024,2024-2025
MO,2024-09-30,inter-total,27,12,5,0,4,2,0,0,0,0,23,73,50,62,TRUE,0.684931506849315,2024,2024-2025
MO,2024-09-30,inter-ucfe,0,0,0,0,0,0,0,0,0,0,0,0,0,0,TRUE,0,2024,2024-2025
MO,2024-09-30,inter-ucx,0,0,0,0,0,0,0,0,0,0,0,0,0,0,TRUE,0,2024,2024-2025
MO,2024-09-30,inter-ui,27,12,5,0,4,2,0,0,0,0,23,73,50,62,TRUE,0.684931506849315,2024,2024-2025
MO,2024-09-30,intra-total,1739,459,129,67,39,53,27,13,13,64,984,3587,2723,3182,TRUE,0.759130192361305,2024,2024-2025
MO,2024-09-30,intra-ucfe,1,4,1,2,0,0,1,0,0,0,3,12,4,8,TRUE,0.333333333333333,2024,2024-2025
MO,2024-09-30,intra-ucx,7,0,0,0,0,0,0,0,0,0,0,7,7,7,TRUE,1,2024,2024-2025
MO,2024-09-30,intra-ui,1731,455,128,65,39,53,26,13,13,64,981,3568,2712,3167,TRUE,0.760089686098655,2024,2024-2025
MO,2024-10-31,inter-total,52,5,4,3,1,2,0,0,1,0,20,88,72,77,TRUE,0.818181818181818,2024,2024-2025
MO,2024-10-31,inter-ucfe,0,0,0,0,0,0,0,0,0,0,0,0,0,0,TRUE,0,2024,2024-2025
MO,2024-10-31,inter-ucx,0,0,0,0,0,0,0,0,0,0,0,0,0,0,TRUE,0,2024,2024-2025
MO,2024-10-31,inter-ui,52,5,4,3,1,2,0,0,1,0,20,88,72,77,TRUE,0.818181818181818,2024,2024-2025
MO,2024-10-31,intra-total,2325,367,109,62,61,39,18,11,11,43,1146,4192,3471,3838,TRUE,0.82800572519084,2024,2024-2025
MO,2024-10-31,intra-ucfe,2,2,1,3,1,0,0,1,1,1,3,15,5,7,TRUE,0.333333333333333,2024,2024-2025
MO,2024-10-31,intra-ucx,5,0,0,0,0,0,0,0,0,0,2,7,7,7,TRUE,1,2024,2024-2025
MO,2024-10-31,intra-ui,2318,365,108,59,60,39,18,10,10,42,1141,4170,3459,3824,TRUE,0.829496402877698,2024,2024-2025
MO,2024-11-30,inter-total,64,9,8,2,2,0,0,0,1,2,23,111,87,96,TRUE,0.783783783783784,2024,2024-2025
MO,2024-11-30,inter-ucfe,0,0,0,0,0,0,0,0,0,0,0,0,0,0,TRUE,0,2024,2024-2025
MO,2024-11-30,inter-ucx,0,0,0,0,0,0,0,0,0,0,0,0,0,0,TRUE,0,2024,2024-2025
MO,2024-11-30,inter-ui,64,9,8,2,2,0,0,0,1,2,23,111,87,96,TRUE,0.783783783783784,2024,2024-2025
MO,2024-11-30,intra-total,2244,243,83,79,57,21,12,9,6,42,912,3708,3156,3399,TRUE,0.851132686084142,2024,2024-2025
MO,2024-11-30,intra-ucfe,3,1,2,2,0,0,0,0,0,0,1,9,4,5,TRUE,0.444444444444444,2024,2024-2025
MO,2024-11-30,intra-ucx,3,0,0,0,0,0,0,0,0,0,3,6,6,6,TRUE,1,2024,2024-2025
MO,2024-11-30,intra-ui,2238,242,81,77,57,21,12,9,6,42,908,3693,3146,3388,TRUE,0.851881938803141,2024,2024-2025
MO,2024-12-31,inter-total,91,7,3,1,5,0,0,0,0,6,16,129,107,114,TRUE,0.829457364341085,2024,2024-2025
MO,2024-12-31,inter-ucfe,0,0,0,0,0,0,0,0,0,0,0,0,0,0,TRUE,0,2024,2024-2025
MO,2024-12-31,inter-ucx,1,0,0,0,0,0,0,0,0,0,0,1,1,1,TRUE,1,2024,2024-2025
MO,2024-12-31,inter-ui,90,7,3,1,5,0,0,0,0,6,16,128,106,113,TRUE,0.828125,2024,2024-2025
MO,2024-12-31,intra-total,3863,223,97,71,47,25,21,13,11,40,967,5378,4830,5053,TRUE,0.898103384157679,2024,2024-2025
MO,2024-12-31,intra-ucfe,2,1,0,0,0,0,0,0,0,0,1,4,3,4,TRUE,0.75,2024,2024-2025
MO,2024-12-31,intra-ucx,9,1,0,0,0,0,0,0,0,0,1,11,10,11,TRUE,0.909090909090909,2024,2024-2025
MO,2024-12-31,intra-ui,3852,221,97,71,47,25,21,13,11,40,965,5363,4817,5038,TRUE,0.898191310833489,2024,2024-2025
MS,2019-01-31,inter-total,24,5,1,3,0,2,0,0,0,0,3,38,27,32,FALSE,0.842105263157895,2018,2018-2019
MS,2019-01-31,inter-ucfe,1,1,0,0,0,0,0,0,0,0,0,2,1,2,FALSE,1,2018,2018-2019
MS,2019-01-31,inter-ucx,0,0,0,0,0,0,0,0,0,0,0,0,0,0,FALSE,0,2018,2018-2019
MS,2019-01-31,inter-ui,23,4,1,3,0,2,0,0,0,0,3,36,26,30,FALSE,0.833333333333333,2018,2018-2019
MS,2019-01-31,intra-total,1418,63,18,24,16,6,5,2,1,9,320,1882,1738,1801,FALSE,0.956960680127524,2018,2018-2019
MS,2019-01-31,intra-ucfe,42,5,0,0,0,0,0,0,0,0,29,76,71,76,FALSE,1,2018,2018-2019
MS,2019-01-31,intra-ucx,4,0,0,0,0,0,0,0,0,0,1,5,5,5,FALSE,1,2018,2018-2019
MS,2019-01-31,intra-ui,1372,58,18,24,16,6,5,2,1,9,290,1801,1662,1720,FALSE,0.955024986118823,2018,2018-2019
MS,2019-02-28,inter-total,19,1,2,0,0,0,1,0,0,1,1,25,20,21,FALSE,0.84,2018,2018-2019
MS,2019-02-28,inter-ucfe,1,0,0,0,0,0,0,0,0,0,0,1,1,1,FALSE,1,2018,2018-2019
MS,2019-02-28,inter-ucx,0,0,0,0,0,0,0,0,0,0,0,0,0,0,FALSE,0,2018,2018-2019
MS,2019-02-28,inter-ui,18,1,2,0,0,0,1,0,0,1,1,24,19,20,FALSE,0.833333333333333,2018,2018-2019
MS,2019-02-28,intra-total,983,72,21,13,10,5,3,2,1,5,211,1326,1194,1266,FALSE,0.954751131221719,2018,2018-2019
MS,2019-02-28,intra-ucfe,12,3,0,1,0,0,0,0,0,0,7,23,19,22,FALSE,0.956521739130435,2018,2018-2019
MS,2019-02-28,intra-ucx,0,2,0,1,0,0,0,0,0,0,0,3,0,2,FALSE,0.666666666666667,2018,2018-2019
MS,2019-02-28,intra-ui,971,67,21,11,10,5,3,2,1,5,204,1300,1175,1242,FALSE,0.955384615384615,2018,2018-2019
MS,2019-03-31,inter-total,10,3,2,1,2,0,0,0,0,0,5,23,15,18,FALSE,0.782608695652174,2018,2018-2019
MS,2019-03-31,inter-ucfe,1,0,0,0,1,0,0,0,0,0,0,2,1,1,FALSE,0.5,2018,2018-2019
MS,2019-03-31,inter-ucx,0,0,1,0,0,0,0,0,0,0,0,1,0,0,FALSE,0,2018,2018-2019
MS,2019-03-31,inter-ui,9,3,1,1,1,0,0,0,0,0,5,20,14,17,FALSE,0.85,2018,2018-2019
MS,2019-03-31,intra-total,871,54,39,21,5,4,3,2,0,6,185,1190,1056,1110,FALSE,0.932773109243698,2018,2018-2019
MS,2019-03-31,intra-ucfe,21,5,2,2,0,0,0,0,0,1,7,38,28,33,FALSE,0.868421052631579,2018,2018-2019
MS,2019-03-31,intra-ucx,1,0,0,0,0,0,0,0,0,0,0,1,1,1,FALSE,1,2018,2018-2019
MS,2019-03-31,intra-ui,849,49,37,19,5,4,3,2,0,5,178,1151,1027,1076,FALSE,0.934839270199826,2018,2018-2019
MS,2019-04-30,inter-total,18,2,1,0,0,0,0,1,0,0,3,25,21,23,FALSE,0.92,2018,2018-2019
MS,2019-04-30,inter-ucfe,1,0,0,0,0,0,0,0,0,0,0,1,1,1,FALSE,1,2018,2018-2019
MS,2019-04-30,inter-ucx,0,0,0,0,0,0,0,1,0,0,0,1,0,0,FALSE,0,2018,2018-2019
MS,2019-04-30,inter-ui,17,2,1,0,0,0,0,0,0,0,3,23,20,22,FALSE,0.956521739130435,2018,2018-2019
MS,2019-04-30,intra-total,795,54,35,21,7,2,6,2,0,6,206,1134,1001,1055,FALSE,0.930335097001764,2018,2018-2019
MS,2019-04-30,intra-ucfe,8,2,1,0,0,0,0,0,0,0,12,23,20,22,FALSE,0.956521739130435,2018,2018-2019
MS,2019-04-30,intra-ucx,2,0,0,0,0,0,0,0,0,0,0,2,2,2,FALSE,1,2018,2018-2019
MS,2019-04-30,intra-ui,785,52,34,21,7,2,6,2,0,6,194,1109,979,1031,FALSE,0.929666366095582,2018,2018-2019
MS,2019-05-31,inter-total,14,2,1,2,1,0,0,0,0,1,10,31,24,26,FALSE,0.838709677419355,2018,2018-2019
MS,2019-05-31,inter-ucfe,0,0,0,0,0,0,0,0,0,0,0,0,0,0,FALSE,0,2018,2018-2019
MS,2019-05-31,inter-ucx,0,0,0,0,0,0,0,0,0,0,0,0,0,0,FALSE,0,2018,2018-2019
MS,2019-05-31,inter-ui,14,2,1,2,1,0,0,0,0,1,10,31,24,26,FALSE,0.838709677419355,2018,2018-2019
MS,2019-05-31,intra-total,1400,102,47,19,13,5,6,4,3,4,341,1944,1741,1843,FALSE,0.948045267489712,2018,2018-2019
MS,2019-05-31,intra-ucfe,12,0,3,0,1,0,0,0,1,0,4,21,16,16,FALSE,0.761904761904762,2018,2018-2019
MS,2019-05-31,intra-ucx,3,0,1,0,0,0,0,0,0,0,3,7,6,6,FALSE,0.857142857142857,2018,2018-2019
MS,2019-05-31,intra-ui,1385,102,43,19,12,5,6,4,2,4,334,1916,1719,1821,FALSE,0.950417536534447,2018,2018-2019
MS,2019-06-30,inter-total,18,2,1,0,1,0,0,0,0,0,6,28,24,26,FALSE,0.928571428571429,2018,2018-2019
MS,2019-06-30,inter-ucfe,0,1,0,0,1,0,0,0,0,0,0,2,0,1,FALSE,0.5,2018,2018-2019
MS,2019-06-30,inter-ucx,0,0,0,0,0,0,0,0,0,0,0,0,0,0,FALSE,0,2018,2018-2019
MS,2019-06-30,inter-ui,18,1,1,0,0,0,0,0,0,0,6,26,24,25,FALSE,0.961538461538461,2018,2018-2019
MS,2019-06-30,intra-total,2091,103,48,33,17,8,2,3,1,4,407,2717,2498,2601,FALSE,0.957305852042694,2018,2018-2019
MS,2019-06-30,intra-ucfe,10,0,0,1,0,0,0,0,0,0,3,14,13,13,FALSE,0.928571428571429,2018,2018-2019
MS,2019-06-30,intra-ucx,3,0,0,0,0,0,0,0,0,0,4,7,7,7,FALSE,1,2018,2018-2019
MS,2019-06-30,intra-ui,2078,103,48,32,17,8,2,3,1,4,400,2696,2478,2581,FALSE,0.957344213649852,2018,2018-2019
MS,2019-07-31,inter-total,15,2,1,1,2,0,1,0,0,1,3,26,18,20,FALSE,0.769230769230769,2019,2019-2020
MS,2019-07-31,inter-ucfe,0,0,0,0,0,0,0,0,0,0,0,0,0,0,FALSE,0,2019,2019-2020
MS,2019-07-31,inter-ucx,1,0,0,0,0,0,0,0,0,0,0,1,1,1,FALSE,1,2019,2019-2020
MS,2019-07-31,inter-ui,14,2,1,1,2,0,1,0,0,1,3,25,17,19,FALSE,0.76,2019,2019-2020
MS,2019-07-31,intra-total,2340,227,81,45,28,6,6,3,1,4,341,3082,2681,2908,FALSE,0.943543153796236,2019,2019-2020
MS,2019-07-31,intra-ucfe,5,1,2,1,0,0,0,0,0,0,1,10,6,7,FALSE,0.7,2019,2019-2020
MS,2019-07-31,intra-ucx,7,1,0,0,0,0,0,0,0,0,0,8,7,8,FALSE,1,2019,2019-2020
MS,2019-07-31,intra-ui,2328,225,79,44,28,6,6,3,1,4,340,3064,2668,2893,FALSE,0.944190600522193,2019,2019-2020
MS,2019-08-31,inter-total,15,4,2,2,1,1,0,0,0,0,3,28,18,22,FALSE,0.785714285714286,2019,2019-2020
MS,2019-08-31,inter-ucfe,0,0,0,0,0,1,0,0,0,0,0,1,0,0,FALSE,0,2019,2019-2020
MS,2019-08-31,inter-ucx,0,0,0,0,0,0,0,0,0,0,0,0,0,0,FALSE,0,2019,2019-2020
MS,2019-08-31,inter-ui,15,4,2,2,1,0,0,0,0,0,3,27,18,22,FALSE,0.814814814814815,2019,2019-2020
MS,2019-08-31,intra-total,967,192,61,31,20,17,5,3,4,6,275,1581,1242,1434,FALSE,0.907020872865275,2019,2019-2020
MS,2019-08-31,intra-ucfe,4,1,1,0,0,1,0,1,0,0,2,10,6,7,FALSE,0.7,2019,2019-2020
MS,2019-08-31,intra-ucx,4,0,0,0,0,0,0,0,0,0,1,5,5,5,FALSE,1,2019,2019-2020
MS,2019-08-31,intra-ui,959,191,60,31,20,16,5,2,4,6,272,1566,1231,1422,FALSE,0.908045977011494,2019,2019-2020
MS,2019-09-30,inter-total,15,2,1,0,0,0,0,0,0,1,5,24,20,22,FALSE,0.916666666666667,2019,2019-2020
MS,2019-09-30,inter-ucfe,0,0,0,0,0,0,0,0,0,0,0,0,0,0,FALSE,0,2019,2019-2020
MS,2019-09-30,inter-ucx,0,0,0,0,0,0,0,0,0,0,0,0,0,0,FALSE,0,2019,2019-2020
MS,2019-09-30,inter-ui,15,2,1,0,0,0,0,0,0,1,5,24,20,22,FALSE,0.916666666666667,2019,2019-2020
MS,2019-09-30,intra-total,772,81,33,22,13,12,11,3,3,8,301,1259,1073,1154,FALSE,0.916600476568705,2019,2019-2020
MS,2019-09-30,intra-ucfe,2,0,0,1,0,0,0,0,0,0,0,3,2,2,FALSE,0.666666666666667,2019,2019-2020
MS,2019-09-30,intra-ucx,5,1,1,0,0,0,0,0,0,0,1,8,6,7,FALSE,0.875,2019,2019-2020
MS,2019-09-30,intra-ui,765,80,32,21,13,12,11,3,3,8,300,1248,1065,1145,FALSE,0.917467948717949,2019,2019-2020
MS,2019-10-31,inter-total,9,2,1,0,1,0,0,0,0,0,3,16,12,14,FALSE,0.875,2019,2019-2020
MS,2019-10-31,inter-ucfe,0,0,0,0,0,0,0,0,0,0,1,1,1,1,FALSE,1,2019,2019-2020
MS,2019-10-31,inter-ucx,0,0,0,0,0,0,0,0,0,0,0,0,0,0,FALSE,0,2019,2019-2020
MS,2019-10-31,inter-ui,9,2,1,0,1,0,0,0,0,0,2,15,11,13,FALSE,0.866666666666667,2019,2019-2020
MS,2019-10-31,intra-total,946,38,29,18,6,6,6,3,3,4,207,1266,1153,1191,FALSE,0.940758293838863,2019,2019-2020
MS,2019-10-31,intra-ucfe,4,3,0,0,0,0,0,0,0,0,1,8,5,8,FALSE,1,2019,2019-2020
MS,2019-10-31,intra-ucx,2,0,0,0,0,0,0,0,0,0,0,2,2,2,FALSE,1,2019,2019-2020
MS,2019-10-31,intra-ui,940,35,29,18,6,6,6,3,3,4,206,1256,1146,1181,FALSE,0.940286624203822,2019,2019-2020
MS,2019-11-30,inter-total,10,0,1,0,0,0,0,0,0,1,4,16,14,14,FALSE,0.875,2019,2019-2020
MS,2019-11-30,inter-ucfe,1,0,0,0,0,0,0,0,0,0,0,1,1,1,FALSE,1,2019,2019-2020
MS,2019-11-30,inter-ucx,0,0,0,0,0,0,0,0,0,0,0,0,0,0,FALSE,0,2019,2019-2020
MS,2019-11-30,inter-ui,9,0,1,0,0,0,0,0,0,1,4,15,13,13,FALSE,0.866666666666667,2019,2019-2020
MS,2019-11-30,intra-total,780,52,18,15,6,4,1,0,0,9,170,1055,950,1002,FALSE,0.949763033175356,2019,2019-2020
MS,2019-11-30,intra-ucfe,7,0,0,0,0,1,0,0,0,0,1,9,8,8,FALSE,0.888888888888889,2019,2019-2020
MS,2019-11-30,intra-ucx,2,1,0,0,0,0,0,0,0,0,0,3,2,3,FALSE,1,2019,2019-2020
MS,2019-11-30,intra-ui,771,51,18,15,6,3,1,0,0,9,169,1043,940,991,FALSE,0.950143815915628,2019,2019-2020
MS,2019-12-31,inter-total,16,1,0,0,2,0,0,0,0,0,5,24,21,22,FALSE,0.916666666666667,2019,2019-2020
MS,2019-12-31,inter-ucfe,0,0,0,0,0,0,0,0,0,0,0,0,0,0,FALSE,0,2019,2019-2020
MS,2019-12-31,inter-ucx,0,0,0,0,0,0,0,0,0,0,0,0,0,0,FALSE,0,2019,2019-2020
MS,2019-12-31,inter-ui,16,1,0,0,2,0,0,0,0,0,5,24,21,22,FALSE,0.916666666666667,2019,2019-2020
MS,2019-12-31,intra-total,1030,50,27,15,6,1,2,2,0,3,232,1368,1262,1312,FALSE,0.95906432748538,2019,2019-2020
MS,2019-12-31,intra-ucfe,5,0,0,0,0,0,0,0,0,0,4,9,9,9,FALSE,1,2019,2019-2020
MS,2019-12-31,intra-ucx,1,1,0,0,0,0,0,0,0,0,1,3,2,3,FALSE,1,2019,2019-2020
MS,2019-12-31,intra-ui,1024,49,27,15,6,1,2,2,0,3,227,1356,1251,1300,FALSE,0.958702064896755,2019,2019-2020
MS,2020-01-31,inter-total,13,3,1,1,1,0,0,0,0,0,5,24,18,21,FALSE,0.875,2019,2019-2020
MS,2020-01-31,inter-ucfe,0,0,0,0,1,0,0,0,0,0,0,1,0,0,FALSE,0,2019,2019-2020
MS,2020-01-31,inter-ucx,0,0,0,0,0,0,0,0,0,0,0,0,0,0,FALSE,0,2019,2019-2020
MS,2020-01-31,inter-ui,13,3,1,1,0,0,0,0,0,0,5,23,18,21,FALSE,0.91304347826087,2019,2019-2020
MS,2020-01-31,intra-total,1271,102,35,27,14,5,4,0,2,4,396,1860,1667,1769,FALSE,0.951075268817204,2019,2019-2020
MS,2020-01-31,intra-ucfe,6,2,0,1,0,0,0,0,0,0,2,11,8,10,FALSE,0.909090909090909,2019,2019-2020
MS,2020-01-31,intra-ucx,0,0,0,0,0,0,0,0,0,0,1,1,1,1,FALSE,1,2019,2019-2020
MS,2020-01-31,intra-ui,1265,100,35,26,14,5,4,0,2,4,393,1848,1658,1758,FALSE,0.951298701298701,2019,2019-2020
MS,2020-02-29,inter-total,13,1,0,0,0,1,0,0,0,1,13,29,26,27,FALSE,0.931034482758621,2019,2019-2020
MS,2020-02-29,inter-ucfe,1,0,0,0,0,0,0,0,0,0,1,2,2,2,FALSE,1,2019,2019-2020
MS,2020-02-29,inter-ucx,0,0,0,0,0,1,0,0,0,0,0,1,0,0,FALSE,0,2019,2019-2020
MS,2020-02-29,inter-ui,12,1,0,0,0,0,0,0,0,1,12,26,24,25,FALSE,0.961538461538461,2019,2019-2020
MS,2020-02-29,intra-total,924,56,21,14,8,3,2,3,0,4,275,1310,1199,1255,FALSE,0.958015267175572,2019,2019-2020
MS,2020-02-29,intra-ucfe,6,2,0,0,0,0,0,0,0,0,1,9,7,9,FALSE,1,2019,2019-2020
MS,2020-02-29,intra-ucx,1,0,0,0,0,0,0,0,0,0,0,1,1,1,FALSE,1,2019,2019-2020
MS,2020-02-29,intra-ui,917,54,21,14,8,3,2,3,0,4,274,1300,1191,1245,FALSE,0.957692307692308,2019,2019-2020
MS,2020-03-31,inter-total,33,2,1,1,0,1,0,0,1,0,10,49,43,45,FALSE,0.918367346938776,2019,2019-2020
MS,2020-03-31,inter-ucfe,1,0,0,0,0,0,0,0,0,0,1,2,2,2,FALSE,1,2019,2019-2020
MS,2020-03-31,inter-ucx,0,0,0,0,0,0,0,0,0,0,0,0,0,0,FALSE,0,2019,2019-2020
MS,2020-03-31,inter-ui,32,2,1,1,0,1,0,0,1,0,9,47,41,43,FALSE,0.914893617021277,2019,2019-2020
MS,2020-03-31,intra-total,11801,211,30,20,8,4,1,1,1,3,1040,13120,12841,13052,FALSE,0.994817073170732,2019,2019-2020
MS,2020-03-31,intra-ucfe,7,5,1,2,0,0,0,0,0,0,6,21,13,18,FALSE,0.857142857142857,2019,2019-2020
MS,2020-03-31,intra-ucx,3,1,0,0,0,0,0,0,0,0,1,5,4,5,FALSE,1,2019,2019-2020
MS,2020-03-31,intra-ui,11791,205,29,18,8,4,1,1,1,3,1033,13094,12824,13029,FALSE,0.995035894302734,2019,2019-2020
MS,2020-04-30,inter-total,132,26,18,14,5,2,0,0,1,1,53,252,185,211,FALSE,0.837301587301587,2019,2019-2020
MS,2020-04-30,inter-ucfe,0,0,0,0,0,0,0,0,0,0,0,0,0,0,FALSE,0,2019,2019-2020
MS,2020-04-30,inter-ucx,0,0,0,0,0,0,0,0,0,0,1,1,1,1,FALSE,1,2019,2019-2020
MS,2020-04-30,inter-ui,132,26,18,14,5,2,0,0,1,1,52,251,184,210,FALSE,0.836653386454183,2019,2019-2020
MS,2020-04-30,intra-total,38239,4315,2617,2136,1400,412,99,32,21,90,11413,60774,49652,53967,FALSE,0.887994866225689,2019,2019-2020
MS,2020-04-30,intra-ucfe,3,0,3,3,0,1,1,0,0,1,7,19,10,10,FALSE,0.526315789473684,2019,2019-2020
MS,2020-04-30,intra-ucx,7,2,2,0,0,1,0,0,0,0,5,17,12,14,FALSE,0.823529411764706,2019,2019-2020
MS,2020-04-30,intra-ui,38229,4313,2612,2133,1400,410,98,32,21,89,11401,60738,49630,53943,FALSE,0.888126049590042,2019,2019-2020
MS,2020-05-31,inter-total,80,28,74,53,53,89,61,37,39,80,23,617,103,131,FALSE,0.212317666126418,2019,2019-2020
MS,2020-05-31,inter-ucfe,0,0,0,0,0,0,0,0,0,0,0,0,0,0,FALSE,0,2019,2019-2020
MS,2020-05-31,inter-ucx,0,1,0,0,0,0,0,0,0,0,0,1,0,1,FALSE,1,2019,2019-2020
MS,2020-05-31,inter-ui,80,27,74,53,53,89,61,37,39,80,23,616,103,130,FALSE,0.211038961038961,2019,2019-2020
MS,2020-05-31,intra-total,11212,4045,11849,9855,10298,18322,12773,4829,2062,3129,3800,92174,15012,19057,FALSE,0.206750276650682,2019,2019-2020
MS,2020-05-31,intra-ucfe,8,12,4,10,3,7,7,2,4,3,6,66,14,26,FALSE,0.393939393939394,2019,2019-2020
MS,2020-05-31,intra-ucx,4,0,2,1,1,1,1,0,0,0,2,12,6,6,FALSE,0.5,2019,2019-2020
MS,2020-05-31,intra-ui,11200,4033,11843,9844,10294,18314,12765,4827,2058,3126,3792,92096,14992,19025,FALSE,0.206577918693537,2019,2019-2020
MS,2020-06-30,inter-total,289,89,6,3,6,4,11,14,15,38,184,659,473,562,FALSE,0.852807283763278,2019,2019-2020
MS,2020-06-30,inter-ucfe,0,0,0,0,0,0,0,0,0,0,0,0,0,0,FALSE,0,2019,2019-2020
MS,2020-06-30,inter-ucx,0,0,0,0,0,0,0,0,0,0,0,0,0,0,FALSE,0,2019,2019-2020
MS,2020-06-30,inter-ui,289,89,6,3,6,4,11,14,15,38,184,659,473,562,FALSE,0.852807283763278,2019,2019-2020
MS,2020-06-30,intra-total,15713,2364,659,437,446,648,1159,1167,990,3313,5819,32715,21532,23896,FALSE,0.730429466605533,2019,2019-2020
MS,2020-06-30,intra-ucfe,7,9,4,5,2,0,5,9,4,7,9,61,16,25,FALSE,0.409836065573771,2019,2019-2020
MS,2020-06-30,intra-ucx,9,2,2,1,0,1,0,1,0,0,3,19,12,14,FALSE,0.736842105263158,2019,2019-2020
MS,2020-06-30,intra-ui,15697,2353,653,431,444,647,1154,1157,986,3306,5807,32635,21504,23857,FALSE,0.731024973188295,2019,2019-2020
MS,2020-07-31,inter-total,136,8,8,1,3,3,4,8,6,43,16,236,152,160,FALSE,0.677966101694915,2020,2020-2021
MS,2020-07-31,inter-ucfe,0,0,0,0,0,0,0,0,0,0,0,0,0,0,FALSE,0,2020,2020-2021
MS,2020-07-31,inter-ucx,0,0,0,0,0,0,0,0,0,0,0,0,0,0,FALSE,0,2020,2020-2021
MS,2020-07-31,inter-ui,136,8,8,1,3,3,4,8,6,43,16,236,152,160,FALSE,0.677966101694915,2020,2020-2021
MS,2020-07-31,intra-total,16148,676,428,458,417,427,609,600,310,4425,1898,26396,18046,18722,FALSE,0.70927413244431,2020,2020-2021
MS,2020-07-31,intra-ucfe,20,3,2,1,3,2,1,4,0,8,7,51,27,30,FALSE,0.588235294117647,2020,2020-2021
MS,2020-07-31,intra-ucx,6,0,0,1,0,1,0,0,0,1,4,13,10,10,FALSE,0.769230769230769,2020,2020-2021
MS,2020-07-31,intra-ui,16122,673,426,456,414,424,608,596,310,4416,1887,26332,18009,18682,FALSE,0.709478960960049,2020,2020-2021
MS,2020-08-31,inter-total,43,8,7,7,5,5,5,6,5,38,3,132,46,54,FALSE,0.409090909090909,2020,2020-2021
MS,2020-08-31,inter-ucfe,0,0,0,0,0,0,0,0,0,0,0,0,0,0,FALSE,0,2020,2020-2021
MS,2020-08-31,inter-ucx,0,0,0,0,0,0,0,0,0,0,0,0,0,0,FALSE,0,2020,2020-2021
MS,2020-08-31,inter-ui,43,8,7,7,5,5,5,6,5,38,3,132,46,54,FALSE,0.409090909090909,2020,2020-2021
MS,2020-08-31,intra-total,3678,596,493,530,403,326,305,242,282,2167,880,9902,4558,5154,FALSE,0.520500908907292,2020,2020-2021
MS,2020-08-31,intra-ucfe,2,1,0,2,0,1,6,0,0,10,3,25,5,6,FALSE,0.24,2020,2020-2021
MS,2020-08-31,intra-ucx,4,0,0,0,0,1,0,0,0,1,1,7,5,5,FALSE,0.714285714285714,2020,2020-2021
MS,2020-08-31,intra-ui,3672,595,493,528,403,324,299,242,282,2156,876,9870,4548,5143,FALSE,0.521073961499493,2020,2020-2021
MS,2020-09-30,inter-total,20,3,2,1,3,4,3,3,2,18,9,68,29,32,FALSE,0.470588235294118,2020,2020-2021
MS,2020-09-30,inter-ucfe,0,0,0,0,0,0,0,0,0,0,0,0,0,0,FALSE,0,2020,2020-2021
MS,2020-09-30,inter-ucx,0,0,0,0,0,0,0,0,0,0,0,0,0,0,FALSE,0,2020,2020-2021
MS,2020-09-30,inter-ui,20,3,2,1,3,4,3,3,2,18,9,68,29,32,FALSE,0.470588235294118,2020,2020-2021
MS,2020-09-30,intra-total,1836,253,150,129,178,195,188,226,223,886,489,4753,2325,2578,FALSE,0.542394277298548,2020,2020-2021
MS,2020-09-30,intra-ucfe,2,4,0,1,0,0,0,1,0,4,0,12,2,6,FALSE,0.5,2020,2020-2021
MS,2020-09-30,intra-ucx,2,0,0,1,0,0,0,0,0,0,3,6,5,5,FALSE,0.833333333333333,2020,2020-2021
MS,2020-09-30,intra-ui,1832,249,150,127,178,195,188,225,223,882,486,4735,2318,2567,FALSE,0.542133051742344,2020,2020-2021
MS,2020-10-31,inter-total,33,4,5,4,5,1,2,1,1,14,10,80,43,47,FALSE,0.5875,2020,2020-2021
MS,2020-10-31,inter-ucfe,0,0,0,0,0,0,0,0,0,0,0,0,0,0,FALSE,0,2020,2020-2021
MS,2020-10-31,inter-ucx,0,0,0,0,0,0,0,0,0,1,0,1,0,0,FALSE,0,2020,2020-2021
MS,2020-10-31,inter-ui,33,4,5,4,5,1,2,1,1,13,10,79,43,47,FALSE,0.59493670886076,2020,2020-2021
MS,2020-10-31,intra-total,2630,294,174,129,61,44,34,32,35,408,491,4332,3121,3415,FALSE,0.788319482917821,2020,2020-2021
MS,2020-10-31,intra-ucfe,2,1,0,2,0,0,0,0,0,1,3,9,5,6,FALSE,0.666666666666667,2020,2020-2021
MS,2020-10-31,intra-ucx,0,1,0,0,0,0,0,1,0,1,2,5,2,3,FALSE,0.6,2020,2020-2021
MS,2020-10-31,intra-ui,2628,292,174,127,61,44,34,31,35,406,486,4318,3114,3406,FALSE,0.788791106993979,2020,2020-2021
MS,2020-11-30,inter-total,9,6,3,3,3,1,0,0,0,6,3,34,12,18,FALSE,0.529411764705882,2020,2020-2021
MS,2020-11-30,inter-ucfe,0,0,0,0,0,0,0,0,0,0,0,0,0,0,FALSE,0,2020,2020-2021
MS,2020-11-30,inter-ucx,0,0,0,0,0,0,0,0,0,0,0,0,0,0,FALSE,0,2020,2020-2021
MS,2020-11-30,inter-ui,9,6,3,3,3,1,0,0,0,6,3,34,12,18,FALSE,0.529411764705882,2020,2020-2021
MS,2020-11-30,intra-total,1071,170,97,65,52,26,24,18,6,128,249,1906,1320,1490,FALSE,0.781741867785939,2020,2020-2021
MS,2020-11-30,intra-ucfe,4,3,0,0,1,0,0,1,0,1,9,19,13,16,FALSE,0.842105263157895,2020,2020-2021
MS,2020-11-30,intra-ucx,1,0,0,0,0,0,0,0,0,0,1,2,2,2,FALSE,1,2020,2020-2021
MS,2020-11-30,intra-ui,1066,167,97,65,51,26,24,17,6,127,239,1885,1305,1472,FALSE,0.780901856763926,2020,2020-2021
MS,2020-12-31,inter-total,21,5,1,3,1,1,0,2,0,8,5,47,26,31,FALSE,0.659574468085106,2020,2020-2021
MS,2020-12-31,inter-ucfe,0,0,0,0,0,0,0,0,0,0,0,0,0,0,FALSE,0,2020,2020-2021
MS,2020-12-31,inter-ucx,0,0,0,0,0,0,0,0,0,0,0,0,0,0,FALSE,0,2020,2020-2021
MS,2020-12-31,inter-ui,21,5,1,3,1,1,0,2,0,8,5,47,26,31,FALSE,0.659574468085106,2020,2020-2021
MS,2020-12-31,intra-total,1384,192,128,72,40,29,30,18,20,186,264,2363,1648,1840,FALSE,0.778671180702497,2020,2020-2021
MS,2020-12-31,intra-ucfe,3,3,5,3,0,0,0,1,1,0,7,23,10,13,FALSE,0.565217391304348,2020,2020-2021
MS,2020-12-31,intra-ucx,1,3,1,0,0,0,0,0,0,0,0,5,1,4,FALSE,0.8,2020,2020-2021
MS,2020-12-31,intra-ui,1380,186,122,69,40,29,30,17,19,186,257,2335,1637,1823,FALSE,0.780728051391863,2020,2020-2021
MS,2021-01-31,inter-total,18,3,1,2,1,0,1,1,0,6,15,48,33,36,FALSE,0.75,2020,2020-2021
MS,2021-01-31,inter-ucfe,0,0,0,0,0,0,0,0,0,0,0,0,0,0,FALSE,0,2020,2020-2021
MS,2021-01-31,inter-ucx,0,0,0,0,0,0,0,0,0,0,0,0,0,0,FALSE,0,2020,2020-2021
MS,2021-01-31,inter-ui,18,3,1,2,1,0,1,1,0,6,15,48,33,36,FALSE,0.75,2020,2020-2021
MS,2021-01-31,intra-total,1138,508,149,113,82,49,42,55,24,181,1207,3548,2345,2853,FALSE,0.804114994363022,2020,2020-2021
MS,2021-01-31,intra-ucfe,6,3,1,2,2,1,1,1,0,4,11,32,17,20,FALSE,0.625,2020,2020-2021
MS,2021-01-31,intra-ucx,0,1,0,0,0,0,0,0,0,0,4,5,4,5,FALSE,1,2020,2020-2021
MS,2021-01-31,intra-ui,1132,504,148,111,80,48,41,54,24,177,1192,3511,2324,2828,FALSE,0.805468527485047,2020,2020-2021
MS,2021-02-28,inter-total,11,3,3,0,0,1,1,0,0,1,5,25,16,19,FALSE,0.76,2020,2020-2021
MS,2021-02-28,inter-ucfe,0,0,0,0,0,0,0,0,0,0,0,0,0,0,FALSE,0,2020,2020-2021
MS,2021-02-28,inter-ucx,0,0,0,0,0,0,0,0,0,0,0,0,0,0,FALSE,0,2020,2020-2021
MS,2021-02-28,inter-ui,11,3,3,0,0,1,1,0,0,1,5,25,16,19,FALSE,0.76,2020,2020-2021
MS,2021-02-28,intra-total,2514,228,190,142,106,90,77,26,14,112,270,3769,2784,3012,FALSE,0.799150968426638,2020,2020-2021
MS,2021-02-28,intra-ucfe,4,3,4,1,1,1,0,1,0,1,3,19,7,10,FALSE,0.526315789473684,2020,2020-2021
MS,2021-02-28,intra-ucx,0,1,0,0,0,0,1,0,0,1,3,6,3,4,FALSE,0.666666666666667,2020,2020-2021
MS,2021-02-28,intra-ui,2510,224,186,141,105,89,76,25,14,110,264,3744,2774,2998,FALSE,0.800747863247863,2020,2020-2021
MS,2021-03-31,inter-total,15,6,2,4,3,1,2,1,0,6,2,42,17,23,FALSE,0.547619047619048,2020,2020-2021
MS,2021-03-31,inter-ucfe,0,0,0,0,0,0,0,0,0,0,0,0,0,0,FALSE,0,2020,2020-2021
MS,2021-03-31,inter-ucx,0,0,0,0,0,0,0,0,0,0,0,0,0,0,FALSE,0,2020,2020-2021
MS,2021-03-31,inter-ui,15,6,2,4,3,1,2,1,0,6,2,42,17,23,FALSE,0.547619047619048,2020,2020-2021
MS,2021-03-31,intra-total,1794,444,347,338,156,97,94,79,47,184,862,4442,2656,3100,FALSE,0.69788383610986,2020,2020-2021
MS,2021-03-31,intra-ucfe,4,2,1,0,0,2,3,1,1,1,4,19,8,10,FALSE,0.526315789473684,2020,2020-2021
MS,2021-03-31,intra-ucx,0,0,0,0,0,0,1,0,0,2,1,4,1,1,FALSE,0.25,2020,2020-2021
MS,2021-03-31,intra-ui,1790,442,346,338,156,95,90,78,46,181,857,4419,2647,3089,FALSE,0.699026929169495,2020,2020-2021
MS,2021-04-30,inter-total,68,5,2,1,1,2,1,0,1,5,8,94,76,81,FALSE,0.861702127659575,2020,2020-2021
MS,2021-04-30,inter-ucfe,0,0,0,0,0,0,0,0,0,0,0,0,0,0,FALSE,0,2020,2020-2021
MS,2021-04-30,inter-ucx,0,0,0,0,0,0,0,0,0,0,0,0,0,0,FALSE,0,2020,2020-2021
MS,2021-04-30,inter-ui,68,5,2,1,1,2,1,0,1,5,8,94,76,81,FALSE,0.861702127659575,2020,2020-2021
MS,2021-04-30,intra-total,6738,275,160,75,112,109,146,106,98,280,459,8558,7197,7472,FALSE,0.873101191867259,2020,2020-2021
MS,2021-04-30,intra-ucfe,23,12,3,4,2,2,1,2,0,6,9,64,32,44,FALSE,0.6875,2020,2020-2021
MS,2021-04-30,intra-ucx,2,0,0,0,0,1,0,0,1,0,2,6,4,4,FALSE,0.666666666666667,2020,2020-2021
MS,2021-04-30,intra-ui,6713,263,157,71,110,106,145,104,97,274,448,8488,7161,7424,FALSE,0.874646559849199,2020,2020-2021
MS,2021-05-31,inter-total,19,6,1,2,2,0,0,0,0,5,5,40,24,30,FALSE,0.75,2020,2020-2021
MS,2021-05-31,inter-ucfe,0,0,0,0,0,0,0,0,0,0,0,0,0,0,FALSE,0,2020,2020-2021
MS,2021-05-31,inter-ucx,0,0,0,0,0,0,0,0,0,0,0,0,0,0,FALSE,0,2020,2020-2021
MS,2021-05-31,inter-ui,19,6,1,2,2,0,0,0,0,5,5,40,24,30,FALSE,0.75,2020,2020-2021
MS,2021-05-31,intra-total,2051,299,149,128,76,53,32,39,41,429,445,3742,2496,2795,FALSE,0.746926777124532,2020,2020-2021
MS,2021-05-31,intra-ucfe,10,7,5,0,3,0,2,2,1,5,5,40,15,22,FALSE,0.55,2020,2020-2021
MS,2021-05-31,intra-ucx,1,0,0,0,0,0,0,0,0,3,1,5,2,2,FALSE,0.4,2020,2020-2021
MS,2021-05-31,intra-ui,2040,292,144,128,73,53,30,37,40,421,439,3697,2479,2771,FALSE,0.749526643224236,2020,2020-2021
MS,2021-06-30,inter-total,11,2,2,1,1,2,2,2,1,16,1,41,12,14,FALSE,0.341463414634146,2020,2020-2021
MS,2021-06-30,inter-ucfe,0,0,0,0,0,1,0,0,0,0,0,1,0,0,FALSE,0,2020,2020-2021
MS,2021-06-30,inter-ucx,0,0,0,0,0,0,0,0,0,0,0,0,0,0,FALSE,0,2020,2020-2021
MS,2021-06-30,inter-ui,11,2,2,1,1,1,2,2,1,16,1,40,12,14,FALSE,0.35,2020,2020-2021
MS,2021-06-30,intra-total,3035,222,110,76,78,67,74,63,62,506,315,4608,3350,3572,FALSE,0.775173611111111,2020,2020-2021
MS,2021-06-30,intra-ucfe,3,3,1,2,3,2,1,1,0,9,5,30,8,11,FALSE,0.366666666666667,2020,2020-2021
MS,2021-06-30,intra-ucx,0,0,1,0,0,0,0,0,0,1,1,3,1,1,FALSE,0.333333333333333,2020,2020-2021
MS,2021-06-30,intra-ui,3032,219,108,74,75,65,73,62,62,496,309,4575,3341,3560,FALSE,0.778142076502732,2020,2020-2021
MS,2021-07-31,inter-total,15,2,1,0,1,1,1,0,1,9,5,36,20,22,FALSE,0.611111111111111,2021,2021-2022
MS,2021-07-31,inter-ucfe,0,0,0,0,0,0,0,0,0,0,0,0,0,0,FALSE,0,2021,2021-2022
MS,2021-07-31,inter-ucx,0,0,0,0,0,0,0,0,0,0,0,0,0,0,FALSE,0,2021,2021-2022
MS,2021-07-31,inter-ui,15,2,1,0,1,1,1,0,1,9,5,36,20,22,FALSE,0.611111111111111,2021,2021-2022
MS,2021-07-31,intra-total,1682,192,75,50,59,27,36,30,33,442,304,2930,1986,2178,FALSE,0.743344709897611,2021,2021-2022
MS,2021-07-31,intra-ucfe,1,1,1,1,2,1,0,0,2,7,4,20,5,6,FALSE,0.3,2021,2021-2022
MS,2021-07-31,intra-ucx,2,0,0,0,0,0,0,0,0,1,0,3,2,2,FALSE,0.666666666666667,2021,2021-2022
MS,2021-07-31,intra-ui,1679,191,74,49,57,26,36,30,31,434,300,2907,1979,2170,FALSE,0.746474028207774,2021,2021-2022
MS,2021-08-31,inter-total,7,1,0,0,0,0,1,0,0,8,4,21,11,12,FALSE,0.571428571428571,2021,2021-2022
MS,2021-08-31,inter-ucfe,0,0,0,0,0,0,0,0,0,0,0,0,0,0,FALSE,0,2021,2021-2022
MS,2021-08-31,inter-ucx,0,0,0,0,0,0,0,0,0,0,0,0,0,0,FALSE,0,2021,2021-2022
MS,2021-08-31,inter-ui,7,1,0,0,0,0,1,0,0,8,4,21,11,12,FALSE,0.571428571428571,2021,2021-2022
MS,2021-08-31,intra-total,825,107,62,51,23,22,11,10,9,273,221,1614,1046,1153,FALSE,0.714374225526642,2021,2021-2022
MS,2021-08-31,intra-ucfe,6,2,0,0,0,0,0,0,0,3,5,16,11,13,FALSE,0.8125,2021,2021-2022
MS,2021-08-31,intra-ucx,1,0,2,0,0,0,0,0,0,0,0,3,1,1,FALSE,0.333333333333333,2021,2021-2022
MS,2021-08-31,intra-ui,818,105,60,51,23,22,11,10,9,270,216,1595,1034,1139,FALSE,0.7141065830721,2021,2021-2022
MS,2021-09-30,inter-total,4,1,1,0,1,1,0,0,0,8,3,19,7,8,FALSE,0.421052631578947,2021,2021-2022
MS,2021-09-30,inter-ucfe,0,0,0,0,0,0,0,0,0,0,0,0,0,0,FALSE,0,2021,2021-2022
MS,2021-09-30,inter-ucx,0,0,0,0,0,0,0,0,0,0,0,0,0,0,FALSE,0,2021,2021-2022
MS,2021-09-30,inter-ui,4,1,1,0,1,1,0,0,0,8,3,19,7,8,FALSE,0.421052631578947,2021,2021-2022
MS,2021-09-30,intra-total,482,84,47,20,18,15,16,20,10,224,154,1090,636,720,FALSE,0.660550458715596,2021,2021-2022
MS,2021-09-30,intra-ucfe,3,1,1,0,0,0,1,0,0,2,2,10,5,6,FALSE,0.6,2021,2021-2022
MS,2021-09-30,intra-ucx,2,0,0,0,0,0,0,0,0,0,0,2,2,2,FALSE,1,2021,2021-2022
MS,2021-09-30,intra-ui,477,83,46,20,18,15,15,20,10,222,152,1078,629,712,FALSE,0.660482374768089,2021,2021-2022
MS,2021-10-31,inter-total,9,0,2,2,1,0,0,0,0,8,2,24,11,11,FALSE,0.458333333333333,2021,2021-2022
MS,2021-10-31,inter-ucfe,0,0,0,0,0,0,0,0,0,0,0,0,0,0,FALSE,0,2021,2021-2022
MS,2021-10-31,inter-ucx,0,0,0,0,0,0,0,0,0,0,0,0,0,0,FALSE,0,2021,2021-2022
MS,2021-10-31,inter-ui,9,0,2,2,1,0,0,0,0,8,2,24,11,11,FALSE,0.458333333333333,2021,2021-2022
MS,2021-10-31,intra-total,334,61,32,30,18,15,16,8,13,154,140,821,474,535,FALSE,0.651644336175396,2021,2021-2022
MS,2021-10-31,intra-ucfe,0,1,1,0,0,0,0,1,0,0,3,6,3,4,FALSE,0.666666666666667,2021,2021-2022
MS,2021-10-31,intra-ucx,2,1,0,0,0,0,0,0,0,0,0,3,2,3,FALSE,1,2021,2021-2022
MS,2021-10-31,intra-ui,332,59,31,30,18,15,16,7,13,154,137,812,469,528,FALSE,0.650246305418719,2021,2021-2022
MS,2021-11-30,inter-total,10,1,0,0,1,0,0,0,0,6,1,19,11,12,FALSE,0.631578947368421,2021,2021-2022
MS,2021-11-30,inter-ucfe,0,0,0,0,0,0,0,0,0,0,0,0,0,0,FALSE,0,2021,2021-2022
MS,2021-11-30,inter-ucx,0,0,0,0,0,0,0,0,0,0,0,0,0,0,FALSE,0,2021,2021-2022
MS,2021-11-30,inter-ui,10,1,0,0,1,0,0,0,0,6,1,19,11,12,FALSE,0.631578947368421,2021,2021-2022
MS,2021-11-30,intra-total,428,51,21,17,17,13,4,4,8,138,113,814,541,592,FALSE,0.727272727272727,2021,2021-2022
MS,2021-11-30,intra-ucfe,4,1,0,0,0,0,0,0,0,4,2,11,6,7,FALSE,0.636363636363636,2021,2021-2022
MS,2021-11-30,intra-ucx,0,0,0,0,0,0,0,0,0,0,2,2,2,2,FALSE,1,2021,2021-2022
MS,2021-11-30,intra-ui,424,50,21,17,17,13,4,4,8,134,109,801,533,583,FALSE,0.727840199750312,2021,2021-2022
MS,2021-12-31,inter-total,8,1,0,0,0,0,0,0,0,6,2,17,10,11,FALSE,0.647058823529412,2021,2021-2022
MS,2021-12-31,inter-ucfe,0,0,0,0,0,0,0,0,0,0,0,0,0,0,FALSE,0,2021,2021-2022
MS,2021-12-31,inter-ucx,0,0,0,0,0,0,0,0,0,0,0,0,0,0,FALSE,0,2021,2021-2022
MS,2021-12-31,inter-ui,8,1,0,0,0,0,0,0,0,6,2,17,10,11,FALSE,0.647058823529412,2021,2021-2022
MS,2021-12-31,intra-total,459,52,35,23,16,7,3,12,7,76,132,822,591,643,FALSE,0.782238442822384,2021,2021-2022
MS,2021-12-31,intra-ucfe,1,1,1,1,1,0,0,1,0,1,1,8,2,3,FALSE,0.375,2021,2021-2022
MS,2021-12-31,intra-ucx,0,0,0,0,0,0,0,0,0,0,1,1,1,1,FALSE,1,2021,2021-2022
MS,2021-12-31,intra-ui,458,51,34,22,15,7,3,11,7,75,130,813,588,639,FALSE,0.785977859778598,2021,2021-2022
MS,2022-01-31,inter-total,6,1,0,2,1,1,0,0,0,2,4,17,10,11,FALSE,0.647058823529412,2021,2021-2022
MS,2022-01-31,inter-ucfe,0,0,0,0,0,0,0,0,0,0,0,0,0,0,FALSE,0,2021,2021-2022
MS,2022-01-31,inter-ucx,0,0,0,0,0,0,0,0,0,0,0,0,0,0,FALSE,0,2021,2021-2022
MS,2022-01-31,inter-ui,6,1,0,2,1,1,0,0,0,2,4,17,10,11,FALSE,0.647058823529412,2021,2021-2022
MS,2022-01-31,intra-total,655,64,35,22,17,10,7,5,2,46,165,1028,820,884,FALSE,0.859922178988327,2021,2021-2022
MS,2022-01-31,intra-ucfe,3,2,1,2,0,1,0,0,0,0,2,11,5,7,FALSE,0.636363636363636,2021,2021-2022
MS,2022-01-31,intra-ucx,2,0,0,0,0,0,0,0,0,0,0,2,2,2,FALSE,1,2021,2021-2022
MS,2022-01-31,intra-ui,650,62,34,20,17,9,7,5,2,46,163,1015,813,875,FALSE,0.862068965517241,2021,2021-2022
MS,2022-02-28,inter-total,4,3,2,0,0,0,0,0,0,0,4,13,8,11,FALSE,0.846153846153846,2021,2021-2022
MS,2022-02-28,inter-ucfe,0,0,0,0,0,0,0,0,0,0,0,0,0,0,FALSE,0,2021,2021-2022
MS,2022-02-28,inter-ucx,0,0,0,0,0,0,0,0,0,0,0,0,0,0,FALSE,0,2021,2021-2022
MS,2022-02-28,inter-ui,4,3,2,0,0,0,0,0,0,0,4,13,8,11,FALSE,0.846153846153846,2021,2021-2022
MS,2022-02-28,intra-total,417,65,31,25,16,11,4,4,4,37,151,765,568,633,FALSE,0.827450980392157,2021,2021-2022
MS,2022-02-28,intra-ucfe,4,0,2,0,1,1,0,0,1,1,0,10,4,4,FALSE,0.4,2021,2021-2022
MS,2022-02-28,intra-ucx,0,0,0,0,0,0,0,0,0,0,1,1,1,1,FALSE,1,2021,2021-2022
MS,2022-02-28,intra-ui,413,65,29,25,15,10,4,4,3,36,150,754,563,628,FALSE,0.83289124668435,2021,2021-2022
MS,2022-03-31,inter-total,13,0,0,1,1,1,0,0,2,2,3,23,16,16,FALSE,0.695652173913044,2021,2021-2022
MS,2022-03-31,inter-ucfe,0,0,0,0,0,0,0,0,0,0,0,0,0,0,FALSE,0,2021,2021-2022
MS,2022-03-31,inter-ucx,0,0,0,0,0,0,0,0,0,0,0,0,0,0,FALSE,0,2021,2021-2022
MS,2022-03-31,inter-ui,13,0,0,1,1,1,0,0,2,2,3,23,16,16,FALSE,0.695652173913044,2021,2021-2022
MS,2022-03-31,intra-total,474,47,20,18,11,19,5,3,4,41,122,764,596,643,FALSE,0.841623036649215,2021,2021-2022
MS,2022-03-31,intra-ucfe,6,2,3,0,0,1,0,0,1,1,3,17,9,11,FALSE,0.647058823529412,2021,2021-2022
MS,2022-03-31,intra-ucx,1,0,0,0,0,0,0,0,0,0,1,2,2,2,FALSE,1,2021,2021-2022
MS,2022-03-31,intra-ui,467,45,17,18,11,18,5,3,3,40,118,745,585,630,FALSE,0.845637583892617,2021,2021-2022
MS,2022-04-30,inter-total,11,0,2,0,0,0,0,0,1,1,1,16,12,12,FALSE,0.75,2021,2021-2022
MS,2022-04-30,inter-ucfe,0,0,0,0,0,0,0,0,0,0,0,0,0,0,FALSE,0,2021,2021-2022
MS,2022-04-30,inter-ucx,0,0,0,0,0,0,0,0,0,0,0,0,0,0,FALSE,0,2021,2021-2022
MS,2022-04-30,inter-ui,11,0,2,0,0,0,0,0,1,1,1,16,12,12,FALSE,0.75,2021,2021-2022
MS,2022-04-30,intra-total,539,38,27,15,11,11,7,8,4,38,126,824,665,703,FALSE,0.853155339805825,2021,2021-2022
MS,2022-04-30,intra-ucfe,9,2,4,1,0,0,0,0,0,0,7,23,16,18,FALSE,0.782608695652174,2021,2021-2022
MS,2022-04-30,intra-ucx,1,0,0,0,0,0,0,0,0,0,1,2,2,2,FALSE,1,2021,2021-2022
MS,2022-04-30,intra-ui,529,36,23,14,11,11,7,8,4,38,118,799,647,683,FALSE,0.854818523153942,2021,2021-2022
MS,2022-05-31,inter-total,10,0,2,0,0,0,0,0,0,0,5,17,15,15,FALSE,0.882352941176471,2021,2021-2022
MS,2022-05-31,inter-ucfe,0,0,0,0,0,0,0,0,0,0,0,0,0,0,FALSE,0,2021,2021-2022
MS,2022-05-31,inter-ucx,0,0,0,0,0,0,0,0,0,0,0,0,0,0,FALSE,0,2021,2021-2022
MS,2022-05-31,inter-ui,10,0,2,0,0,0,0,0,0,0,5,17,15,15,FALSE,0.882352941176471,2021,2021-2022
MS,2022-05-31,intra-total,806,48,25,22,14,9,6,1,0,27,119,1077,925,973,FALSE,0.903435468895079,2021,2021-2022
MS,2022-05-31,intra-ucfe,4,2,0,0,1,2,0,0,0,1,6,16,10,12,FALSE,0.75,2021,2021-2022
MS,2022-05-31,intra-ucx,1,0,0,0,0,0,0,0,0,0,0,1,1,1,FALSE,1,2021,2021-2022
MS,2022-05-31,intra-ui,801,46,25,22,13,7,6,1,0,26,113,1060,914,960,FALSE,0.905660377358491,2021,2021-2022
MS,2022-06-30,inter-total,7,3,0,0,1,0,0,0,1,1,5,18,12,15,FALSE,0.833333333333333,2021,2021-2022
MS,2022-06-30,inter-ucfe,1,0,0,0,0,0,0,0,1,0,0,2,1,1,FALSE,0.5,2021,2021-2022
MS,2022-06-30,inter-ucx,0,0,0,0,0,0,0,0,0,0,0,0,0,0,FALSE,0,2021,2021-2022
MS,2022-06-30,inter-ui,6,3,0,0,1,0,0,0,0,1,5,16,11,14,FALSE,0.875,2021,2021-2022
MS,2022-06-30,intra-total,1575,82,23,15,15,12,7,5,2,29,279,2044,1854,1936,FALSE,0.947162426614481,2021,2021-2022
MS,2022-06-30,intra-ucfe,9,1,0,3,1,2,1,1,0,2,5,25,14,15,FALSE,0.6,2021,2021-2022
MS,2022-06-30,intra-ucx,2,0,0,0,0,0,0,0,0,0,1,3,3,3,FALSE,1,2021,2021-2022
MS,2022-06-30,intra-ui,1564,81,23,12,14,10,6,4,2,27,273,2016,1837,1918,FALSE,0.951388888888889,2021,2021-2022
MS,2022-07-31,inter-total,9,4,0,0,1,0,0,0,0,0,4,18,13,17,FALSE,0.944444444444444,2022,2022-2023
MS,2022-07-31,inter-ucfe,0,0,0,0,0,0,0,0,0,0,0,0,0,0,FALSE,0,2022,2022-2023
MS,2022-07-31,inter-ucx,0,0,0,0,0,0,0,0,0,0,0,0,0,0,FALSE,0,2022,2022-2023
MS,2022-07-31,inter-ui,9,4,0,0,1,0,0,0,0,0,4,18,13,17,FALSE,0.944444444444444,2022,2022-2023
MS,2022-07-31,intra-total,1807,141,42,21,18,14,8,3,5,18,298,2375,2105,2246,FALSE,0.945684210526316,2022,2022-2023
MS,2022-07-31,intra-ucfe,1,1,2,1,1,0,0,0,0,0,3,9,4,5,FALSE,0.555555555555556,2022,2022-2023
MS,2022-07-31,intra-ucx,0,0,0,0,0,0,0,0,0,0,0,0,0,0,FALSE,0,2022,2022-2023
MS,2022-07-31,intra-ui,1806,140,40,20,17,14,8,3,5,18,295,2366,2101,2241,FALSE,0.947168216398986,2022,2022-2023
MS,2022-08-31,inter-total,8,6,3,1,0,0,2,0,0,3,3,26,11,17,FALSE,0.653846153846154,2022,2022-2023
MS,2022-08-31,inter-ucfe,0,0,0,0,0,0,0,0,0,0,0,0,0,0,FALSE,0,2022,2022-2023
MS,2022-08-31,inter-ucx,0,0,0,0,0,0,0,0,0,0,0,0,0,0,FALSE,0,2022,2022-2023
MS,2022-08-31,inter-ui,8,6,3,1,0,0,2,0,0,3,3,26,11,17,FALSE,0.653846153846154,2022,2022-2023
MS,2022-08-31,intra-total,832,132,61,26,29,28,11,15,6,24,219,1383,1051,1183,FALSE,0.855386840202458,2022,2022-2023
MS,2022-08-31,intra-ucfe,6,1,0,0,0,0,0,0,0,1,2,10,8,9,FALSE,0.9,2022,2022-2023
MS,2022-08-31,intra-ucx,1,0,0,0,0,0,0,0,0,0,1,2,2,2,FALSE,1,2022,2022-2023
MS,2022-08-31,intra-ui,825,131,61,26,29,28,11,15,6,23,216,1371,1041,1172,FALSE,0.854850474106492,2022,2022-2023
MS,2022-09-30,inter-total,9,5,3,1,1,0,0,0,0,1,3,23,12,17,FALSE,0.739130434782609,2022,2022-2023
MS,2022-09-30,inter-ucfe,0,0,0,1,0,0,0,0,0,0,0,1,0,0,FALSE,0,2022,2022-2023
MS,2022-09-30,inter-ucx,0,0,0,0,0,0,0,0,0,0,0,0,0,0,FALSE,0,2022,2022-2023
MS,2022-09-30,inter-ui,9,5,3,0,1,0,0,0,0,1,3,22,12,17,FALSE,0.772727272727273,2022,2022-2023
MS,2022-09-30,intra-total,335,155,96,49,33,19,12,9,7,23,176,914,511,666,FALSE,0.728665207877462,2022,2022-2023
MS,2022-09-30,intra-ucfe,0,0,0,3,2,0,0,0,0,0,0,5,0,0,FALSE,0,2022,2022-2023
MS,2022-09-30,intra-ucx,2,1,0,0,0,0,0,0,0,0,1,4,3,4,FALSE,1,2022,2022-2023
MS,2022-09-30,intra-ui,333,154,96,46,31,19,12,9,7,23,175,905,508,662,FALSE,0.731491712707182,2022,2022-2023
MS,2022-10-31,inter-total,12,1,0,0,1,1,0,0,0,3,5,23,17,18,FALSE,0.782608695652174,2022,2022-2023
MS,2022-10-31,inter-ucfe,0,0,0,0,0,0,0,0,0,0,0,0,0,0,FALSE,0,2022,2022-2023
MS,2022-10-31,inter-ucx,0,0,0,0,0,0,0,0,0,0,0,0,0,0,FALSE,0,2022,2022-2023
MS,2022-10-31,inter-ui,12,1,0,0,1,1,0,0,0,3,5,23,17,18,FALSE,0.782608695652174,2022,2022-2023
MS,2022-10-31,intra-total,575,68,32,23,6,9,7,9,4,151,204,1088,779,847,FALSE,0.778492647058824,2022,2022-2023
MS,2022-10-31,intra-ucfe,0,0,1,1,0,0,0,0,0,1,1,4,1,1,FALSE,0.25,2022,2022-2023
MS,2022-10-31,intra-ucx,2,0,0,0,0,0,0,0,0,0,1,3,3,3,FALSE,1,2022,2022-2023
MS,2022-10-31,intra-ui,573,68,31,22,6,9,7,9,4,150,202,1081,775,843,FALSE,0.779833487511563,2022,2022-2023
MS,2022-11-30,inter-total,19,1,0,0,1,0,0,0,0,2,2,25,21,22,FALSE,0.88,2022,2022-2023
MS,2022-11-30,inter-ucfe,0,0,0,0,0,0,0,0,0,0,0,0,0,0,FALSE,0,2022,2022-2023
MS,2022-11-30,inter-ucx,0,0,0,0,0,0,0,0,0,0,0,0,0,0,FALSE,0,2022,2022-2023
MS,2022-11-30,inter-ui,19,1,0,0,1,0,0,0,0,2,2,25,21,22,FALSE,0.88,2022,2022-2023
MS,2022-11-30,intra-total,602,55,26,25,13,7,1,5,1,27,144,906,746,801,FALSE,0.884105960264901,2022,2022-2023
MS,2022-11-30,intra-ucfe,0,0,0,1,0,0,0,0,0,0,0,1,0,0,FALSE,0,2022,2022-2023
MS,2022-11-30,intra-ucx,2,0,0,0,1,0,0,0,0,0,2,5,4,4,FALSE,0.8,2022,2022-2023
MS,2022-11-30,intra-ui,600,55,26,24,12,7,1,5,1,27,142,900,742,797,FALSE,0.885555555555556,2022,2022-2023
MS,2022-12-31,inter-total,20,3,0,0,1,0,0,0,0,1,6,31,26,29,FALSE,0.935483870967742,2022,2022-2023
MS,2022-12-31,inter-ucfe,0,0,0,0,1,0,0,0,0,0,0,1,0,0,FALSE,0,2022,2022-2023
MS,2022-12-31,inter-ucx,0,0,0,0,0,0,0,0,0,0,0,0,0,0,FALSE,0,2022,2022-2023
MS,2022-12-31,inter-ui,20,3,0,0,0,0,0,0,0,1,6,30,26,29,FALSE,0.966666666666667,2022,2022-2023
MS,2022-12-31,intra-total,986,88,25,30,16,7,8,5,1,40,213,1419,1199,1287,FALSE,0.906976744186047,2022,2022-2023
MS,2022-12-31,intra-ucfe,1,0,2,0,0,0,0,0,0,0,1,4,2,2,FALSE,0.5,2022,2022-2023
MS,2022-12-31,intra-ucx,0,1,0,0,0,0,0,0,0,0,1,2,1,2,FALSE,1,2022,2022-2023
MS,2022-12-31,intra-ui,985,87,23,30,16,7,8,5,1,40,211,1413,1196,1283,FALSE,0.907997169143666,2022,2022-2023
MS,2023-01-31,inter-total,17,3,0,1,0,0,1,0,0,0,5,27,22,25,FALSE,0.925925925925926,2022,2022-2023
MS,2023-01-31,inter-ucfe,0,0,0,0,0,0,0,0,0,0,0,0,0,0,FALSE,0,2022,2022-2023
MS,2023-01-31,inter-ucx,0,0,0,0,0,0,0,0,0,0,0,0,0,0,FALSE,0,2022,2022-2023
MS,2023-01-31,inter-ui,17,3,0,1,0,0,1,0,0,0,5,27,22,25,FALSE,0.925925925925926,2022,2022-2023
MS,2023-01-31,intra-total,911,80,33,40,34,9,6,8,8,25,234,1388,1145,1225,FALSE,0.882564841498559,2022,2022-2023
MS,2023-01-31,intra-ucfe,4,1,1,1,0,0,0,1,0,1,1,10,5,6,FALSE,0.6,2022,2022-2023
MS,2023-01-31,intra-ucx,1,1,0,1,0,1,0,0,0,0,0,4,1,2,FALSE,0.5,2022,2022-2023
MS,2023-01-31,intra-ui,906,78,32,38,34,8,6,7,8,24,233,1374,1139,1217,FALSE,0.885735080058224,2022,2022-2023
MS,2023-02-28,inter-total,16,3,0,2,2,0,1,1,1,1,10,37,26,29,FALSE,0.783783783783784,2022,2022-2023
MS,2023-02-28,inter-ucfe,1,0,0,0,1,0,0,0,0,0,0,2,1,1,FALSE,0.5,2022,2022-2023
MS,2023-02-28,inter-ucx,0,0,0,0,0,0,0,0,0,0,0,0,0,0,FALSE,0,2022,2022-2023
MS,2023-02-28,inter-ui,15,3,0,2,1,0,1,1,1,1,10,35,25,28,FALSE,0.8,2022,2022-2023
MS,2023-02-28,intra-total,691,56,35,14,16,8,9,7,3,14,180,1033,871,927,FALSE,0.897386253630203,2022,2022-2023
MS,2023-02-28,intra-ucfe,1,1,0,0,0,0,0,0,0,0,2,4,3,4,FALSE,1,2022,2022-2023
MS,2023-02-28,intra-ucx,2,0,0,0,0,0,0,0,0,0,0,2,2,2,FALSE,1,2022,2022-2023
MS,2023-02-28,intra-ui,688,55,35,14,16,8,9,7,3,14,178,1027,866,921,FALSE,0.896786757546251,2022,2022-2023
MS,2023-03-31,inter-total,19,5,1,2,1,2,0,0,0,0,4,34,23,28,FALSE,0.823529411764706,2022,2022-2023
MS,2023-03-31,inter-ucfe,0,0,0,0,0,0,0,0,0,0,0,0,0,0,FALSE,0,2022,2022-2023
MS,2023-03-31,inter-ucx,0,1,0,0,0,0,0,0,0,0,0,1,0,1,FALSE,1,2022,2022-2023
MS,2023-03-31,inter-ui,19,4,1,2,1,2,0,0,0,0,4,33,23,27,FALSE,0.818181818181818,2022,2022-2023
MS,2023-03-31,intra-total,685,56,22,22,11,16,12,3,2,21,181,1031,866,922,FALSE,0.894277400581959,2022,2022-2023
MS,2023-03-31,intra-ucfe,0,1,1,2,1,0,0,0,0,1,2,8,2,3,FALSE,0.375,2022,2022-2023
MS,2023-03-31,intra-ucx,1,0,0,0,0,0,0,0,0,0,1,2,2,2,FALSE,1,2022,2022-2023
MS,2023-03-31,intra-ui,684,55,21,20,10,16,12,3,2,20,178,1021,862,917,FALSE,0.898139079333986,2022,2022-2023
MS,2023-04-30,inter-total,17,3,1,1,1,0,0,0,0,0,4,27,21,24,FALSE,0.888888888888889,2022,2022-2023
MS,2023-04-30,inter-ucfe,1,1,0,1,0,0,0,0,0,0,0,3,1,2,FALSE,0.666666666666667,2022,2022-2023
MS,2023-04-30,inter-ucx,0,0,0,0,0,0,0,0,0,0,0,0,0,0,FALSE,0,2022,2022-2023
MS,2023-04-30,inter-ui,16,2,1,0,1,0,0,0,0,0,4,24,20,22,FALSE,0.916666666666667,2022,2022-2023
MS,2023-04-30,intra-total,757,80,43,14,13,4,1,6,2,11,211,1142,968,1048,FALSE,0.91768826619965,2022,2022-2023
MS,2023-04-30,intra-ucfe,4,3,1,0,0,0,0,0,1,0,4,13,8,11,FALSE,0.846153846153846,2022,2022-2023
MS,2023-04-30,intra-ucx,2,0,0,0,0,0,0,0,0,0,1,3,3,3,FALSE,1,2022,2022-2023
MS,2023-04-30,intra-ui,751,77,42,14,13,4,1,6,1,11,206,1126,957,1034,FALSE,0.918294849023091,2022,2022-2023
MS,2023-05-31,inter-total,10,2,2,0,1,0,1,0,0,0,8,24,18,20,FALSE,0.833333333333333,2022,2022-2023
MS,2023-05-31,inter-ucfe,0,0,0,0,1,0,0,0,0,0,0,1,0,0,FALSE,0,2022,2022-2023
MS,2023-05-31,inter-ucx,0,0,0,0,0,0,0,0,0,0,0,0,0,0,FALSE,0,2022,2022-2023
MS,2023-05-31,inter-ui,10,2,2,0,0,0,1,0,0,0,8,23,18,20,FALSE,0.869565217391304,2022,2022-2023
MS,2023-05-31,intra-total,871,72,37,43,35,14,14,1,2,13,297,1399,1168,1240,FALSE,0.886347390993567,2022,2022-2023
MS,2023-05-31,intra-ucfe,10,4,7,4,0,0,0,0,0,0,3,28,13,17,FALSE,0.607142857142857,2022,2022-2023
MS,2023-05-31,intra-ucx,1,0,0,0,1,0,0,0,0,1,2,5,3,3,FALSE,0.6,2022,2022-2023
MS,2023-05-31,intra-ui,860,68,30,39,34,14,14,1,2,12,292,1366,1152,1220,FALSE,0.89311859443631,2022,2022-2023
MS,2023-06-30,inter-total,9,2,1,0,0,0,0,0,0,1,11,24,20,22,FALSE,0.916666666666667,2022,2022-2023
MS,2023-06-30,inter-ucfe,0,0,0,0,0,0,0,0,0,0,0,0,0,0,FALSE,0,2022,2022-2023
MS,2023-06-30,inter-ucx,0,0,0,0,0,0,0,0,0,0,0,0,0,0,FALSE,0,2022,2022-2023
MS,2023-06-30,inter-ui,9,2,1,0,0,0,0,0,0,1,11,24,20,22,FALSE,0.916666666666667,2022,2022-2023
MS,2023-06-30,intra-total,1362,136,47,29,26,23,15,6,10,16,378,2048,1740,1876,FALSE,0.916015625,2022,2022-2023
MS,2023-06-30,intra-ucfe,1,1,1,1,2,0,0,0,1,0,1,8,2,3,FALSE,0.375,2022,2022-2023
MS,2023-06-30,intra-ucx,0,0,0,0,0,0,0,0,0,0,1,1,1,1,FALSE,1,2022,2022-2023
MS,2023-06-30,intra-ui,1361,135,46,28,24,23,15,6,9,16,376,2039,1737,1872,FALSE,0.918097106424718,2022,2022-2023
MS,2023-07-31,inter-total,12,6,2,0,3,1,1,0,0,2,8,35,20,26,FALSE,0.742857142857143,2023,2023-2024
MS,2023-07-31,inter-ucfe,0,0,0,0,0,0,0,0,0,0,0,0,0,0,FALSE,0,2023,2023-2024
MS,2023-07-31,inter-ucx,0,0,0,0,0,0,0,0,0,0,0,0,0,0,FALSE,0,2023,2023-2024
MS,2023-07-31,inter-ui,12,6,2,0,3,1,1,0,0,2,8,35,20,26,FALSE,0.742857142857143,2023,2023-2024
MS,2023-07-31,intra-total,1323,168,48,36,34,24,15,11,3,20,372,2054,1695,1863,FALSE,0.907010710808179,2023,2023-2024
MS,2023-07-31,intra-ucfe,5,2,0,0,0,0,0,0,0,3,0,10,5,7,FALSE,0.7,2023,2023-2024
MS,2023-07-31,intra-ucx,0,1,0,0,0,0,0,0,0,0,1,2,1,2,FALSE,1,2023,2023-2024
MS,2023-07-31,intra-ui,1318,165,48,36,34,24,15,11,3,17,371,2042,1689,1854,FALSE,0.907933398628795,2023,2023-2024
MS,2023-08-31,inter-total,9,1,2,0,0,1,0,2,0,1,7,23,16,17,FALSE,0.739130434782609,2023,2023-2024
MS,2023-08-31,inter-ucfe,1,0,0,0,0,0,0,0,0,1,0,2,1,1,FALSE,0.5,2023,2023-2024
MS,2023-08-31,inter-ucx,0,0,0,0,0,0,0,0,0,0,0,0,0,0,FALSE,0,2023,2023-2024
MS,2023-08-31,inter-ui,8,1,2,0,0,1,0,2,0,0,7,21,15,16,FALSE,0.761904761904762,2023,2023-2024
MS,2023-08-31,intra-total,681,182,68,47,33,22,18,15,7,20,339,1432,1020,1202,FALSE,0.839385474860335,2023,2023-2024
MS,2023-08-31,intra-ucfe,3,1,2,0,0,0,0,0,0,0,2,8,5,6,FALSE,0.75,2023,2023-2024
MS,2023-08-31,intra-ucx,0,0,1,0,0,0,0,0,0,0,2,3,2,2,FALSE,0.666666666666667,2023,2023-2024
MS,2023-08-31,intra-ui,678,181,65,47,33,22,18,15,7,20,335,1421,1013,1194,FALSE,0.840253342716397,2023,2023-2024
MS,2023-09-30,inter-total,7,13,2,1,0,0,1,0,0,0,0,24,7,20,FALSE,0.833333333333333,2023,2023-2024
MS,2023-09-30,inter-ucfe,0,0,0,1,0,0,0,0,0,0,0,1,0,0,FALSE,0,2023,2023-2024
MS,2023-09-30,inter-ucx,0,0,0,0,0,0,0,0,0,0,0,0,0,0,FALSE,0,2023,2023-2024
MS,2023-09-30,inter-ui,7,13,2,0,0,0,1,0,0,0,0,23,7,20,FALSE,0.869565217391304,2023,2023-2024
MS,2023-09-30,intra-total,420,192,95,40,24,20,11,6,2,13,147,970,567,759,FALSE,0.782474226804124,2023,2023-2024
MS,2023-09-30,intra-ucfe,2,1,1,0,0,0,0,0,0,0,0,4,2,3,FALSE,0.75,2023,2023-2024
MS,2023-09-30,intra-ucx,0,0,0,0,0,0,0,0,0,0,0,0,0,0,FALSE,0,2023,2023-2024
MS,2023-09-30,intra-ui,418,191,94,40,24,20,11,6,2,13,147,966,565,756,FALSE,0.782608695652174,2023,2023-2024
MS,2023-10-31,inter-total,12,3,3,0,0,1,0,1,0,1,5,26,17,20,FALSE,0.769230769230769,2023,2023-2024
MS,2023-10-31,inter-ucfe,0,0,0,0,0,0,0,0,0,0,0,0,0,0,FALSE,0,2023,2023-2024
MS,2023-10-31,inter-ucx,0,0,0,0,0,0,0,0,0,0,0,0,0,0,FALSE,0,2023,2023-2024
MS,2023-10-31,inter-ui,12,3,3,0,0,1,0,1,0,1,5,26,17,20,FALSE,0.769230769230769,2023,2023-2024
MS,2023-10-31,intra-total,473,178,93,37,33,15,21,5,4,11,195,1065,668,846,FALSE,0.794366197183099,2023,2023-2024
MS,2023-10-31,intra-ucfe,1,1,1,0,0,0,0,0,0,0,1,4,2,3,FALSE,0.75,2023,2023-2024
MS,2023-10-31,intra-ucx,2,0,1,0,0,0,0,0,0,0,0,3,2,2,FALSE,0.666666666666667,2023,2023-2024
MS,2023-10-31,intra-ui,470,177,91,37,33,15,21,5,4,11,194,1058,664,841,FALSE,0.794896030245747,2023,2023-2024
MS,2023-11-30,inter-total,6,3,2,1,0,3,0,0,0,2,3,20,9,12,FALSE,0.6,2023,2023-2024
MS,2023-11-30,inter-ucfe,0,0,0,0,0,0,0,0,0,0,0,0,0,0,FALSE,0,2023,2023-2024
MS,2023-11-30,inter-ucx,0,0,0,0,0,0,0,0,0,0,0,0,0,0,FALSE,0,2023,2023-2024
MS,2023-11-30,inter-ui,6,3,2,1,0,3,0,0,0,2,3,20,9,12,FALSE,0.6,2023,2023-2024
MS,2023-11-30,intra-total,530,159,89,39,27,22,7,14,1,4,210,1102,740,899,FALSE,0.81578947368421,2023,2023-2024
MS,2023-11-30,intra-ucfe,1,0,2,0,1,0,0,0,0,0,1,5,2,2,FALSE,0.4,2023,2023-2024
MS,2023-11-30,intra-ucx,2,0,0,0,0,0,0,0,0,0,0,2,2,2,FALSE,1,2023,2023-2024
MS,2023-11-30,intra-ui,527,159,87,39,26,22,7,14,1,4,209,1095,736,895,FALSE,0.817351598173516,2023,2023-2024
MS,2023-12-31,inter-total,19,3,0,0,0,0,0,0,0,0,4,26,23,26,FALSE,1,2023,2023-2024
MS,2023-12-31,inter-ucfe,0,0,0,0,0,0,0,0,0,0,0,0,0,0,FALSE,0,2023,2023-2024
MS,2023-12-31,inter-ucx,0,0,0,0,0,0,0,0,0,0,0,0,0,0,FALSE,0,2023,2023-2024
MS,2023-12-31,inter-ui,19,3,0,0,0,0,0,0,0,0,4,26,23,26,FALSE,1,2023,2023-2024
MS,2023-12-31,intra-total,662,114,38,22,21,9,20,8,8,10,233,1145,895,1009,FALSE,0.881222707423581,2023,2023-2024
MS,2023-12-31,intra-ucfe,2,0,0,1,0,0,0,0,0,0,1,4,3,3,FALSE,0.75,2023,2023-2024
MS,2023-12-31,intra-ucx,0,0,0,0,0,0,0,0,0,0,0,0,0,0,FALSE,0,2023,2023-2024
MS,2023-12-31,intra-ui,660,114,38,21,21,9,20,8,8,10,232,1141,892,1006,FALSE,0.881682734443471,2023,2023-2024
MS,2024-01-31,inter-total,5,4,3,0,0,1,1,0,0,3,4,21,9,13,FALSE,0.619047619047619,2023,2023-2024
MS,2024-01-31,inter-ucfe,0,0,0,0,0,0,0,0,0,0,0,0,0,0,FALSE,0,2023,2023-2024
MS,2024-01-31,inter-ucx,0,0,0,0,0,0,0,0,0,0,0,0,0,0,FALSE,0,2023,2023-2024
MS,2024-01-31,inter-ui,5,4,3,0,0,1,1,0,0,3,4,21,9,13,FALSE,0.619047619047619,2023,2023-2024
MS,2024-01-31,intra-total,902,118,48,23,13,12,25,12,11,19,310,1493,1212,1330,FALSE,0.890823844608172,2023,2023-2024
MS,2024-01-31,intra-ucfe,1,0,1,0,0,0,0,0,0,1,2,5,3,3,FALSE,0.6,2023,2023-2024
MS,2024-01-31,intra-ucx,3,0,0,0,0,0,0,0,0,0,3,6,6,6,FALSE,1,2023,2023-2024
MS,2024-01-31,intra-ui,898,118,47,23,13,12,25,12,11,18,305,1482,1203,1321,FALSE,0.89136302294197,2023,2023-2024
MS,2024-02-29,inter-total,16,2,1,1,0,0,1,1,0,1,6,29,22,24,FALSE,0.827586206896552,2023,2023-2024
MS,2024-02-29,inter-ucfe,0,0,0,0,0,0,0,0,0,0,0,0,0,0,FALSE,0,2023,2023-2024
MS,2024-02-29,inter-ucx,0,0,0,0,0,0,0,0,0,0,0,0,0,0,FALSE,0,2023,2023-2024
MS,2024-02-29,inter-ui,16,2,1,1,0,0,1,1,0,1,6,29,22,24,FALSE,0.827586206896552,2023,2023-2024
MS,2024-02-29,intra-total,767,62,19,11,28,13,21,15,3,16,228,1183,995,1057,FALSE,0.893491124260355,2023,2023-2024
MS,2024-02-29,intra-ucfe,4,1,0,0,0,0,0,1,0,0,0,6,4,5,FALSE,0.833333333333333,2023,2023-2024
MS,2024-02-29,intra-ucx,0,0,0,0,0,0,0,0,0,0,1,1,1,1,FALSE,1,2023,2023-2024
MS,2024-02-29,intra-ui,763,61,19,11,28,13,21,14,3,16,227,1176,990,1051,FALSE,0.893707482993197,2023,2023-2024
MS,2024-03-31,inter-total,16,1,2,1,1,0,0,0,1,1,7,30,23,24,FALSE,0.8,2023,2023-2024
MS,2024-03-31,inter-ucfe,0,0,0,0,0,0,0,0,0,0,0,0,0,0,FALSE,0,2023,2023-2024
MS,2024-03-31,inter-ucx,0,0,0,0,0,0,0,0,0,0,0,0,0,0,FALSE,0,2023,2023-2024
MS,2024-03-31,inter-ui,16,1,2,1,1,0,0,0,1,1,7,30,23,24,FALSE,0.8,2023,2023-2024
MS,2024-03-31,intra-total,697,48,18,12,12,23,6,7,5,17,193,1038,890,938,FALSE,0.903660886319846,2023,2023-2024
MS,2024-03-31,intra-ucfe,3,2,2,0,0,0,0,0,0,0,1,8,4,6,FALSE,0.75,2023,2023-2024
MS,2024-03-31,intra-ucx,3,0,0,0,0,0,0,0,0,0,1,4,4,4,FALSE,1,2023,2023-2024
MS,2024-03-31,intra-ui,691,46,16,12,12,23,6,7,5,17,191,1026,882,928,FALSE,0.90448343079922,2023,2023-2024
MS,2024-04-30,inter-total,15,3,0,4,1,1,1,0,0,0,9,34,24,27,FALSE,0.794117647058824,2023,2023-2024
MS,2024-04-30,inter-ucfe,0,0,0,0,0,0,0,0,0,0,0,0,0,0,FALSE,0,2023,2023-2024
MS,2024-04-30,inter-ucx,0,0,0,0,0,0,0,0,0,0,0,0,0,0,FALSE,0,2023,2023-2024
MS,2024-04-30,inter-ui,15,3,0,4,1,1,1,0,0,0,9,34,24,27,FALSE,0.794117647058824,2023,2023-2024
MS,2024-04-30,intra-total,736,68,21,5,15,16,21,10,7,17,207,1123,943,1011,FALSE,0.90026714158504,2023,2023-2024
MS,2024-04-30,intra-ucfe,3,0,0,0,0,0,0,0,0,0,1,4,4,4,FALSE,1,2023,2023-2024
MS,2024-04-30,intra-ucx,2,0,1,0,0,0,0,0,0,0,0,3,2,2,FALSE,0.666666666666667,2023,2023-2024
MS,2024-04-30,intra-ui,731,68,20,5,15,16,21,10,7,17,206,1116,937,1005,FALSE,0.900537634408602,2023,2023-2024
MS,2024-05-31,inter-total,13,2,1,0,1,1,0,0,1,2,11,32,24,26,FALSE,0.8125,2023,2023-2024
MS,2024-05-31,inter-ucfe,0,0,0,0,0,0,0,0,0,0,0,0,0,0,FALSE,0,2023,2023-2024
MS,2024-05-31,inter-ucx,0,0,0,0,0,0,0,0,0,0,0,0,0,0,FALSE,0,2023,2023-2024
MS,2024-05-31,inter-ui,13,2,1,0,1,1,0,0,1,2,11,32,24,26,FALSE,0.8125,2023,2023-2024
MS,2024-05-31,intra-total,783,76,22,19,24,16,22,6,1,24,281,1274,1064,1140,FALSE,0.894819466248038,2023,2023-2024
MS,2024-05-31,intra-ucfe,3,0,0,0,0,0,0,0,0,1,1,5,4,4,FALSE,0.8,2023,2023-2024
MS,2024-05-31,intra-ucx,2,0,0,0,0,0,0,0,0,0,0,2,2,2,FALSE,1,2023,2023-2024
MS,2024-05-31,intra-ui,778,76,22,19,24,16,22,6,1,23,280,1267,1058,1134,FALSE,0.895027624309392,2023,2023-2024
MS,2024-06-30,inter-total,12,2,2,1,0,2,0,0,0,0,6,25,18,20,FALSE,0.8,2023,2023-2024
MS,2024-06-30,inter-ucfe,0,0,0,0,0,0,0,0,0,0,0,0,0,0,FALSE,0,2023,2023-2024
MS,2024-06-30,inter-ucx,0,0,0,0,0,0,0,0,0,0,0,0,0,0,FALSE,0,2023,2023-2024
MS,2024-06-30,inter-ui,12,2,2,1,0,2,0,0,0,0,6,25,18,20,FALSE,0.8,2023,2023-2024
MS,2024-06-30,intra-total,1383,151,34,17,25,10,8,4,6,15,367,2020,1750,1901,FALSE,0.941089108910891,2023,2023-2024
MS,2024-06-30,intra-ucfe,1,2,0,0,0,0,0,0,0,0,1,4,2,4,FALSE,1,2023,2023-2024
MS,2024-06-30,intra-ucx,3,0,0,0,0,0,0,0,0,0,0,3,3,3,FALSE,1,2023,2023-2024
MS,2024-06-30,intra-ui,1379,149,34,17,25,10,8,4,6,15,366,2013,1745,1894,FALSE,0.940884252359662,2023,2023-2024
MS,2024-07-31,inter-total,19,4,2,3,2,0,0,0,0,3,7,40,26,30,FALSE,0.75,2024,2024-2025
MS,2024-07-31,inter-ucfe,0,0,0,0,0,0,0,0,0,0,0,0,0,0,FALSE,0,2024,2024-2025
MS,2024-07-31,inter-ucx,0,0,0,0,0,0,0,0,0,0,0,0,0,0,FALSE,0,2024,2024-2025
MS,2024-07-31,inter-ui,19,4,2,3,2,0,0,0,0,3,7,40,26,30,FALSE,0.75,2024,2024-2025
MS,2024-07-31,intra-total,1699,209,111,43,36,35,14,12,8,18,274,2459,1973,2182,FALSE,0.887352582350549,2024,2024-2025
MS,2024-07-31,intra-ucfe,1,0,0,0,0,0,0,0,0,0,0,1,1,1,FALSE,1,2024,2024-2025
MS,2024-07-31,intra-ucx,2,0,0,0,0,0,0,0,0,0,0,2,2,2,FALSE,1,2024,2024-2025
MS,2024-07-31,intra-ui,1696,209,111,43,36,35,14,12,8,18,274,2456,1970,2179,FALSE,0.887214983713355,2024,2024-2025
MS,2024-08-31,inter-total,28,6,3,3,2,1,1,0,1,3,10,58,38,44,FALSE,0.758620689655172,2024,2024-2025
MS,2024-08-31,inter-ucfe,1,0,0,0,0,0,0,0,0,0,0,1,1,1,FALSE,1,2024,2024-2025
MS,2024-08-31,inter-ucx,0,0,0,0,0,0,0,0,0,0,0,0,0,0,FALSE,0,2024,2024-2025
MS,2024-08-31,inter-ui,27,6,3,3,2,1,1,0,1,3,10,57,37,43,FALSE,0.754385964912281,2024,2024-2025
MS,2024-08-31,intra-total,827,169,69,47,40,20,11,8,3,19,325,1538,1152,1321,FALSE,0.858907672301691,2024,2024-2025
MS,2024-08-31,intra-ucfe,2,1,0,1,0,1,0,0,0,1,0,6,2,3,FALSE,0.5,2024,2024-2025
MS,2024-08-31,intra-ucx,3,0,0,0,0,0,0,0,0,0,0,3,3,3,FALSE,1,2024,2024-2025
MS,2024-08-31,intra-ui,822,168,69,46,40,19,11,8,3,18,325,1529,1147,1315,FALSE,0.860039241334205,2024,2024-2025
MS,2024-09-30,inter-total,32,8,1,1,0,1,1,0,1,0,8,53,40,48,FALSE,0.905660377358491,2024,2024-2025
MS,2024-09-30,inter-ucfe,0,0,0,0,0,0,0,0,0,0,0,0,0,0,FALSE,0,2024,2024-2025
MS,2024-09-30,inter-ucx,0,0,0,0,0,0,0,0,0,0,0,0,0,0,FALSE,0,2024,2024-2025
MS,2024-09-30,inter-ui,32,8,1,1,0,1,1,0,1,0,8,53,40,48,FALSE,0.905660377358491,2024,2024-2025
MS,2024-09-30,intra-total,637,74,41,21,24,11,8,9,5,13,229,1072,866,940,FALSE,0.876865671641791,2024,2024-2025
MS,2024-09-30,intra-ucfe,0,0,0,0,0,0,0,0,0,0,1,1,1,1,FALSE,1,2024,2024-2025
MS,2024-09-30,intra-ucx,0,1,0,0,0,0,0,0,0,0,0,1,0,1,FALSE,1,2024,2024-2025
MS,2024-09-30,intra-ui,637,73,41,21,24,11,8,9,5,13,228,1070,865,938,FALSE,0.876635514018692,2024,2024-2025
MS,2024-10-31,inter-total,51,5,2,1,1,2,1,0,1,1,18,83,69,74,FALSE,0.891566265060241,2024,2024-2025
MS,2024-10-31,inter-ucfe,0,0,0,0,0,0,0,0,0,0,0,0,0,0,FALSE,0,2024,2024-2025
MS,2024-10-31,inter-ucx,0,0,0,0,0,0,0,0,0,0,0,0,0,0,FALSE,0,2024,2024-2025
MS,2024-10-31,inter-ui,51,5,2,1,1,2,1,0,1,1,18,83,69,74,FALSE,0.891566265060241,2024,2024-2025
MS,2024-10-31,intra-total,694,69,45,39,11,9,5,2,3,17,197,1091,891,960,FALSE,0.879926672777269,2024,2024-2025
MS,2024-10-31,intra-ucfe,1,2,1,1,0,0,0,0,0,0,0,5,1,3,FALSE,0.6,2024,2024-2025
MS,2024-10-31,intra-ucx,2,0,0,0,0,0,0,0,0,0,0,2,2,2,FALSE,1,2024,2024-2025
MS,2024-10-31,intra-ui,691,67,44,38,11,9,5,2,3,17,197,1084,888,955,FALSE,0.8809963099631,2024,2024-2025
MS,2024-11-30,inter-total,33,4,1,2,1,1,0,2,0,0,12,56,45,49,FALSE,0.875,2024,2024-2025
MS,2024-11-30,inter-ucfe,0,0,0,0,0,0,0,0,0,0,1,1,1,1,FALSE,1,2024,2024-2025
MS,2024-11-30,inter-ucx,0,0,0,0,0,0,0,0,0,0,0,0,0,0,FALSE,0,2024,2024-2025
MS,2024-11-30,inter-ui,33,4,1,2,1,1,0,2,0,0,11,55,44,48,FALSE,0.872727272727273,2024,2024-2025
MS,2024-11-30,intra-total,632,63,46,18,13,9,2,4,0,5,180,972,812,875,FALSE,0.900205761316873,2024,2024-2025
MS,2024-11-30,intra-ucfe,1,0,1,0,0,0,0,0,0,1,1,4,2,2,FALSE,0.5,2024,2024-2025
MS,2024-11-30,intra-ucx,1,0,0,0,0,0,0,0,0,0,0,1,1,1,FALSE,1,2024,2024-2025
MS,2024-11-30,intra-ui,630,63,45,18,13,9,2,4,0,4,179,967,809,872,FALSE,0.901758014477766,2024,2024-2025
MS,2024-12-31,inter-total,45,1,2,1,2,0,0,0,1,2,17,71,62,63,FALSE,0.887323943661972,2024,2024-2025
MS,2024-12-31,inter-ucfe,0,0,0,0,0,0,0,0,0,0,0,0,0,0,FALSE,0,2024,2024-2025
MS,2024-12-31,inter-ucx,0,0,0,0,0,0,0,0,0,0,0,0,0,0,FALSE,0,2024,2024-2025
MS,2024-12-31,inter-ui,45,1,2,1,2,0,0,0,1,2,17,71,62,63,FALSE,0.887323943661972,2024,2024-2025
MS,2024-12-31,intra-total,1048,98,47,29,17,9,1,1,0,3,257,1510,1305,1403,FALSE,0.929139072847682,2024,2024-2025
MS,2024-12-31,intra-ucfe,2,1,0,0,1,0,0,0,0,0,1,5,3,4,FALSE,0.8,2024,2024-2025
MS,2024-12-31,intra-ucx,2,0,0,0,0,0,0,0,0,0,0,2,2,2,FALSE,1,2024,2024-2025
MS,2024-12-31,intra-ui,1044,97,47,29,16,9,1,1,0,3,256,1503,1300,1397,FALSE,0.929474384564205,2024,2024-2025
MT,2019-01-31,inter-total,113,7,4,1,2,1,0,0,0,0,38,166,151,158,FALSE,0.951807228915663,2018,2018-2019
MT,2019-01-31,inter-ucfe,15,0,1,0,0,0,0,0,0,0,7,23,22,22,FALSE,0.956521739130435,2018,2018-2019
MT,2019-01-31,inter-ucx,0,1,0,0,0,0,0,0,0,0,0,1,0,1,FALSE,1,2018,2018-2019
MT,2019-01-31,inter-ui,98,6,3,1,2,1,0,0,0,0,31,142,129,135,FALSE,0.950704225352113,2018,2018-2019
MT,2019-01-31,intra-total,4272,120,37,15,7,5,1,0,0,0,748,5205,5020,5140,FALSE,0.987512007684918,2018,2018-2019
MT,2019-01-31,intra-ucfe,595,33,2,0,1,0,0,0,0,0,175,806,770,803,FALSE,0.996277915632754,2018,2018-2019
MT,2019-01-31,intra-ucx,3,0,1,0,1,0,0,0,0,0,0,5,3,3,FALSE,0.6,2018,2018-2019
MT,2019-01-31,intra-ui,3674,87,34,15,5,5,1,0,0,0,573,4394,4247,4334,FALSE,0.986345015930815,2018,2018-2019
MT,2019-02-28,inter-total,71,2,4,2,0,2,0,0,0,0,16,97,87,89,FALSE,0.917525773195876,2018,2018-2019
MT,2019-02-28,inter-ucfe,5,0,2,0,0,0,0,0,0,0,4,11,9,9,FALSE,0.818181818181818,2018,2018-2019
MT,2019-02-28,inter-ucx,0,0,0,0,0,0,0,0,0,0,0,0,0,0,FALSE,0,2018,2018-2019
MT,2019-02-28,inter-ui,66,2,2,2,0,2,0,0,0,0,12,86,78,80,FALSE,0.930232558139535,2018,2018-2019
MT,2019-02-28,intra-total,1869,122,40,22,6,2,0,0,0,0,420,2481,2289,2411,FALSE,0.971785570334542,2018,2018-2019
MT,2019-02-28,intra-ucfe,57,15,2,5,1,1,0,0,0,0,20,101,77,92,FALSE,0.910891089108911,2018,2018-2019
MT,2019-02-28,intra-ucx,3,0,0,0,0,0,0,0,0,0,1,4,4,4,FALSE,1,2018,2018-2019
MT,2019-02-28,intra-ui,1809,107,38,17,5,1,0,0,0,0,399,2376,2208,2315,FALSE,0.974326599326599,2018,2018-2019
MT,2019-03-31,inter-total,22,2,3,1,0,0,0,0,0,0,6,34,28,30,FALSE,0.882352941176471,2018,2018-2019
MT,2019-03-31,inter-ucfe,4,0,1,0,0,0,0,0,0,0,0,5,4,4,FALSE,0.8,2018,2018-2019
MT,2019-03-31,inter-ucx,0,0,0,0,0,0,0,0,0,0,0,0,0,0,FALSE,0,2018,2018-2019
MT,2019-03-31,inter-ui,18,2,2,1,0,0,0,0,0,0,6,29,24,26,FALSE,0.896551724137931,2018,2018-2019
MT,2019-03-31,intra-total,1230,55,29,10,9,5,5,2,0,6,238,1589,1468,1523,FALSE,0.958464443045941,2018,2018-2019
MT,2019-03-31,intra-ucfe,16,3,0,1,0,2,0,1,0,0,5,28,21,24,FALSE,0.857142857142857,2018,2018-2019
MT,2019-03-31,intra-ucx,1,0,0,0,0,0,0,0,0,0,2,3,3,3,FALSE,1,2018,2018-2019
MT,2019-03-31,intra-ui,1213,52,29,9,9,3,5,1,0,6,231,1558,1444,1496,FALSE,0.9602053915276,2018,2018-2019
MT,2019-04-30,inter-total,40,4,0,0,2,2,0,0,0,0,14,62,54,58,FALSE,0.935483870967742,2018,2018-2019
MT,2019-04-30,inter-ucfe,2,0,0,0,0,0,0,0,0,0,0,2,2,2,FALSE,1,2018,2018-2019
MT,2019-04-30,inter-ucx,0,0,0,0,0,0,0,0,0,0,0,0,0,0,FALSE,0,2018,2018-2019
MT,2019-04-30,inter-ui,38,4,0,0,2,2,0,0,0,0,14,60,52,56,FALSE,0.933333333333333,2018,2018-2019
MT,2019-04-30,intra-total,906,44,14,10,2,2,2,0,0,0,238,1218,1144,1188,FALSE,0.975369458128079,2018,2018-2019
MT,2019-04-30,intra-ucfe,8,2,1,2,1,0,1,0,0,0,7,22,15,17,FALSE,0.772727272727273,2018,2018-2019
MT,2019-04-30,intra-ucx,1,1,0,0,0,0,0,0,0,0,2,4,3,4,FALSE,1,2018,2018-2019
MT,2019-04-30,intra-ui,897,41,13,8,1,2,1,0,0,0,229,1192,1126,1167,FALSE,0.979026845637584,2018,2018-2019
MT,2019-05-31,inter-total,63,9,1,0,1,0,0,1,1,0,24,100,87,96,FALSE,0.96,2018,2018-2019
MT,2019-05-31,inter-ucfe,1,0,0,0,0,0,0,0,0,0,1,2,2,2,FALSE,1,2018,2018-2019
MT,2019-05-31,inter-ucx,0,0,0,0,0,0,0,0,0,0,0,0,0,0,FALSE,0,2018,2018-2019
MT,2019-05-31,inter-ui,62,9,1,0,1,0,0,1,1,0,23,98,85,94,FALSE,0.959183673469388,2018,2018-2019
MT,2019-05-31,intra-total,656,51,12,15,6,3,0,0,0,0,186,929,842,893,FALSE,0.961248654467169,2018,2018-2019
MT,2019-05-31,intra-ucfe,2,1,0,0,0,0,0,0,0,0,0,3,2,3,FALSE,1,2018,2018-2019
MT,2019-05-31,intra-ucx,3,0,0,0,0,0,0,0,0,0,1,4,4,4,FALSE,1,2018,2018-2019
MT,2019-05-31,intra-ui,651,50,12,15,6,3,0,0,0,0,185,922,836,886,FALSE,0.960954446854664,2018,2018-2019
MT,2019-06-30,inter-total,66,4,1,1,0,1,0,0,0,0,11,84,77,81,FALSE,0.964285714285714,2018,2018-2019
MT,2019-06-30,inter-ucfe,1,0,0,0,0,0,0,0,0,0,0,1,1,1,FALSE,1,2018,2018-2019
MT,2019-06-30,inter-ucx,0,0,0,0,0,0,0,0,0,0,0,0,0,0,FALSE,0,2018,2018-2019
MT,2019-06-30,inter-ui,65,4,1,1,0,1,0,0,0,0,11,83,76,80,FALSE,0.963855421686747,2018,2018-2019
MT,2019-06-30,intra-total,872,48,12,4,2,4,1,0,0,0,170,1113,1042,1090,FALSE,0.979335130278526,2018,2018-2019
MT,2019-06-30,intra-ucfe,5,2,0,1,0,0,0,0,0,0,4,12,9,11,FALSE,0.916666666666667,2018,2018-2019
MT,2019-06-30,intra-ucx,2,1,0,0,0,0,0,0,0,0,0,3,2,3,FALSE,1,2018,2018-2019
MT,2019-06-30,intra-ui,865,45,12,3,2,4,1,0,0,0,166,1098,1031,1076,FALSE,0.979963570127505,2018,2018-2019
MT,2019-07-31,inter-total,64,4,3,1,0,0,0,0,0,0,23,95,87,91,FALSE,0.957894736842105,2019,2019-2020
MT,2019-07-31,inter-ucfe,1,0,0,0,0,0,0,0,0,0,0,1,1,1,FALSE,1,2019,2019-2020
MT,2019-07-31,inter-ucx,0,0,0,0,0,0,0,0,0,0,0,0,0,0,FALSE,0,2019,2019-2020
MT,2019-07-31,inter-ui,63,4,3,1,0,0,0,0,0,0,23,94,86,90,FALSE,0.957446808510638,2019,2019-2020
MT,2019-07-31,intra-total,852,40,15,5,4,0,0,0,0,0,209,1125,1061,1101,FALSE,0.978666666666667,2019,2019-2020
MT,2019-07-31,intra-ucfe,3,0,0,0,0,0,0,0,0,0,1,4,4,4,FALSE,1,2019,2019-2020
MT,2019-07-31,intra-ucx,1,1,0,0,0,0,0,0,0,0,3,5,4,5,FALSE,1,2019,2019-2020
MT,2019-07-31,intra-ui,848,39,15,5,4,0,0,0,0,0,205,1116,1053,1092,FALSE,0.978494623655914,2019,2019-2020
MT,2019-08-31,inter-total,55,6,1,0,1,0,0,0,0,0,11,74,66,72,FALSE,0.972972972972973,2019,2019-2020
MT,2019-08-31,inter-ucfe,1,1,1,0,0,0,0,0,0,0,1,4,2,3,FALSE,0.75,2019,2019-2020
MT,2019-08-31,inter-ucx,0,0,0,0,0,0,0,0,0,0,0,0,0,0,FALSE,0,2019,2019-2020
MT,2019-08-31,inter-ui,54,5,0,0,1,0,0,0,0,0,10,70,64,69,FALSE,0.985714285714286,2019,2019-2020
MT,2019-08-31,intra-total,407,53,20,8,1,1,0,0,0,0,143,633,550,603,FALSE,0.95260663507109,2019,2019-2020
MT,2019-08-31,intra-ucfe,4,0,0,0,1,0,0,0,0,0,0,5,4,4,FALSE,0.8,2019,2019-2020
MT,2019-08-31,intra-ucx,0,0,0,0,0,0,0,0,0,0,0,0,0,0,FALSE,0,2019,2019-2020
MT,2019-08-31,intra-ui,403,53,20,8,0,1,0,0,0,0,143,628,546,599,FALSE,0.953821656050955,2019,2019-2020
MT,2019-09-30,inter-total,33,0,1,0,1,0,0,0,0,0,9,44,42,42,FALSE,0.954545454545455,2019,2019-2020
MT,2019-09-30,inter-ucfe,0,0,0,0,0,0,0,0,0,0,0,0,0,0,FALSE,0,2019,2019-2020
MT,2019-09-30,inter-ucx,0,0,0,0,0,0,0,0,0,0,0,0,0,0,FALSE,0,2019,2019-2020
MT,2019-09-30,inter-ui,33,0,1,0,1,0,0,0,0,0,9,44,42,42,FALSE,0.954545454545455,2019,2019-2020
MT,2019-09-30,intra-total,349,31,15,5,1,0,1,0,0,0,122,524,471,502,FALSE,0.958015267175572,2019,2019-2020
MT,2019-09-30,intra-ucfe,0,0,1,1,0,0,0,0,0,0,0,2,0,0,FALSE,0,2019,2019-2020
MT,2019-09-30,intra-ucx,2,0,0,0,0,0,0,0,0,0,0,2,2,2,FALSE,1,2019,2019-2020
MT,2019-09-30,intra-ui,347,31,14,4,1,0,1,0,0,0,122,520,469,500,FALSE,0.961538461538461,2019,2019-2020
MT,2019-10-31,inter-total,60,0,2,1,0,0,0,0,0,0,10,73,70,70,FALSE,0.958904109589041,2019,2019-2020
MT,2019-10-31,inter-ucfe,9,0,0,0,0,0,0,0,0,0,1,10,10,10,FALSE,1,2019,2019-2020
MT,2019-10-31,inter-ucx,0,0,0,0,0,0,0,0,0,0,0,0,0,0,FALSE,0,2019,2019-2020
MT,2019-10-31,inter-ui,51,0,2,1,0,0,0,0,0,0,9,63,60,60,FALSE,0.952380952380952,2019,2019-2020
MT,2019-10-31,intra-total,855,32,10,6,3,0,0,0,0,8,155,1069,1010,1042,FALSE,0.974742750233863,2019,2019-2020
MT,2019-10-31,intra-ucfe,18,1,0,0,0,0,0,0,0,0,3,22,21,22,FALSE,1,2019,2019-2020
MT,2019-10-31,intra-ucx,6,0,0,0,0,0,0,0,0,0,2,8,8,8,FALSE,1,2019,2019-2020
MT,2019-10-31,intra-ui,831,31,10,6,3,0,0,0,0,8,150,1039,981,1012,FALSE,0.974013474494706,2019,2019-2020
MT,2019-11-30,inter-total,72,2,1,3,0,0,0,0,0,0,9,87,81,83,FALSE,0.954022988505747,2019,2019-2020
MT,2019-11-30,inter-ucfe,13,0,1,0,0,0,0,0,0,0,4,18,17,17,FALSE,0.944444444444444,2019,2019-2020
MT,2019-11-30,inter-ucx,0,0,0,0,0,0,0,0,0,0,0,0,0,0,FALSE,0,2019,2019-2020
MT,2019-11-30,inter-ui,59,2,0,3,0,0,0,0,0,0,5,69,64,66,FALSE,0.956521739130435,2019,2019-2020
MT,2019-11-30,intra-total,1528,45,23,6,1,0,1,0,0,9,202,1815,1730,1775,FALSE,0.977961432506887,2019,2019-2020
MT,2019-11-30,intra-ucfe,90,0,2,0,0,0,0,0,0,0,17,109,107,107,FALSE,0.981651376146789,2019,2019-2020
MT,2019-11-30,intra-ucx,1,0,0,0,0,0,0,0,0,0,1,2,2,2,FALSE,1,2019,2019-2020
MT,2019-11-30,intra-ui,1437,45,21,6,1,0,1,0,0,9,184,1704,1621,1666,FALSE,0.977699530516432,2019,2019-2020
MT,2019-12-31,inter-total,145,7,8,2,3,2,0,0,0,0,24,191,169,176,FALSE,0.921465968586387,2019,2019-2020
MT,2019-12-31,inter-ucfe,12,1,2,0,0,0,0,0,0,0,6,21,18,19,FALSE,0.904761904761905,2019,2019-2020
MT,2019-12-31,inter-ucx,0,0,0,0,0,0,0,0,0,0,0,0,0,0,FALSE,0,2019,2019-2020
MT,2019-12-31,inter-ui,133,6,6,2,3,2,0,0,0,0,18,170,151,157,FALSE,0.923529411764706,2019,2019-2020
MT,2019-12-31,intra-total,2936,98,23,6,2,2,0,0,1,0,463,3531,3399,3497,FALSE,0.990370999716794,2019,2019-2020
MT,2019-12-31,intra-ucfe,127,10,1,0,1,0,0,0,0,0,45,184,172,182,FALSE,0.989130434782609,2019,2019-2020
MT,2019-12-31,intra-ucx,2,0,0,0,0,0,0,0,0,0,1,3,3,3,FALSE,1,2019,2019-2020
MT,2019-12-31,intra-ui,2807,88,22,6,1,2,0,0,1,0,417,3344,3224,3312,FALSE,0.990430622009569,2019,2019-2020
MT,2020-01-31,inter-total,146,4,6,5,0,0,0,0,0,0,38,199,184,188,FALSE,0.944723618090452,2019,2019-2020
MT,2020-01-31,inter-ucfe,17,1,0,0,0,0,0,0,0,0,6,24,23,24,FALSE,1,2019,2019-2020
MT,2020-01-31,inter-ucx,0,0,0,0,0,0,0,0,0,0,0,0,0,0,FALSE,0,2019,2019-2020
MT,2020-01-31,inter-ui,129,3,6,5,0,0,0,0,0,0,32,175,161,164,FALSE,0.937142857142857,2019,2019-2020
MT,2020-01-31,intra-total,3336,85,23,14,9,4,0,0,0,0,596,4067,3932,4017,FALSE,0.987705925743791,2019,2019-2020
MT,2020-01-31,intra-ucfe,221,9,4,2,1,0,0,0,0,0,37,274,258,267,FALSE,0.974452554744525,2019,2019-2020
MT,2020-01-31,intra-ucx,4,0,0,0,0,0,0,0,0,0,0,4,4,4,FALSE,1,2019,2019-2020
MT,2020-01-31,intra-ui,3111,76,19,12,8,4,0,0,0,0,559,3789,3670,3746,FALSE,0.988651359197677,2019,2019-2020
MT,2020-02-29,inter-total,76,5,4,0,1,0,0,0,0,1,23,110,99,104,FALSE,0.945454545454546,2019,2019-2020
MT,2020-02-29,inter-ucfe,12,1,1,0,0,0,0,0,0,1,5,20,17,18,FALSE,0.9,2019,2019-2020
MT,2020-02-29,inter-ucx,0,0,0,0,0,0,0,0,0,0,0,0,0,0,FALSE,0,2019,2019-2020
MT,2020-02-29,inter-ui,64,4,3,0,1,0,0,0,0,0,18,90,82,86,FALSE,0.955555555555556,2019,2019-2020
MT,2020-02-29,intra-total,1542,108,22,12,11,3,0,0,0,0,349,2047,1891,1999,FALSE,0.976551050317538,2019,2019-2020
MT,2020-02-29,intra-ucfe,62,6,2,1,2,0,0,0,0,0,16,89,78,84,FALSE,0.943820224719101,2019,2019-2020
MT,2020-02-29,intra-ucx,1,0,0,0,0,0,0,0,0,0,1,2,2,2,FALSE,1,2019,2019-2020
MT,2020-02-29,intra-ui,1479,102,20,11,9,3,0,0,0,0,332,1956,1811,1913,FALSE,0.978016359918201,2019,2019-2020
MT,2020-03-31,inter-total,85,6,1,1,0,0,0,2,0,0,11,106,96,102,FALSE,0.962264150943396,2019,2019-2020
MT,2020-03-31,inter-ucfe,6,1,0,1,0,0,0,0,0,0,0,8,6,7,FALSE,0.875,2019,2019-2020
MT,2020-03-31,inter-ucx,0,0,0,0,0,0,0,0,0,0,0,0,0,0,FALSE,0,2019,2019-2020
MT,2020-03-31,inter-ui,79,5,1,0,0,0,0,2,0,0,11,98,90,95,FALSE,0.969387755102041,2019,2019-2020
MT,2020-03-31,intra-total,1260,40,22,7,4,1,0,1,0,0,281,1616,1541,1581,FALSE,0.978341584158416,2019,2019-2020
MT,2020-03-31,intra-ucfe,18,0,1,0,1,0,0,0,0,0,7,27,25,25,FALSE,0.925925925925926,2019,2019-2020
MT,2020-03-31,intra-ucx,1,0,0,0,0,0,0,0,0,0,0,1,1,1,FALSE,1,2019,2019-2020
MT,2020-03-31,intra-ui,1241,40,21,7,3,1,0,1,0,0,274,1588,1515,1555,FALSE,0.979219143576826,2019,2019-2020
MT,2020-04-30,inter-total,26,11,3,3,0,0,0,0,0,0,9,52,35,46,FALSE,0.884615384615385,2019,2019-2020
MT,2020-04-30,inter-ucfe,0,0,0,0,0,0,0,0,0,0,1,1,1,1,FALSE,1,2019,2019-2020
MT,2020-04-30,inter-ucx,0,0,0,0,0,0,0,0,0,0,0,0,0,0,FALSE,0,2019,2019-2020
MT,2020-04-30,inter-ui,26,11,3,3,0,0,0,0,0,0,8,51,34,45,FALSE,0.882352941176471,2019,2019-2020
MT,2020-04-30,intra-total,685,146,66,26,1,2,0,0,0,0,331,1257,1016,1162,FALSE,0.92442322991249,2019,2019-2020
MT,2020-04-30,intra-ucfe,6,1,0,0,0,0,0,0,0,0,4,11,10,11,FALSE,1,2019,2019-2020
MT,2020-04-30,intra-ucx,1,1,0,0,0,1,0,0,0,0,0,3,1,2,FALSE,0.666666666666667,2019,2019-2020
MT,2020-04-30,intra-ui,678,144,66,26,1,1,0,0,0,0,327,1243,1005,1149,FALSE,0.924376508447305,2019,2019-2020
MT,2020-05-31,inter-total,16,1,4,1,1,1,0,0,0,0,5,29,21,22,FALSE,0.758620689655172,2019,2019-2020
MT,2020-05-31,inter-ucfe,1,0,0,0,0,0,0,0,0,0,0,1,1,1,FALSE,1,2019,2019-2020
MT,2020-05-31,inter-ucx,0,0,0,0,0,0,0,0,0,0,0,0,0,0,FALSE,0,2019,2019-2020
MT,2020-05-31,inter-ui,15,1,4,1,1,1,0,0,0,0,5,28,20,21,FALSE,0.75,2019,2019-2020
MT,2020-05-31,intra-total,270,76,44,38,35,12,6,1,1,0,124,607,394,470,FALSE,0.774299835255354,2019,2019-2020
MT,2020-05-31,intra-ucfe,3,0,0,0,0,1,0,0,0,0,0,4,3,3,FALSE,0.75,2019,2019-2020
MT,2020-05-31,intra-ucx,1,0,1,0,0,0,0,0,0,0,0,2,1,1,FALSE,0.5,2019,2019-2020
MT,2020-05-31,intra-ui,266,76,43,38,35,11,6,1,1,0,124,601,390,466,FALSE,0.775374376039934,2019,2019-2020
MT,2020-06-30,inter-total,12,1,2,2,2,1,0,0,0,0,5,25,17,18,FALSE,0.72,2019,2019-2020
MT,2020-06-30,inter-ucfe,0,0,0,0,0,0,0,0,0,0,0,0,0,0,FALSE,0,2019,2019-2020
MT,2020-06-30,inter-ucx,0,0,0,0,0,0,0,0,0,0,0,0,0,0,FALSE,0,2019,2019-2020
MT,2020-06-30,inter-ui,12,1,2,2,2,1,0,0,0,0,5,25,17,18,FALSE,0.72,2019,2019-2020
MT,2020-06-30,intra-total,440,52,29,15,19,10,2,3,3,10,130,713,570,622,FALSE,0.872370266479664,2019,2019-2020
MT,2020-06-30,intra-ucfe,1,0,0,0,0,1,0,0,0,0,0,2,1,1,FALSE,0.5,2019,2019-2020
MT,2020-06-30,intra-ucx,4,1,1,0,0,0,0,0,0,0,1,7,5,6,FALSE,0.857142857142857,2019,2019-2020
MT,2020-06-30,intra-ui,435,51,28,15,19,9,2,3,3,10,129,704,564,615,FALSE,0.873579545454545,2019,2019-2020
MT,2020-07-31,inter-total,9,5,0,0,3,0,0,0,0,0,5,22,14,19,FALSE,0.863636363636364,2020,2020-2021
MT,2020-07-31,inter-ucfe,0,0,0,0,0,0,0,0,0,0,0,0,0,0,FALSE,0,2020,2020-2021
MT,2020-07-31,inter-ucx,0,0,0,0,0,0,0,0,0,0,0,0,0,0,FALSE,0,2020,2020-2021
MT,2020-07-31,inter-ui,9,5,0,0,3,0,0,0,0,0,5,22,14,19,FALSE,0.863636363636364,2020,2020-2021
MT,2020-07-31,intra-total,399,44,25,16,14,8,1,1,1,2,110,621,509,553,FALSE,0.890499194847021,2020,2020-2021
MT,2020-07-31,intra-ucfe,4,1,0,0,0,0,0,0,0,0,0,5,4,5,FALSE,1,2020,2020-2021
MT,2020-07-31,intra-ucx,1,2,0,1,0,0,0,0,0,0,1,5,2,4,FALSE,0.8,2020,2020-2021
MT,2020-07-31,intra-ui,394,41,25,15,14,8,1,1,1,2,109,611,503,544,FALSE,0.890343698854337,2020,2020-2021
MT,2020-08-31,inter-total,25,2,4,1,1,3,0,0,0,0,9,45,34,36,FALSE,0.8,2020,2020-2021
MT,2020-08-31,inter-ucfe,0,0,0,0,0,0,0,0,0,0,0,0,0,0,FALSE,0,2020,2020-2021
MT,2020-08-31,inter-ucx,0,0,0,0,0,0,0,0,0,0,0,0,0,0,FALSE,0,2020,2020-2021
MT,2020-08-31,inter-ui,25,2,4,1,1,3,0,0,0,0,9,45,34,36,FALSE,0.8,2020,2020-2021
MT,2020-08-31,intra-total,487,105,58,54,74,70,1,0,0,5,230,1084,717,822,FALSE,0.75830258302583,2020,2020-2021
MT,2020-08-31,intra-ucfe,2,0,0,1,0,0,0,0,0,0,0,3,2,2,FALSE,0.666666666666667,2020,2020-2021
MT,2020-08-31,intra-ucx,1,0,0,0,0,0,0,0,0,0,1,2,2,2,FALSE,1,2020,2020-2021
MT,2020-08-31,intra-ui,484,105,58,53,74,70,1,0,0,5,229,1079,713,818,FALSE,0.758109360518999,2020,2020-2021
MT,2020-09-30,inter-total,13,1,0,0,2,3,0,0,0,0,7,26,20,21,FALSE,0.807692307692308,2020,2020-2021
MT,2020-09-30,inter-ucfe,0,0,0,0,0,0,0,0,0,0,0,0,0,0,FALSE,0,2020,2020-2021
MT,2020-09-30,inter-ucx,0,0,0,0,0,0,0,0,0,0,0,0,0,0,FALSE,0,2020,2020-2021
MT,2020-09-30,inter-ui,13,1,0,0,2,3,0,0,0,0,7,26,20,21,FALSE,0.807692307692308,2020,2020-2021
MT,2020-09-30,intra-total,171,31,21,13,12,9,4,0,1,7,69,338,240,271,FALSE,0.801775147928994,2020,2020-2021
MT,2020-09-30,intra-ucfe,2,0,0,0,0,0,0,0,0,0,0,2,2,2,FALSE,1,2020,2020-2021
MT,2020-09-30,intra-ucx,2,0,0,0,0,0,0,0,0,0,1,3,3,3,FALSE,1,2020,2020-2021
MT,2020-09-30,intra-ui,167,31,21,13,12,9,4,0,1,7,68,333,235,266,FALSE,0.798798798798799,2020,2020-2021
MT,2020-10-31,inter-total,16,3,2,2,2,0,0,0,0,0,4,29,20,23,FALSE,0.793103448275862,2020,2020-2021
MT,2020-10-31,inter-ucfe,0,0,0,0,0,0,0,0,0,0,0,0,0,0,FALSE,0,2020,2020-2021
MT,2020-10-31,inter-ucx,0,0,0,0,0,0,0,0,0,0,0,0,0,0,FALSE,0,2020,2020-2021
MT,2020-10-31,inter-ui,16,3,2,2,2,0,0,0,0,0,4,29,20,23,FALSE,0.793103448275862,2020,2020-2021
MT,2020-10-31,intra-total,177,27,11,9,13,15,1,0,1,0,63,317,240,267,FALSE,0.842271293375394,2020,2020-2021
MT,2020-10-31,intra-ucfe,0,0,0,0,0,1,1,0,0,0,1,3,1,1,FALSE,0.333333333333333,2020,2020-2021
MT,2020-10-31,intra-ucx,1,0,0,0,0,1,0,0,0,0,0,2,1,1,FALSE,0.5,2020,2020-2021
MT,2020-10-31,intra-ui,176,27,11,9,13,13,0,0,1,0,62,312,238,265,FALSE,0.849358974358974,2020,2020-2021
MT,2020-11-30,inter-total,21,14,5,6,0,4,1,0,0,2,14,67,35,49,FALSE,0.73134328358209,2020,2020-2021
MT,2020-11-30,inter-ucfe,0,1,1,0,0,0,0,0,0,0,3,5,3,4,FALSE,0.8,2020,2020-2021
MT,2020-11-30,inter-ucx,0,0,0,0,0,0,0,0,0,0,0,0,0,0,FALSE,0,2020,2020-2021
MT,2020-11-30,inter-ui,21,13,4,6,0,4,1,0,0,2,11,62,32,45,FALSE,0.725806451612903,2020,2020-2021
MT,2020-11-30,intra-total,483,91,59,28,11,17,1,0,0,4,194,888,677,768,FALSE,0.864864864864865,2020,2020-2021
MT,2020-11-30,intra-ucfe,7,2,5,1,1,0,0,0,0,0,3,19,10,12,FALSE,0.631578947368421,2020,2020-2021
MT,2020-11-30,intra-ucx,0,1,1,1,0,0,0,0,0,0,1,4,1,2,FALSE,0.5,2020,2020-2021
MT,2020-11-30,intra-ui,476,88,53,26,10,17,1,0,0,4,190,865,666,754,FALSE,0.871676300578035,2020,2020-2021
MT,2020-12-31,inter-total,48,14,5,10,3,2,0,1,0,0,28,111,76,90,FALSE,0.810810810810811,2020,2020-2021
MT,2020-12-31,inter-ucfe,5,2,1,1,0,0,0,0,0,0,4,13,9,11,FALSE,0.846153846153846,2020,2020-2021
MT,2020-12-31,inter-ucx,0,0,0,0,0,0,0,0,0,0,0,0,0,0,FALSE,0,2020,2020-2021
MT,2020-12-31,inter-ui,43,12,4,9,3,2,0,1,0,0,24,98,67,79,FALSE,0.806122448979592,2020,2020-2021
MT,2020-12-31,intra-total,1232,153,78,77,55,22,7,1,1,4,392,2022,1624,1777,FALSE,0.878832838773492,2020,2020-2021
MT,2020-12-31,intra-ucfe,50,8,6,8,5,4,1,1,1,1,23,108,73,81,FALSE,0.75,2020,2020-2021
MT,2020-12-31,intra-ucx,2,0,0,0,0,0,0,0,0,0,0,2,2,2,FALSE,1,2020,2020-2021
MT,2020-12-31,intra-ui,1180,145,72,69,50,18,6,0,0,3,369,1912,1549,1694,FALSE,0.885983263598326,2020,2020-2021
MT,2021-01-31,inter-total,53,9,2,1,3,2,1,0,2,2,16,91,69,78,FALSE,0.857142857142857,2020,2020-2021
MT,2021-01-31,inter-ucfe,8,0,0,0,0,1,0,0,1,1,5,16,13,13,FALSE,0.8125,2020,2020-2021
MT,2021-01-31,inter-ucx,0,0,0,0,0,0,0,0,0,0,0,0,0,0,FALSE,0,2020,2020-2021
MT,2021-01-31,inter-ui,45,9,2,1,3,1,1,0,1,1,11,75,56,65,FALSE,0.866666666666667,2020,2020-2021
MT,2021-01-31,intra-total,1595,159,72,50,35,29,8,2,1,3,453,2407,2048,2207,FALSE,0.916909015371832,2020,2020-2021
MT,2021-01-31,intra-ucfe,116,13,11,5,5,0,0,2,1,0,46,199,162,175,FALSE,0.879396984924623,2020,2020-2021
MT,2021-01-31,intra-ucx,1,0,1,0,0,1,0,0,0,0,0,3,1,1,FALSE,0.333333333333333,2020,2020-2021
MT,2021-01-31,intra-ui,1478,146,60,45,30,28,8,0,0,3,407,2205,1885,2031,FALSE,0.92108843537415,2020,2020-2021
MT,2021-02-28,inter-total,26,8,4,3,4,4,0,1,1,3,16,70,42,50,FALSE,0.714285714285714,2020,2020-2021
MT,2021-02-28,inter-ucfe,1,2,1,0,1,0,0,0,1,1,1,8,2,4,FALSE,0.5,2020,2020-2021
MT,2021-02-28,inter-ucx,0,0,0,0,0,0,0,0,0,0,0,0,0,0,FALSE,0,2020,2020-2021
MT,2021-02-28,inter-ui,25,6,3,3,3,4,0,1,0,2,15,62,40,46,FALSE,0.741935483870968,2020,2020-2021
MT,2021-02-28,intra-total,1043,142,102,65,56,29,4,5,2,20,274,1742,1317,1459,FALSE,0.837543053960964,2020,2020-2021
MT,2021-02-28,intra-ucfe,28,13,18,11,6,9,2,3,1,11,11,113,39,52,FALSE,0.460176991150443,2020,2020-2021
MT,2021-02-28,intra-ucx,0,0,0,0,0,0,0,0,0,1,0,1,0,0,FALSE,0,2020,2020-2021
MT,2021-02-28,intra-ui,1015,129,84,54,50,20,2,2,1,8,263,1628,1278,1407,FALSE,0.864250614250614,2020,2020-2021
MT,2021-03-31,inter-total,29,4,2,2,2,1,1,1,0,3,9,54,38,42,FALSE,0.777777777777778,2020,2020-2021
MT,2021-03-31,inter-ucfe,3,0,1,0,0,0,0,1,0,1,0,6,3,3,FALSE,0.5,2020,2020-2021
MT,2021-03-31,inter-ucx,0,0,0,0,0,0,0,0,0,0,0,0,0,0,FALSE,0,2020,2020-2021
MT,2021-03-31,inter-ui,26,4,1,2,2,1,1,0,0,2,9,48,35,39,FALSE,0.8125,2020,2020-2021
MT,2021-03-31,intra-total,887,97,53,50,38,39,11,6,4,30,208,1423,1095,1192,FALSE,0.837666900913563,2020,2020-2021
MT,2021-03-31,intra-ucfe,7,2,11,8,3,9,4,1,0,17,1,63,8,10,FALSE,0.158730158730159,2020,2020-2021
MT,2021-03-31,intra-ucx,2,0,0,1,0,0,0,0,0,0,0,3,2,2,FALSE,0.666666666666667,2020,2020-2021
MT,2021-03-31,intra-ui,878,95,42,41,35,30,7,5,4,13,207,1357,1085,1180,FALSE,0.869565217391304,2020,2020-2021
MT,2021-04-30,inter-total,35,12,1,2,2,4,0,1,0,0,8,65,43,55,FALSE,0.846153846153846,2020,2020-2021
MT,2021-04-30,inter-ucfe,1,1,0,1,0,0,0,0,0,0,1,4,2,3,FALSE,0.75,2020,2020-2021
MT,2021-04-30,inter-ucx,0,0,0,0,0,0,0,0,0,0,0,0,0,0,FALSE,0,2020,2020-2021
MT,2021-04-30,inter-ui,34,11,1,1,2,4,0,1,0,0,7,61,41,52,FALSE,0.852459016393443,2020,2020-2021
MT,2021-04-30,intra-total,1436,198,79,31,12,14,8,5,5,26,414,2228,1850,2048,FALSE,0.919210053859964,2020,2020-2021
MT,2021-04-30,intra-ucfe,5,0,2,2,3,3,1,2,2,12,5,37,10,10,FALSE,0.27027027027027,2020,2020-2021
MT,2021-04-30,intra-ucx,1,0,0,0,0,0,0,0,0,0,0,1,1,1,FALSE,1,2020,2020-2021
MT,2021-04-30,intra-ui,1430,198,77,29,9,11,7,3,3,14,409,2190,1839,2037,FALSE,0.93013698630137,2020,2020-2021
MT,2021-05-31,inter-total,35,11,1,3,1,1,0,0,1,6,14,73,49,60,FALSE,0.821917808219178,2020,2020-2021
MT,2021-05-31,inter-ucfe,0,2,0,0,0,0,0,0,0,1,0,3,0,2,FALSE,0.666666666666667,2020,2020-2021
MT,2021-05-31,inter-ucx,0,0,0,0,0,0,0,0,0,0,0,0,0,0,FALSE,0,2020,2020-2021
MT,2021-05-31,inter-ui,35,9,1,3,1,1,0,0,1,5,14,70,49,58,FALSE,0.828571428571429,2020,2020-2021
MT,2021-05-31,intra-total,678,151,87,89,67,38,14,8,2,75,235,1444,913,1064,FALSE,0.736842105263158,2020,2020-2021
MT,2021-05-31,intra-ucfe,1,0,3,3,0,0,1,0,1,7,0,16,1,1,FALSE,0.0625,2020,2020-2021
MT,2021-05-31,intra-ucx,2,0,0,1,0,0,0,0,0,1,0,4,2,2,FALSE,0.5,2020,2020-2021
MT,2021-05-31,intra-ui,675,151,84,85,67,38,13,8,1,67,235,1424,910,1061,FALSE,0.745084269662921,2020,2020-2021
MT,2021-06-30,inter-total,16,4,7,3,4,5,2,0,0,3,9,53,25,29,FALSE,0.547169811320755,2020,2020-2021
MT,2021-06-30,inter-ucfe,0,0,0,0,0,0,0,0,0,0,0,0,0,0,FALSE,0,2020,2020-2021
MT,2021-06-30,inter-ucx,0,0,0,0,0,0,0,0,0,0,0,0,0,0,FALSE,0,2020,2020-2021
MT,2021-06-30,inter-ui,16,4,7,3,4,5,2,0,0,3,9,53,25,29,FALSE,0.547169811320755,2020,2020-2021
MT,2021-06-30,intra-total,608,97,57,41,34,28,14,21,11,42,220,1173,828,925,FALSE,0.788576300085252,2020,2020-2021
MT,2021-06-30,intra-ucfe,2,0,1,1,0,1,0,0,0,2,0,7,2,2,FALSE,0.285714285714286,2020,2020-2021
MT,2021-06-30,intra-ucx,1,0,0,0,0,0,0,0,0,0,0,1,1,1,FALSE,1,2020,2020-2021
MT,2021-06-30,intra-ui,605,97,56,40,34,27,14,21,11,40,220,1165,825,922,FALSE,0.791416309012876,2020,2020-2021
MT,2021-07-31,inter-total,15,2,6,2,1,1,1,0,2,4,6,40,21,23,FALSE,0.575,2021,2021-2022
MT,2021-07-31,inter-ucfe,0,0,0,0,0,0,0,0,0,0,0,0,0,0,FALSE,0,2021,2021-2022
MT,2021-07-31,inter-ucx,0,0,0,0,0,0,0,0,0,0,0,0,0,0,FALSE,0,2021,2021-2022
MT,2021-07-31,inter-ui,15,2,6,2,1,1,1,0,2,4,6,40,21,23,FALSE,0.575,2021,2021-2022
MT,2021-07-31,intra-total,399,89,65,45,27,14,13,5,2,40,165,864,564,653,FALSE,0.755787037037037,2021,2021-2022
MT,2021-07-31,intra-ucfe,5,1,0,0,1,0,1,0,0,3,1,12,6,7,FALSE,0.583333333333333,2021,2021-2022
MT,2021-07-31,intra-ucx,2,0,0,0,0,0,0,0,0,0,0,2,2,2,FALSE,1,2021,2021-2022
MT,2021-07-31,intra-ui,392,88,65,45,26,14,12,5,2,37,164,850,556,644,FALSE,0.75764705882353,2021,2021-2022
MT,2021-08-31,inter-total,4,7,3,1,1,2,2,0,1,1,7,29,11,18,FALSE,0.620689655172414,2021,2021-2022
MT,2021-08-31,inter-ucfe,0,0,0,0,0,0,0,0,0,0,0,0,0,0,FALSE,0,2021,2021-2022
MT,2021-08-31,inter-ucx,0,0,0,0,0,0,0,0,0,0,0,0,0,0,FALSE,0,2021,2021-2022
MT,2021-08-31,inter-ui,4,7,3,1,1,2,2,0,1,1,7,29,11,18,FALSE,0.620689655172414,2021,2021-2022
MT,2021-08-31,intra-total,226,67,60,39,22,23,12,4,6,41,119,619,345,412,FALSE,0.665589660743134,2021,2021-2022
MT,2021-08-31,intra-ucfe,4,0,0,0,0,1,1,0,0,3,0,9,4,4,FALSE,0.444444444444444,2021,2021-2022
MT,2021-08-31,intra-ucx,0,0,1,0,0,0,0,0,0,0,0,1,0,0,FALSE,0,2021,2021-2022
MT,2021-08-31,intra-ui,222,67,59,39,22,22,11,4,6,38,119,609,341,408,FALSE,0.669950738916256,2021,2021-2022
MT,2021-09-30,inter-total,0,0,0,0,0,0,0,0,0,0,0,0,0,0,FALSE,0,2021,2021-2022
MT,2021-09-30,inter-ucfe,0,0,0,0,0,0,0,0,0,0,0,0,0,0,FALSE,0,2021,2021-2022
MT,2021-09-30,inter-ucx,0,0,0,0,0,0,0,0,0,0,0,0,0,0,FALSE,0,2021,2021-2022
MT,2021-09-30,inter-ui,0,0,0,0,0,0,0,0,0,0,0,0,0,0,FALSE,0,2021,2021-2022
MT,2021-09-30,intra-total,30,8,2,2,3,0,0,0,0,2,13,60,43,51,FALSE,0.85,2021,2021-2022
MT,2021-09-30,intra-ucfe,0,0,0,0,0,0,0,0,0,0,0,0,0,0,FALSE,0,2021,2021-2022
MT,2021-09-30,intra-ucx,0,0,0,0,0,0,0,0,0,0,0,0,0,0,FALSE,0,2021,2021-2022
MT,2021-09-30,intra-ui,30,8,2,2,3,0,0,0,0,2,13,60,43,51,FALSE,0.85,2021,2021-2022
MT,2021-10-31,inter-total,39,8,1,3,2,3,1,0,0,7,9,73,48,56,FALSE,0.767123287671233,2021,2021-2022
MT,2021-10-31,inter-ucfe,2,0,0,0,0,0,0,0,0,1,1,4,3,3,FALSE,0.75,2021,2021-2022
MT,2021-10-31,inter-ucx,0,0,0,0,0,0,0,0,0,1,0,1,0,0,FALSE,0,2021,2021-2022
MT,2021-10-31,inter-ui,37,8,1,3,2,3,1,0,0,5,8,68,45,53,FALSE,0.779411764705882,2021,2021-2022
MT,2021-10-31,intra-total,314,32,23,14,4,1,1,1,0,9,113,512,427,459,FALSE,0.896484375,2021,2021-2022
MT,2021-10-31,intra-ucfe,5,1,0,0,0,0,0,0,0,1,2,9,7,8,FALSE,0.888888888888889,2021,2021-2022
MT,2021-10-31,intra-ucx,0,0,0,0,0,0,0,0,0,0,1,1,1,1,FALSE,1,2021,2021-2022
MT,2021-10-31,intra-ui,309,31,23,14,4,1,1,1,0,8,110,502,419,450,FALSE,0.896414342629482,2021,2021-2022
MT,2021-11-30,inter-total,58,16,6,2,2,2,1,0,0,0,24,111,82,98,FALSE,0.882882882882883,2021,2021-2022
MT,2021-11-30,inter-ucfe,7,4,2,1,1,0,0,0,0,0,5,20,12,16,FALSE,0.8,2021,2021-2022
MT,2021-11-30,inter-ucx,0,0,0,0,0,0,0,0,0,0,0,0,0,0,FALSE,0,2021,2021-2022
MT,2021-11-30,inter-ui,51,12,4,1,1,2,1,0,0,0,19,91,70,82,FALSE,0.901098901098901,2021,2021-2022
MT,2021-11-30,intra-total,910,101,46,24,8,2,1,2,1,10,238,1343,1148,1249,FALSE,0.930007446016381,2021,2021-2022
MT,2021-11-30,intra-ucfe,47,11,2,0,1,0,0,0,0,4,15,80,62,73,FALSE,0.9125,2021,2021-2022
MT,2021-11-30,intra-ucx,1,0,0,0,0,0,0,0,0,0,1,2,2,2,FALSE,1,2021,2021-2022
MT,2021-11-30,intra-ui,862,90,44,24,7,2,1,2,1,6,222,1261,1084,1174,FALSE,0.931007137192704,2021,2021-2022
MT,2021-12-31,inter-total,90,8,2,6,5,1,0,0,0,1,23,136,113,121,FALSE,0.889705882352941,2021,2021-2022
MT,2021-12-31,inter-ucfe,11,2,0,1,1,0,0,0,0,0,6,21,17,19,FALSE,0.904761904761905,2021,2021-2022
MT,2021-12-31,inter-ucx,0,1,0,0,0,0,0,0,0,0,0,1,0,1,FALSE,1,2021,2021-2022
MT,2021-12-31,inter-ui,79,5,2,5,4,1,0,0,0,1,17,114,96,101,FALSE,0.885964912280702,2021,2021-2022
MT,2021-12-31,intra-total,1671,156,84,37,24,17,4,1,0,9,365,2368,2036,2192,FALSE,0.925675675675676,2021,2021-2022
MT,2021-12-31,intra-ucfe,107,23,16,5,0,2,0,0,0,2,35,190,142,165,FALSE,0.868421052631579,2021,2021-2022
MT,2021-12-31,intra-ucx,2,0,1,0,0,0,0,0,0,0,1,4,3,3,FALSE,0.75,2021,2021-2022
MT,2021-12-31,intra-ui,1562,133,67,32,24,15,4,1,0,7,329,2174,1891,2024,FALSE,0.931002759889605,2021,2021-2022
MT,2022-01-31,inter-total,90,12,10,4,0,2,0,2,1,0,31,152,121,133,FALSE,0.875,2021,2021-2022
MT,2022-01-31,inter-ucfe,12,1,2,0,0,0,0,0,0,0,8,23,20,21,FALSE,0.91304347826087,2021,2021-2022
MT,2022-01-31,inter-ucx,0,0,0,0,0,0,0,0,0,0,0,0,0,0,FALSE,0,2021,2021-2022
MT,2022-01-31,inter-ui,78,11,8,4,0,2,0,2,1,0,23,129,101,112,FALSE,0.868217054263566,2021,2021-2022
MT,2022-01-31,intra-total,2314,197,81,61,51,18,13,4,1,11,581,3332,2895,3092,FALSE,0.92797118847539,2021,2021-2022
MT,2022-01-31,intra-ucfe,82,11,8,3,2,2,3,0,0,2,68,181,150,161,FALSE,0.889502762430939,2021,2021-2022
MT,2022-01-31,intra-ucx,0,1,0,1,0,0,0,0,0,0,2,4,2,3,FALSE,0.75,2021,2021-2022
MT,2022-01-31,intra-ui,2232,185,73,57,49,16,10,4,1,9,511,3147,2743,2928,FALSE,0.930409914204004,2021,2021-2022
MT,2022-02-28,inter-total,36,14,9,5,4,1,0,0,0,2,15,86,51,65,FALSE,0.755813953488372,2021,2021-2022
MT,2022-02-28,inter-ucfe,4,2,5,3,0,1,0,0,0,0,3,18,7,9,FALSE,0.5,2021,2021-2022
MT,2022-02-28,inter-ucx,0,0,0,0,0,0,0,0,0,0,0,0,0,0,FALSE,0,2021,2021-2022
MT,2022-02-28,inter-ui,32,12,4,2,4,0,0,0,0,2,12,68,44,56,FALSE,0.823529411764706,2021,2021-2022
MT,2022-02-28,intra-total,1177,143,83,47,37,11,3,1,0,9,268,1779,1445,1588,FALSE,0.892636312535132,2021,2021-2022
MT,2022-02-28,intra-ucfe,44,20,25,8,9,1,1,0,0,1,29,138,73,93,FALSE,0.673913043478261,2021,2021-2022
MT,2022-02-28,intra-ucx,1,0,2,1,0,0,0,0,0,0,0,4,1,1,FALSE,0.25,2021,2021-2022
MT,2022-02-28,intra-ui,1132,123,56,38,28,10,2,1,0,8,239,1637,1371,1494,FALSE,0.912645082467929,2021,2021-2022
MT,2022-03-31,inter-total,44,3,3,1,4,1,0,0,0,1,11,68,55,58,FALSE,0.852941176470588,2021,2021-2022
MT,2022-03-31,inter-ucfe,1,0,0,1,2,0,0,0,0,0,2,6,3,3,FALSE,0.5,2021,2021-2022
MT,2022-03-31,inter-ucx,2,0,0,0,0,0,0,0,0,0,0,2,2,2,FALSE,1,2021,2021-2022
MT,2022-03-31,inter-ui,41,3,3,0,2,1,0,0,0,1,9,60,50,53,FALSE,0.883333333333333,2021,2021-2022
MT,2022-03-31,intra-total,764,84,48,17,14,14,4,0,2,7,186,1140,950,1034,FALSE,0.907017543859649,2021,2021-2022
MT,2022-03-31,intra-ucfe,26,5,2,0,1,2,1,0,0,0,7,44,33,38,FALSE,0.863636363636364,2021,2021-2022
MT,2022-03-31,intra-ucx,0,0,0,0,0,0,0,0,0,0,0,0,0,0,FALSE,0,2021,2021-2022
MT,2022-03-31,intra-ui,738,79,46,17,13,12,3,0,2,7,179,1096,917,996,FALSE,0.908759124087591,2021,2021-2022
MT,2022-04-30,inter-total,25,2,1,2,1,0,0,0,1,0,9,41,34,36,FALSE,0.878048780487805,2021,2021-2022
MT,2022-04-30,inter-ucfe,2,0,0,0,1,0,0,0,0,0,1,4,3,3,FALSE,0.75,2021,2021-2022
MT,2022-04-30,inter-ucx,0,0,0,0,0,0,0,0,0,0,0,0,0,0,FALSE,0,2021,2021-2022
MT,2022-04-30,inter-ui,23,2,1,2,0,0,0,0,1,0,8,37,31,33,FALSE,0.891891891891892,2021,2021-2022
MT,2022-04-30,intra-total,490,59,31,5,12,3,1,1,0,5,139,746,629,688,FALSE,0.92225201072386,2021,2021-2022
MT,2022-04-30,intra-ucfe,2,1,3,0,1,1,0,0,0,0,5,13,7,8,FALSE,0.615384615384615,2021,2021-2022
MT,2022-04-30,intra-ucx,1,0,0,0,0,0,0,0,0,0,1,2,2,2,FALSE,1,2021,2021-2022
MT,2022-04-30,intra-ui,487,58,28,5,11,2,1,1,0,5,133,731,620,678,FALSE,0.92749658002736,2021,2021-2022
MT,2022-05-31,inter-total,51,6,1,1,1,0,0,0,0,0,19,79,70,76,FALSE,0.962025316455696,2021,2021-2022
MT,2022-05-31,inter-ucfe,0,1,0,0,0,0,0,0,0,0,0,1,0,1,FALSE,1,2021,2021-2022
MT,2022-05-31,inter-ucx,1,0,0,0,0,0,0,0,0,0,0,1,1,1,FALSE,1,2021,2021-2022
MT,2022-05-31,inter-ui,50,5,1,1,1,0,0,0,0,0,19,77,69,74,FALSE,0.961038961038961,2021,2021-2022
MT,2022-05-31,intra-total,422,52,21,6,2,2,2,0,0,5,152,664,574,626,FALSE,0.942771084337349,2021,2021-2022
MT,2022-05-31,intra-ucfe,0,0,1,0,0,0,0,0,0,1,2,4,2,2,FALSE,0.5,2021,2021-2022
MT,2022-05-31,intra-ucx,1,1,0,0,0,0,0,0,0,0,0,2,1,2,FALSE,1,2021,2021-2022
MT,2022-05-31,intra-ui,421,51,20,6,2,2,2,0,0,4,150,658,571,622,FALSE,0.945288753799392,2021,2021-2022
MT,2022-06-30,inter-total,53,3,4,3,1,0,0,0,0,0,19,83,72,75,FALSE,0.903614457831325,2021,2021-2022
MT,2022-06-30,inter-ucfe,0,0,0,0,0,0,0,0,0,0,0,0,0,0,FALSE,0,2021,2021-2022
MT,2022-06-30,inter-ucx,0,0,0,0,0,0,0,0,0,0,0,0,0,0,FALSE,0,2021,2021-2022
MT,2022-06-30,inter-ui,53,3,4,3,1,0,0,0,0,0,19,83,72,75,FALSE,0.903614457831325,2021,2021-2022
MT,2022-06-30,intra-total,729,59,22,8,7,7,0,1,0,2,167,1002,896,955,FALSE,0.95309381237525,2021,2021-2022
MT,2022-06-30,intra-ucfe,1,1,1,0,1,1,0,0,0,0,0,5,1,2,FALSE,0.4,2021,2021-2022
MT,2022-06-30,intra-ucx,1,1,0,0,0,0,0,0,0,0,1,3,2,3,FALSE,1,2021,2021-2022
MT,2022-06-30,intra-ui,727,57,21,8,6,6,0,1,0,2,166,994,893,950,FALSE,0.955734406438632,2021,2021-2022
MT,2022-07-31,inter-total,48,7,6,1,1,1,0,0,0,0,14,78,62,69,FALSE,0.884615384615385,2022,2022-2023
MT,2022-07-31,inter-ucfe,0,0,0,0,0,0,0,0,0,0,0,0,0,0,FALSE,0,2022,2022-2023
MT,2022-07-31,inter-ucx,1,0,0,0,0,0,0,0,0,0,0,1,1,1,FALSE,1,2022,2022-2023
MT,2022-07-31,inter-ui,47,7,6,1,1,1,0,0,0,0,14,77,61,68,FALSE,0.883116883116883,2022,2022-2023
MT,2022-07-31,intra-total,483,61,30,12,3,3,3,1,0,0,165,761,648,709,FALSE,0.931668856767411,2022,2022-2023
MT,2022-07-31,intra-ucfe,1,0,1,0,0,0,0,1,0,0,1,4,2,2,FALSE,0.5,2022,2022-2023
MT,2022-07-31,intra-ucx,1,0,0,1,0,0,0,0,0,0,0,2,1,1,FALSE,0.5,2022,2022-2023
MT,2022-07-31,intra-ui,481,61,29,11,3,3,3,0,0,0,164,755,645,706,FALSE,0.935099337748344,2022,2022-2023
MT,2022-08-31,inter-total,27,8,0,2,2,1,1,0,0,0,8,49,35,43,FALSE,0.877551020408163,2022,2022-2023
MT,2022-08-31,inter-ucfe,0,0,0,0,0,0,0,0,0,0,0,0,0,0,FALSE,0,2022,2022-2023
MT,2022-08-31,inter-ucx,0,0,0,0,0,0,0,0,0,0,0,0,0,0,FALSE,0,2022,2022-2023
MT,2022-08-31,inter-ui,27,8,0,2,2,1,1,0,0,0,8,49,35,43,FALSE,0.877551020408163,2022,2022-2023
MT,2022-08-31,intra-total,354,61,27,19,10,1,1,0,0,3,155,631,509,570,FALSE,0.903328050713154,2022,2022-2023
MT,2022-08-31,intra-ucfe,1,4,1,2,0,0,0,0,0,1,3,12,4,8,FALSE,0.666666666666667,2022,2022-2023
MT,2022-08-31,intra-ucx,1,0,1,0,1,0,0,0,0,0,0,3,1,1,FALSE,0.333333333333333,2022,2022-2023
MT,2022-08-31,intra-ui,352,57,25,17,9,1,1,0,0,2,152,616,504,561,FALSE,0.910714285714286,2022,2022-2023
MT,2022-09-30,inter-total,18,7,4,0,0,0,0,0,0,0,9,38,27,34,FALSE,0.894736842105263,2022,2022-2023
MT,2022-09-30,inter-ucfe,0,0,0,0,0,0,0,0,0,0,0,0,0,0,FALSE,0,2022,2022-2023
MT,2022-09-30,inter-ucx,0,0,0,0,0,0,0,0,0,0,0,0,0,0,FALSE,0,2022,2022-2023
MT,2022-09-30,inter-ui,18,7,4,0,0,0,0,0,0,0,9,38,27,34,FALSE,0.894736842105263,2022,2022-2023
MT,2022-09-30,intra-total,272,40,20,12,4,5,0,1,1,0,127,482,399,439,FALSE,0.910788381742739,2022,2022-2023
MT,2022-09-30,intra-ucfe,2,1,0,0,0,1,0,0,0,0,0,4,2,3,FALSE,0.75,2022,2022-2023
MT,2022-09-30,intra-ucx,2,1,0,0,0,0,0,0,0,0,2,5,4,5,FALSE,1,2022,2022-2023
MT,2022-09-30,intra-ui,268,38,20,12,4,4,0,1,1,0,125,473,393,431,FALSE,0.911205073995772,2022,2022-2023
MT,2022-10-31,inter-total,86,6,0,0,2,0,0,0,0,0,20,114,106,112,FALSE,0.982456140350877,2022,2022-2023
MT,2022-10-31,inter-ucfe,3,0,0,0,0,0,0,0,0,0,3,6,6,6,FALSE,1,2022,2022-2023
MT,2022-10-31,inter-ucx,0,0,0,0,0,0,0,0,0,0,0,0,0,0,FALSE,0,2022,2022-2023
MT,2022-10-31,inter-ui,83,6,0,0,2,0,0,0,0,0,17,108,100,106,FALSE,0.981481481481481,2022,2022-2023
MT,2022-10-31,intra-total,390,61,14,9,4,4,0,1,0,0,126,609,516,577,FALSE,0.947454844006568,2022,2022-2023
MT,2022-10-31,intra-ucfe,1,0,1,1,0,0,0,0,0,0,1,4,2,2,FALSE,0.5,2022,2022-2023
MT,2022-10-31,intra-ucx,5,0,0,0,0,0,0,0,0,0,1,6,6,6,FALSE,1,2022,2022-2023
MT,2022-10-31,intra-ui,384,61,13,8,4,4,0,1,0,0,124,599,508,569,FALSE,0.94991652754591,2022,2022-2023
MT,2022-11-30,inter-total,123,11,16,2,0,0,0,0,0,0,50,202,173,184,FALSE,0.910891089108911,2022,2022-2023
MT,2022-11-30,inter-ucfe,10,2,1,0,0,0,0,0,0,0,10,23,20,22,FALSE,0.956521739130435,2022,2022-2023
MT,2022-11-30,inter-ucx,0,0,0,0,0,0,0,0,0,0,0,0,0,0,FALSE,0,2022,2022-2023
MT,2022-11-30,inter-ui,113,9,15,2,0,0,0,0,0,0,40,179,153,162,FALSE,0.905027932960894,2022,2022-2023
MT,2022-11-30,intra-total,1566,81,41,14,2,2,0,1,1,1,317,2026,1883,1964,FALSE,0.969397828232971,2022,2022-2023
MT,2022-11-30,intra-ucfe,48,6,3,1,0,0,0,0,0,0,22,80,70,76,FALSE,0.95,2022,2022-2023
MT,2022-11-30,intra-ucx,3,1,0,0,0,0,0,0,0,0,2,6,5,6,FALSE,1,2022,2022-2023
MT,2022-11-30,intra-ui,1515,74,38,13,2,2,0,1,1,1,293,1940,1808,1882,FALSE,0.970103092783505,2022,2022-2023
MT,2022-12-31,inter-total,131,18,11,2,3,3,0,1,0,0,35,204,166,184,FALSE,0.901960784313725,2022,2022-2023
MT,2022-12-31,inter-ucfe,11,2,2,1,0,2,0,0,0,0,1,19,12,14,FALSE,0.736842105263158,2022,2022-2023
MT,2022-12-31,inter-ucx,0,0,0,0,0,0,0,0,0,0,0,0,0,0,FALSE,0,2022,2022-2023
MT,2022-12-31,inter-ui,120,16,9,1,3,1,0,1,0,0,34,185,154,170,FALSE,0.918918918918919,2022,2022-2023
MT,2022-12-31,intra-total,2182,171,66,26,8,7,1,0,0,3,416,2880,2598,2769,FALSE,0.961458333333333,2022,2022-2023
MT,2022-12-31,intra-ucfe,80,9,5,1,0,0,0,0,0,0,46,141,126,135,FALSE,0.957446808510638,2022,2022-2023
MT,2022-12-31,intra-ucx,1,1,0,0,0,0,0,0,0,0,0,2,1,2,FALSE,1,2022,2022-2023
MT,2022-12-31,intra-ui,2101,161,61,25,8,7,1,0,0,3,370,2737,2471,2632,FALSE,0.961636828644501,2022,2022-2023
MT,2023-01-31,inter-total,126,22,8,5,3,1,1,0,0,0,54,220,180,202,FALSE,0.918181818181818,2022,2022-2023
MT,2023-01-31,inter-ucfe,14,1,0,0,0,1,1,0,0,0,11,28,25,26,FALSE,0.928571428571429,2022,2022-2023
MT,2023-01-31,inter-ucx,0,0,0,0,0,0,0,0,0,0,0,0,0,0,FALSE,0,2022,2022-2023
MT,2023-01-31,inter-ui,112,21,8,5,3,0,0,0,0,0,43,192,155,176,FALSE,0.916666666666667,2022,2022-2023
MT,2023-01-31,intra-total,2657,183,64,28,11,9,0,0,1,0,605,3558,3262,3445,FALSE,0.968240584598089,2022,2022-2023
MT,2023-01-31,intra-ucfe,118,11,4,1,2,1,0,0,0,0,74,211,192,203,FALSE,0.962085308056872,2022,2022-2023
MT,2023-01-31,intra-ucx,4,0,0,0,0,0,0,0,0,0,2,6,6,6,FALSE,1,2022,2022-2023
MT,2023-01-31,intra-ui,2535,172,60,27,9,8,0,0,1,0,529,3341,3064,3236,FALSE,0.968572283747381,2022,2022-2023
MT,2023-02-28,inter-total,49,10,4,5,2,1,2,1,1,1,19,95,68,78,FALSE,0.821052631578947,2022,2022-2023
MT,2023-02-28,inter-ucfe,2,0,1,2,0,0,2,0,0,0,2,9,4,4,FALSE,0.444444444444444,2022,2022-2023
MT,2023-02-28,inter-ucx,0,0,0,0,0,0,0,0,0,0,0,0,0,0,FALSE,0,2022,2022-2023
MT,2023-02-28,inter-ui,47,10,3,3,2,1,0,1,1,1,17,86,64,74,FALSE,0.86046511627907,2022,2022-2023
MT,2023-02-28,intra-total,1147,133,69,27,16,7,1,0,0,1,321,1722,1468,1601,FALSE,0.929732868757259,2022,2022-2023
MT,2023-02-28,intra-ucfe,40,8,6,3,0,0,0,0,0,0,19,76,59,67,FALSE,0.881578947368421,2022,2022-2023
MT,2023-02-28,intra-ucx,2,0,0,0,0,0,0,0,0,0,0,2,2,2,FALSE,1,2022,2022-2023
MT,2023-02-28,intra-ui,1105,125,63,24,16,7,1,0,0,1,302,1644,1407,1532,FALSE,0.931873479318735,2022,2022-2023
MT,2023-03-31,inter-total,38,9,2,5,1,0,0,0,0,0,17,72,55,64,FALSE,0.888888888888889,2022,2022-2023
MT,2023-03-31,inter-ucfe,2,1,0,0,0,0,0,0,0,0,2,5,4,5,FALSE,1,2022,2022-2023
MT,2023-03-31,inter-ucx,0,0,0,0,0,0,0,0,0,0,0,0,0,0,FALSE,0,2022,2022-2023
MT,2023-03-31,inter-ui,36,8,2,5,1,0,0,0,0,0,15,67,51,59,FALSE,0.880597014925373,2022,2022-2023
MT,2023-03-31,intra-total,673,98,42,30,20,12,0,2,0,2,242,1121,915,1013,FALSE,0.903657448706512,2022,2022-2023
MT,2023-03-31,intra-ucfe,18,4,3,0,0,2,0,1,0,0,10,38,28,32,FALSE,0.842105263157895,2022,2022-2023
MT,2023-03-31,intra-ucx,4,1,0,0,0,1,0,0,0,0,0,6,4,5,FALSE,0.833333333333333,2022,2022-2023
MT,2023-03-31,intra-ui,651,93,39,30,20,9,0,1,0,2,232,1077,883,976,FALSE,0.906220984215413,2022,2022-2023
MT,2023-04-30,inter-total,57,3,4,1,0,0,0,0,0,0,16,81,73,76,FALSE,0.938271604938272,2022,2022-2023
MT,2023-04-30,inter-ucfe,0,0,0,0,0,0,0,0,0,0,1,1,1,1,FALSE,1,2022,2022-2023
MT,2023-04-30,inter-ucx,0,0,0,0,0,0,0,0,0,0,0,0,0,0,FALSE,0,2022,2022-2023
MT,2023-04-30,inter-ui,57,3,4,1,0,0,0,0,0,0,15,80,72,75,FALSE,0.9375,2022,2022-2023
MT,2023-04-30,intra-total,524,59,24,14,5,3,0,0,0,2,159,790,683,742,FALSE,0.939240506329114,2022,2022-2023
MT,2023-04-30,intra-ucfe,4,2,0,0,0,0,0,0,0,0,4,10,8,10,FALSE,1,2022,2022-2023
MT,2023-04-30,intra-ucx,1,0,0,0,0,0,0,0,0,0,0,1,1,1,FALSE,1,2022,2022-2023
MT,2023-04-30,intra-ui,519,57,24,14,5,3,0,0,0,2,155,779,674,731,FALSE,0.938382541720154,2022,2022-2023
MT,2023-05-31,inter-total,73,5,6,2,1,0,0,0,0,0,28,115,101,106,FALSE,0.921739130434783,2022,2022-2023
MT,2023-05-31,inter-ucfe,2,0,0,0,0,0,0,0,0,0,0,2,2,2,FALSE,1,2022,2022-2023
MT,2023-05-31,inter-ucx,0,0,0,0,0,0,0,0,0,0,0,0,0,0,FALSE,0,2022,2022-2023
MT,2023-05-31,inter-ui,71,5,6,2,1,0,0,0,0,0,28,113,99,104,FALSE,0.920353982300885,2022,2022-2023
MT,2023-05-31,intra-total,512,60,23,19,4,2,0,0,0,3,181,804,693,753,FALSE,0.936567164179104,2022,2022-2023
MT,2023-05-31,intra-ucfe,0,1,0,0,0,0,0,0,0,0,4,5,4,5,FALSE,1,2022,2022-2023
MT,2023-05-31,intra-ucx,0,0,0,0,0,0,0,0,0,0,0,0,0,0,FALSE,0,2022,2022-2023
MT,2023-05-31,intra-ui,512,59,23,19,4,2,0,0,0,3,177,799,689,748,FALSE,0.936170212765957,2022,2022-2023
MT,2023-06-30,inter-total,45,1,8,1,1,2,1,0,0,0,17,76,62,63,FALSE,0.828947368421053,2022,2022-2023
MT,2023-06-30,inter-ucfe,0,0,0,0,0,0,0,0,0,0,1,1,1,1,FALSE,1,2022,2022-2023
MT,2023-06-30,inter-ucx,0,0,0,0,0,0,0,0,0,0,0,0,0,0,FALSE,0,2022,2022-2023
MT,2023-06-30,inter-ui,45,1,8,1,1,2,1,0,0,0,16,75,61,62,FALSE,0.826666666666667,2022,2022-2023
MT,2023-06-30,intra-total,691,58,33,5,4,3,1,0,0,1,163,959,854,912,FALSE,0.950990615224192,2022,2022-2023
MT,2023-06-30,intra-ucfe,0,0,0,0,0,0,0,0,0,0,1,1,1,1,FALSE,1,2022,2022-2023
MT,2023-06-30,intra-ucx,0,0,0,0,0,0,0,0,0,0,0,0,0,0,FALSE,0,2022,2022-2023
MT,2023-06-30,intra-ui,691,58,33,5,4,3,1,0,0,1,162,958,853,911,FALSE,0.950939457202505,2022,2022-2023
MT,2023-07-31,inter-total,25,5,4,2,3,0,0,0,0,1,17,57,42,47,FALSE,0.824561403508772,2023,2023-2024
MT,2023-07-31,inter-ucfe,0,0,0,0,0,0,0,0,0,0,0,0,0,0,FALSE,0,2023,2023-2024
MT,2023-07-31,inter-ucx,0,0,0,0,0,0,0,0,0,0,0,0,0,0,FALSE,0,2023,2023-2024
MT,2023-07-31,inter-ui,25,5,4,2,3,0,0,0,0,1,17,57,42,47,FALSE,0.824561403508772,2023,2023-2024
MT,2023-07-31,intra-total,477,73,25,12,5,4,0,0,0,0,182,778,659,732,FALSE,0.940874035989717,2023,2023-2024
MT,2023-07-31,intra-ucfe,4,1,1,0,0,0,0,0,0,0,0,6,4,5,FALSE,0.833333333333333,2023,2023-2024
MT,2023-07-31,intra-ucx,1,0,0,0,0,0,0,0,0,0,0,1,1,1,FALSE,1,2023,2023-2024
MT,2023-07-31,intra-ui,472,72,24,12,5,4,0,0,0,0,182,771,654,726,FALSE,0.941634241245136,2023,2023-2024
MT,2023-08-31,inter-total,33,6,0,3,1,2,0,1,0,1,11,58,44,50,FALSE,0.862068965517241,2023,2023-2024
MT,2023-08-31,inter-ucfe,0,0,0,0,0,0,0,0,0,0,0,0,0,0,FALSE,0,2023,2023-2024
MT,2023-08-31,inter-ucx,0,0,0,0,0,0,0,0,0,0,0,0,0,0,FALSE,0,2023,2023-2024
MT,2023-08-31,inter-ui,33,6,0,3,1,2,0,1,0,1,11,58,44,50,FALSE,0.862068965517241,2023,2023-2024
MT,2023-08-31,intra-total,416,50,21,13,4,3,0,0,0,0,163,670,579,629,FALSE,0.938805970149254,2023,2023-2024
MT,2023-08-31,intra-ucfe,5,0,0,0,0,1,0,0,0,0,0,6,5,5,FALSE,0.833333333333333,2023,2023-2024
MT,2023-08-31,intra-ucx,1,0,0,0,0,0,0,0,0,0,0,1,1,1,FALSE,1,2023,2023-2024
MT,2023-08-31,intra-ui,410,50,21,13,4,2,0,0,0,0,163,663,573,623,FALSE,0.939668174962293,2023,2023-2024
MT,2023-09-30,inter-total,20,4,5,0,0,1,0,0,0,0,8,38,28,32,FALSE,0.842105263157895,2023,2023-2024
MT,2023-09-30,inter-ucfe,0,0,0,0,0,0,0,0,0,0,0,0,0,0,FALSE,0,2023,2023-2024
MT,2023-09-30,inter-ucx,0,0,0,0,0,0,0,0,0,0,0,0,0,0,FALSE,0,2023,2023-2024
MT,2023-09-30,inter-ui,20,4,5,0,0,1,0,0,0,0,8,38,28,32,FALSE,0.842105263157895,2023,2023-2024
MT,2023-09-30,intra-total,267,34,12,9,4,2,0,0,0,0,111,439,378,412,FALSE,0.938496583143508,2023,2023-2024
MT,2023-09-30,intra-ucfe,0,0,0,0,0,0,0,0,0,0,0,0,0,0,FALSE,0,2023,2023-2024
MT,2023-09-30,intra-ucx,1,0,0,0,0,0,0,0,0,0,0,1,1,1,FALSE,1,2023,2023-2024
MT,2023-09-30,intra-ui,266,34,12,9,4,2,0,0,0,0,111,438,377,411,FALSE,0.938356164383562,2023,2023-2024
MT,2023-10-31,inter-total,27,8,6,4,0,0,0,0,0,1,11,57,38,46,FALSE,0.807017543859649,2023,2023-2024
MT,2023-10-31,inter-ucfe,0,1,0,0,0,0,0,0,0,0,0,1,0,1,FALSE,1,2023,2023-2024
MT,2023-10-31,inter-ucx,0,0,0,0,0,0,0,0,0,0,0,0,0,0,FALSE,0,2023,2023-2024
MT,2023-10-31,inter-ui,27,7,6,4,0,0,0,0,0,1,11,56,38,45,FALSE,0.803571428571429,2023,2023-2024
MT,2023-10-31,intra-total,360,82,32,19,5,2,5,1,1,8,144,659,504,586,FALSE,0.889226100151745,2023,2023-2024
MT,2023-10-31,intra-ucfe,0,0,1,0,0,0,0,0,0,0,0,1,0,0,FALSE,0,2023,2023-2024
MT,2023-10-31,intra-ucx,0,0,0,0,0,0,0,0,0,0,0,0,0,0,FALSE,0,2023,2023-2024
MT,2023-10-31,intra-ui,360,82,31,19,5,2,5,1,1,8,144,658,504,586,FALSE,0.890577507598784,2023,2023-2024
MT,2023-11-30,inter-total,23,6,8,3,2,2,2,0,0,2,9,57,32,38,FALSE,0.666666666666667,2023,2023-2024
MT,2023-11-30,inter-ucfe,0,0,2,1,0,1,0,0,0,0,0,4,0,0,FALSE,0,2023,2023-2024
MT,2023-11-30,inter-ucx,0,0,0,0,0,0,0,0,0,0,0,0,0,0,FALSE,0,2023,2023-2024
MT,2023-11-30,inter-ui,23,6,6,2,2,1,2,0,0,2,9,53,32,38,FALSE,0.716981132075472,2023,2023-2024
MT,2023-11-30,intra-total,652,187,93,30,23,6,3,1,1,7,302,1305,954,1141,FALSE,0.874329501915709,2023,2023-2024
MT,2023-11-30,intra-ucfe,0,1,2,0,2,0,0,0,0,0,0,5,0,1,FALSE,0.2,2023,2023-2024
MT,2023-11-30,intra-ucx,0,0,0,0,1,0,0,0,0,0,0,1,0,0,FALSE,0,2023,2023-2024
MT,2023-11-30,intra-ui,652,186,91,30,20,6,3,1,1,7,302,1299,954,1140,FALSE,0.877598152424942,2023,2023-2024
MT,2023-12-31,inter-total,29,13,14,15,7,8,2,3,3,5,10,109,39,52,FALSE,0.477064220183486,2023,2023-2024
MT,2023-12-31,inter-ucfe,0,1,1,0,3,5,1,1,0,0,0,12,0,1,FALSE,0.0833333333333333,2023,2023-2024
MT,2023-12-31,inter-ucx,0,0,0,0,0,0,0,0,0,0,0,0,0,0,FALSE,0,2023,2023-2024
MT,2023-12-31,inter-ui,29,12,13,15,4,3,1,2,3,5,10,97,39,51,FALSE,0.525773195876289,2023,2023-2024
MT,2023-12-31,intra-total,1129,371,234,124,88,51,39,5,5,15,378,2439,1507,1878,FALSE,0.769987699876999,2023,2023-2024
MT,2023-12-31,intra-ucfe,7,2,3,9,8,6,4,0,0,0,1,40,8,10,FALSE,0.25,2023,2023-2024
MT,2023-12-31,intra-ucx,0,0,0,0,0,0,0,0,0,0,0,0,0,0,FALSE,0,2023,2023-2024
MT,2023-12-31,intra-ui,1122,369,231,115,80,45,35,5,5,15,377,2399,1499,1868,FALSE,0.77865777407253,2023,2023-2024
MT,2024-01-31,inter-total,19,14,13,14,13,13,7,6,2,7,11,119,30,44,FALSE,0.369747899159664,2023,2023-2024
MT,2024-01-31,inter-ucfe,0,1,1,3,1,2,3,1,1,2,2,17,2,3,FALSE,0.176470588235294,2023,2023-2024
MT,2024-01-31,inter-ucx,0,0,0,0,0,0,0,0,0,0,0,0,0,0,FALSE,0,2023,2023-2024
MT,2024-01-31,inter-ui,19,13,12,11,12,11,4,5,1,5,9,102,28,41,FALSE,0.401960784313726,2023,2023-2024
MT,2024-01-31,intra-total,1925,286,272,280,169,113,64,42,26,42,508,3727,2433,2719,FALSE,0.729541185940435,2023,2023-2024
MT,2024-01-31,intra-ucfe,10,4,16,18,14,17,16,10,3,5,12,125,22,26,FALSE,0.208,2023,2023-2024
MT,2024-01-31,intra-ucx,0,0,0,0,0,0,0,0,0,0,1,1,1,1,FALSE,1,2023,2023-2024
MT,2024-01-31,intra-ui,1915,282,256,262,155,96,48,32,23,37,495,3601,2410,2692,FALSE,0.747570119411275,2023,2023-2024
MT,2024-02-29,inter-total,7,11,9,14,11,3,1,4,9,14,11,94,18,29,FALSE,0.308510638297872,2023,2023-2024
MT,2024-02-29,inter-ucfe,1,1,2,4,1,0,0,2,4,2,0,17,1,2,FALSE,0.117647058823529,2023,2023-2024
MT,2024-02-29,inter-ucx,0,0,0,0,0,0,0,0,0,0,0,0,0,0,FALSE,0,2023,2023-2024
MT,2024-02-29,inter-ui,6,10,7,10,10,3,1,2,5,12,11,77,17,27,FALSE,0.350649350649351,2023,2023-2024
MT,2024-02-29,intra-total,712,332,224,208,201,133,74,51,45,97,475,2552,1187,1519,FALSE,0.595219435736677,2023,2023-2024
MT,2024-02-29,intra-ucfe,0,9,10,23,17,21,12,16,19,14,5,146,5,14,FALSE,0.0958904109589041,2023,2023-2024
MT,2024-02-29,intra-ucx,0,0,0,1,0,0,0,0,0,0,0,1,0,0,FALSE,0,2023,2023-2024
MT,2024-02-29,intra-ui,712,323,214,184,184,112,62,35,26,83,470,2405,1182,1505,FALSE,0.625779625779626,2023,2023-2024
MT,2024-03-31,inter-total,13,2,7,6,5,7,11,3,1,19,3,77,16,18,FALSE,0.233766233766234,2023,2023-2024
MT,2024-03-31,inter-ucfe,0,0,1,0,1,4,5,1,0,4,0,16,0,0,FALSE,0,2023,2023-2024
MT,2024-03-31,inter-ucx,0,0,0,0,0,0,0,0,0,0,0,0,0,0,FALSE,0,2023,2023-2024
MT,2024-03-31,inter-ui,13,2,6,6,4,3,6,2,1,15,3,61,16,18,FALSE,0.295081967213115,2023,2023-2024
MT,2024-03-31,intra-total,526,108,93,74,81,91,88,46,45,111,281,1544,807,915,FALSE,0.592616580310881,2023,2023-2024
MT,2024-03-31,intra-ucfe,2,2,5,6,9,24,20,7,10,20,0,105,2,4,FALSE,0.0380952380952381,2023,2023-2024
MT,2024-03-31,intra-ucx,0,0,0,0,1,1,1,0,0,0,1,4,1,1,FALSE,0.25,2023,2023-2024
MT,2024-03-31,intra-ui,524,106,88,68,71,66,67,39,35,91,280,1435,804,910,FALSE,0.634146341463415,2023,2023-2024
MT,2024-04-30,inter-total,11,11,10,3,4,2,3,1,1,12,8,66,19,30,FALSE,0.454545454545455,2023,2023-2024
MT,2024-04-30,inter-ucfe,0,0,2,1,0,0,0,1,0,4,1,9,1,1,FALSE,0.111111111111111,2023,2023-2024
MT,2024-04-30,inter-ucx,0,0,0,0,0,0,0,0,0,0,0,0,0,0,FALSE,0,2023,2023-2024
MT,2024-04-30,inter-ui,11,11,8,2,4,2,3,0,1,8,7,57,18,29,FALSE,0.508771929824562,2023,2023-2024
MT,2024-04-30,intra-total,489,99,55,33,31,36,41,37,41,191,184,1237,673,772,FALSE,0.624090541632983,2023,2023-2024
MT,2024-04-30,intra-ucfe,0,2,0,1,9,3,5,4,5,32,3,64,3,5,FALSE,0.078125,2023,2023-2024
MT,2024-04-30,intra-ucx,0,0,0,0,0,0,0,0,0,0,0,0,0,0,FALSE,0,2023,2023-2024
MT,2024-04-30,intra-ui,489,97,55,32,22,33,36,33,36,159,181,1173,670,767,FALSE,0.6538789428815,2023,2023-2024
MT,2024-05-31,inter-total,13,9,4,1,3,2,4,1,1,6,10,54,23,32,FALSE,0.592592592592593,2023,2023-2024
MT,2024-05-31,inter-ucfe,0,0,0,0,1,0,0,0,0,2,0,3,0,0,FALSE,0,2023,2023-2024
MT,2024-05-31,inter-ucx,0,0,0,0,0,0,0,0,0,0,0,0,0,0,FALSE,0,2023,2023-2024
MT,2024-05-31,inter-ui,13,9,4,1,2,2,4,1,1,4,10,51,23,32,FALSE,0.627450980392157,2023,2023-2024
MT,2024-05-31,intra-total,406,97,44,32,14,10,3,8,6,77,188,885,594,691,FALSE,0.780790960451977,2023,2023-2024
MT,2024-05-31,intra-ucfe,3,3,1,1,0,1,1,1,0,3,1,15,4,7,FALSE,0.466666666666667,2023,2023-2024
MT,2024-05-31,intra-ucx,0,0,0,0,1,0,0,0,0,0,1,2,1,1,FALSE,0.5,2023,2023-2024
MT,2024-05-31,intra-ui,403,94,43,31,13,9,2,7,6,74,186,868,589,683,FALSE,0.786866359447005,2023,2023-2024
MT,2024-06-30,inter-total,13,5,5,0,3,0,0,2,0,1,5,34,18,23,FALSE,0.676470588235294,2023,2023-2024
MT,2024-06-30,inter-ucfe,0,0,0,0,0,0,0,0,0,0,0,0,0,0,FALSE,0,2023,2023-2024
MT,2024-06-30,inter-ucx,0,0,0,0,0,0,0,0,0,0,0,0,0,0,FALSE,0,2023,2023-2024
MT,2024-06-30,inter-ui,13,5,5,0,3,0,0,2,0,1,5,34,18,23,FALSE,0.676470588235294,2023,2023-2024
MT,2024-06-30,intra-total,487,62,43,31,7,13,13,9,3,38,184,890,671,733,FALSE,0.823595505617978,2023,2023-2024
MT,2024-06-30,intra-ucfe,0,1,0,1,1,0,1,0,0,2,1,7,1,2,FALSE,0.285714285714286,2023,2023-2024
MT,2024-06-30,intra-ucx,2,0,0,0,0,0,0,0,0,0,0,2,2,2,FALSE,1,2023,2023-2024
MT,2024-06-30,intra-ui,485,61,43,30,6,13,12,9,3,36,183,881,668,729,FALSE,0.827468785471056,2023,2023-2024
MT,2024-07-31,inter-total,10,6,4,2,4,1,0,0,0,4,8,39,18,24,FALSE,0.615384615384615,2024,2024-2025
MT,2024-07-31,inter-ucfe,0,1,0,0,0,0,0,0,0,0,0,1,0,1,FALSE,1,2024,2024-2025
MT,2024-07-31,inter-ucx,0,0,0,0,0,0,0,0,0,0,0,0,0,0,FALSE,0,2024,2024-2025
MT,2024-07-31,inter-ui,10,5,4,2,4,1,0,0,0,4,8,38,18,23,FALSE,0.605263157894737,2024,2024-2025
MT,2024-07-31,intra-total,566,93,54,25,23,19,19,8,5,32,227,1071,793,886,FALSE,0.827264239028945,2024,2024-2025
MT,2024-07-31,intra-ucfe,3,0,0,1,0,1,0,0,1,0,1,7,4,4,FALSE,0.571428571428571,2024,2024-2025
MT,2024-07-31,intra-ucx,1,0,0,0,0,0,0,0,0,0,0,1,1,1,FALSE,1,2024,2024-2025
MT,2024-07-31,intra-ui,562,93,54,24,23,18,19,8,4,32,226,1063,788,881,FALSE,0.828786453433678,2024,2024-2025
MT,2024-08-31,inter-total,15,8,8,3,2,1,1,0,1,4,9,52,24,32,FALSE,0.615384615384615,2024,2024-2025
MT,2024-08-31,inter-ucfe,0,0,0,0,0,0,0,0,0,0,0,0,0,0,FALSE,0,2024,2024-2025
MT,2024-08-31,inter-ucx,0,0,0,0,0,0,0,0,0,0,0,0,0,0,FALSE,0,2024,2024-2025
MT,2024-08-31,inter-ui,15,8,8,3,2,1,1,0,1,4,9,52,24,32,FALSE,0.615384615384615,2024,2024-2025
MT,2024-08-31,intra-total,349,51,37,23,24,21,20,9,4,24,171,733,520,571,FALSE,0.778990450204638,2024,2024-2025
MT,2024-08-31,intra-ucfe,3,0,0,1,0,1,0,0,0,0,1,6,4,4,FALSE,0.666666666666667,2024,2024-2025
MT,2024-08-31,intra-ucx,0,0,0,0,0,0,0,0,0,0,0,0,0,0,FALSE,0,2024,2024-2025
MT,2024-08-31,intra-ui,346,51,37,22,24,20,20,9,4,24,170,727,516,567,FALSE,0.779917469050894,2024,2024-2025
MT,2024-09-30,inter-total,18,3,2,2,1,0,2,2,0,0,10,40,28,31,FALSE,0.775,2024,2024-2025
MT,2024-09-30,inter-ucfe,0,0,0,0,0,0,0,0,0,0,0,0,0,0,FALSE,0,2024,2024-2025
MT,2024-09-30,inter-ucx,0,0,0,0,0,0,0,0,0,0,0,0,0,0,FALSE,0,2024,2024-2025
MT,2024-09-30,inter-ui,18,3,2,2,1,0,2,2,0,0,10,40,28,31,FALSE,0.775,2024,2024-2025
MT,2024-09-30,intra-total,435,51,17,20,12,3,9,2,6,32,118,705,553,604,FALSE,0.856737588652482,2024,2024-2025
MT,2024-09-30,intra-ucfe,0,0,0,0,1,0,1,0,0,2,0,4,0,0,FALSE,0,2024,2024-2025
MT,2024-09-30,intra-ucx,0,0,0,0,0,0,0,1,0,0,0,1,0,0,FALSE,0,2024,2024-2025
MT,2024-09-30,intra-ui,435,51,17,20,11,3,8,1,6,30,118,700,553,604,FALSE,0.862857142857143,2024,2024-2025
MT,2024-10-31,inter-total,28,9,1,6,2,0,1,0,1,4,7,59,35,44,FALSE,0.745762711864407,2024,2024-2025
MT,2024-10-31,inter-ucfe,1,0,0,0,0,0,0,0,0,0,0,1,1,1,FALSE,1,2024,2024-2025
MT,2024-10-31,inter-ucx,0,0,0,0,0,0,0,0,0,0,0,0,0,0,FALSE,0,2024,2024-2025
MT,2024-10-31,inter-ui,27,9,1,6,2,0,1,0,1,4,7,58,34,43,FALSE,0.741379310344828,2024,2024-2025
MT,2024-10-31,intra-total,569,72,22,26,17,6,3,7,3,23,148,896,717,789,FALSE,0.880580357142857,2024,2024-2025
MT,2024-10-31,intra-ucfe,3,1,0,1,0,0,0,0,0,1,4,10,7,8,FALSE,0.8,2024,2024-2025
MT,2024-10-31,intra-ucx,2,0,0,0,0,0,0,0,0,1,1,4,3,3,FALSE,0.75,2024,2024-2025
MT,2024-10-31,intra-ui,564,71,22,25,17,6,3,7,3,21,143,882,707,778,FALSE,0.882086167800454,2024,2024-2025
MT,2024-11-30,inter-total,42,19,5,6,3,1,1,1,0,4,26,108,68,87,FALSE,0.805555555555556,2024,2024-2025
MT,2024-11-30,inter-ucfe,6,6,0,2,0,0,1,0,0,1,9,25,15,21,FALSE,0.84,2024,2024-2025
MT,2024-11-30,inter-ucx,0,0,0,0,0,0,0,0,0,0,0,0,0,0,FALSE,0,2024,2024-2025
MT,2024-11-30,inter-ui,36,13,5,4,3,1,0,1,0,3,17,83,53,66,FALSE,0.795180722891566,2024,2024-2025
MT,2024-11-30,intra-total,977,119,47,45,27,9,8,2,4,25,294,1557,1271,1390,FALSE,0.892742453436095,2024,2024-2025
MT,2024-11-30,intra-ucfe,28,11,4,6,1,1,0,0,0,2,26,79,54,65,FALSE,0.822784810126582,2024,2024-2025
MT,2024-11-30,intra-ucx,0,0,1,0,1,0,0,0,0,1,0,3,0,0,FALSE,0,2024,2024-2025
MT,2024-11-30,intra-ui,949,108,42,39,25,8,8,2,4,22,268,1475,1217,1325,FALSE,0.898305084745763,2024,2024-2025
MT,2024-12-31,inter-total,35,21,13,4,5,4,2,3,1,3,17,108,52,73,FALSE,0.675925925925926,2024,2024-2025
MT,2024-12-31,inter-ucfe,3,3,1,0,2,0,2,1,0,0,2,14,5,8,FALSE,0.571428571428571,2024,2024-2025
MT,2024-12-31,inter-ucx,0,0,0,0,0,0,0,0,0,0,0,0,0,0,FALSE,0,2024,2024-2025
MT,2024-12-31,inter-ui,32,18,12,4,3,4,0,2,1,3,15,94,47,65,FALSE,0.691489361702128,2024,2024-2025
MT,2024-12-31,intra-total,2110,272,171,101,55,26,18,9,7,46,649,3464,2759,3031,FALSE,0.875,2024,2024-2025
MT,2024-12-31,intra-ucfe,79,16,17,6,2,0,1,0,2,3,39,165,118,134,FALSE,0.812121212121212,2024,2024-2025
MT,2024-12-31,intra-ucx,0,0,0,0,0,0,0,0,0,0,1,1,1,1,FALSE,1,2024,2024-2025
MT,2024-12-31,intra-ui,2031,256,154,95,53,26,17,9,5,43,609,3298,2640,2896,FALSE,0.878107944208611,2024,2024-2025
NC,2019-01-31,inter-total,59,18,25,21,15,6,7,7,2,15,50,225,109,127,FALSE,0.564444444444444,2018,2018-2019
NC,2019-01-31,inter-ucfe,1,1,0,1,0,0,0,1,0,0,3,7,4,5,FALSE,0.714285714285714,2018,2018-2019
NC,2019-01-31,inter-ucx,0,0,0,0,0,0,0,0,0,0,0,0,0,0,FALSE,0,2018,2018-2019
NC,2019-01-31,inter-ui,58,17,25,20,15,6,7,6,2,15,47,218,105,122,FALSE,0.559633027522936,2018,2018-2019
NC,2019-01-31,intra-total,2119,633,391,368,370,377,297,238,173,622,1575,7163,3694,4327,FALSE,0.604076504257992,2018,2018-2019
NC,2019-01-31,intra-ucfe,28,12,0,1,1,3,0,1,1,5,76,128,104,116,FALSE,0.90625,2018,2018-2019
NC,2019-01-31,intra-ucx,11,2,1,1,4,4,0,1,1,1,5,31,16,18,FALSE,0.580645161290323,2018,2018-2019
NC,2019-01-31,intra-ui,2080,619,390,366,365,370,297,236,171,616,1494,7004,3574,4193,FALSE,0.598657909765848,2018,2018-2019
NC,2019-02-28,inter-total,31,22,16,16,10,8,10,8,2,8,37,168,68,90,FALSE,0.535714285714286,2018,2018-2019
NC,2019-02-28,inter-ucfe,0,0,1,1,0,0,0,0,0,2,0,4,0,0,FALSE,0,2018,2018-2019
NC,2019-02-28,inter-ucx,0,0,0,0,0,0,0,0,0,0,0,0,0,0,FALSE,0,2018,2018-2019
NC,2019-02-28,inter-ui,31,22,15,15,10,8,10,8,2,6,37,164,68,90,FALSE,0.548780487804878,2018,2018-2019
NC,2019-02-28,intra-total,1429,557,488,547,343,275,214,200,158,696,942,5849,2371,2928,FALSE,0.500598392887673,2018,2018-2019
NC,2019-02-28,intra-ucfe,0,2,3,1,1,3,1,1,3,6,3,24,3,5,FALSE,0.208333333333333,2018,2018-2019
NC,2019-02-28,intra-ucx,8,0,1,2,3,2,1,1,2,3,3,26,11,11,FALSE,0.423076923076923,2018,2018-2019
NC,2019-02-28,intra-ui,1421,555,484,544,339,270,212,198,153,687,936,5799,2357,2912,FALSE,0.502155544059321,2018,2018-2019
NC,2019-03-31,inter-total,32,16,9,10,9,6,7,3,3,13,18,126,50,66,FALSE,0.523809523809524,2018,2018-2019
NC,2019-03-31,inter-ucfe,0,0,1,0,0,0,0,0,1,1,0,3,0,0,FALSE,0,2018,2018-2019
NC,2019-03-31,inter-ucx,0,0,0,0,0,0,0,0,0,0,0,0,0,0,FALSE,0,2018,2018-2019
NC,2019-03-31,inter-ui,32,16,8,10,9,6,7,3,2,12,18,123,50,66,FALSE,0.536585365853659,2018,2018-2019
NC,2019-03-31,intra-total,1415,591,493,336,318,179,131,82,50,460,835,4890,2250,2841,FALSE,0.580981595092025,2018,2018-2019
NC,2019-03-31,intra-ucfe,1,0,1,0,1,2,2,0,1,6,1,15,2,2,FALSE,0.133333333333333,2018,2018-2019
NC,2019-03-31,intra-ucx,10,2,2,0,4,1,4,0,1,11,7,42,17,19,FALSE,0.452380952380952,2018,2018-2019
NC,2019-03-31,intra-ui,1404,589,490,336,313,176,125,82,48,443,827,4833,2231,2820,FALSE,0.58348851644941,2018,2018-2019
NC,2019-04-30,inter-total,33,13,8,10,7,7,3,2,1,12,28,124,61,74,FALSE,0.596774193548387,2018,2018-2019
NC,2019-04-30,inter-ucfe,0,0,1,0,0,0,0,0,0,2,0,3,0,0,FALSE,0,2018,2018-2019
NC,2019-04-30,inter-ucx,1,0,0,0,0,0,0,0,0,0,0,1,1,1,FALSE,1,2018,2018-2019
NC,2019-04-30,inter-ui,32,13,7,10,7,7,3,2,1,10,28,120,60,73,FALSE,0.608333333333333,2018,2018-2019
NC,2019-04-30,intra-total,1465,448,297,411,364,230,162,83,58,366,816,4700,2281,2729,FALSE,0.580638297872341,2018,2018-2019
NC,2019-04-30,intra-ucfe,0,0,0,1,1,1,1,0,1,9,1,15,1,1,FALSE,0.0666666666666667,2018,2018-2019
NC,2019-04-30,intra-ucx,18,5,5,2,0,0,2,2,1,4,6,45,24,29,FALSE,0.644444444444445,2018,2018-2019
NC,2019-04-30,intra-ui,1447,443,292,408,363,229,159,81,56,353,809,4640,2256,2699,FALSE,0.581681034482759,2018,2018-2019
NC,2019-05-31,inter-total,53,23,12,9,9,1,4,2,0,10,26,149,79,102,FALSE,0.684563758389262,2018,2018-2019
NC,2019-05-31,inter-ucfe,0,0,0,0,0,0,0,0,0,0,0,0,0,0,FALSE,0,2018,2018-2019
NC,2019-05-31,inter-ucx,0,0,0,0,0,0,0,0,0,0,0,0,0,0,FALSE,0,2018,2018-2019
NC,2019-05-31,inter-ui,53,23,12,9,9,1,4,2,0,10,26,149,79,102,FALSE,0.684563758389262,2018,2018-2019
NC,2019-05-31,intra-total,1530,472,375,406,248,128,62,57,48,248,645,4219,2175,2647,FALSE,0.627399857786205,2018,2018-2019
NC,2019-05-31,intra-ucfe,0,1,1,0,2,1,1,0,1,5,0,12,0,1,FALSE,0.0833333333333333,2018,2018-2019
NC,2019-05-31,intra-ucx,9,6,2,1,1,1,1,0,0,1,2,24,11,17,FALSE,0.708333333333333,2018,2018-2019
NC,2019-05-31,intra-ui,1521,465,372,405,245,126,60,57,47,242,643,4183,2164,2629,FALSE,0.62849629452546,2018,2018-2019
NC,2019-06-30,inter-total,63,22,26,9,6,4,0,1,1,8,31,171,94,116,FALSE,0.678362573099415,2018,2018-2019
NC,2019-06-30,inter-ucfe,0,0,2,0,0,0,0,0,0,0,0,2,0,0,FALSE,0,2018,2018-2019
NC,2019-06-30,inter-ucx,0,0,0,0,0,0,0,0,0,0,0,0,0,0,FALSE,0,2018,2018-2019
NC,2019-06-30,inter-ui,63,22,24,9,6,4,0,1,1,8,31,169,94,116,FALSE,0.686390532544379,2018,2018-2019
NC,2019-06-30,intra-total,1753,497,423,391,241,135,93,48,37,245,1005,4868,2758,3255,FALSE,0.668652423993427,2018,2018-2019
NC,2019-06-30,intra-ucfe,0,2,2,2,2,3,1,0,0,6,1,19,1,3,FALSE,0.157894736842105,2018,2018-2019
NC,2019-06-30,intra-ucx,12,6,6,0,0,0,0,0,0,1,2,27,14,20,FALSE,0.740740740740741,2018,2018-2019
NC,2019-06-30,intra-ui,1741,489,415,389,239,132,92,48,37,238,1002,4822,2743,3232,FALSE,0.670261302364164,2018,2018-2019
NC,2019-07-31,inter-total,67,13,24,21,6,6,4,1,2,7,38,189,105,118,FALSE,0.624338624338624,2019,2019-2020
NC,2019-07-31,inter-ucfe,0,0,2,0,0,1,0,0,0,1,2,6,2,2,FALSE,0.333333333333333,2019,2019-2020
NC,2019-07-31,inter-ucx,0,0,0,0,0,0,0,0,0,0,0,0,0,0,FALSE,0,2019,2019-2020
NC,2019-07-31,inter-ui,67,13,22,21,6,5,4,1,2,6,36,183,103,116,FALSE,0.633879781420765,2019,2019-2020
NC,2019-07-31,intra-total,1874,597,476,372,243,183,126,80,68,230,1070,5319,2944,3541,FALSE,0.66572664034593,2019,2019-2020
NC,2019-07-31,intra-ucfe,1,5,2,1,1,3,1,1,3,5,0,23,1,6,FALSE,0.260869565217391,2019,2019-2020
NC,2019-07-31,intra-ucx,8,5,4,2,0,0,0,0,1,3,1,24,9,14,FALSE,0.583333333333333,2019,2019-2020
NC,2019-07-31,intra-ui,1865,587,470,369,242,180,125,79,64,222,1069,5272,2934,3521,FALSE,0.667867981790592,2019,2019-2020
NC,2019-08-31,inter-total,88,25,13,9,4,5,3,0,2,6,34,189,122,147,FALSE,0.777777777777778,2019,2019-2020
NC,2019-08-31,inter-ucfe,0,0,1,1,0,1,0,0,0,1,0,4,0,0,FALSE,0,2019,2019-2020
NC,2019-08-31,inter-ucx,0,0,0,0,0,0,0,0,0,0,0,0,0,0,FALSE,0,2019,2019-2020
NC,2019-08-31,inter-ui,88,25,12,8,4,4,3,0,2,5,34,185,122,147,FALSE,0.794594594594595,2019,2019-2020
NC,2019-08-31,intra-total,2079,484,302,218,150,84,78,46,33,231,1147,4852,3226,3710,FALSE,0.764633140972795,2019,2019-2020
NC,2019-08-31,intra-ucfe,1,2,1,1,0,1,0,0,1,1,1,9,2,4,FALSE,0.444444444444444,2019,2019-2020
NC,2019-08-31,intra-ucx,10,5,6,1,3,1,1,0,2,0,7,36,17,22,FALSE,0.611111111111111,2019,2019-2020
NC,2019-08-31,intra-ui,2068,477,295,216,147,82,77,46,30,230,1139,4807,3207,3684,FALSE,0.766382359059705,2019,2019-2020
NC,2019-09-30,inter-total,72,15,7,3,6,2,1,2,5,9,39,161,111,126,FALSE,0.782608695652174,2019,2019-2020
NC,2019-09-30,inter-ucfe,0,0,0,0,1,0,0,0,0,0,1,2,1,1,FALSE,0.5,2019,2019-2020
NC,2019-09-30,inter-ucx,1,0,0,0,0,0,0,0,0,0,1,2,2,2,FALSE,1,2019,2019-2020
NC,2019-09-30,inter-ui,71,15,7,3,5,2,1,2,5,9,37,157,108,123,FALSE,0.78343949044586,2019,2019-2020
NC,2019-09-30,intra-total,1968,359,222,167,130,98,91,70,47,279,927,4358,2895,3254,FALSE,0.746672785681505,2019,2019-2020
NC,2019-09-30,intra-ucfe,1,3,4,4,5,1,0,3,2,8,0,31,1,4,FALSE,0.129032258064516,2019,2019-2020
NC,2019-09-30,intra-ucx,12,2,2,2,0,2,0,0,0,3,6,29,18,20,FALSE,0.689655172413793,2019,2019-2020
NC,2019-09-30,intra-ui,1955,354,216,161,125,95,91,67,45,268,921,4298,2876,3230,FALSE,0.751512331316892,2019,2019-2020
NC,2019-10-31,inter-total,99,7,8,7,1,5,0,0,2,3,34,166,133,140,FALSE,0.843373493975904,2019,2019-2020
NC,2019-10-31,inter-ucfe,0,0,1,0,0,0,0,0,0,2,0,3,0,0,FALSE,0,2019,2019-2020
NC,2019-10-31,inter-ucx,0,0,0,0,0,0,0,0,0,0,0,0,0,0,FALSE,0,2019,2019-2020
NC,2019-10-31,inter-ui,99,7,7,7,1,5,0,0,2,1,34,163,133,140,FALSE,0.858895705521472,2019,2019-2020
NC,2019-10-31,intra-total,2397,401,254,176,120,76,57,57,45,177,1229,4989,3626,4027,FALSE,0.807175786730808,2019,2019-2020
NC,2019-10-31,intra-ucfe,0,2,1,2,2,2,0,0,0,6,3,18,3,5,FALSE,0.277777777777778,2019,2019-2020
NC,2019-10-31,intra-ucx,9,2,1,1,1,1,0,0,2,3,8,28,17,19,FALSE,0.678571428571429,2019,2019-2020
NC,2019-10-31,intra-ui,2388,397,252,173,117,73,57,57,43,168,1218,4943,3606,4003,FALSE,0.809832085777868,2019,2019-2020
NC,2019-11-30,inter-total,121,11,10,3,4,3,1,2,5,2,34,196,155,166,FALSE,0.846938775510204,2019,2019-2020
NC,2019-11-30,inter-ucfe,1,0,0,1,0,0,0,0,1,0,1,4,2,2,FALSE,0.5,2019,2019-2020
NC,2019-11-30,inter-ucx,0,0,0,0,0,0,0,0,0,0,0,0,0,0,FALSE,0,2019,2019-2020
NC,2019-11-30,inter-ui,120,11,10,2,4,3,1,2,4,2,33,192,153,164,FALSE,0.854166666666667,2019,2019-2020
NC,2019-11-30,intra-total,2254,366,202,147,105,84,44,56,20,121,1074,4473,3328,3694,FALSE,0.825843952604516,2019,2019-2020
NC,2019-11-30,intra-ucfe,1,4,3,2,1,1,0,1,0,1,4,18,5,9,FALSE,0.5,2019,2019-2020
NC,2019-11-30,intra-ucx,10,3,4,0,2,0,1,1,0,1,10,32,20,23,FALSE,0.71875,2019,2019-2020
NC,2019-11-30,intra-ui,2243,359,195,145,102,83,43,54,20,119,1060,4423,3303,3662,FALSE,0.827944833823197,2019,2019-2020
NC,2019-12-31,inter-total,122,8,15,3,5,0,2,0,0,1,44,200,166,174,FALSE,0.87,2019,2019-2020
NC,2019-12-31,inter-ucfe,1,0,0,1,0,0,1,0,0,0,0,3,1,1,FALSE,0.333333333333333,2019,2019-2020
NC,2019-12-31,inter-ucx,0,0,0,0,0,0,0,0,0,0,0,0,0,0,FALSE,0,2019,2019-2020
NC,2019-12-31,inter-ui,121,8,15,2,5,0,1,0,0,1,44,197,165,173,FALSE,0.878172588832487,2019,2019-2020
NC,2019-12-31,intra-total,2340,380,206,153,123,97,54,49,44,150,1196,4792,3536,3916,FALSE,0.817195325542571,2019,2019-2020
NC,2019-12-31,intra-ucfe,1,1,3,0,1,0,1,2,3,2,4,18,5,6,FALSE,0.333333333333333,2019,2019-2020
NC,2019-12-31,intra-ucx,12,3,2,2,2,1,3,2,0,0,6,33,18,21,FALSE,0.636363636363636,2019,2019-2020
NC,2019-12-31,intra-ui,2327,376,201,151,120,96,50,45,41,148,1186,4741,3513,3889,FALSE,0.820291077831681,2019,2019-2020
NC,2020-01-31,inter-total,133,20,3,12,7,9,4,0,0,4,71,263,204,224,FALSE,0.85171102661597,2019,2019-2020
NC,2020-01-31,inter-ucfe,1,0,0,0,0,1,1,0,0,0,1,4,2,2,FALSE,0.5,2019,2019-2020
NC,2020-01-31,inter-ucx,0,0,0,0,0,1,0,0,0,0,0,1,0,0,FALSE,0,2019,2019-2020
NC,2020-01-31,inter-ui,132,20,3,12,7,7,3,0,0,4,70,258,202,222,FALSE,0.86046511627907,2019,2019-2020
NC,2020-01-31,intra-total,2937,431,289,232,162,135,96,67,39,169,1195,5752,4132,4563,FALSE,0.793289290681502,2019,2019-2020
NC,2020-01-31,intra-ucfe,0,1,0,2,2,1,1,0,0,2,0,9,0,1,FALSE,0.111111111111111,2019,2019-2020
NC,2020-01-31,intra-ucx,11,2,2,7,3,3,0,0,1,0,4,33,15,17,FALSE,0.515151515151515,2019,2019-2020
NC,2020-01-31,intra-ui,2926,428,287,223,157,131,95,67,38,167,1191,5710,4117,4545,FALSE,0.795971978984238,2019,2019-2020
NC,2020-02-29,inter-total,103,24,18,7,2,3,2,1,1,3,36,200,139,163,FALSE,0.815,2019,2019-2020
NC,2020-02-29,inter-ucfe,0,1,1,0,0,1,0,0,0,0,0,3,0,1,FALSE,0.333333333333333,2019,2019-2020
NC,2020-02-29,inter-ucx,0,0,0,0,0,0,0,0,0,0,0,0,0,0,FALSE,0,2019,2019-2020
NC,2020-02-29,inter-ui,103,23,17,7,2,2,2,1,1,3,36,197,139,162,FALSE,0.822335025380711,2019,2019-2020
NC,2020-02-29,intra-total,2056,617,411,262,183,93,62,60,38,170,906,4858,2962,3579,FALSE,0.736722931247427,2019,2019-2020
NC,2020-02-29,intra-ucfe,0,5,2,4,3,0,1,0,0,3,2,20,2,7,FALSE,0.35,2019,2019-2020
NC,2020-02-29,intra-ucx,9,2,4,1,3,1,0,0,0,0,4,24,13,15,FALSE,0.625,2019,2019-2020
NC,2020-02-29,intra-ui,2047,610,405,257,177,92,61,60,38,167,900,4814,2947,3557,FALSE,0.738886580805983,2019,2019-2020
NC,2020-03-31,inter-total,211,14,13,4,4,7,1,1,3,7,59,324,270,284,FALSE,0.876543209876543,2019,2019-2020
NC,2020-03-31,inter-ucfe,0,0,1,0,0,0,0,0,1,0,0,2,0,0,FALSE,0,2019,2019-2020
NC,2020-03-31,inter-ucx,0,0,0,0,0,0,0,0,0,0,0,0,0,0,FALSE,0,2019,2019-2020
NC,2020-03-31,inter-ui,211,14,12,4,4,7,1,1,2,7,59,322,270,284,FALSE,0.881987577639752,2019,2019-2020
NC,2020-03-31,intra-total,12996,470,315,316,255,191,131,110,80,234,3738,18836,16734,17204,FALSE,0.913357400722022,2019,2019-2020
NC,2020-03-31,intra-ucfe,2,3,3,1,3,4,2,3,1,7,2,31,4,7,FALSE,0.225806451612903,2019,2019-2020
NC,2020-03-31,intra-ucx,12,3,1,1,3,2,1,1,0,2,0,26,12,15,FALSE,0.576923076923077,2019,2019-2020
NC,2020-03-31,intra-ui,12982,464,311,314,249,185,128,106,79,225,3736,18779,16718,17182,FALSE,0.914958197987113,2019,2019-2020
NC,2020-04-30,inter-total,1821,796,253,64,11,0,0,1,0,7,2290,5243,4111,4907,FALSE,0.935914552736983,2019,2019-2020
NC,2020-04-30,inter-ucfe,0,0,0,0,0,0,0,0,0,2,1,3,1,1,FALSE,0.333333333333333,2019,2019-2020
NC,2020-04-30,inter-ucx,0,1,0,0,0,0,0,0,0,0,0,1,0,1,FALSE,1,2019,2019-2020
NC,2020-04-30,inter-ui,1821,795,253,64,11,0,0,1,0,5,2289,5239,4110,4905,FALSE,0.936247375453331,2019,2019-2020
NC,2020-04-30,intra-total,103156,56845,17797,5079,1049,72,59,33,28,174,146491,330783,249647,306492,FALSE,0.926565149962362,2019,2019-2020
NC,2020-04-30,intra-ucfe,2,1,5,3,1,0,0,0,0,1,3,16,5,6,FALSE,0.375,2019,2019-2020
NC,2020-04-30,intra-ucx,26,7,2,3,0,1,0,0,1,1,19,60,45,52,FALSE,0.866666666666667,2019,2019-2020
NC,2020-04-30,intra-ui,103128,56837,17790,5073,1048,71,59,33,27,172,146469,330707,249597,306434,FALSE,0.92660270269453,2019,2019-2020
NC,2020-05-31,inter-total,620,504,304,194,133,85,41,19,6,6,805,2717,1425,1929,FALSE,0.709974236290026,2019,2019-2020
NC,2020-05-31,inter-ucfe,0,0,0,0,0,0,0,0,0,0,0,0,0,0,FALSE,0,2019,2019-2020
NC,2020-05-31,inter-ucx,0,1,0,0,0,0,0,0,0,0,0,1,0,1,FALSE,1,2019,2019-2020
NC,2020-05-31,inter-ui,620,503,304,194,133,85,41,19,6,6,805,2716,1425,1928,FALSE,0.709867452135493,2019,2019-2020
NC,2020-05-31,intra-total,29758,24526,16856,11630,8306,5849,3638,1693,355,193,32252,135056,62010,86536,FALSE,0.640741618291672,2019,2019-2020
NC,2020-05-31,intra-ucfe,1,3,2,1,6,2,4,5,5,1,0,30,1,4,FALSE,0.133333333333333,2019,2019-2020
NC,2020-05-31,intra-ucx,29,2,2,4,6,7,7,14,8,4,10,93,39,41,FALSE,0.440860215053763,2019,2019-2020
NC,2020-05-31,intra-ui,29728,24521,16852,11625,8294,5840,3627,1674,342,188,32242,134933,61970,86491,FALSE,0.640992196126967,2019,2019-2020
NC,2020-06-30,inter-total,419,194,171,193,186,177,123,87,91,84,298,2023,717,911,FALSE,0.450321304992585,2019,2019-2020
NC,2020-06-30,inter-ucfe,0,0,0,0,0,0,0,0,2,0,0,2,0,0,FALSE,0,2019,2019-2020
NC,2020-06-30,inter-ucx,2,0,0,0,0,1,1,0,1,0,0,5,2,2,FALSE,0.4,2019,2019-2020
NC,2020-06-30,inter-ui,417,194,171,193,186,176,122,87,88,84,298,2016,715,909,FALSE,0.450892857142857,2019,2019-2020
NC,2020-06-30,intra-total,17637,7642,7268,7574,8277,7058,5796,4437,3440,5248,12152,86529,29789,37431,FALSE,0.432583295773671,2019,2019-2020
NC,2020-06-30,intra-ucfe,3,1,1,0,0,3,2,7,23,65,0,105,3,4,FALSE,0.0380952380952381,2019,2019-2020
NC,2020-06-30,intra-ucx,20,0,5,3,4,8,37,57,36,48,9,227,29,29,FALSE,0.127753303964758,2019,2019-2020
NC,2020-06-30,intra-ui,17614,7641,7262,7571,8273,7047,5757,4373,3381,5135,12143,86197,29757,37398,FALSE,0.433866607886585,2019,2019-2020
NC,2020-07-31,inter-total,320,103,81,43,40,28,38,45,23,81,239,1041,559,662,FALSE,0.635926993275696,2020,2020-2021
NC,2020-07-31,inter-ucfe,0,0,0,0,0,0,1,3,1,3,0,8,0,0,FALSE,0,2020,2020-2021
NC,2020-07-31,inter-ucx,1,1,1,4,4,1,2,4,0,1,1,20,2,3,FALSE,0.15,2020,2020-2021
NC,2020-07-31,inter-ui,319,102,80,39,36,27,35,38,22,77,238,1013,557,659,FALSE,0.650542941757157,2020,2020-2021
NC,2020-07-31,intra-total,13581,4331,2798,2553,1881,1692,1596,1710,1190,3466,10695,45493,24276,28607,FALSE,0.628822016573978,2020,2020-2021
NC,2020-07-31,intra-ucfe,2,19,10,8,14,9,14,17,16,14,10,133,12,31,FALSE,0.233082706766917,2020,2020-2021
NC,2020-07-31,intra-ucx,31,19,25,34,29,22,31,45,24,19,18,297,49,68,FALSE,0.228956228956229,2020,2020-2021
NC,2020-07-31,intra-ui,13548,4293,2763,2511,1838,1661,1551,1648,1150,3433,10667,45063,24215,28508,FALSE,0.632625435501409,2020,2020-2021
NC,2020-08-31,inter-total,185,80,49,40,28,32,21,13,12,67,156,683,341,421,FALSE,0.616398243045388,2020,2020-2021
NC,2020-08-31,inter-ucfe,3,1,1,0,0,0,0,0,0,0,2,7,5,6,FALSE,0.857142857142857,2020,2020-2021
NC,2020-08-31,inter-ucx,2,0,0,0,0,0,0,0,0,1,3,6,5,5,FALSE,0.833333333333333,2020,2020-2021
NC,2020-08-31,inter-ui,180,79,48,40,28,32,21,13,12,66,151,670,331,410,FALSE,0.611940298507463,2020,2020-2021
NC,2020-08-31,intra-total,6204,3126,1852,1402,1133,1094,997,791,674,3547,5816,26636,12020,15146,FALSE,0.568628923261751,2020,2020-2021
NC,2020-08-31,intra-ucfe,11,8,7,4,7,3,0,2,1,20,18,81,29,37,FALSE,0.45679012345679,2020,2020-2021
NC,2020-08-31,intra-ucx,58,24,12,5,5,4,1,2,1,19,24,155,82,106,FALSE,0.683870967741935,2020,2020-2021
NC,2020-08-31,intra-ui,6135,3094,1833,1393,1121,1087,996,787,672,3508,5774,26400,11909,15003,FALSE,0.568295454545455,2020,2020-2021
NC,2020-09-30,inter-total,190,48,24,17,14,5,7,10,4,62,139,520,329,377,FALSE,0.725,2020,2020-2021
NC,2020-09-30,inter-ucfe,0,1,1,0,0,0,0,0,0,0,0,2,0,1,FALSE,0.5,2020,2020-2021
NC,2020-09-30,inter-ucx,1,0,2,2,0,0,0,0,0,0,0,5,1,1,FALSE,0.2,2020,2020-2021
NC,2020-09-30,inter-ui,189,47,21,15,14,5,7,10,4,62,139,513,328,375,FALSE,0.730994152046784,2020,2020-2021
NC,2020-09-30,intra-total,5657,1806,743,506,438,312,279,226,190,2032,4785,16974,10442,12248,FALSE,0.721574172263462,2020,2020-2021
NC,2020-09-30,intra-ucfe,3,7,5,2,1,1,0,1,0,3,4,27,7,14,FALSE,0.518518518518519,2020,2020-2021
NC,2020-09-30,intra-ucx,24,7,13,12,4,0,0,0,1,4,22,87,46,53,FALSE,0.609195402298851,2020,2020-2021
NC,2020-09-30,intra-ui,5630,1792,725,492,433,311,279,225,189,2025,4759,16860,10389,12181,FALSE,0.722479240806643,2020,2020-2021
NC,2020-10-31,inter-total,145,42,21,6,9,3,2,4,4,36,123,395,268,310,FALSE,0.784810126582278,2020,2020-2021
NC,2020-10-31,inter-ucfe,0,0,1,0,0,0,0,1,0,0,1,3,1,1,FALSE,0.333333333333333,2020,2020-2021
NC,2020-10-31,inter-ucx,0,0,2,0,0,0,0,0,0,0,1,3,1,1,FALSE,0.333333333333333,2020,2020-2021
NC,2020-10-31,inter-ui,145,42,18,6,9,3,2,3,4,36,121,389,266,308,FALSE,0.791773778920309,2020,2020-2021
NC,2020-10-31,intra-total,4641,1412,557,395,655,96,79,93,122,1684,3419,13153,8060,9472,FALSE,0.720139892039839,2020,2020-2021
NC,2020-10-31,intra-ucfe,5,8,3,3,0,1,0,0,1,7,7,35,12,20,FALSE,0.571428571428571,2020,2020-2021
NC,2020-10-31,intra-ucx,25,39,25,6,1,4,2,1,1,4,25,133,50,89,FALSE,0.669172932330827,2020,2020-2021
NC,2020-10-31,intra-ui,4611,1365,529,386,654,91,77,92,120,1673,3387,12985,7998,9363,FALSE,0.721062764728533,2020,2020-2021
NC,2020-11-30,inter-total,105,51,18,5,6,1,2,0,0,24,89,301,194,245,FALSE,0.813953488372093,2020,2020-2021
NC,2020-11-30,inter-ucfe,0,0,2,0,0,0,0,0,0,0,1,3,1,1,FALSE,0.333333333333333,2020,2020-2021
NC,2020-11-30,inter-ucx,0,3,1,0,0,0,0,0,0,0,0,4,0,3,FALSE,0.75,2020,2020-2021
NC,2020-11-30,inter-ui,105,48,15,5,6,1,2,0,0,24,88,294,193,241,FALSE,0.819727891156463,2020,2020-2021
NC,2020-11-30,intra-total,2699,1302,551,229,126,68,31,23,26,1010,2413,8478,5112,6414,FALSE,0.75654635527247,2020,2020-2021
NC,2020-11-30,intra-ucfe,0,8,6,2,2,1,0,0,0,5,5,29,5,13,FALSE,0.448275862068966,2020,2020-2021
NC,2020-11-30,intra-ucx,29,15,4,2,1,2,1,1,0,6,27,88,56,71,FALSE,0.806818181818182,2020,2020-2021
NC,2020-11-30,intra-ui,2670,1279,541,225,123,65,30,22,26,999,2381,8361,5051,6330,FALSE,0.757086472909939,2020,2020-2021
NC,2020-12-31,inter-total,128,39,23,6,9,4,1,0,0,42,96,348,224,263,FALSE,0.755747126436782,2020,2020-2021
NC,2020-12-31,inter-ucfe,0,1,0,0,0,0,0,0,0,1,0,2,0,1,FALSE,0.5,2020,2020-2021
NC,2020-12-31,inter-ucx,1,1,0,0,0,0,0,0,0,0,0,2,1,2,FALSE,1,2020,2020-2021
NC,2020-12-31,inter-ui,127,37,23,6,9,4,1,0,0,41,96,344,223,260,FALSE,0.755813953488372,2020,2020-2021
NC,2020-12-31,intra-total,3441,1194,471,263,156,81,69,42,34,1344,3056,10151,6497,7691,FALSE,0.757659343907004,2020,2020-2021
NC,2020-12-31,intra-ucfe,1,6,14,6,5,2,0,0,0,5,5,44,6,12,FALSE,0.272727272727273,2020,2020-2021
NC,2020-12-31,intra-ucx,13,9,4,1,1,0,0,0,0,3,6,37,19,28,FALSE,0.756756756756757,2020,2020-2021
NC,2020-12-31,intra-ui,3427,1179,453,256,150,79,69,42,34,1336,3045,10070,6472,7651,FALSE,0.759781529294935,2020,2020-2021
NC,2021-01-31,inter-total,200,29,19,13,4,2,3,0,1,12,79,362,279,308,FALSE,0.850828729281768,2020,2020-2021
NC,2021-01-31,inter-ucfe,0,0,0,0,1,0,0,0,0,0,1,2,1,1,FALSE,0.5,2020,2020-2021
NC,2021-01-31,inter-ucx,2,0,2,0,0,0,0,0,0,0,0,4,2,2,FALSE,0.5,2020,2020-2021
NC,2021-01-31,inter-ui,198,29,17,13,3,2,3,0,1,12,78,356,276,305,FALSE,0.856741573033708,2020,2020-2021
NC,2021-01-31,intra-total,5691,1471,750,422,175,88,54,34,26,959,3558,13228,9249,10720,FALSE,0.810402177199879,2020,2020-2021
NC,2021-01-31,intra-ucfe,6,1,2,10,3,3,1,0,0,8,5,39,11,12,FALSE,0.307692307692308,2020,2020-2021
NC,2021-01-31,intra-ucx,29,3,16,12,3,0,0,0,0,0,4,67,33,36,FALSE,0.537313432835821,2020,2020-2021
NC,2021-01-31,intra-ui,5656,1467,732,400,169,85,53,34,26,951,3549,13122,9205,10672,FALSE,0.813290656912056,2020,2020-2021
NC,2021-02-28,inter-total,117,34,16,23,11,6,2,0,1,31,95,336,212,246,FALSE,0.732142857142857,2020,2020-2021
NC,2021-02-28,inter-ucfe,0,1,0,0,0,0,0,0,0,1,0,2,0,1,FALSE,0.5,2020,2020-2021
NC,2021-02-28,inter-ucx,0,0,0,0,1,0,0,0,0,0,0,1,0,0,FALSE,0,2020,2020-2021
NC,2021-02-28,inter-ui,117,33,16,23,10,6,2,0,1,30,95,333,212,245,FALSE,0.735735735735736,2020,2020-2021
NC,2021-02-28,intra-total,3239,1223,929,627,403,207,110,48,26,1064,2859,10735,6098,7321,FALSE,0.68197484862599,2020,2020-2021
NC,2021-02-28,intra-ucfe,6,3,2,4,7,4,2,0,0,9,1,38,7,10,FALSE,0.263157894736842,2020,2020-2021
NC,2021-02-28,intra-ucx,21,1,3,0,1,1,2,1,1,12,2,45,23,24,FALSE,0.533333333333333,2020,2020-2021
NC,2021-02-28,intra-ui,3212,1219,924,623,395,202,106,47,25,1043,2856,10652,6068,7287,FALSE,0.68409688321442,2020,2020-2021
NC,2021-03-31,inter-total,117,26,16,21,8,12,14,4,4,42,54,318,171,197,FALSE,0.619496855345912,2020,2020-2021
NC,2021-03-31,inter-ucfe,0,0,1,0,0,0,2,1,0,1,2,7,2,2,FALSE,0.285714285714286,2020,2020-2021
NC,2021-03-31,inter-ucx,2,0,0,0,0,0,2,0,0,1,0,5,2,2,FALSE,0.4,2020,2020-2021
NC,2021-03-31,inter-ui,115,26,15,21,8,12,10,3,4,40,52,306,167,193,FALSE,0.630718954248366,2020,2020-2021
NC,2021-03-31,intra-total,3232,863,753,668,516,442,369,236,124,1287,1478,9968,4710,5573,FALSE,0.559089085072231,2020,2020-2021
NC,2021-03-31,intra-ucfe,4,2,2,2,10,17,8,2,2,11,2,62,6,8,FALSE,0.129032258064516,2020,2020-2021
NC,2021-03-31,intra-ucx,13,2,0,1,0,2,7,15,3,11,5,59,18,20,FALSE,0.338983050847458,2020,2020-2021
NC,2021-03-31,intra-ui,3215,859,751,665,506,423,354,219,119,1265,1471,9847,4686,5545,FALSE,0.563115669747131,2020,2020-2021
NC,2021-04-30,inter-total,65,10,7,2,7,1,3,0,1,11,23,130,88,98,FALSE,0.753846153846154,2020,2020-2021
NC,2021-04-30,inter-ucfe,0,0,0,0,0,0,0,0,0,0,0,0,0,0,FALSE,0,2020,2020-2021
NC,2021-04-30,inter-ucx,0,0,0,0,0,0,0,0,1,0,0,1,0,0,FALSE,0,2020,2020-2021
NC,2021-04-30,inter-ui,65,10,7,2,7,1,3,0,0,11,23,129,88,98,FALSE,0.75968992248062,2020,2020-2021
NC,2021-04-30,intra-total,4861,749,291,243,166,90,52,39,30,545,1891,8957,6752,7501,FALSE,0.83744557329463,2020,2020-2021
NC,2021-04-30,intra-ucfe,0,0,0,3,0,5,4,0,1,3,1,17,1,1,FALSE,0.0588235294117647,2020,2020-2021
NC,2021-04-30,intra-ucx,8,0,0,0,3,4,8,3,0,8,3,37,11,11,FALSE,0.297297297297297,2020,2020-2021
NC,2021-04-30,intra-ui,4853,749,291,240,163,81,40,36,29,534,1887,8903,6740,7489,FALSE,0.841177131304055,2020,2020-2021
NC,2021-05-31,inter-total,151,22,12,7,3,1,4,2,1,39,47,289,198,220,FALSE,0.761245674740485,2020,2020-2021
NC,2021-05-31,inter-ucfe,0,0,0,0,0,0,0,0,0,0,0,0,0,0,FALSE,0,2020,2020-2021
NC,2021-05-31,inter-ucx,1,0,0,0,1,0,2,0,0,0,0,4,1,1,FALSE,0.25,2020,2020-2021
NC,2021-05-31,inter-ui,150,22,12,7,2,1,2,2,1,39,47,285,197,219,FALSE,0.768421052631579,2020,2020-2021
NC,2021-05-31,intra-total,6240,887,536,319,180,131,78,41,36,1059,2059,11566,8299,9186,FALSE,0.794224450977002,2020,2020-2021
NC,2021-05-31,intra-ucfe,0,3,0,0,0,1,0,0,2,16,0,22,0,3,FALSE,0.136363636363636,2020,2020-2021
NC,2021-05-31,intra-ucx,18,1,2,2,4,11,2,3,3,1,4,51,22,23,FALSE,0.450980392156863,2020,2020-2021
NC,2021-05-31,intra-ui,6222,883,534,317,176,119,76,38,31,1042,2055,11493,8277,9160,FALSE,0.797006873749239,2020,2020-2021
NC,2021-06-30,inter-total,93,20,7,5,1,4,0,4,1,21,45,201,138,158,FALSE,0.786069651741294,2020,2020-2021
NC,2021-06-30,inter-ucfe,0,0,0,0,0,0,0,2,0,1,1,4,1,1,FALSE,0.25,2020,2020-2021
NC,2021-06-30,inter-ucx,0,0,0,1,0,1,0,0,0,1,0,3,0,0,FALSE,0,2020,2020-2021
NC,2021-06-30,inter-ui,93,20,7,4,1,3,0,2,1,19,44,194,137,157,FALSE,0.809278350515464,2020,2020-2021
NC,2021-06-30,intra-total,3745,616,283,171,122,118,77,81,63,1028,1700,8004,5445,6061,FALSE,0.757246376811594,2020,2020-2021
NC,2021-06-30,intra-ucfe,6,0,0,0,0,2,0,1,3,11,2,25,8,8,FALSE,0.32,2020,2020-2021
NC,2021-06-30,intra-ucx,12,0,3,3,5,7,0,0,0,6,0,36,12,12,FALSE,0.333333333333333,2020,2020-2021
NC,2021-06-30,intra-ui,3727,616,280,168,117,109,77,80,60,1011,1698,7943,5425,6041,FALSE,0.76054387511016,2020,2020-2021
NC,2021-07-31,inter-total,85,18,7,3,4,1,0,0,2,29,22,171,107,125,FALSE,0.730994152046784,2021,2021-2022
NC,2021-07-31,inter-ucfe,0,0,0,0,0,0,0,0,0,0,0,0,0,0,FALSE,0,2021,2021-2022
NC,2021-07-31,inter-ucx,0,0,0,0,0,0,0,0,0,0,1,1,1,1,FALSE,1,2021,2021-2022
NC,2021-07-31,inter-ui,85,18,7,3,4,1,0,0,2,29,21,170,106,124,FALSE,0.729411764705882,2021,2021-2022
NC,2021-07-31,intra-total,3541,565,234,131,66,46,45,41,35,956,1182,6842,4723,5288,FALSE,0.772873428821982,2021,2021-2022
NC,2021-07-31,intra-ucfe,2,1,0,2,0,1,0,0,0,11,2,19,4,5,FALSE,0.263157894736842,2021,2021-2022
NC,2021-07-31,intra-ucx,8,4,6,10,3,1,0,0,1,4,8,45,16,20,FALSE,0.444444444444444,2021,2021-2022
NC,2021-07-31,intra-ui,3531,560,228,119,63,44,45,41,34,941,1172,6778,4703,5263,FALSE,0.776482738270876,2021,2021-2022
NC,2021-08-31,inter-total,70,6,7,6,2,2,1,0,2,17,31,144,101,107,FALSE,0.743055555555556,2021,2021-2022
NC,2021-08-31,inter-ucfe,0,0,0,0,0,0,0,0,0,1,0,1,0,0,FALSE,0,2021,2021-2022
NC,2021-08-31,inter-ucx,1,0,0,1,0,0,0,0,0,0,0,2,1,1,FALSE,0.5,2021,2021-2022
NC,2021-08-31,inter-ui,69,6,7,5,2,2,1,0,2,16,31,141,100,106,FALSE,0.75177304964539,2021,2021-2022
NC,2021-08-31,intra-total,2520,514,353,240,177,147,98,68,61,816,1297,6291,3817,4331,FALSE,0.688443808615483,2021,2021-2022
NC,2021-08-31,intra-ucfe,0,0,0,0,0,0,0,1,0,19,0,20,0,0,FALSE,0,2021,2021-2022
NC,2021-08-31,intra-ucx,27,0,2,0,0,0,0,0,2,10,7,48,34,34,FALSE,0.708333333333333,2021,2021-2022
NC,2021-08-31,intra-ui,2493,514,351,240,177,147,98,67,59,787,1290,6223,3783,4297,FALSE,0.69050297284268,2021,2021-2022
NC,2021-09-30,inter-total,198,11,5,4,0,2,2,3,1,15,30,271,228,239,FALSE,0.881918819188192,2021,2021-2022
NC,2021-09-30,inter-ucfe,0,0,0,0,0,0,0,0,0,1,0,1,0,0,FALSE,0,2021,2021-2022
NC,2021-09-30,inter-ucx,0,0,0,0,0,0,0,0,1,0,0,1,0,0,FALSE,0,2021,2021-2022
NC,2021-09-30,inter-ui,198,11,5,4,0,2,2,3,0,14,30,269,228,239,FALSE,0.888475836431227,2021,2021-2022
NC,2021-09-30,intra-total,10634,413,306,250,169,152,134,105,91,670,1363,14287,11997,12410,FALSE,0.868621824035837,2021,2021-2022
NC,2021-09-30,intra-ucfe,4,2,0,0,1,1,3,1,2,16,0,30,4,6,FALSE,0.2,2021,2021-2022
NC,2021-09-30,intra-ucx,5,1,5,5,0,1,0,0,0,5,2,24,7,8,FALSE,0.333333333333333,2021,2021-2022
NC,2021-09-30,intra-ui,10625,410,301,245,168,150,131,104,89,649,1361,14233,11986,12396,FALSE,0.870933745520972,2021,2021-2022
NC,2021-10-31,inter-total,55,6,8,4,1,2,1,0,1,18,21,117,76,82,FALSE,0.700854700854701,2021,2021-2022
NC,2021-10-31,inter-ucfe,1,0,0,1,0,0,0,0,0,0,0,2,1,1,FALSE,0.5,2021,2021-2022
NC,2021-10-31,inter-ucx,0,0,0,1,0,0,0,0,0,0,0,1,0,0,FALSE,0,2021,2021-2022
NC,2021-10-31,inter-ui,54,6,8,2,1,2,1,0,1,18,21,114,75,81,FALSE,0.710526315789474,2021,2021-2022
NC,2021-10-31,intra-total,1475,382,261,200,138,126,79,73,61,624,648,4067,2123,2505,FALSE,0.615933120236046,2021,2021-2022
NC,2021-10-31,intra-ucfe,0,0,2,1,1,1,0,0,1,12,3,21,3,3,FALSE,0.142857142857143,2021,2021-2022
NC,2021-10-31,intra-ucx,5,3,1,8,2,1,1,1,0,3,2,27,7,10,FALSE,0.37037037037037,2021,2021-2022
NC,2021-10-31,intra-ui,1470,379,258,191,135,124,78,72,60,609,643,4019,2113,2492,FALSE,0.620054739985071,2021,2021-2022
NC,2021-11-30,inter-total,65,9,5,6,3,1,7,1,3,13,15,128,80,89,FALSE,0.6953125,2021,2021-2022
NC,2021-11-30,inter-ucfe,0,0,0,0,0,0,0,0,0,0,0,0,0,0,FALSE,0,2021,2021-2022
NC,2021-11-30,inter-ucx,0,0,0,0,0,0,0,0,0,0,0,0,0,0,FALSE,0,2021,2021-2022
NC,2021-11-30,inter-ui,65,9,5,6,3,1,7,1,3,13,15,128,80,89,FALSE,0.6953125,2021,2021-2022
NC,2021-11-30,intra-total,1238,323,178,154,126,99,61,51,49,492,554,3325,1792,2115,FALSE,0.63609022556391,2021,2021-2022
NC,2021-11-30,intra-ucfe,0,3,0,0,2,1,1,2,0,13,1,23,1,4,FALSE,0.173913043478261,2021,2021-2022
NC,2021-11-30,intra-ucx,3,1,1,1,3,2,0,0,0,4,1,16,4,5,FALSE,0.3125,2021,2021-2022
NC,2021-11-30,intra-ui,1235,319,177,153,121,96,60,49,49,475,552,3286,1787,2106,FALSE,0.640900791235545,2021,2021-2022
NC,2021-12-31,inter-total,32,4,6,3,2,3,2,1,1,13,13,80,45,49,FALSE,0.6125,2021,2021-2022
NC,2021-12-31,inter-ucfe,1,0,0,0,0,0,0,0,0,0,0,1,1,1,FALSE,1,2021,2021-2022
NC,2021-12-31,inter-ucx,0,0,0,0,0,0,0,0,0,0,0,0,0,0,FALSE,0,2021,2021-2022
NC,2021-12-31,inter-ui,31,4,6,3,2,3,2,1,1,13,13,79,44,48,FALSE,0.607594936708861,2021,2021-2022
NC,2021-12-31,intra-total,670,282,182,181,104,64,49,39,29,377,469,2446,1139,1421,FALSE,0.580948487326247,2021,2021-2022
NC,2021-12-31,intra-ucfe,1,1,1,1,1,0,1,2,1,11,1,21,2,3,FALSE,0.142857142857143,2021,2021-2022
NC,2021-12-31,intra-ucx,5,0,7,2,3,2,2,3,1,4,2,31,7,7,FALSE,0.225806451612903,2021,2021-2022
NC,2021-12-31,intra-ui,664,281,174,178,100,62,46,34,27,362,466,2394,1130,1411,FALSE,0.589390142021721,2021,2021-2022
NC,2022-01-31,inter-total,63,15,13,8,7,4,1,5,1,10,34,161,97,112,FALSE,0.695652173913044,2021,2021-2022
NC,2022-01-31,inter-ucfe,0,1,1,0,0,0,0,1,0,1,0,4,0,1,FALSE,0.25,2021,2021-2022
NC,2022-01-31,inter-ucx,0,0,0,0,0,0,0,0,0,1,0,1,0,0,FALSE,0,2021,2021-2022
NC,2022-01-31,inter-ui,63,14,12,8,7,4,1,4,1,8,34,156,97,111,FALSE,0.711538461538462,2021,2021-2022
NC,2022-01-31,intra-total,1818,491,380,293,174,141,98,67,46,477,654,4639,2472,2963,FALSE,0.638715240353525,2021,2021-2022
NC,2022-01-31,intra-ucfe,2,4,0,2,1,2,2,1,3,8,3,28,5,9,FALSE,0.321428571428571,2021,2021-2022
NC,2022-01-31,intra-ucx,4,1,6,7,1,0,2,2,1,5,2,31,6,7,FALSE,0.225806451612903,2021,2021-2022
NC,2022-01-31,intra-ui,1812,486,374,284,172,139,94,64,42,464,649,4580,2461,2947,FALSE,0.643449781659389,2021,2021-2022
NC,2022-02-28,inter-total,59,15,5,4,1,2,2,1,0,23,19,131,78,93,FALSE,0.709923664122137,2021,2021-2022
NC,2022-02-28,inter-ucfe,0,0,1,1,0,0,0,0,0,0,0,2,0,0,FALSE,0,2021,2021-2022
NC,2022-02-28,inter-ucx,0,1,0,0,0,0,0,0,0,0,0,1,0,1,FALSE,1,2021,2021-2022
NC,2022-02-28,inter-ui,59,14,4,3,1,2,2,1,0,23,19,128,78,92,FALSE,0.71875,2021,2021-2022
NC,2022-02-28,intra-total,1318,446,227,159,120,59,62,37,40,541,580,3589,1898,2344,FALSE,0.653106714962385,2021,2021-2022
NC,2022-02-28,intra-ucfe,3,5,1,2,1,0,0,0,1,7,1,21,4,9,FALSE,0.428571428571429,2021,2021-2022
NC,2022-02-28,intra-ucx,6,6,3,0,0,0,0,0,0,3,6,24,12,18,FALSE,0.75,2021,2021-2022
NC,2022-02-28,intra-ui,1309,435,223,157,119,59,62,37,39,531,573,3544,1882,2317,FALSE,0.653781038374718,2021,2021-2022
NC,2022-03-31,inter-total,32,14,5,2,3,4,2,1,0,27,21,111,53,67,FALSE,0.603603603603604,2021,2021-2022
NC,2022-03-31,inter-ucfe,0,0,0,0,0,0,0,0,0,0,1,1,1,1,FALSE,1,2021,2021-2022
NC,2022-03-31,inter-ucx,0,0,0,0,0,0,0,0,0,0,0,0,0,0,FALSE,0,2021,2021-2022
NC,2022-03-31,inter-ui,32,14,5,2,3,4,2,1,0,27,20,110,52,66,FALSE,0.6,2021,2021-2022
NC,2022-03-31,intra-total,1110,374,203,116,98,70,61,40,32,991,663,3758,1773,2147,FALSE,0.57131452900479,2021,2021-2022
NC,2022-03-31,intra-ucfe,0,3,1,1,2,1,1,2,0,9,3,23,3,6,FALSE,0.260869565217391,2021,2021-2022
NC,2022-03-31,intra-ucx,11,2,3,1,0,0,1,0,0,3,2,23,13,15,FALSE,0.652173913043478,2021,2021-2022
NC,2022-03-31,intra-ui,1099,369,199,114,96,69,59,38,32,979,658,3712,1757,2126,FALSE,0.572737068965517,2021,2021-2022
NC,2022-04-30,inter-total,31,17,10,3,1,2,0,1,0,13,20,98,51,68,FALSE,0.693877551020408,2021,2021-2022
NC,2022-04-30,inter-ucfe,0,0,0,0,0,0,0,0,0,1,0,1,0,0,FALSE,0,2021,2021-2022
NC,2022-04-30,inter-ucx,0,0,0,0,0,0,0,0,0,0,0,0,0,0,FALSE,0,2021,2021-2022
NC,2022-04-30,inter-ui,31,17,10,3,1,2,0,1,0,12,20,97,51,68,FALSE,0.701030927835052,2021,2021-2022
NC,2022-04-30,intra-total,1041,489,268,135,104,55,68,51,48,545,699,3503,1740,2229,FALSE,0.636311732800457,2021,2021-2022
NC,2022-04-30,intra-ucfe,2,1,2,1,1,0,1,0,0,4,1,13,3,4,FALSE,0.307692307692308,2021,2021-2022
NC,2022-04-30,intra-ucx,9,5,2,1,1,2,0,0,0,3,6,29,15,20,FALSE,0.689655172413793,2021,2021-2022
NC,2022-04-30,intra-ui,1030,483,264,133,102,53,67,51,48,538,692,3461,1722,2205,FALSE,0.637099104305114,2021,2021-2022
NC,2022-05-31,inter-total,57,7,3,5,1,0,1,0,0,6,27,107,84,91,FALSE,0.850467289719626,2021,2021-2022
NC,2022-05-31,inter-ucfe,0,0,0,0,0,0,0,0,0,0,0,0,0,0,FALSE,0,2021,2021-2022
NC,2022-05-31,inter-ucx,0,0,0,0,0,0,0,0,0,0,0,0,0,0,FALSE,0,2021,2021-2022
NC,2022-05-31,inter-ui,57,7,3,5,1,0,1,0,0,6,27,107,84,91,FALSE,0.850467289719626,2021,2021-2022
NC,2022-05-31,intra-total,1974,367,197,125,67,68,37,32,26,294,794,3981,2768,3135,FALSE,0.787490580256217,2021,2021-2022
NC,2022-05-31,intra-ucfe,4,0,1,2,1,0,1,0,0,8,3,20,7,7,FALSE,0.35,2021,2021-2022
NC,2022-05-31,intra-ucx,5,1,1,6,1,1,0,1,0,4,1,21,6,7,FALSE,0.333333333333333,2021,2021-2022
NC,2022-05-31,intra-ui,1965,366,195,117,65,67,36,31,26,282,790,3940,2755,3121,FALSE,0.792131979695432,2021,2021-2022
NC,2022-06-30,inter-total,63,6,5,4,1,0,4,1,0,11,28,123,91,97,FALSE,0.788617886178862,2021,2021-2022
NC,2022-06-30,inter-ucfe,0,0,0,0,0,0,0,0,0,1,0,1,0,0,FALSE,0,2021,2021-2022
NC,2022-06-30,inter-ucx,0,0,0,0,0,0,0,0,0,0,0,0,0,0,FALSE,0,2021,2021-2022
NC,2022-06-30,inter-ui,63,6,5,4,1,0,4,1,0,10,28,122,91,97,FALSE,0.795081967213115,2021,2021-2022
NC,2022-06-30,intra-total,2423,265,125,75,77,49,52,28,32,326,897,4349,3320,3585,FALSE,0.82432743159347,2021,2021-2022
NC,2022-06-30,intra-ucfe,3,2,0,0,3,3,0,0,0,4,4,19,7,9,FALSE,0.473684210526316,2021,2021-2022
NC,2022-06-30,intra-ucx,7,0,0,1,7,4,0,0,0,1,1,21,8,8,FALSE,0.380952380952381,2021,2021-2022
NC,2022-06-30,intra-ui,2413,263,125,74,67,42,52,28,32,321,892,4309,3305,3568,FALSE,0.828034346716176,2021,2021-2022
NC,2022-07-31,inter-total,62,7,0,2,0,2,0,2,1,7,24,107,86,93,FALSE,0.869158878504673,2022,2022-2023
NC,2022-07-31,inter-ucfe,0,0,0,0,0,0,0,0,0,0,0,0,0,0,FALSE,0,2022,2022-2023
NC,2022-07-31,inter-ucx,0,0,0,0,0,0,0,0,1,0,0,1,0,0,FALSE,0,2022,2022-2023
NC,2022-07-31,inter-ui,62,7,0,2,0,2,0,2,0,7,24,106,86,93,FALSE,0.877358490566038,2022,2022-2023
NC,2022-07-31,intra-total,2424,290,146,77,47,36,55,49,33,269,884,4310,3308,3598,FALSE,0.834802784222738,2022,2022-2023
NC,2022-07-31,intra-ucfe,1,2,1,1,2,1,0,3,2,3,0,16,1,3,FALSE,0.1875,2022,2022-2023
NC,2022-07-31,intra-ucx,7,0,1,1,6,4,3,3,0,1,1,27,8,8,FALSE,0.296296296296296,2022,2022-2023
NC,2022-07-31,intra-ui,2416,288,144,75,39,31,52,43,31,265,883,4267,3299,3587,FALSE,0.840637450199203,2022,2022-2023
NC,2022-08-31,inter-total,53,10,9,2,1,1,2,0,1,7,24,110,77,87,FALSE,0.790909090909091,2022,2022-2023
NC,2022-08-31,inter-ucfe,0,0,0,0,0,0,0,0,1,0,0,1,0,0,FALSE,0,2022,2022-2023
NC,2022-08-31,inter-ucx,0,0,1,0,0,0,0,0,0,0,0,1,0,0,FALSE,0,2022,2022-2023
NC,2022-08-31,inter-ui,53,10,8,2,1,1,2,0,0,7,24,108,77,87,FALSE,0.805555555555556,2022,2022-2023
NC,2022-08-31,intra-total,2277,276,199,124,139,108,82,53,31,263,867,4419,3144,3420,FALSE,0.773930753564155,2022,2022-2023
NC,2022-08-31,intra-ucfe,2,1,2,0,1,3,4,6,2,12,0,33,2,3,FALSE,0.0909090909090909,2022,2022-2023
NC,2022-08-31,intra-ucx,13,4,6,6,2,0,2,0,0,6,1,40,14,18,FALSE,0.45,2022,2022-2023
NC,2022-08-31,intra-ui,2262,271,191,118,136,105,76,47,29,245,866,4346,3128,3399,FALSE,0.782098481362172,2022,2022-2023
NC,2022-09-30,inter-total,56,5,5,4,4,2,1,0,1,6,27,111,83,88,FALSE,0.792792792792793,2022,2022-2023
NC,2022-09-30,inter-ucfe,0,0,0,0,0,1,0,0,0,0,0,1,0,0,FALSE,0,2022,2022-2023
NC,2022-09-30,inter-ucx,0,0,0,0,0,0,0,0,0,0,1,1,1,1,FALSE,1,2022,2022-2023
NC,2022-09-30,inter-ui,56,5,5,4,4,1,1,0,1,6,26,109,82,87,FALSE,0.798165137614679,2022,2022-2023
NC,2022-09-30,intra-total,2080,291,196,173,164,133,100,50,52,241,710,4190,2790,3081,FALSE,0.735322195704057,2022,2022-2023
NC,2022-09-30,intra-ucfe,2,0,2,0,0,2,0,0,0,10,4,20,6,6,FALSE,0.3,2022,2022-2023
NC,2022-09-30,intra-ucx,16,6,4,1,4,0,0,0,0,24,3,58,19,25,FALSE,0.431034482758621,2022,2022-2023
NC,2022-09-30,intra-ui,2062,285,190,172,160,131,100,50,52,207,703,4112,2765,3050,FALSE,0.741731517509728,2022,2022-2023
NC,2022-10-31,inter-total,54,5,8,1,3,1,1,4,0,8,26,111,80,85,FALSE,0.765765765765766,2022,2022-2023
NC,2022-10-31,inter-ucfe,0,1,0,0,0,0,0,0,0,1,0,2,0,1,FALSE,0.5,2022,2022-2023
NC,2022-10-31,inter-ucx,0,0,0,0,0,0,0,0,0,0,0,0,0,0,FALSE,0,2022,2022-2023
NC,2022-10-31,inter-ui,54,4,8,1,3,1,1,4,0,7,26,109,80,84,FALSE,0.770642201834862,2022,2022-2023
NC,2022-10-31,intra-total,1989,237,170,161,107,76,75,58,29,168,660,3730,2649,2886,FALSE,0.77372654155496,2022,2022-2023
NC,2022-10-31,intra-ucfe,3,0,0,1,0,0,0,1,0,5,1,11,4,4,FALSE,0.363636363636364,2022,2022-2023
NC,2022-10-31,intra-ucx,27,3,2,2,2,0,1,1,0,5,6,49,33,36,FALSE,0.73469387755102,2022,2022-2023
NC,2022-10-31,intra-ui,1959,234,168,158,105,76,74,56,29,158,653,3670,2612,2846,FALSE,0.775476839237057,2022,2022-2023
NC,2022-11-30,inter-total,70,5,12,2,2,4,1,0,2,5,26,129,96,101,FALSE,0.782945736434109,2022,2022-2023
NC,2022-11-30,inter-ucfe,0,0,0,0,0,0,0,0,0,0,2,2,2,2,FALSE,1,2022,2022-2023
NC,2022-11-30,inter-ucx,0,0,0,0,0,0,0,0,0,0,0,0,0,0,FALSE,0,2022,2022-2023
NC,2022-11-30,inter-ui,70,5,12,2,2,4,1,0,2,5,24,127,94,99,FALSE,0.779527559055118,2022,2022-2023
NC,2022-11-30,intra-total,1897,396,220,152,104,75,48,32,37,288,746,3995,2643,3039,FALSE,0.760700876095119,2022,2022-2023
NC,2022-11-30,intra-ucfe,0,1,1,0,1,1,2,0,0,4,2,12,2,3,FALSE,0.25,2022,2022-2023
NC,2022-11-30,intra-ucx,15,1,0,0,0,0,0,0,0,1,6,23,21,22,FALSE,0.956521739130435,2022,2022-2023
NC,2022-11-30,intra-ui,1882,394,219,152,103,74,46,32,37,283,738,3960,2620,3014,FALSE,0.761111111111111,2022,2022-2023
NC,2022-12-31,inter-total,85,12,10,4,0,2,0,1,1,7,23,145,108,120,FALSE,0.827586206896552,2022,2022-2023
NC,2022-12-31,inter-ucfe,0,0,1,1,0,0,0,0,0,0,0,2,0,0,FALSE,0,2022,2022-2023
NC,2022-12-31,inter-ucx,0,0,0,0,0,0,0,0,0,0,0,0,0,0,FALSE,0,2022,2022-2023
NC,2022-12-31,inter-ui,85,12,9,3,0,2,0,1,1,7,23,143,108,120,FALSE,0.839160839160839,2022,2022-2023
NC,2022-12-31,intra-total,2241,603,263,129,91,64,46,46,20,135,775,4413,3016,3619,FALSE,0.82007704509404,2022,2022-2023
NC,2022-12-31,intra-ucfe,2,3,0,1,0,0,0,1,1,0,2,10,4,7,FALSE,0.7,2022,2022-2023
NC,2022-12-31,intra-ucx,14,0,1,0,0,0,0,0,0,4,5,24,19,19,FALSE,0.791666666666667,2022,2022-2023
NC,2022-12-31,intra-ui,2225,600,262,128,91,64,46,45,19,131,768,4379,2993,3593,FALSE,0.820506965060516,2022,2022-2023
NC,2023-01-31,inter-total,85,20,19,4,1,1,2,5,1,4,26,168,111,131,FALSE,0.779761904761905,2022,2022-2023
NC,2023-01-31,inter-ucfe,1,0,0,0,0,0,0,0,0,0,1,2,2,2,FALSE,1,2022,2022-2023
NC,2023-01-31,inter-ucx,0,0,0,0,0,0,0,0,0,0,0,0,0,0,FALSE,0,2022,2022-2023
NC,2023-01-31,inter-ui,84,20,19,4,1,1,2,5,1,4,25,166,109,129,FALSE,0.77710843373494,2022,2022-2023
NC,2023-01-31,intra-total,2814,678,634,266,107,67,71,48,37,189,759,5670,3573,4251,FALSE,0.74973544973545,2022,2022-2023
NC,2023-01-31,intra-ucfe,1,3,3,0,0,0,1,0,0,2,2,12,3,6,FALSE,0.5,2022,2022-2023
NC,2023-01-31,intra-ucx,14,1,1,0,0,0,1,0,0,0,4,21,18,19,FALSE,0.904761904761905,2022,2022-2023
NC,2023-01-31,intra-ui,2799,674,630,266,107,67,69,48,37,187,753,5637,3552,4226,FALSE,0.749689551179706,2022,2022-2023
NC,2023-02-28,inter-total,62,20,14,3,2,3,4,3,0,3,20,134,82,102,FALSE,0.761194029850746,2022,2022-2023
NC,2023-02-28,inter-ucfe,0,1,2,0,0,0,0,0,0,0,0,3,0,1,FALSE,0.333333333333333,2022,2022-2023
NC,2023-02-28,inter-ucx,0,0,0,0,0,0,0,0,0,0,1,1,1,1,FALSE,1,2022,2022-2023
NC,2023-02-28,inter-ui,62,19,12,3,2,3,4,3,0,3,19,130,81,100,FALSE,0.769230769230769,2022,2022-2023
NC,2023-02-28,intra-total,2284,956,457,167,89,63,67,68,36,186,737,5110,3021,3977,FALSE,0.778277886497065,2022,2022-2023
NC,2023-02-28,intra-ucfe,2,1,1,1,0,1,0,1,0,1,2,10,4,5,FALSE,0.5,2022,2022-2023
NC,2023-02-28,intra-ucx,18,1,1,1,2,0,2,0,1,2,4,32,22,23,FALSE,0.71875,2022,2022-2023
NC,2023-02-28,intra-ui,2264,954,455,165,87,62,65,67,35,183,731,5068,2995,3949,FALSE,0.779202841357538,2022,2022-2023
NC,2023-03-31,inter-total,59,18,11,7,2,0,1,0,1,5,27,131,86,104,FALSE,0.793893129770992,2022,2022-2023
NC,2023-03-31,inter-ucfe,0,0,1,2,0,0,0,0,0,0,0,3,0,0,FALSE,0,2022,2022-2023
NC,2023-03-31,inter-ucx,0,0,0,0,0,0,0,0,0,0,0,0,0,0,FALSE,0,2022,2022-2023
NC,2023-03-31,inter-ui,59,18,10,5,2,0,1,0,1,5,27,128,86,104,FALSE,0.8125,2022,2022-2023
NC,2023-03-31,intra-total,1798,843,525,184,83,59,63,67,36,175,668,4501,2466,3309,FALSE,0.735169962230615,2022,2022-2023
NC,2023-03-31,intra-ucfe,0,2,1,0,0,0,0,0,0,1,1,5,1,3,FALSE,0.6,2022,2022-2023
NC,2023-03-31,intra-ucx,18,4,1,0,0,0,0,0,1,5,2,31,20,24,FALSE,0.774193548387097,2022,2022-2023
NC,2023-03-31,intra-ui,1780,837,523,184,83,59,63,67,35,169,665,4465,2445,3282,FALSE,0.73505039193729,2022,2022-2023
NC,2023-04-30,inter-total,53,21,13,2,1,2,0,0,2,4,11,109,64,85,FALSE,0.779816513761468,2022,2022-2023
NC,2023-04-30,inter-ucfe,0,0,0,0,0,0,0,0,0,0,0,0,0,0,FALSE,0,2022,2022-2023
NC,2023-04-30,inter-ucx,0,0,0,0,0,0,0,0,0,0,0,0,0,0,FALSE,0,2022,2022-2023
NC,2023-04-30,inter-ui,53,21,13,2,1,2,0,0,2,4,11,109,64,85,FALSE,0.779816513761468,2022,2022-2023
NC,2023-04-30,intra-total,1916,696,530,167,78,56,43,46,49,189,564,4334,2480,3176,FALSE,0.732810336871251,2022,2022-2023
NC,2023-04-30,intra-ucfe,2,2,1,0,0,0,0,1,1,2,2,11,4,6,FALSE,0.545454545454545,2022,2022-2023
NC,2023-04-30,intra-ucx,21,1,0,1,1,2,0,0,2,5,7,40,28,29,FALSE,0.725,2022,2022-2023
NC,2023-04-30,intra-ui,1893,693,529,166,77,54,43,45,46,182,555,4283,2448,3141,FALSE,0.733364464160635,2022,2022-2023
NC,2023-05-31,inter-total,78,17,9,7,3,2,3,0,1,12,18,150,96,113,FALSE,0.753333333333333,2022,2022-2023
NC,2023-05-31,inter-ucfe,0,0,0,0,0,0,0,0,0,1,0,1,0,0,FALSE,0,2022,2022-2023
NC,2023-05-31,inter-ucx,1,0,0,0,0,0,0,0,0,0,0,1,1,1,FALSE,1,2022,2022-2023
NC,2023-05-31,inter-ui,77,17,9,7,3,2,3,0,1,11,18,148,95,112,FALSE,0.756756756756757,2022,2022-2023
NC,2023-05-31,intra-total,2319,766,525,233,104,63,56,65,62,265,566,5024,2885,3651,FALSE,0.726711783439491,2022,2022-2023
NC,2023-05-31,intra-ucfe,1,0,4,0,0,1,0,0,0,1,3,10,4,4,FALSE,0.4,2022,2022-2023
NC,2023-05-31,intra-ucx,24,0,1,0,0,0,0,0,0,3,3,31,27,27,FALSE,0.870967741935484,2022,2022-2023
NC,2023-05-31,intra-ui,2294,766,520,233,104,62,56,65,62,261,560,4983,2854,3620,FALSE,0.726469997993177,2022,2022-2023
NC,2023-06-30,inter-total,80,11,11,7,4,2,1,0,1,6,20,143,100,111,FALSE,0.776223776223776,2022,2022-2023
NC,2023-06-30,inter-ucfe,0,0,0,0,0,0,0,0,0,0,0,0,0,0,FALSE,0,2022,2022-2023
NC,2023-06-30,inter-ucx,0,1,0,0,0,0,0,0,0,0,0,1,0,1,FALSE,1,2022,2022-2023
NC,2023-06-30,inter-ui,80,10,11,7,4,2,1,0,1,6,20,142,100,110,FALSE,0.774647887323944,2022,2022-2023
NC,2023-06-30,intra-total,2397,522,519,398,152,100,84,73,51,211,746,5253,3143,3665,FALSE,0.697696554349895,2022,2022-2023
NC,2023-06-30,intra-ucfe,1,2,3,2,0,0,0,0,1,1,0,10,1,3,FALSE,0.3,2022,2022-2023
NC,2023-06-30,intra-ucx,22,1,2,1,0,0,2,0,0,0,6,34,28,29,FALSE,0.852941176470588,2022,2022-2023
NC,2023-06-30,intra-ui,2374,519,514,395,152,100,82,73,50,210,740,5209,3114,3633,FALSE,0.697446726818967,2022,2022-2023
NC,2023-07-31,inter-total,73,5,11,12,7,1,2,2,3,3,23,142,96,101,FALSE,0.711267605633803,2023,2023-2024
NC,2023-07-31,inter-ucfe,0,0,1,2,1,0,0,1,0,0,0,5,0,0,FALSE,0,2023,2023-2024
NC,2023-07-31,inter-ucx,1,0,0,0,0,0,0,0,0,0,0,1,1,1,FALSE,1,2023,2023-2024
NC,2023-07-31,inter-ui,72,5,10,10,6,1,2,1,3,3,23,136,95,100,FALSE,0.735294117647059,2023,2023-2024
NC,2023-07-31,intra-total,2344,338,297,372,298,143,74,58,41,213,624,4802,2968,3306,FALSE,0.688463140358184,2023,2023-2024
NC,2023-07-31,intra-ucfe,2,1,2,1,2,1,0,0,0,1,1,11,3,4,FALSE,0.363636363636364,2023,2023-2024
NC,2023-07-31,intra-ucx,13,2,1,0,0,0,0,0,0,0,1,17,14,16,FALSE,0.941176470588235,2023,2023-2024
NC,2023-07-31,intra-ui,2329,335,294,371,296,142,74,58,41,212,622,4774,2951,3286,FALSE,0.688311688311688,2023,2023-2024
NC,2023-08-31,inter-total,81,8,5,8,11,9,1,5,1,4,21,154,102,110,FALSE,0.714285714285714,2023,2023-2024
NC,2023-08-31,inter-ucfe,0,0,0,1,0,0,0,0,0,0,0,1,0,0,FALSE,0,2023,2023-2024
NC,2023-08-31,inter-ucx,0,0,0,0,0,0,0,0,0,0,0,0,0,0,FALSE,0,2023,2023-2024
NC,2023-08-31,inter-ui,81,8,5,7,11,9,1,5,1,4,21,153,102,110,FALSE,0.718954248366013,2023,2023-2024
NC,2023-08-31,intra-total,2452,238,229,389,486,329,134,68,66,319,651,5361,3103,3341,FALSE,0.623204626002612,2023,2023-2024
NC,2023-08-31,intra-ucfe,0,1,1,3,1,2,1,0,0,1,2,12,2,3,FALSE,0.25,2023,2023-2024
NC,2023-08-31,intra-ucx,15,1,0,1,0,1,0,0,0,2,4,24,19,20,FALSE,0.833333333333333,2023,2023-2024
NC,2023-08-31,intra-ui,2437,236,228,385,485,326,133,68,66,316,645,5325,3082,3318,FALSE,0.623098591549296,2023,2023-2024
NC,2023-09-30,inter-total,50,5,1,2,12,7,6,4,1,2,7,97,57,62,FALSE,0.639175257731959,2023,2023-2024
NC,2023-09-30,inter-ucfe,0,0,0,0,0,0,0,0,0,0,0,0,0,0,FALSE,0,2023,2023-2024
NC,2023-09-30,inter-ucx,0,0,0,0,0,0,0,0,0,0,0,0,0,0,FALSE,0,2023,2023-2024
NC,2023-09-30,inter-ui,50,5,1,2,12,7,6,4,1,2,7,97,57,62,FALSE,0.639175257731959,2023,2023-2024
NC,2023-09-30,intra-total,1967,207,194,221,291,513,289,107,77,284,477,4627,2444,2651,FALSE,0.572941430732656,2023,2023-2024
NC,2023-09-30,intra-ucfe,0,0,0,0,0,3,2,1,0,0,0,6,0,0,FALSE,0,2023,2023-2024
NC,2023-09-30,intra-ucx,11,2,0,1,0,0,0,1,0,0,7,22,18,20,FALSE,0.909090909090909,2023,2023-2024
NC,2023-09-30,intra-ui,1956,205,194,220,291,510,287,105,77,284,470,4599,2426,2631,FALSE,0.57208088714938,2023,2023-2024
NC,2023-10-31,inter-total,73,6,9,3,7,13,8,2,0,8,11,140,84,90,FALSE,0.642857142857143,2023,2023-2024
NC,2023-10-31,inter-ucfe,0,0,0,0,0,0,0,0,0,1,0,1,0,0,FALSE,0,2023,2023-2024
NC,2023-10-31,inter-ucx,0,0,0,0,0,0,0,0,0,0,0,0,0,0,FALSE,0,2023,2023-2024
NC,2023-10-31,inter-ui,73,6,9,3,7,13,8,2,0,7,11,139,84,90,FALSE,0.647482014388489,2023,2023-2024
NC,2023-10-31,intra-total,2155,305,267,215,314,404,283,163,74,329,449,4958,2604,2909,FALSE,0.58672851956434,2023,2023-2024
NC,2023-10-31,intra-ucfe,1,1,0,2,3,1,3,4,1,4,1,21,2,3,FALSE,0.142857142857143,2023,2023-2024
NC,2023-10-31,intra-ucx,14,3,1,0,0,0,3,1,0,2,7,31,21,24,FALSE,0.774193548387097,2023,2023-2024
NC,2023-10-31,intra-ui,2140,301,266,213,311,403,277,158,73,323,441,4906,2581,2882,FALSE,0.587443946188341,2023,2023-2024
NC,2023-11-30,inter-total,61,9,8,6,10,5,7,3,0,10,20,139,81,90,FALSE,0.647482014388489,2023,2023-2024
NC,2023-11-30,inter-ucfe,1,0,0,0,0,0,1,0,0,0,1,3,2,2,FALSE,0.666666666666667,2023,2023-2024
NC,2023-11-30,inter-ucx,2,0,0,0,0,0,0,0,0,0,0,2,2,2,FALSE,1,2023,2023-2024
NC,2023-11-30,inter-ui,58,9,8,6,10,5,6,3,0,10,19,134,77,86,FALSE,0.641791044776119,2023,2023-2024
NC,2023-11-30,intra-total,1813,416,282,264,303,306,247,152,64,290,619,4756,2432,2848,FALSE,0.598822539949537,2023,2023-2024
NC,2023-11-30,intra-ucfe,2,1,3,0,1,2,0,0,0,6,2,17,4,5,FALSE,0.294117647058824,2023,2023-2024
NC,2023-11-30,intra-ucx,13,0,2,1,0,2,0,0,0,1,4,23,17,17,FALSE,0.739130434782609,2023,2023-2024
NC,2023-11-30,intra-ui,1798,415,277,263,302,302,247,152,64,283,613,4716,2411,2826,FALSE,0.599236641221374,2023,2023-2024
NC,2023-12-31,inter-total,82,10,4,4,6,2,3,5,2,3,20,141,102,112,FALSE,0.794326241134752,2023,2023-2024
NC,2023-12-31,inter-ucfe,0,2,0,0,0,0,0,0,0,1,0,3,0,2,FALSE,0.666666666666667,2023,2023-2024
NC,2023-12-31,inter-ucx,0,0,0,0,0,0,0,0,0,0,0,0,0,0,FALSE,0,2023,2023-2024
NC,2023-12-31,inter-ui,82,8,4,4,6,2,3,5,2,2,20,138,102,110,FALSE,0.797101449275362,2023,2023-2024
NC,2023-12-31,intra-total,2028,389,394,305,241,254,175,134,68,268,515,4771,2543,2932,FALSE,0.614546216726053,2023,2023-2024
NC,2023-12-31,intra-ucfe,0,0,0,3,0,4,1,1,0,2,1,12,1,1,FALSE,0.0833333333333333,2023,2023-2024
NC,2023-12-31,intra-ucx,19,1,0,1,0,2,1,0,0,3,5,32,24,25,FALSE,0.78125,2023,2023-2024
NC,2023-12-31,intra-ui,2009,388,394,301,241,248,173,133,68,263,509,4727,2518,2906,FALSE,0.614766236513645,2023,2023-2024
NC,2024-01-31,inter-total,81,13,13,4,6,3,6,2,0,10,35,173,116,129,FALSE,0.745664739884393,2023,2023-2024
NC,2024-01-31,inter-ucfe,1,0,0,0,0,0,0,0,0,0,2,3,3,3,FALSE,1,2023,2023-2024
NC,2024-01-31,inter-ucx,1,0,0,0,0,0,0,0,0,0,0,1,1,1,FALSE,1,2023,2023-2024
NC,2024-01-31,inter-ui,79,13,13,4,6,3,6,2,0,10,33,169,112,125,FALSE,0.739644970414201,2023,2023-2024
NC,2024-01-31,intra-total,3091,571,423,257,195,158,132,86,48,358,1032,6351,4123,4694,FALSE,0.739096205321997,2023,2023-2024
NC,2024-01-31,intra-ucfe,1,3,6,2,1,0,2,1,0,1,7,24,8,11,FALSE,0.458333333333333,2023,2023-2024
NC,2024-01-31,intra-ucx,21,2,3,0,1,0,1,0,0,4,4,36,25,27,FALSE,0.75,2023,2023-2024
NC,2024-01-31,intra-ui,3069,566,414,255,193,158,129,85,48,353,1021,6291,4090,4656,FALSE,0.740104911778732,2023,2023-2024
NC,2024-02-29,inter-total,75,15,7,4,1,2,1,0,0,3,28,136,103,118,FALSE,0.867647058823529,2023,2023-2024
NC,2024-02-29,inter-ucfe,0,1,0,0,0,0,0,0,0,0,0,1,0,1,FALSE,1,2023,2023-2024
NC,2024-02-29,inter-ucx,1,0,0,0,0,0,0,0,0,0,0,1,1,1,FALSE,1,2023,2023-2024
NC,2024-02-29,inter-ui,74,14,7,4,1,2,1,0,0,3,28,134,102,116,FALSE,0.865671641791045,2023,2023-2024
NC,2024-02-29,intra-total,2802,513,237,123,72,68,50,46,39,242,1129,5321,3931,4444,FALSE,0.835181356887803,2023,2023-2024
NC,2024-02-29,intra-ucfe,0,0,1,0,0,0,0,0,1,1,1,4,1,1,FALSE,0.25,2023,2023-2024
NC,2024-02-29,intra-ucx,9,1,3,0,0,0,0,1,0,3,9,26,18,19,FALSE,0.730769230769231,2023,2023-2024
NC,2024-02-29,intra-ui,2793,512,233,123,72,68,50,45,38,238,1119,5291,3912,4424,FALSE,0.836136836136836,2023,2023-2024
NC,2024-03-31,inter-total,76,7,6,3,4,4,1,1,1,5,30,138,106,113,FALSE,0.818840579710145,2023,2023-2024
NC,2024-03-31,inter-ucfe,0,0,0,0,0,0,1,0,0,0,0,1,0,0,FALSE,0,2023,2023-2024
NC,2024-03-31,inter-ucx,1,0,0,0,0,0,0,0,0,0,0,1,1,1,FALSE,1,2023,2023-2024
NC,2024-03-31,inter-ui,75,7,6,3,4,4,0,1,1,5,30,136,105,112,FALSE,0.823529411764706,2023,2023-2024
NC,2024-03-31,intra-total,2445,517,244,100,81,88,59,38,61,209,1229,5071,3674,4191,FALSE,0.82646420824295,2023,2023-2024
NC,2024-03-31,intra-ucfe,0,2,0,1,0,2,0,0,0,1,3,9,3,5,FALSE,0.555555555555556,2023,2023-2024
NC,2024-03-31,intra-ucx,22,1,0,0,0,2,0,0,0,1,5,31,27,28,FALSE,0.903225806451613,2023,2023-2024
NC,2024-03-31,intra-ui,2423,514,244,99,81,84,59,38,61,207,1221,5031,3644,4158,FALSE,0.826475849731664,2023,2023-2024
NC,2024-04-30,inter-total,82,9,2,7,0,1,2,3,3,4,32,145,114,123,FALSE,0.848275862068966,2023,2023-2024
NC,2024-04-30,inter-ucfe,0,0,0,0,0,0,0,0,0,0,0,0,0,0,FALSE,0,2023,2023-2024
NC,2024-04-30,inter-ucx,0,0,0,0,0,0,0,0,0,0,0,0,0,0,FALSE,0,2023,2023-2024
NC,2024-04-30,inter-ui,82,9,2,7,0,1,2,3,3,4,32,145,114,123,FALSE,0.848275862068966,2023,2023-2024
NC,2024-04-30,intra-total,2923,352,159,90,55,38,75,62,38,198,1126,5116,4049,4401,FALSE,0.86024237685692,2023,2023-2024
NC,2024-04-30,intra-ucfe,1,3,0,0,0,0,0,1,0,5,1,11,2,5,FALSE,0.454545454545455,2023,2023-2024
NC,2024-04-30,intra-ucx,19,4,1,2,0,1,0,0,0,2,3,32,22,26,FALSE,0.8125,2023,2023-2024
NC,2024-04-30,intra-ui,2903,345,158,88,55,37,75,61,38,191,1122,5073,4025,4370,FALSE,0.861423220973783,2023,2023-2024
NC,2024-05-31,inter-total,79,7,2,1,2,1,0,4,1,4,27,128,106,113,FALSE,0.8828125,2023,2023-2024
NC,2024-05-31,inter-ucfe,0,0,0,0,0,0,0,0,0,0,0,0,0,0,FALSE,0,2023,2023-2024
NC,2024-05-31,inter-ucx,0,0,0,0,0,0,0,0,0,0,0,0,0,0,FALSE,0,2023,2023-2024
NC,2024-05-31,inter-ui,79,7,2,1,2,1,0,4,1,4,27,128,106,113,FALSE,0.8828125,2023,2023-2024
NC,2024-05-31,intra-total,2990,289,125,76,41,46,48,57,38,190,1223,5123,4213,4502,FALSE,0.878781963693149,2023,2023-2024
NC,2024-05-31,intra-ucfe,1,1,0,2,0,1,0,1,1,1,5,13,6,7,FALSE,0.538461538461538,2023,2023-2024
NC,2024-05-31,intra-ucx,35,0,0,0,1,0,0,0,0,2,6,44,41,41,FALSE,0.931818181818182,2023,2023-2024
NC,2024-05-31,intra-ui,2954,288,125,74,40,45,48,56,37,187,1212,5066,4166,4454,FALSE,0.879194630872483,2023,2023-2024
NC,2024-06-30,inter-total,83,12,3,1,0,0,1,1,1,2,33,137,116,128,FALSE,0.934306569343066,2023,2023-2024
NC,2024-06-30,inter-ucfe,1,0,0,1,0,0,0,0,0,0,0,2,1,1,FALSE,0.5,2023,2023-2024
NC,2024-06-30,inter-ucx,0,0,0,0,0,0,0,0,0,0,0,0,0,0,FALSE,0,2023,2023-2024
NC,2024-06-30,inter-ui,82,12,3,0,0,0,1,1,1,2,33,135,115,127,FALSE,0.940740740740741,2023,2023-2024
NC,2024-06-30,intra-total,2861,517,132,83,31,50,59,39,30,152,1321,5275,4182,4699,FALSE,0.890805687203791,2023,2023-2024
NC,2024-06-30,intra-ucfe,1,0,2,2,0,0,1,0,0,1,1,8,2,2,FALSE,0.25,2023,2023-2024
NC,2024-06-30,intra-ucx,16,0,2,1,0,1,0,0,0,4,7,31,23,23,FALSE,0.741935483870968,2023,2023-2024
NC,2024-06-30,intra-ui,2844,517,128,80,31,49,58,39,30,147,1313,5236,4157,4674,FALSE,0.89266615737204,2023,2023-2024
NC,2024-07-31,inter-total,96,9,6,0,2,2,0,1,1,6,39,162,135,144,FALSE,0.888888888888889,2024,2024-2025
NC,2024-07-31,inter-ucfe,0,0,1,0,0,0,0,0,0,0,0,1,0,0,FALSE,0,2024,2024-2025
NC,2024-07-31,inter-ucx,0,0,0,0,0,0,0,0,0,0,0,0,0,0,FALSE,0,2024,2024-2025
NC,2024-07-31,inter-ui,96,9,5,0,2,2,0,1,1,6,39,161,135,144,FALSE,0.894409937888199,2024,2024-2025
NC,2024-07-31,intra-total,2827,598,191,68,44,35,42,62,53,203,1474,5597,4301,4899,FALSE,0.875290334107558,2024,2024-2025
NC,2024-07-31,intra-ucfe,3,1,2,1,1,0,0,1,0,2,4,15,7,8,FALSE,0.533333333333333,2024,2024-2025
NC,2024-07-31,intra-ucx,27,2,1,1,1,0,0,0,0,1,7,40,34,36,FALSE,0.9,2024,2024-2025
NC,2024-07-31,intra-ui,2797,595,188,66,42,35,42,61,53,200,1463,5542,4260,4855,FALSE,0.876037531577048,2024,2024-2025
NC,2024-08-31,inter-total,95,14,4,3,0,0,0,1,1,5,38,161,133,147,FALSE,0.91304347826087,2024,2024-2025
NC,2024-08-31,inter-ucfe,0,0,0,0,0,0,0,0,0,0,0,0,0,0,FALSE,0,2024,2024-2025
NC,2024-08-31,inter-ucx,0,0,0,0,0,0,0,0,0,0,0,0,0,0,FALSE,0,2024,2024-2025
NC,2024-08-31,inter-ui,95,14,4,3,0,0,0,1,1,5,38,161,133,147,FALSE,0.91304347826087,2024,2024-2025
NC,2024-08-31,intra-total,3217,413,163,87,35,25,19,40,62,183,1285,5529,4502,4915,FALSE,0.888949177066377,2024,2024-2025
NC,2024-08-31,intra-ucfe,1,2,4,1,0,1,0,0,0,0,1,10,2,4,FALSE,0.4,2024,2024-2025
NC,2024-08-31,intra-ucx,18,2,2,1,0,0,0,1,1,2,7,34,25,27,FALSE,0.794117647058824,2024,2024-2025
NC,2024-08-31,intra-ui,3198,409,157,85,35,24,19,39,61,181,1277,5485,4475,4884,FALSE,0.890428441203282,2024,2024-2025
NC,2024-09-30,inter-total,71,4,2,1,0,0,1,0,0,4,29,112,100,104,FALSE,0.928571428571429,2024,2024-2025
NC,2024-09-30,inter-ucfe,1,0,0,0,0,0,0,0,0,0,0,1,1,1,FALSE,1,2024,2024-2025
NC,2024-09-30,inter-ucx,1,0,0,0,0,0,0,0,0,0,0,1,1,1,FALSE,1,2024,2024-2025
NC,2024-09-30,inter-ui,69,4,2,1,0,0,1,0,0,4,29,110,98,102,FALSE,0.927272727272727,2024,2024-2025
NC,2024-09-30,intra-total,2662,214,84,37,25,27,16,26,54,245,1088,4478,3750,3964,FALSE,0.885216614560072,2024,2024-2025
NC,2024-09-30,intra-ucfe,3,1,0,1,0,0,0,0,1,2,2,10,5,6,FALSE,0.6,2024,2024-2025
NC,2024-09-30,intra-ucx,24,1,2,1,0,0,0,0,0,1,2,31,26,27,FALSE,0.870967741935484,2024,2024-2025
NC,2024-09-30,intra-ui,2635,212,82,35,25,27,16,26,53,242,1084,4437,3719,3931,FALSE,0.885958981293667,2024,2024-2025
NC,2024-10-31,inter-total,92,16,10,1,0,2,0,4,1,8,52,186,144,160,FALSE,0.860215053763441,2024,2024-2025
NC,2024-10-31,inter-ucfe,0,0,0,0,0,0,0,0,0,0,1,1,1,1,FALSE,1,2024,2024-2025
NC,2024-10-31,inter-ucx,0,0,0,0,0,0,0,0,0,0,0,0,0,0,FALSE,0,2024,2024-2025
NC,2024-10-31,inter-ui,92,16,10,1,0,2,0,4,1,8,51,185,143,159,FALSE,0.85945945945946,2024,2024-2025
NC,2024-10-31,intra-total,4421,2280,603,39,22,17,31,50,62,316,5322,13163,9743,12023,FALSE,0.913393603281927,2024,2024-2025
NC,2024-10-31,intra-ucfe,1,2,3,0,0,0,0,1,2,3,0,12,1,3,FALSE,0.25,2024,2024-2025
NC,2024-10-31,intra-ucx,16,3,0,0,0,0,0,0,0,1,1,21,17,20,FALSE,0.952380952380952,2024,2024-2025
NC,2024-10-31,intra-ui,4404,2275,600,39,22,17,31,49,60,312,5321,13130,9725,12000,FALSE,0.913937547600914,2024,2024-2025
NC,2024-11-30,inter-total,87,9,4,8,1,0,2,1,1,4,33,150,120,129,FALSE,0.86,2024,2024-2025
NC,2024-11-30,inter-ucfe,0,0,0,0,0,0,0,0,0,0,0,0,0,0,FALSE,0,2024,2024-2025
NC,2024-11-30,inter-ucx,0,1,0,0,0,0,0,0,0,0,0,1,0,1,FALSE,1,2024,2024-2025
NC,2024-11-30,inter-ui,87,8,4,8,1,0,2,1,1,4,33,149,120,128,FALSE,0.859060402684564,2024,2024-2025
NC,2024-11-30,intra-total,2516,672,727,535,509,442,280,45,41,231,1565,7563,4081,4753,FALSE,0.628454317069946,2024,2024-2025
NC,2024-11-30,intra-ucfe,1,0,3,1,4,3,0,0,0,1,3,16,4,4,FALSE,0.25,2024,2024-2025
NC,2024-11-30,intra-ucx,13,3,1,0,0,1,1,0,0,6,14,39,27,30,FALSE,0.769230769230769,2024,2024-2025
NC,2024-11-30,intra-ui,2502,669,723,534,505,438,279,45,41,224,1548,7508,4050,4719,FALSE,0.628529568460309,2024,2024-2025
NC,2024-12-31,inter-total,116,18,9,4,1,4,3,5,1,3,47,211,163,181,FALSE,0.85781990521327,2024,2024-2025
NC,2024-12-31,inter-ucfe,0,2,2,0,0,0,0,0,0,0,1,5,1,3,FALSE,0.6,2024,2024-2025
NC,2024-12-31,inter-ucx,1,0,0,1,0,0,0,0,0,0,0,2,1,1,FALSE,0.5,2024,2024-2025
NC,2024-12-31,inter-ui,115,16,7,3,1,4,3,5,1,3,46,204,161,177,FALSE,0.867647058823529,2024,2024-2025
NC,2024-12-31,intra-total,2934,765,334,153,91,97,215,3336,302,324,1684,10235,4618,5383,FALSE,0.525940400586224,2024,2024-2025
NC,2024-12-31,intra-ucfe,1,2,1,2,0,2,1,3,1,0,1,14,2,4,FALSE,0.285714285714286,2024,2024-2025
NC,2024-12-31,intra-ucx,23,3,2,0,0,1,2,0,0,1,8,40,31,34,FALSE,0.85,2024,2024-2025
NC,2024-12-31,intra-ui,2910,760,331,151,91,94,212,3333,301,323,1675,10181,4585,5345,FALSE,0.524997544445536,2024,2024-2025
ND,2019-01-31,inter-total,221,4,0,2,1,0,1,0,0,0,12,241,233,237,FALSE,0.983402489626556,2018,2018-2019
ND,2019-01-31,inter-ucfe,1,0,0,0,0,0,0,0,0,0,0,1,1,1,FALSE,1,2018,2018-2019
ND,2019-01-31,inter-ucx,0,0,0,0,0,0,0,0,0,0,0,0,0,0,FALSE,0,2018,2018-2019
ND,2019-01-31,inter-ui,220,4,0,2,1,0,1,0,0,0,12,240,232,236,FALSE,0.983333333333333,2018,2018-2019
ND,2019-01-31,intra-total,2514,17,3,1,1,1,0,0,0,2,109,2648,2623,2640,FALSE,0.996978851963746,2018,2018-2019
ND,2019-01-31,intra-ucfe,98,3,1,0,0,0,0,0,0,0,19,121,117,120,FALSE,0.991735537190083,2018,2018-2019
ND,2019-01-31,intra-ucx,1,1,0,0,0,0,0,0,0,0,0,2,1,2,FALSE,1,2018,2018-2019
ND,2019-01-31,intra-ui,2415,13,2,1,1,1,0,0,0,2,90,2525,2505,2518,FALSE,0.997227722772277,2018,2018-2019
ND,2019-02-28,inter-total,125,3,0,0,0,1,0,1,1,0,5,136,130,133,FALSE,0.977941176470588,2018,2018-2019
ND,2019-02-28,inter-ucfe,0,0,0,0,0,0,0,0,1,0,0,1,0,0,FALSE,0,2018,2018-2019
ND,2019-02-28,inter-ucx,0,0,0,0,0,0,0,0,0,0,0,0,0,0,FALSE,0,2018,2018-2019
ND,2019-02-28,inter-ui,125,3,0,0,0,1,0,1,0,0,5,135,130,133,FALSE,0.985185185185185,2018,2018-2019
ND,2019-02-28,intra-total,1129,13,2,1,2,0,0,1,2,1,75,1226,1204,1217,FALSE,0.992659053833605,2018,2018-2019
ND,2019-02-28,intra-ucfe,2,0,0,0,0,0,0,0,0,0,0,2,2,2,FALSE,1,2018,2018-2019
ND,2019-02-28,intra-ucx,0,0,0,0,0,0,0,0,0,0,0,0,0,0,FALSE,0,2018,2018-2019
ND,2019-02-28,intra-ui,1127,13,2,1,2,0,0,1,2,1,75,1224,1202,1215,FALSE,0.992647058823529,2018,2018-2019
ND,2019-03-31,inter-total,81,0,1,1,0,0,0,0,0,6,7,96,88,88,FALSE,0.916666666666667,2018,2018-2019
ND,2019-03-31,inter-ucfe,1,0,0,0,0,0,0,0,0,0,0,1,1,1,FALSE,1,2018,2018-2019
ND,2019-03-31,inter-ucx,0,0,0,0,0,0,0,0,0,0,0,0,0,0,FALSE,0,2018,2018-2019
ND,2019-03-31,inter-ui,80,0,1,1,0,0,0,0,0,6,7,95,87,87,FALSE,0.91578947368421,2018,2018-2019
ND,2019-03-31,intra-total,432,14,3,3,0,1,2,0,0,0,45,500,477,491,FALSE,0.982,2018,2018-2019
ND,2019-03-31,intra-ucfe,2,0,0,0,0,0,0,0,0,0,1,3,3,3,FALSE,1,2018,2018-2019
ND,2019-03-31,intra-ucx,0,0,0,0,0,0,0,0,0,0,1,1,1,1,FALSE,1,2018,2018-2019
ND,2019-03-31,intra-ui,430,14,3,3,0,1,2,0,0,0,43,496,473,487,FALSE,0.981854838709677,2018,2018-2019
ND,2019-04-30,inter-total,62,1,0,0,1,0,0,0,0,0,2,66,64,65,FALSE,0.984848484848485,2018,2018-2019
ND,2019-04-30,inter-ucfe,0,0,0,0,0,0,0,0,0,0,0,0,0,0,FALSE,0,2018,2018-2019
ND,2019-04-30,inter-ucx,0,0,0,0,0,0,0,0,0,0,0,0,0,0,FALSE,0,2018,2018-2019
ND,2019-04-30,inter-ui,62,1,0,0,1,0,0,0,0,0,2,66,64,65,FALSE,0.984848484848485,2018,2018-2019
ND,2019-04-30,intra-total,321,3,0,0,2,1,0,0,0,1,25,353,346,349,FALSE,0.988668555240793,2018,2018-2019
ND,2019-04-30,intra-ucfe,4,0,0,0,0,0,0,0,0,0,0,4,4,4,FALSE,1,2018,2018-2019
ND,2019-04-30,intra-ucx,0,0,0,0,0,0,0,0,0,0,0,0,0,0,FALSE,0,2018,2018-2019
ND,2019-04-30,intra-ui,317,3,0,0,2,1,0,0,0,1,25,349,342,345,FALSE,0.988538681948424,2018,2018-2019
ND,2019-05-31,inter-total,67,0,0,0,0,0,0,0,0,0,3,70,70,70,FALSE,1,2018,2018-2019
ND,2019-05-31,inter-ucfe,0,0,0,0,0,0,0,0,0,0,0,0,0,0,FALSE,0,2018,2018-2019
ND,2019-05-31,inter-ucx,0,0,0,0,0,0,0,0,0,0,0,0,0,0,FALSE,0,2018,2018-2019
ND,2019-05-31,inter-ui,67,0,0,0,0,0,0,0,0,0,3,70,70,70,FALSE,1,2018,2018-2019
ND,2019-05-31,intra-total,312,3,3,0,0,0,1,0,0,1,24,344,336,339,FALSE,0.98546511627907,2018,2018-2019
ND,2019-05-31,intra-ucfe,3,0,0,0,0,0,0,0,0,0,1,4,4,4,FALSE,1,2018,2018-2019
ND,2019-05-31,intra-ucx,1,0,0,0,0,0,0,0,0,0,0,1,1,1,FALSE,1,2018,2018-2019
ND,2019-05-31,intra-ui,308,3,3,0,0,0,1,0,0,1,23,339,331,334,FALSE,0.985250737463127,2018,2018-2019
ND,2019-06-30,inter-total,40,1,0,0,0,0,0,0,0,0,3,44,43,44,FALSE,1,2018,2018-2019
ND,2019-06-30,inter-ucfe,0,0,0,0,0,0,0,0,0,0,0,0,0,0,FALSE,0,2018,2018-2019
ND,2019-06-30,inter-ucx,0,0,0,0,0,0,0,0,0,0,0,0,0,0,FALSE,0,2018,2018-2019
ND,2019-06-30,inter-ui,40,1,0,0,0,0,0,0,0,0,3,44,43,44,FALSE,1,2018,2018-2019
ND,2019-06-30,intra-total,412,8,1,3,2,0,0,0,0,3,16,445,428,436,FALSE,0.979775280898876,2018,2018-2019
ND,2019-06-30,intra-ucfe,34,1,0,0,0,0,0,0,0,0,0,35,34,35,FALSE,1,2018,2018-2019
ND,2019-06-30,intra-ucx,0,0,0,0,0,0,0,0,0,0,0,0,0,0,FALSE,0,2018,2018-2019
ND,2019-06-30,intra-ui,378,7,1,3,2,0,0,0,0,3,16,410,394,401,FALSE,0.978048780487805,2018,2018-2019
ND,2019-07-31,inter-total,66,3,0,0,0,0,0,0,0,0,3,72,69,72,FALSE,1,2019,2019-2020
ND,2019-07-31,inter-ucfe,0,0,0,0,0,0,0,0,0,0,0,0,0,0,FALSE,0,2019,2019-2020
ND,2019-07-31,inter-ucx,0,0,0,0,0,0,0,0,0,0,0,0,0,0,FALSE,0,2019,2019-2020
ND,2019-07-31,inter-ui,66,3,0,0,0,0,0,0,0,0,3,72,69,72,FALSE,1,2019,2019-2020
ND,2019-07-31,intra-total,598,3,1,0,0,0,0,0,0,0,25,627,623,626,FALSE,0.998405103668262,2019,2019-2020
ND,2019-07-31,intra-ucfe,107,0,0,0,0,0,0,0,0,0,2,109,109,109,FALSE,1,2019,2019-2020
ND,2019-07-31,intra-ucx,1,0,0,0,0,0,0,0,0,0,0,1,1,1,FALSE,1,2019,2019-2020
ND,2019-07-31,intra-ui,490,3,1,0,0,0,0,0,0,0,23,517,513,516,FALSE,0.998065764023211,2019,2019-2020
ND,2019-08-31,inter-total,57,2,0,0,0,0,0,0,0,1,3,63,60,62,FALSE,0.984126984126984,2019,2019-2020
ND,2019-08-31,inter-ucfe,0,0,0,0,0,0,0,0,0,0,0,0,0,0,FALSE,0,2019,2019-2020
ND,2019-08-31,inter-ucx,0,0,0,0,0,0,0,0,0,0,0,0,0,0,FALSE,0,2019,2019-2020
ND,2019-08-31,inter-ui,57,2,0,0,0,0,0,0,0,1,3,63,60,62,FALSE,0.984126984126984,2019,2019-2020
ND,2019-08-31,intra-total,252,6,2,0,0,2,2,0,0,3,25,292,277,283,FALSE,0.969178082191781,2019,2019-2020
ND,2019-08-31,intra-ucfe,8,0,0,0,0,1,0,0,0,0,0,9,8,8,FALSE,0.888888888888889,2019,2019-2020
ND,2019-08-31,intra-ucx,0,0,0,0,0,0,0,0,0,0,0,0,0,0,FALSE,0,2019,2019-2020
ND,2019-08-31,intra-ui,244,6,2,0,0,1,2,0,0,3,25,283,269,275,FALSE,0.971731448763251,2019,2019-2020
ND,2019-09-30,inter-total,66,4,2,0,0,0,0,0,0,1,6,79,72,76,FALSE,0.962025316455696,2019,2019-2020
ND,2019-09-30,inter-ucfe,0,0,0,0,0,0,0,0,0,0,0,0,0,0,FALSE,0,2019,2019-2020
ND,2019-09-30,inter-ucx,0,0,0,0,0,0,0,0,0,0,0,0,0,0,FALSE,0,2019,2019-2020
ND,2019-09-30,inter-ui,66,4,2,0,0,0,0,0,0,1,6,79,72,76,FALSE,0.962025316455696,2019,2019-2020
ND,2019-09-30,intra-total,284,0,1,0,0,0,0,0,0,0,25,310,309,309,FALSE,0.996774193548387,2019,2019-2020
ND,2019-09-30,intra-ucfe,0,0,0,0,0,0,0,0,0,0,1,1,1,1,FALSE,1,2019,2019-2020
ND,2019-09-30,intra-ucx,1,0,0,0,0,0,0,0,0,0,0,1,1,1,FALSE,1,2019,2019-2020
ND,2019-09-30,intra-ui,283,0,1,0,0,0,0,0,0,0,24,308,307,307,FALSE,0.996753246753247,2019,2019-2020
ND,2019-10-31,inter-total,77,3,0,2,0,0,0,0,0,1,5,88,82,85,FALSE,0.965909090909091,2019,2019-2020
ND,2019-10-31,inter-ucfe,0,0,0,0,0,0,0,0,0,0,0,0,0,0,FALSE,0,2019,2019-2020
ND,2019-10-31,inter-ucx,0,0,0,0,0,0,0,0,0,0,0,0,0,0,FALSE,0,2019,2019-2020
ND,2019-10-31,inter-ui,77,3,0,2,0,0,0,0,0,1,5,88,82,85,FALSE,0.965909090909091,2019,2019-2020
ND,2019-10-31,intra-total,194,6,0,0,1,0,1,0,0,0,16,218,210,216,FALSE,0.990825688073395,2019,2019-2020
ND,2019-10-31,intra-ucfe,0,0,0,0,0,0,0,0,0,0,0,0,0,0,FALSE,0,2019,2019-2020
ND,2019-10-31,intra-ucx,0,0,0,0,0,0,0,0,0,0,0,0,0,0,FALSE,0,2019,2019-2020
ND,2019-10-31,intra-ui,194,6,0,0,1,0,1,0,0,0,16,218,210,216,FALSE,0.990825688073395,2019,2019-2020
ND,2019-11-30,inter-total,191,3,1,1,0,0,0,0,0,2,12,210,203,206,FALSE,0.980952380952381,2019,2019-2020
ND,2019-11-30,inter-ucfe,0,0,0,0,0,0,0,0,0,0,0,0,0,0,FALSE,0,2019,2019-2020
ND,2019-11-30,inter-ucx,0,0,0,0,0,0,0,0,0,0,0,0,0,0,FALSE,0,2019,2019-2020
ND,2019-11-30,inter-ui,191,3,1,1,0,0,0,0,0,2,12,210,203,206,FALSE,0.980952380952381,2019,2019-2020
ND,2019-11-30,intra-total,619,7,1,0,0,0,1,0,1,0,36,665,655,662,FALSE,0.995488721804511,2019,2019-2020
ND,2019-11-30,intra-ucfe,1,0,0,0,0,0,0,0,0,0,0,1,1,1,FALSE,1,2019,2019-2020
ND,2019-11-30,intra-ucx,1,0,0,0,0,0,0,0,0,0,0,1,1,1,FALSE,1,2019,2019-2020
ND,2019-11-30,intra-ui,617,7,1,0,0,0,1,0,1,0,36,663,653,660,FALSE,0.995475113122172,2019,2019-2020
ND,2019-12-31,inter-total,329,9,1,0,0,0,0,0,0,1,24,364,353,362,FALSE,0.994505494505495,2019,2019-2020
ND,2019-12-31,inter-ucfe,2,0,0,0,0,0,0,0,0,0,0,2,2,2,FALSE,1,2019,2019-2020
ND,2019-12-31,inter-ucx,0,0,0,0,0,0,0,0,0,0,0,0,0,0,FALSE,0,2019,2019-2020
ND,2019-12-31,inter-ui,327,9,1,0,0,0,0,0,0,1,24,362,351,360,FALSE,0.994475138121547,2019,2019-2020
ND,2019-12-31,intra-total,1913,10,3,0,0,1,3,1,0,0,66,1997,1979,1989,FALSE,0.99599399098648,2019,2019-2020
ND,2019-12-31,intra-ucfe,4,0,0,0,0,0,0,0,0,0,0,4,4,4,FALSE,1,2019,2019-2020
ND,2019-12-31,intra-ucx,0,0,0,0,0,0,0,0,0,0,0,0,0,0,FALSE,0,2019,2019-2020
ND,2019-12-31,intra-ui,1909,10,3,0,0,1,3,1,0,0,66,1993,1975,1985,FALSE,0.995985950827898,2019,2019-2020
ND,2020-01-31,inter-total,307,4,1,0,1,0,1,0,0,1,29,344,336,340,FALSE,0.988372093023256,2019,2019-2020
ND,2020-01-31,inter-ucfe,2,0,0,0,0,0,0,0,0,0,0,2,2,2,FALSE,1,2019,2019-2020
ND,2020-01-31,inter-ucx,0,0,0,0,0,0,0,0,0,0,0,0,0,0,FALSE,0,2019,2019-2020
ND,2020-01-31,inter-ui,305,4,1,0,1,0,1,0,0,1,29,342,334,338,FALSE,0.988304093567251,2019,2019-2020
ND,2020-01-31,intra-total,2600,11,3,1,1,3,1,0,0,0,108,2728,2708,2719,FALSE,0.996700879765396,2019,2019-2020
ND,2020-01-31,intra-ucfe,5,0,0,0,0,0,0,0,0,0,0,5,5,5,FALSE,1,2019,2019-2020
ND,2020-01-31,intra-ucx,3,0,0,0,0,0,0,0,0,0,0,3,3,3,FALSE,1,2019,2019-2020
ND,2020-01-31,intra-ui,2592,11,3,1,1,3,1,0,0,0,108,2720,2700,2711,FALSE,0.996691176470588,2019,2019-2020
ND,2020-02-29,inter-total,224,6,1,3,0,0,0,1,0,0,16,251,240,246,FALSE,0.9800796812749,2019,2019-2020
ND,2020-02-29,inter-ucfe,0,0,0,0,0,0,0,0,0,0,0,0,0,0,FALSE,0,2019,2019-2020
ND,2020-02-29,inter-ucx,0,0,0,0,0,0,0,0,0,0,0,0,0,0,FALSE,0,2019,2019-2020
ND,2020-02-29,inter-ui,224,6,1,3,0,0,0,1,0,0,16,251,240,246,FALSE,0.9800796812749,2019,2019-2020
ND,2020-02-29,intra-total,1049,11,3,2,0,2,1,0,0,3,55,1126,1104,1115,FALSE,0.990230905861456,2019,2019-2020
ND,2020-02-29,intra-ucfe,2,0,0,0,0,0,0,0,0,0,0,2,2,2,FALSE,1,2019,2019-2020
ND,2020-02-29,intra-ucx,0,0,0,0,0,0,0,0,0,0,0,0,0,0,FALSE,0,2019,2019-2020
ND,2020-02-29,intra-ui,1047,11,3,2,0,2,1,0,0,3,55,1124,1102,1113,FALSE,0.990213523131673,2019,2019-2020
ND,2020-03-31,inter-total,285,4,0,1,1,0,0,0,0,1,9,301,294,298,FALSE,0.990033222591362,2019,2019-2020
ND,2020-03-31,inter-ucfe,1,0,0,0,0,0,0,0,0,0,0,1,1,1,FALSE,1,2019,2019-2020
ND,2020-03-31,inter-ucx,0,0,0,0,0,0,0,0,0,0,0,0,0,0,FALSE,0,2019,2019-2020
ND,2020-03-31,inter-ui,284,4,0,1,1,0,0,0,0,1,9,300,293,297,FALSE,0.99,2019,2019-2020
ND,2020-03-31,intra-total,2745,11,3,2,0,1,2,1,0,2,46,2813,2791,2802,FALSE,0.996089584073942,2019,2019-2020
ND,2020-03-31,intra-ucfe,1,0,0,0,0,0,0,0,0,0,0,1,1,1,FALSE,1,2019,2019-2020
ND,2020-03-31,intra-ucx,1,0,0,0,0,0,0,0,0,0,0,1,1,1,FALSE,1,2019,2019-2020
ND,2020-03-31,intra-ui,2743,11,3,2,0,1,2,1,0,2,46,2811,2789,2800,FALSE,0.996086801849876,2019,2019-2020
ND,2020-04-30,inter-total,1755,255,66,8,2,1,0,0,0,1,742,2830,2497,2752,FALSE,0.97243816254417,2019,2019-2020
ND,2020-04-30,inter-ucfe,0,1,0,1,0,0,0,0,0,0,0,2,0,1,FALSE,0.5,2019,2019-2020
ND,2020-04-30,inter-ucx,0,0,0,0,0,0,0,0,0,0,0,0,0,0,FALSE,0,2019,2019-2020
ND,2020-04-30,inter-ui,1755,254,66,7,2,1,0,0,0,1,742,2828,2497,2751,FALSE,0.972772277227723,2019,2019-2020
ND,2020-04-30,intra-total,19510,2033,399,38,16,1,0,0,0,1,10448,32446,29958,31991,FALSE,0.985976699747272,2019,2019-2020
ND,2020-04-30,intra-ucfe,3,1,0,0,0,0,0,0,0,0,9,13,12,13,FALSE,1,2019,2019-2020
ND,2020-04-30,intra-ucx,4,1,0,0,0,0,0,0,0,0,4,9,8,9,FALSE,1,2019,2019-2020
ND,2020-04-30,intra-ui,19503,2031,399,38,16,1,0,0,0,1,10435,32424,29938,31969,FALSE,0.985967184801382,2019,2019-2020
ND,2020-05-31,inter-total,1024,199,65,29,16,8,7,2,0,2,332,1684,1356,1555,FALSE,0.923396674584323,2019,2019-2020
ND,2020-05-31,inter-ucfe,0,0,0,0,0,0,0,0,0,0,0,0,0,0,FALSE,0,2019,2019-2020
ND,2020-05-31,inter-ucx,0,0,0,0,0,0,0,0,0,0,0,0,0,0,FALSE,0,2019,2019-2020
ND,2020-05-31,inter-ui,1024,199,65,29,16,8,7,2,0,2,332,1684,1356,1555,FALSE,0.923396674584323,2019,2019-2020
ND,2020-05-31,intra-total,6206,698,259,122,49,50,21,17,3,6,1544,8975,7750,8448,FALSE,0.941281337047354,2019,2019-2020
ND,2020-05-31,intra-ucfe,3,2,1,2,0,0,0,0,0,0,0,8,3,5,FALSE,0.625,2019,2019-2020
ND,2020-05-31,intra-ucx,1,4,2,0,0,0,0,0,0,0,0,7,1,5,FALSE,0.714285714285714,2019,2019-2020
ND,2020-05-31,intra-ui,6202,692,256,120,49,50,21,17,3,6,1544,8960,7746,8438,FALSE,0.941741071428572,2019,2019-2020
ND,2020-06-30,inter-total,545,81,24,9,10,13,8,10,11,15,143,869,688,769,FALSE,0.884925201380898,2019,2019-2020
ND,2020-06-30,inter-ucfe,1,0,0,0,0,0,0,0,0,0,0,1,1,1,FALSE,1,2019,2019-2020
ND,2020-06-30,inter-ucx,0,0,0,0,0,0,0,0,0,0,0,0,0,0,FALSE,0,2019,2019-2020
ND,2020-06-30,inter-ui,544,81,24,9,10,13,8,10,11,15,143,868,687,768,FALSE,0.884792626728111,2019,2019-2020
ND,2020-06-30,intra-total,4095,378,140,46,35,30,42,23,26,33,786,5634,4881,5259,FALSE,0.933439829605964,2019,2019-2020
ND,2020-06-30,intra-ucfe,46,1,1,0,0,1,1,0,0,0,23,73,69,70,FALSE,0.958904109589041,2019,2019-2020
ND,2020-06-30,intra-ucx,4,0,3,0,0,0,0,0,0,0,3,10,7,7,FALSE,0.7,2019,2019-2020
ND,2020-06-30,intra-ui,4045,377,136,46,35,29,41,23,26,33,760,5551,4805,5182,FALSE,0.93352549090254,2019,2019-2020
ND,2020-07-31,inter-total,260,31,12,8,3,4,5,2,5,19,71,420,331,362,FALSE,0.861904761904762,2020,2020-2021
ND,2020-07-31,inter-ucfe,0,0,1,0,0,0,0,0,0,0,1,2,1,1,FALSE,0.5,2020,2020-2021
ND,2020-07-31,inter-ucx,0,0,0,0,0,0,0,0,0,0,0,0,0,0,FALSE,0,2020,2020-2021
ND,2020-07-31,inter-ui,260,31,11,8,3,4,5,2,5,19,70,418,330,361,FALSE,0.863636363636364,2020,2020-2021
ND,2020-07-31,intra-total,1725,282,82,24,22,13,8,9,9,62,523,2759,2248,2530,FALSE,0.916998912649511,2020,2020-2021
ND,2020-07-31,intra-ucfe,1,3,2,1,1,0,0,0,0,0,115,123,116,119,FALSE,0.967479674796748,2020,2020-2021
ND,2020-07-31,intra-ucx,3,1,0,0,0,0,0,0,0,0,0,4,3,4,FALSE,1,2020,2020-2021
ND,2020-07-31,intra-ui,1721,278,80,23,21,13,8,9,9,62,408,2632,2129,2407,FALSE,0.91451367781155,2020,2020-2021
ND,2020-08-31,inter-total,154,13,12,8,3,3,0,1,1,8,34,237,188,201,FALSE,0.848101265822785,2020,2020-2021
ND,2020-08-31,inter-ucfe,0,0,0,0,0,0,0,0,0,0,0,0,0,0,FALSE,0,2020,2020-2021
ND,2020-08-31,inter-ucx,0,0,0,0,0,0,0,0,0,0,0,0,0,0,FALSE,0,2020,2020-2021
ND,2020-08-31,inter-ui,154,13,12,8,3,3,0,1,1,8,34,237,188,201,FALSE,0.848101265822785,2020,2020-2021
ND,2020-08-31,intra-total,694,126,59,28,14,10,6,3,2,26,155,1123,849,975,FALSE,0.868210151380232,2020,2020-2021
ND,2020-08-31,intra-ucfe,0,1,1,1,0,0,1,0,0,0,8,12,8,9,FALSE,0.75,2020,2020-2021
ND,2020-08-31,intra-ucx,2,0,1,0,0,0,0,0,0,0,0,3,2,2,FALSE,0.666666666666667,2020,2020-2021
ND,2020-08-31,intra-ui,692,125,57,27,14,10,5,3,2,26,147,1108,839,964,FALSE,0.870036101083033,2020,2020-2021
ND,2020-09-30,inter-total,111,12,7,2,6,1,1,1,0,11,33,185,144,156,FALSE,0.843243243243243,2020,2020-2021
ND,2020-09-30,inter-ucfe,0,0,0,0,0,0,0,0,0,0,0,0,0,0,FALSE,0,2020,2020-2021
ND,2020-09-30,inter-ucx,0,0,0,0,0,0,0,0,0,0,0,0,0,0,FALSE,0,2020,2020-2021
ND,2020-09-30,inter-ui,111,12,7,2,6,1,1,1,0,11,33,185,144,156,FALSE,0.843243243243243,2020,2020-2021
ND,2020-09-30,intra-total,571,105,62,24,16,9,3,4,6,31,165,996,736,841,FALSE,0.844377510040161,2020,2020-2021
ND,2020-09-30,intra-ucfe,1,0,1,1,0,0,0,0,0,0,1,4,2,2,FALSE,0.5,2020,2020-2021
ND,2020-09-30,intra-ucx,1,0,0,0,0,0,0,0,0,0,0,1,1,1,FALSE,1,2020,2020-2021
ND,2020-09-30,intra-ui,569,105,61,23,16,9,3,4,6,31,164,991,733,838,FALSE,0.84561049445005,2020,2020-2021
ND,2020-10-31,inter-total,107,18,2,3,2,0,1,1,1,11,28,174,135,153,FALSE,0.879310344827586,2020,2020-2021
ND,2020-10-31,inter-ucfe,0,0,0,0,0,0,0,0,0,0,0,0,0,0,FALSE,0,2020,2020-2021
ND,2020-10-31,inter-ucx,0,0,0,0,0,0,0,0,0,0,0,0,0,0,FALSE,0,2020,2020-2021
ND,2020-10-31,inter-ui,107,18,2,3,2,0,1,1,1,11,28,174,135,153,FALSE,0.879310344827586,2020,2020-2021
ND,2020-10-31,intra-total,687,73,34,9,5,2,3,3,0,73,143,1032,830,903,FALSE,0.875,2020,2020-2021
ND,2020-10-31,intra-ucfe,1,0,1,1,0,0,0,0,0,0,0,3,1,1,FALSE,0.333333333333333,2020,2020-2021
ND,2020-10-31,intra-ucx,1,0,0,0,0,0,0,0,0,0,1,2,2,2,FALSE,1,2020,2020-2021
ND,2020-10-31,intra-ui,685,73,33,8,5,2,3,3,0,73,142,1027,827,900,FALSE,0.876338851022395,2020,2020-2021
ND,2020-11-30,inter-total,268,9,11,4,2,3,1,0,0,8,40,346,308,317,FALSE,0.916184971098266,2020,2020-2021
ND,2020-11-30,inter-ucfe,1,1,0,0,0,0,0,0,0,0,1,3,2,3,FALSE,1,2020,2020-2021
ND,2020-11-30,inter-ucx,0,0,0,0,0,0,0,0,0,0,0,0,0,0,FALSE,0,2020,2020-2021
ND,2020-11-30,inter-ui,267,8,11,4,2,3,1,0,0,8,39,343,306,314,FALSE,0.915451895043732,2020,2020-2021
ND,2020-11-30,intra-total,1667,148,39,17,8,2,2,2,2,23,240,2150,1907,2055,FALSE,0.955813953488372,2020,2020-2021
ND,2020-11-30,intra-ucfe,1,1,1,1,0,0,0,0,0,0,1,5,2,3,FALSE,0.6,2020,2020-2021
ND,2020-11-30,intra-ucx,0,0,0,0,0,0,0,0,0,0,0,0,0,0,FALSE,0,2020,2020-2021
ND,2020-11-30,intra-ui,1666,147,38,16,8,2,2,2,2,23,239,2145,1905,2052,FALSE,0.956643356643357,2020,2020-2021
ND,2020-12-31,inter-total,210,19,7,6,1,0,1,2,0,2,57,305,267,286,FALSE,0.937704918032787,2020,2020-2021
ND,2020-12-31,inter-ucfe,0,0,0,0,0,0,0,0,0,0,0,0,0,0,FALSE,0,2020,2020-2021
ND,2020-12-31,inter-ucx,0,0,0,0,0,0,0,0,0,0,0,0,0,0,FALSE,0,2020,2020-2021
ND,2020-12-31,inter-ui,210,19,7,6,1,0,1,2,0,2,57,305,267,286,FALSE,0.937704918032787,2020,2020-2021
ND,2020-12-31,intra-total,2003,140,71,41,17,12,5,5,5,29,288,2616,2291,2431,FALSE,0.929281345565749,2020,2020-2021
ND,2020-12-31,intra-ucfe,1,1,0,0,0,0,0,0,0,0,4,6,5,6,FALSE,1,2020,2020-2021
ND,2020-12-31,intra-ucx,1,0,0,0,0,0,0,0,0,0,0,1,1,1,FALSE,1,2020,2020-2021
ND,2020-12-31,intra-ui,2001,139,71,41,17,12,5,5,5,29,284,2609,2285,2424,FALSE,0.929091605979302,2020,2020-2021
ND,2021-01-31,inter-total,256,14,9,5,4,0,2,0,1,9,39,339,295,309,FALSE,0.911504424778761,2020,2020-2021
ND,2021-01-31,inter-ucfe,0,1,1,0,0,0,0,0,0,0,2,4,2,3,FALSE,0.75,2020,2020-2021
ND,2021-01-31,inter-ucx,0,0,0,0,0,0,0,0,0,0,0,0,0,0,FALSE,0,2020,2020-2021
ND,2021-01-31,inter-ui,256,13,8,5,4,0,2,0,1,9,37,335,293,306,FALSE,0.913432835820896,2020,2020-2021
ND,2021-01-31,intra-total,2695,127,50,28,13,9,7,10,10,96,259,3304,2954,3081,FALSE,0.932506053268765,2020,2020-2021
ND,2021-01-31,intra-ucfe,0,0,0,0,0,0,0,0,1,0,2,3,2,2,FALSE,0.666666666666667,2020,2020-2021
ND,2021-01-31,intra-ucx,0,0,0,0,0,0,0,0,0,0,0,0,0,0,FALSE,0,2020,2020-2021
ND,2021-01-31,intra-ui,2695,127,50,28,13,9,7,10,9,96,257,3301,2952,3079,FALSE,0.932747652226598,2020,2020-2021
ND,2021-02-28,inter-total,145,7,8,2,3,3,2,0,1,8,22,201,167,174,FALSE,0.865671641791045,2020,2020-2021
ND,2021-02-28,inter-ucfe,0,0,0,0,0,0,0,0,0,0,1,1,1,1,FALSE,1,2020,2020-2021
ND,2021-02-28,inter-ucx,0,0,0,0,0,0,0,0,0,0,0,0,0,0,FALSE,0,2020,2020-2021
ND,2021-02-28,inter-ui,145,7,8,2,3,3,2,0,1,8,21,200,166,173,FALSE,0.865,2020,2020-2021
ND,2021-02-28,intra-total,1279,97,57,26,23,10,8,5,3,31,199,1738,1478,1575,FALSE,0.906214039125432,2020,2020-2021
ND,2021-02-28,intra-ucfe,0,0,0,0,0,0,0,0,0,0,0,0,0,0,FALSE,0,2020,2020-2021
ND,2021-02-28,intra-ucx,1,0,0,0,0,0,0,0,0,0,0,1,1,1,FALSE,1,2020,2020-2021
ND,2021-02-28,intra-ui,1278,97,57,26,23,10,8,5,3,31,199,1737,1477,1574,FALSE,0.906160046056419,2020,2020-2021
ND,2021-03-31,inter-total,94,11,4,2,1,0,1,0,1,11,17,142,111,122,FALSE,0.859154929577465,2020,2020-2021
ND,2021-03-31,inter-ucfe,1,1,0,0,0,0,0,0,0,0,0,2,1,2,FALSE,1,2020,2020-2021
ND,2021-03-31,inter-ucx,0,0,0,0,0,0,0,0,0,0,0,0,0,0,FALSE,0,2020,2020-2021
ND,2021-03-31,inter-ui,93,10,4,2,1,0,1,0,1,11,17,140,110,120,FALSE,0.857142857142857,2020,2020-2021
ND,2021-03-31,intra-total,1049,111,40,11,14,6,4,7,1,24,140,1407,1189,1300,FALSE,0.923951670220327,2020,2020-2021
ND,2021-03-31,intra-ucfe,0,1,1,0,0,1,1,1,1,0,2,8,2,3,FALSE,0.375,2020,2020-2021
ND,2021-03-31,intra-ucx,0,0,0,0,0,0,0,0,0,0,0,0,0,0,FALSE,0,2020,2020-2021
ND,2021-03-31,intra-ui,1049,110,39,11,14,5,3,6,0,24,138,1399,1187,1297,FALSE,0.927090779127949,2020,2020-2021
ND,2021-04-30,inter-total,113,9,0,2,1,3,0,1,1,4,19,153,132,141,FALSE,0.92156862745098,2020,2020-2021
ND,2021-04-30,inter-ucfe,0,0,0,0,0,0,0,0,0,0,0,0,0,0,FALSE,0,2020,2020-2021
ND,2021-04-30,inter-ucx,0,0,0,0,0,0,0,0,0,0,0,0,0,0,FALSE,0,2020,2020-2021
ND,2021-04-30,inter-ui,113,9,0,2,1,3,0,1,1,4,19,153,132,141,FALSE,0.92156862745098,2020,2020-2021
ND,2021-04-30,intra-total,1195,109,37,11,6,5,1,3,1,25,168,1561,1363,1472,FALSE,0.942985265855221,2020,2020-2021
ND,2021-04-30,intra-ucfe,3,0,0,0,0,0,0,0,0,0,2,5,5,5,FALSE,1,2020,2020-2021
ND,2021-04-30,intra-ucx,1,0,0,0,0,0,0,0,0,0,0,1,1,1,FALSE,1,2020,2020-2021
ND,2021-04-30,intra-ui,1191,109,37,11,6,5,1,3,1,25,166,1555,1357,1466,FALSE,0.942765273311897,2020,2020-2021
ND,2021-05-31,inter-total,48,10,0,1,3,3,2,1,1,4,8,81,56,66,FALSE,0.814814814814815,2020,2020-2021
ND,2021-05-31,inter-ucfe,0,0,0,0,0,0,0,0,0,0,0,0,0,0,FALSE,0,2020,2020-2021
ND,2021-05-31,inter-ucx,0,0,0,0,0,0,0,0,0,0,0,0,0,0,FALSE,0,2020,2020-2021
ND,2021-05-31,inter-ui,48,10,0,1,3,3,2,1,1,4,8,81,56,66,FALSE,0.814814814814815,2020,2020-2021
ND,2021-05-31,intra-total,462,79,31,14,11,5,1,4,1,25,103,736,565,644,FALSE,0.875,2020,2020-2021
ND,2021-05-31,intra-ucfe,0,0,0,1,0,0,0,0,0,0,4,5,4,4,FALSE,0.8,2020,2020-2021
ND,2021-05-31,intra-ucx,0,0,0,0,0,0,0,0,0,0,0,0,0,0,FALSE,0,2020,2020-2021
ND,2021-05-31,intra-ui,462,79,31,13,11,5,1,4,1,25,99,731,561,640,FALSE,0.875512995896033,2020,2020-2021
ND,2021-06-30,inter-total,37,3,1,0,1,0,0,0,0,9,6,57,43,46,FALSE,0.807017543859649,2020,2020-2021
ND,2021-06-30,inter-ucfe,0,0,0,0,0,0,0,0,0,0,0,0,0,0,FALSE,0,2020,2020-2021
ND,2021-06-30,inter-ucx,0,0,0,0,0,0,0,0,0,0,0,0,0,0,FALSE,0,2020,2020-2021
ND,2021-06-30,inter-ui,37,3,1,0,1,0,0,0,0,9,6,57,43,46,FALSE,0.807017543859649,2020,2020-2021
ND,2021-06-30,intra-total,539,105,24,6,4,5,3,2,3,29,123,843,662,767,FALSE,0.909845788849348,2020,2020-2021
ND,2021-06-30,intra-ucfe,11,0,0,0,1,0,0,0,0,1,10,23,21,21,FALSE,0.91304347826087,2020,2020-2021
ND,2021-06-30,intra-ucx,0,0,0,0,0,0,0,0,0,0,0,0,0,0,FALSE,0,2020,2020-2021
ND,2021-06-30,intra-ui,528,105,24,6,3,5,3,2,3,28,113,820,641,746,FALSE,0.909756097560976,2020,2020-2021
ND,2021-07-31,inter-total,33,3,1,0,0,2,0,0,0,1,7,47,40,43,FALSE,0.914893617021277,2021,2021-2022
ND,2021-07-31,inter-ucfe,0,0,0,0,0,0,0,0,0,0,0,0,0,0,FALSE,0,2021,2021-2022
ND,2021-07-31,inter-ucx,0,0,0,0,0,0,0,0,0,0,0,0,0,0,FALSE,0,2021,2021-2022
ND,2021-07-31,inter-ui,33,3,1,0,0,2,0,0,0,1,7,47,40,43,FALSE,0.914893617021277,2021,2021-2022
ND,2021-07-31,intra-total,593,78,21,11,5,2,0,2,0,28,263,1003,856,934,FALSE,0.931206380857428,2021,2021-2022
ND,2021-07-31,intra-ucfe,22,4,2,0,0,0,0,0,0,0,123,151,145,149,FALSE,0.986754966887417,2021,2021-2022
ND,2021-07-31,intra-ucx,0,1,0,0,0,0,0,0,0,0,0,1,0,1,FALSE,1,2021,2021-2022
ND,2021-07-31,intra-ui,571,73,19,11,5,2,0,2,0,28,140,851,711,784,FALSE,0.921269095182139,2021,2021-2022
ND,2021-08-31,inter-total,31,3,2,0,0,1,1,0,0,0,3,41,34,37,FALSE,0.902439024390244,2021,2021-2022
ND,2021-08-31,inter-ucfe,0,0,0,0,0,0,0,0,0,0,0,0,0,0,FALSE,0,2021,2021-2022
ND,2021-08-31,inter-ucx,0,0,0,0,0,0,0,0,0,0,0,0,0,0,FALSE,0,2021,2021-2022
ND,2021-08-31,inter-ui,31,3,2,0,0,1,1,0,0,0,3,41,34,37,FALSE,0.902439024390244,2021,2021-2022
ND,2021-08-31,intra-total,241,72,13,6,0,4,5,4,6,22,58,431,299,371,FALSE,0.860788863109049,2021,2021-2022
ND,2021-08-31,intra-ucfe,3,1,0,0,0,1,0,0,0,1,6,12,9,10,FALSE,0.833333333333333,2021,2021-2022
ND,2021-08-31,intra-ucx,0,0,0,0,0,0,0,0,0,0,1,1,1,1,FALSE,1,2021,2021-2022
ND,2021-08-31,intra-ui,238,71,13,6,0,3,5,4,6,21,51,418,289,360,FALSE,0.861244019138756,2021,2021-2022
ND,2021-09-30,inter-total,9,0,0,0,0,0,0,0,0,0,4,13,13,13,FALSE,1,2021,2021-2022
ND,2021-09-30,inter-ucfe,0,0,0,0,0,0,0,0,0,0,0,0,0,0,FALSE,0,2021,2021-2022
ND,2021-09-30,inter-ucx,0,0,0,0,0,0,0,0,0,0,0,0,0,0,FALSE,0,2021,2021-2022
ND,2021-09-30,inter-ui,9,0,0,0,0,0,0,0,0,0,4,13,13,13,FALSE,1,2021,2021-2022
ND,2021-09-30,intra-total,109,39,8,0,2,1,4,0,0,9,31,203,140,179,FALSE,0.881773399014778,2021,2021-2022
ND,2021-09-30,intra-ucfe,0,0,0,0,0,0,0,0,0,0,0,0,0,0,FALSE,0,2021,2021-2022
ND,2021-09-30,intra-ucx,0,0,0,0,0,0,0,0,0,0,0,0,0,0,FALSE,0,2021,2021-2022
ND,2021-09-30,intra-ui,109,39,8,0,2,1,4,0,0,9,31,203,140,179,FALSE,0.881773399014778,2021,2021-2022
ND,2021-10-31,inter-total,13,1,0,0,0,0,0,1,0,2,3,20,16,17,FALSE,0.85,2021,2021-2022
ND,2021-10-31,inter-ucfe,0,0,0,0,0,0,0,0,0,0,0,0,0,0,FALSE,0,2021,2021-2022
ND,2021-10-31,inter-ucx,0,0,0,0,0,0,0,0,0,0,0,0,0,0,FALSE,0,2021,2021-2022
ND,2021-10-31,inter-ui,13,1,0,0,0,0,0,1,0,2,3,20,16,17,FALSE,0.85,2021,2021-2022
ND,2021-10-31,intra-total,106,3,0,1,9,1,0,1,0,2,15,138,121,124,FALSE,0.898550724637681,2021,2021-2022
ND,2021-10-31,intra-ucfe,1,0,0,0,0,0,0,0,0,0,0,1,1,1,FALSE,1,2021,2021-2022
ND,2021-10-31,intra-ucx,0,0,0,0,0,0,0,0,0,0,0,0,0,0,FALSE,0,2021,2021-2022
ND,2021-10-31,intra-ui,105,3,0,1,9,1,0,1,0,2,15,137,120,123,FALSE,0.897810218978102,2021,2021-2022
ND,2021-11-30,inter-total,92,0,0,1,0,0,0,0,0,1,3,97,95,95,FALSE,0.979381443298969,2021,2021-2022
ND,2021-11-30,inter-ucfe,0,0,0,0,0,0,0,0,0,0,0,0,0,0,FALSE,0,2021,2021-2022
ND,2021-11-30,inter-ucx,0,0,0,0,0,0,0,0,0,0,0,0,0,0,FALSE,0,2021,2021-2022
ND,2021-11-30,inter-ui,92,0,0,1,0,0,0,0,0,1,3,97,95,95,FALSE,0.979381443298969,2021,2021-2022
ND,2021-11-30,intra-total,545,7,0,2,1,0,0,0,1,4,21,581,566,573,FALSE,0.986230636833047,2021,2021-2022
ND,2021-11-30,intra-ucfe,1,0,0,0,0,0,0,0,0,0,0,1,1,1,FALSE,1,2021,2021-2022
ND,2021-11-30,intra-ucx,0,0,0,0,0,0,0,0,0,0,0,0,0,0,FALSE,0,2021,2021-2022
ND,2021-11-30,intra-ui,544,7,0,2,1,0,0,0,1,4,21,580,565,572,FALSE,0.986206896551724,2021,2021-2022
ND,2021-12-31,inter-total,145,3,0,0,2,1,0,0,0,2,3,156,148,151,FALSE,0.967948717948718,2021,2021-2022
ND,2021-12-31,inter-ucfe,1,0,0,0,0,0,0,0,0,0,0,1,1,1,FALSE,1,2021,2021-2022
ND,2021-12-31,inter-ucx,0,0,0,0,0,0,0,0,0,0,0,0,0,0,FALSE,0,2021,2021-2022
ND,2021-12-31,inter-ui,144,3,0,0,2,1,0,0,0,2,3,155,147,150,FALSE,0.967741935483871,2021,2021-2022
ND,2021-12-31,intra-total,1295,12,2,2,0,1,0,0,0,2,44,1358,1339,1351,FALSE,0.994845360824742,2021,2021-2022
ND,2021-12-31,intra-ucfe,1,0,0,0,0,0,0,0,0,0,0,1,1,1,FALSE,1,2021,2021-2022
ND,2021-12-31,intra-ucx,0,0,0,0,0,0,0,0,0,0,0,0,0,0,FALSE,0,2021,2021-2022
ND,2021-12-31,intra-ui,1294,12,2,2,0,1,0,0,0,2,44,1357,1338,1350,FALSE,0.994841562269713,2021,2021-2022
ND,2022-01-31,inter-total,186,3,1,0,0,0,1,0,0,2,9,202,195,198,FALSE,0.98019801980198,2021,2021-2022
ND,2022-01-31,inter-ucfe,1,0,0,0,0,0,0,0,0,0,1,2,2,2,FALSE,1,2021,2021-2022
ND,2022-01-31,inter-ucx,0,0,0,0,0,0,0,0,0,0,0,0,0,0,FALSE,0,2021,2021-2022
ND,2022-01-31,inter-ui,185,3,1,0,0,0,1,0,0,2,8,200,193,196,FALSE,0.98,2021,2021-2022
ND,2022-01-31,intra-total,2535,18,4,3,3,0,0,1,0,3,86,2653,2621,2639,FALSE,0.994722955145119,2021,2021-2022
ND,2022-01-31,intra-ucfe,1,0,0,0,0,0,0,0,0,0,1,2,2,2,FALSE,1,2021,2021-2022
ND,2022-01-31,intra-ucx,0,0,0,0,0,0,0,0,0,0,0,0,0,0,FALSE,0,2021,2021-2022
ND,2022-01-31,intra-ui,2534,18,4,3,3,0,0,1,0,3,85,2651,2619,2637,FALSE,0.994718973972086,2021,2021-2022
ND,2022-02-28,inter-total,77,2,2,0,0,0,0,0,0,0,9,90,86,88,FALSE,0.977777777777778,2021,2021-2022
ND,2022-02-28,inter-ucfe,0,0,0,0,0,0,0,0,0,0,0,0,0,0,FALSE,0,2021,2021-2022
ND,2022-02-28,inter-ucx,0,0,0,0,0,0,0,0,0,0,0,0,0,0,FALSE,0,2021,2021-2022
ND,2022-02-28,inter-ui,77,2,2,0,0,0,0,0,0,0,9,90,86,88,FALSE,0.977777777777778,2021,2021-2022
ND,2022-02-28,intra-total,876,8,6,6,1,0,0,0,0,1,37,935,913,921,FALSE,0.985026737967914,2021,2021-2022
ND,2022-02-28,intra-ucfe,0,1,0,0,0,0,0,0,0,0,1,2,1,2,FALSE,1,2021,2021-2022
ND,2022-02-28,intra-ucx,0,0,0,0,0,0,0,0,0,0,0,0,0,0,FALSE,0,2021,2021-2022
ND,2022-02-28,intra-ui,876,7,6,6,1,0,0,0,0,1,36,933,912,919,FALSE,0.984994640943194,2021,2021-2022
ND,2022-03-31,inter-total,35,0,0,0,2,0,0,0,0,1,1,39,36,36,FALSE,0.923076923076923,2021,2021-2022
ND,2022-03-31,inter-ucfe,0,0,0,0,0,0,0,0,0,0,0,0,0,0,FALSE,0,2021,2021-2022
ND,2022-03-31,inter-ucx,0,0,0,0,0,0,0,0,0,0,0,0,0,0,FALSE,0,2021,2021-2022
ND,2022-03-31,inter-ui,35,0,0,0,2,0,0,0,0,1,1,39,36,36,FALSE,0.923076923076923,2021,2021-2022
ND,2022-03-31,intra-total,387,4,2,2,2,2,1,0,0,0,33,433,420,424,FALSE,0.979214780600462,2021,2021-2022
ND,2022-03-31,intra-ucfe,1,0,0,1,0,0,0,0,0,0,0,2,1,1,FALSE,0.5,2021,2021-2022
ND,2022-03-31,intra-ucx,0,0,0,0,0,0,0,0,0,0,0,0,0,0,FALSE,0,2021,2021-2022
ND,2022-03-31,intra-ui,386,4,2,1,2,2,1,0,0,0,33,431,419,423,FALSE,0.981438515081206,2021,2021-2022
ND,2022-04-30,inter-total,40,0,1,2,0,0,0,0,0,1,1,45,41,41,FALSE,0.911111111111111,2021,2021-2022
ND,2022-04-30,inter-ucfe,0,0,0,0,0,0,0,0,0,0,0,0,0,0,FALSE,0,2021,2021-2022
ND,2022-04-30,inter-ucx,0,0,0,0,0,0,0,0,0,0,0,0,0,0,FALSE,0,2021,2021-2022
ND,2022-04-30,inter-ui,40,0,1,2,0,0,0,0,0,1,1,45,41,41,FALSE,0.911111111111111,2021,2021-2022
ND,2022-04-30,intra-total,245,3,0,3,0,0,0,0,0,2,10,263,255,258,FALSE,0.980988593155893,2021,2021-2022
ND,2022-04-30,intra-ucfe,1,0,0,0,0,0,0,0,0,0,0,1,1,1,FALSE,1,2021,2021-2022
ND,2022-04-30,intra-ucx,1,0,0,0,0,0,0,0,0,0,0,1,1,1,FALSE,1,2021,2021-2022
ND,2022-04-30,intra-ui,243,3,0,3,0,0,0,0,0,2,10,261,253,256,FALSE,0.980842911877395,2021,2021-2022
ND,2022-05-31,inter-total,34,0,0,0,0,0,0,0,0,0,1,35,35,35,FALSE,1,2021,2021-2022
ND,2022-05-31,inter-ucfe,0,0,0,0,0,0,0,0,0,0,0,0,0,0,FALSE,0,2021,2021-2022
ND,2022-05-31,inter-ucx,0,0,0,0,0,0,0,0,0,0,0,0,0,0,FALSE,0,2021,2021-2022
ND,2022-05-31,inter-ui,34,0,0,0,0,0,0,0,0,0,1,35,35,35,FALSE,1,2021,2021-2022
ND,2022-05-31,intra-total,228,3,0,2,0,0,0,0,0,0,13,246,241,244,FALSE,0.991869918699187,2021,2021-2022
ND,2022-05-31,intra-ucfe,5,1,0,0,0,0,0,0,0,0,1,7,6,7,FALSE,1,2021,2021-2022
ND,2022-05-31,intra-ucx,2,0,0,0,0,0,0,0,0,0,0,2,2,2,FALSE,1,2021,2021-2022
ND,2022-05-31,intra-ui,221,2,0,2,0,0,0,0,0,0,12,237,233,235,FALSE,0.991561181434599,2021,2021-2022
ND,2022-06-30,inter-total,18,0,0,0,0,0,0,0,0,0,3,21,21,21,FALSE,1,2021,2021-2022
ND,2022-06-30,inter-ucfe,0,0,0,0,0,0,0,0,0,0,0,0,0,0,FALSE,0,2021,2021-2022
ND,2022-06-30,inter-ucx,0,0,0,0,0,0,0,0,0,0,0,0,0,0,FALSE,0,2021,2021-2022
ND,2022-06-30,inter-ui,18,0,0,0,0,0,0,0,0,0,3,21,21,21,FALSE,1,2021,2021-2022
ND,2022-06-30,intra-total,294,5,0,0,1,0,1,0,0,0,11,312,305,310,FALSE,0.993589743589744,2021,2021-2022
ND,2022-06-30,intra-ucfe,9,0,0,0,0,0,0,0,0,0,0,9,9,9,FALSE,1,2021,2021-2022
ND,2022-06-30,intra-ucx,0,0,0,0,0,0,0,0,0,0,0,0,0,0,FALSE,0,2021,2021-2022
ND,2022-06-30,intra-ui,285,5,0,0,1,0,1,0,0,0,11,303,296,301,FALSE,0.993399339933993,2021,2021-2022
ND,2022-07-31,inter-total,23,1,0,0,0,0,1,0,0,1,0,26,23,24,FALSE,0.923076923076923,2022,2022-2023
ND,2022-07-31,inter-ucfe,0,0,0,0,0,0,0,0,0,0,0,0,0,0,FALSE,0,2022,2022-2023
ND,2022-07-31,inter-ucx,0,0,0,0,0,0,0,0,0,0,0,0,0,0,FALSE,0,2022,2022-2023
ND,2022-07-31,inter-ui,23,1,0,0,0,0,1,0,0,1,0,26,23,24,FALSE,0.923076923076923,2022,2022-2023
ND,2022-07-31,intra-total,287,2,2,0,0,1,0,0,0,1,43,336,330,332,FALSE,0.988095238095238,2022,2022-2023
ND,2022-07-31,intra-ucfe,44,1,1,0,0,0,0,0,0,0,29,75,73,74,FALSE,0.986666666666667,2022,2022-2023
ND,2022-07-31,intra-ucx,0,0,0,0,0,0,0,0,0,0,0,0,0,0,FALSE,0,2022,2022-2023
ND,2022-07-31,intra-ui,243,1,1,0,0,1,0,0,0,1,14,261,257,258,FALSE,0.988505747126437,2022,2022-2023
ND,2022-08-31,inter-total,33,1,0,0,0,1,0,0,0,0,2,37,35,36,FALSE,0.972972972972973,2022,2022-2023
ND,2022-08-31,inter-ucfe,0,0,0,0,0,0,0,0,0,0,0,0,0,0,FALSE,0,2022,2022-2023
ND,2022-08-31,inter-ucx,0,0,0,0,0,0,0,0,0,0,0,0,0,0,FALSE,0,2022,2022-2023
ND,2022-08-31,inter-ui,33,1,0,0,0,1,0,0,0,0,2,37,35,36,FALSE,0.972972972972973,2022,2022-2023
ND,2022-08-31,intra-total,167,31,0,2,1,1,0,0,0,0,12,214,179,210,FALSE,0.981308411214953,2022,2022-2023
ND,2022-08-31,intra-ucfe,9,24,0,0,0,0,0,0,0,0,2,35,11,35,FALSE,1,2022,2022-2023
ND,2022-08-31,intra-ucx,0,0,0,0,0,0,0,0,0,0,0,0,0,0,FALSE,0,2022,2022-2023
ND,2022-08-31,intra-ui,158,7,0,2,1,1,0,0,0,0,10,179,168,175,FALSE,0.977653631284916,2022,2022-2023
ND,2022-09-30,inter-total,17,0,0,0,0,0,0,0,0,1,0,18,17,17,FALSE,0.944444444444444,2022,2022-2023
ND,2022-09-30,inter-ucfe,0,0,0,0,0,0,0,0,0,0,0,0,0,0,FALSE,0,2022,2022-2023
ND,2022-09-30,inter-ucx,0,0,0,0,0,0,0,0,0,0,0,0,0,0,FALSE,0,2022,2022-2023
ND,2022-09-30,inter-ui,17,0,0,0,0,0,0,0,0,1,0,18,17,17,FALSE,0.944444444444444,2022,2022-2023
ND,2022-09-30,intra-total,62,1,2,0,0,1,1,0,0,0,9,76,71,72,FALSE,0.947368421052632,2022,2022-2023
ND,2022-09-30,intra-ucfe,2,0,0,0,0,0,0,0,0,0,0,2,2,2,FALSE,1,2022,2022-2023
ND,2022-09-30,intra-ucx,0,0,0,0,0,0,0,0,0,0,1,1,1,1,FALSE,1,2022,2022-2023
ND,2022-09-30,intra-ui,60,1,2,0,0,1,1,0,0,0,8,73,68,69,FALSE,0.945205479452055,2022,2022-2023
ND,2022-10-31,inter-total,42,1,0,1,0,0,0,0,0,0,2,46,44,45,FALSE,0.978260869565217,2022,2022-2023
ND,2022-10-31,inter-ucfe,0,0,0,0,0,0,0,0,0,0,0,0,0,0,FALSE,0,2022,2022-2023
ND,2022-10-31,inter-ucx,0,0,0,0,0,0,0,0,0,0,0,0,0,0,FALSE,0,2022,2022-2023
ND,2022-10-31,inter-ui,42,1,0,1,0,0,0,0,0,0,2,46,44,45,FALSE,0.978260869565217,2022,2022-2023
ND,2022-10-31,intra-total,111,0,0,0,0,0,0,0,0,0,5,116,116,116,FALSE,1,2022,2022-2023
ND,2022-10-31,intra-ucfe,0,0,0,0,0,0,0,0,0,0,1,1,1,1,FALSE,1,2022,2022-2023
ND,2022-10-31,intra-ucx,1,0,0,0,0,0,0,0,0,0,0,1,1,1,FALSE,1,2022,2022-2023
ND,2022-10-31,intra-ui,110,0,0,0,0,0,0,0,0,0,4,114,114,114,FALSE,1,2022,2022-2023
ND,2022-11-30,inter-total,115,2,0,0,0,0,0,0,0,0,3,120,118,120,FALSE,1,2022,2022-2023
ND,2022-11-30,inter-ucfe,0,0,0,0,0,0,0,0,0,0,0,0,0,0,FALSE,0,2022,2022-2023
ND,2022-11-30,inter-ucx,0,0,0,0,0,0,0,0,0,0,0,0,0,0,FALSE,0,2022,2022-2023
ND,2022-11-30,inter-ui,115,2,0,0,0,0,0,0,0,0,3,120,118,120,FALSE,1,2022,2022-2023
ND,2022-11-30,intra-total,455,2,2,1,0,0,2,0,0,0,14,476,469,471,FALSE,0.989495798319328,2022,2022-2023
ND,2022-11-30,intra-ucfe,1,0,0,0,0,0,0,0,0,0,0,1,1,1,FALSE,1,2022,2022-2023
ND,2022-11-30,intra-ucx,0,0,0,0,0,0,0,0,0,0,0,0,0,0,FALSE,0,2022,2022-2023
ND,2022-11-30,intra-ui,454,2,2,1,0,0,2,0,0,0,14,475,468,470,FALSE,0.989473684210526,2022,2022-2023
ND,2022-12-31,inter-total,137,1,3,1,1,1,0,0,0,1,5,150,142,143,FALSE,0.953333333333333,2022,2022-2023
ND,2022-12-31,inter-ucfe,0,0,0,0,0,0,0,0,0,0,0,0,0,0,FALSE,0,2022,2022-2023
ND,2022-12-31,inter-ucx,0,0,0,0,0,0,0,0,0,0,0,0,0,0,FALSE,0,2022,2022-2023
ND,2022-12-31,inter-ui,137,1,3,1,1,1,0,0,0,1,5,150,142,143,FALSE,0.953333333333333,2022,2022-2023
ND,2022-12-31,intra-total,1284,10,3,1,2,0,0,0,0,0,50,1350,1334,1344,FALSE,0.995555555555556,2022,2022-2023
ND,2022-12-31,intra-ucfe,0,0,0,0,0,0,0,0,0,0,0,0,0,0,FALSE,0,2022,2022-2023
ND,2022-12-31,intra-ucx,3,0,0,0,0,0,0,0,0,0,0,3,3,3,FALSE,1,2022,2022-2023
ND,2022-12-31,intra-ui,1281,10,3,1,2,0,0,0,0,0,50,1347,1331,1341,FALSE,0.99554565701559,2022,2022-2023
ND,2023-01-31,inter-total,171,4,1,1,0,0,1,0,0,0,10,188,181,185,FALSE,0.984042553191489,2022,2022-2023
ND,2023-01-31,inter-ucfe,0,0,0,0,0,0,0,0,0,0,1,1,1,1,FALSE,1,2022,2022-2023
ND,2023-01-31,inter-ucx,0,0,0,0,0,0,0,0,0,0,0,0,0,0,FALSE,0,2022,2022-2023
ND,2023-01-31,inter-ui,171,4,1,1,0,0,1,0,0,0,9,187,180,184,FALSE,0.983957219251337,2022,2022-2023
ND,2023-01-31,intra-total,2167,9,3,0,2,0,1,0,0,0,73,2255,2240,2249,FALSE,0.997339246119734,2022,2022-2023
ND,2023-01-31,intra-ucfe,4,0,0,0,0,0,0,0,0,0,0,4,4,4,FALSE,1,2022,2022-2023
ND,2023-01-31,intra-ucx,1,0,0,0,0,0,0,0,0,0,0,1,1,1,FALSE,1,2022,2022-2023
ND,2023-01-31,intra-ui,2162,9,3,0,2,0,1,0,0,0,73,2250,2235,2244,FALSE,0.997333333333333,2022,2022-2023
ND,2023-02-28,inter-total,71,1,2,0,0,0,0,0,0,0,6,80,77,78,FALSE,0.975,2022,2022-2023
ND,2023-02-28,inter-ucfe,0,0,0,0,0,0,0,0,0,0,0,0,0,0,FALSE,0,2022,2022-2023
ND,2023-02-28,inter-ucx,0,0,0,0,0,0,0,0,0,0,0,0,0,0,FALSE,0,2022,2022-2023
ND,2023-02-28,inter-ui,71,1,2,0,0,0,0,0,0,0,6,80,77,78,FALSE,0.975,2022,2022-2023
ND,2023-02-28,intra-total,771,8,4,0,2,0,0,0,0,0,45,830,816,824,FALSE,0.992771084337349,2022,2022-2023
ND,2023-02-28,intra-ucfe,0,0,0,0,0,0,0,0,0,0,0,0,0,0,FALSE,0,2022,2022-2023
ND,2023-02-28,intra-ucx,0,0,0,0,0,0,0,0,0,0,0,0,0,0,FALSE,0,2022,2022-2023
ND,2023-02-28,intra-ui,771,8,4,0,2,0,0,0,0,0,45,830,816,824,FALSE,0.992771084337349,2022,2022-2023
ND,2023-03-31,inter-total,50,0,2,0,0,0,0,0,0,0,2,54,52,52,FALSE,0.962962962962963,2022,2022-2023
ND,2023-03-31,inter-ucfe,0,0,0,0,0,0,0,0,0,0,0,0,0,0,FALSE,0,2022,2022-2023
ND,2023-03-31,inter-ucx,0,0,0,0,0,0,0,0,0,0,0,0,0,0,FALSE,0,2022,2022-2023
ND,2023-03-31,inter-ui,50,0,2,0,0,0,0,0,0,0,2,54,52,52,FALSE,0.962962962962963,2022,2022-2023
ND,2023-03-31,intra-total,370,3,2,0,1,2,2,1,0,1,26,408,396,399,FALSE,0.977941176470588,2022,2022-2023
ND,2023-03-31,intra-ucfe,1,0,0,0,0,0,0,0,0,0,0,1,1,1,FALSE,1,2022,2022-2023
ND,2023-03-31,intra-ucx,0,0,0,0,0,0,0,0,0,0,0,0,0,0,FALSE,0,2022,2022-2023
ND,2023-03-31,intra-ui,369,3,2,0,1,2,2,1,0,1,26,407,395,398,FALSE,0.977886977886978,2022,2022-2023
ND,2023-04-30,inter-total,40,0,0,0,0,1,0,0,0,0,1,42,41,41,FALSE,0.976190476190476,2022,2022-2023
ND,2023-04-30,inter-ucfe,0,0,0,0,0,0,0,0,0,0,0,0,0,0,FALSE,0,2022,2022-2023
ND,2023-04-30,inter-ucx,0,0,0,0,0,0,0,0,0,0,0,0,0,0,FALSE,0,2022,2022-2023
ND,2023-04-30,inter-ui,40,0,0,0,0,1,0,0,0,0,1,42,41,41,FALSE,0.976190476190476,2022,2022-2023
ND,2023-04-30,intra-total,215,4,0,0,0,0,0,1,0,0,18,238,233,237,FALSE,0.995798319327731,2022,2022-2023
ND,2023-04-30,intra-ucfe,1,0,0,0,0,0,0,0,0,0,0,1,1,1,FALSE,1,2022,2022-2023
ND,2023-04-30,intra-ucx,1,0,0,0,0,0,0,0,0,0,0,1,1,1,FALSE,1,2022,2022-2023
ND,2023-04-30,intra-ui,213,4,0,0,0,0,0,1,0,0,18,236,231,235,FALSE,0.995762711864407,2022,2022-2023
ND,2023-05-31,inter-total,28,0,0,0,0,1,0,0,0,1,3,33,31,31,FALSE,0.939393939393939,2022,2022-2023
ND,2023-05-31,inter-ucfe,0,0,0,0,0,0,0,0,0,0,0,0,0,0,FALSE,0,2022,2022-2023
ND,2023-05-31,inter-ucx,0,0,0,0,0,0,0,0,0,0,0,0,0,0,FALSE,0,2022,2022-2023
ND,2023-05-31,inter-ui,28,0,0,0,0,1,0,0,0,1,3,33,31,31,FALSE,0.939393939393939,2022,2022-2023
ND,2023-05-31,intra-total,215,1,0,3,0,0,0,0,0,0,13,232,228,229,FALSE,0.987068965517241,2022,2022-2023
ND,2023-05-31,intra-ucfe,4,0,0,0,0,0,0,0,0,0,1,5,5,5,FALSE,1,2022,2022-2023
ND,2023-05-31,intra-ucx,1,0,0,0,0,0,0,0,0,0,0,1,1,1,FALSE,1,2022,2022-2023
ND,2023-05-31,intra-ui,210,1,0,3,0,0,0,0,0,0,12,226,222,223,FALSE,0.986725663716814,2022,2022-2023
ND,2023-06-30,inter-total,39,1,0,0,0,0,0,0,0,0,2,42,41,42,FALSE,1,2022,2022-2023
ND,2023-06-30,inter-ucfe,0,0,0,0,0,0,0,0,0,0,0,0,0,0,FALSE,0,2022,2022-2023
ND,2023-06-30,inter-ucx,0,0,0,0,0,0,0,0,0,0,0,0,0,0,FALSE,0,2022,2022-2023
ND,2023-06-30,inter-ui,39,1,0,0,0,0,0,0,0,0,2,42,41,42,FALSE,1,2022,2022-2023
ND,2023-06-30,intra-total,328,4,1,0,2,0,0,0,0,0,15,350,343,347,FALSE,0.991428571428571,2022,2022-2023
ND,2023-06-30,intra-ucfe,6,0,0,0,0,0,0,0,0,0,0,6,6,6,FALSE,1,2022,2022-2023
ND,2023-06-30,intra-ucx,1,0,0,0,0,0,0,0,0,0,0,1,1,1,FALSE,1,2022,2022-2023
ND,2023-06-30,intra-ui,321,4,1,0,2,0,0,0,0,0,15,343,336,340,FALSE,0.991253644314869,2022,2022-2023
ND,2023-07-31,inter-total,30,0,0,0,1,0,0,0,0,1,1,33,31,31,FALSE,0.939393939393939,2023,2023-2024
ND,2023-07-31,inter-ucfe,0,0,0,0,0,0,0,0,0,0,0,0,0,0,FALSE,0,2023,2023-2024
ND,2023-07-31,inter-ucx,0,0,0,0,0,0,0,0,0,0,0,0,0,0,FALSE,0,2023,2023-2024
ND,2023-07-31,inter-ui,30,0,0,0,1,0,0,0,0,1,1,33,31,31,FALSE,0.939393939393939,2023,2023-2024
ND,2023-07-31,intra-total,396,7,1,2,1,0,0,0,0,1,11,419,407,414,FALSE,0.988066825775656,2023,2023-2024
ND,2023-07-31,intra-ucfe,116,1,0,1,0,0,0,0,0,0,0,118,116,117,FALSE,0.991525423728813,2023,2023-2024
ND,2023-07-31,intra-ucx,0,0,0,0,0,0,0,0,0,0,0,0,0,0,FALSE,0,2023,2023-2024
ND,2023-07-31,intra-ui,280,6,1,1,1,0,0,0,0,1,11,301,291,297,FALSE,0.98671096345515,2023,2023-2024
ND,2023-08-31,inter-total,26,0,0,0,0,0,0,0,0,0,2,28,28,28,FALSE,1,2023,2023-2024
ND,2023-08-31,inter-ucfe,0,0,0,0,0,0,0,0,0,0,0,0,0,0,FALSE,0,2023,2023-2024
ND,2023-08-31,inter-ucx,0,0,0,0,0,0,0,0,0,0,0,0,0,0,FALSE,0,2023,2023-2024
ND,2023-08-31,inter-ui,26,0,0,0,0,0,0,0,0,0,2,28,28,28,FALSE,1,2023,2023-2024
ND,2023-08-31,intra-total,171,9,2,0,1,0,0,0,0,0,21,204,192,201,FALSE,0.985294117647059,2023,2023-2024
ND,2023-08-31,intra-ucfe,9,1,0,0,0,0,0,0,0,0,3,13,12,13,FALSE,1,2023,2023-2024
ND,2023-08-31,intra-ucx,0,0,0,0,0,0,0,0,0,0,0,0,0,0,FALSE,0,2023,2023-2024
ND,2023-08-31,intra-ui,162,8,2,0,1,0,0,0,0,0,18,191,180,188,FALSE,0.984293193717278,2023,2023-2024
ND,2023-09-30,inter-total,13,0,0,0,0,0,0,0,0,0,3,16,16,16,FALSE,1,2023,2023-2024
ND,2023-09-30,inter-ucfe,0,0,0,0,0,0,0,0,0,0,0,0,0,0,FALSE,0,2023,2023-2024
ND,2023-09-30,inter-ucx,0,0,0,0,0,0,0,0,0,0,0,0,0,0,FALSE,0,2023,2023-2024
ND,2023-09-30,inter-ui,13,0,0,0,0,0,0,0,0,0,3,16,16,16,FALSE,1,2023,2023-2024
ND,2023-09-30,intra-total,82,4,1,0,0,0,0,0,0,2,14,103,96,100,FALSE,0.970873786407767,2023,2023-2024
ND,2023-09-30,intra-ucfe,0,0,0,0,0,0,0,0,0,0,0,0,0,0,FALSE,0,2023,2023-2024
ND,2023-09-30,intra-ucx,0,1,0,0,0,0,0,0,0,0,0,1,0,1,FALSE,1,2023,2023-2024
ND,2023-09-30,intra-ui,82,3,1,0,0,0,0,0,0,2,14,102,96,99,FALSE,0.970588235294118,2023,2023-2024
ND,2023-10-31,inter-total,27,0,1,0,0,0,0,0,0,0,1,29,28,28,FALSE,0.96551724137931,2023,2023-2024
ND,2023-10-31,inter-ucfe,0,0,0,0,0,0,0,0,0,0,0,0,0,0,FALSE,0,2023,2023-2024
ND,2023-10-31,inter-ucx,0,0,0,0,0,0,0,0,0,0,0,0,0,0,FALSE,0,2023,2023-2024
ND,2023-10-31,inter-ui,27,0,1,0,0,0,0,0,0,0,1,29,28,28,FALSE,0.96551724137931,2023,2023-2024
ND,2023-10-31,intra-total,143,1,0,0,0,0,0,0,0,0,23,167,166,167,FALSE,1,2023,2023-2024
ND,2023-10-31,intra-ucfe,2,0,0,0,0,0,0,0,0,0,0,2,2,2,FALSE,1,2023,2023-2024
ND,2023-10-31,intra-ucx,0,0,0,0,0,0,0,0,0,0,0,0,0,0,FALSE,0,2023,2023-2024
ND,2023-10-31,intra-ui,141,1,0,0,0,0,0,0,0,0,23,165,164,165,FALSE,1,2023,2023-2024
ND,2023-11-30,inter-total,109,1,1,0,0,0,0,0,0,0,6,117,115,116,FALSE,0.991452991452991,2023,2023-2024
ND,2023-11-30,inter-ucfe,0,0,0,0,0,0,0,0,0,0,0,0,0,0,FALSE,0,2023,2023-2024
ND,2023-11-30,inter-ucx,0,0,0,0,0,0,0,0,0,0,0,0,0,0,FALSE,0,2023,2023-2024
ND,2023-11-30,inter-ui,109,1,1,0,0,0,0,0,0,0,6,117,115,116,FALSE,0.991452991452991,2023,2023-2024
ND,2023-11-30,intra-total,469,1,1,0,1,1,2,0,0,0,34,509,503,504,FALSE,0.990176817288802,2023,2023-2024
ND,2023-11-30,intra-ucfe,0,0,0,0,0,0,0,0,0,0,0,0,0,0,FALSE,0,2023,2023-2024
ND,2023-11-30,intra-ucx,1,0,0,0,0,0,0,0,0,0,0,1,1,1,FALSE,1,2023,2023-2024
ND,2023-11-30,intra-ui,468,1,1,0,1,1,2,0,0,0,34,508,502,503,FALSE,0.990157480314961,2023,2023-2024
ND,2023-12-31,inter-total,132,2,0,0,0,0,0,0,0,0,5,139,137,139,FALSE,1,2023,2023-2024
ND,2023-12-31,inter-ucfe,0,0,0,0,0,0,0,0,0,0,0,0,0,0,FALSE,0,2023,2023-2024
ND,2023-12-31,inter-ucx,0,0,0,0,0,0,0,0,0,0,0,0,0,0,FALSE,0,2023,2023-2024
ND,2023-12-31,inter-ui,132,2,0,0,0,0,0,0,0,0,5,139,137,139,FALSE,1,2023,2023-2024
ND,2023-12-31,intra-total,1194,6,4,1,1,1,1,1,0,0,43,1252,1237,1243,FALSE,0.992811501597444,2023,2023-2024
ND,2023-12-31,intra-ucfe,0,0,0,0,0,0,0,0,0,0,0,0,0,0,FALSE,0,2023,2023-2024
ND,2023-12-31,intra-ucx,1,0,0,0,0,0,0,0,0,0,0,1,1,1,FALSE,1,2023,2023-2024
ND,2023-12-31,intra-ui,1193,6,4,1,1,1,1,1,0,0,43,1251,1236,1242,FALSE,0.992805755395683,2023,2023-2024
ND,2024-01-31,inter-total,183,1,0,0,1,0,0,2,0,0,11,198,194,195,FALSE,0.984848484848485,2023,2023-2024
ND,2024-01-31,inter-ucfe,0,0,0,0,0,0,0,0,0,0,1,1,1,1,FALSE,1,2023,2023-2024
ND,2024-01-31,inter-ucx,0,0,0,0,0,0,0,0,0,0,0,0,0,0,FALSE,0,2023,2023-2024
ND,2024-01-31,inter-ui,183,1,0,0,1,0,0,2,0,0,10,197,193,194,FALSE,0.984771573604061,2023,2023-2024
ND,2024-01-31,intra-total,2474,8,3,2,1,1,0,0,0,0,79,2568,2553,2561,FALSE,0.997274143302181,2023,2023-2024
ND,2024-01-31,intra-ucfe,1,0,0,0,0,0,0,0,0,0,0,1,1,1,FALSE,1,2023,2023-2024
ND,2024-01-31,intra-ucx,0,0,0,0,0,0,0,0,0,0,0,0,0,0,FALSE,0,2023,2023-2024
ND,2024-01-31,intra-ui,2473,8,3,2,1,1,0,0,0,0,79,2567,2552,2560,FALSE,0.997273081417998,2023,2023-2024
ND,2024-02-29,inter-total,82,2,2,0,0,1,0,0,0,0,7,94,89,91,FALSE,0.968085106382979,2023,2023-2024
ND,2024-02-29,inter-ucfe,0,0,0,0,0,0,0,0,0,0,0,0,0,0,FALSE,0,2023,2023-2024
ND,2024-02-29,inter-ucx,0,0,0,0,0,0,0,0,0,0,0,0,0,0,FALSE,0,2023,2023-2024
ND,2024-02-29,inter-ui,82,2,2,0,0,1,0,0,0,0,7,94,89,91,FALSE,0.968085106382979,2023,2023-2024
ND,2024-02-29,intra-total,825,8,1,2,1,1,0,2,0,0,40,880,865,873,FALSE,0.992045454545454,2023,2023-2024
ND,2024-02-29,intra-ucfe,0,0,0,0,0,0,0,0,0,0,1,1,1,1,FALSE,1,2023,2023-2024
ND,2024-02-29,intra-ucx,1,0,0,0,0,0,0,0,0,0,0,1,1,1,FALSE,1,2023,2023-2024
ND,2024-02-29,intra-ui,824,8,1,2,1,1,0,2,0,0,39,878,863,871,FALSE,0.992027334851936,2023,2023-2024
ND,2024-03-31,inter-total,38,0,1,0,0,1,0,0,0,0,1,41,39,39,FALSE,0.951219512195122,2023,2023-2024
ND,2024-03-31,inter-ucfe,0,0,0,0,0,0,0,0,0,0,0,0,0,0,FALSE,0,2023,2023-2024
ND,2024-03-31,inter-ucx,0,0,0,0,0,0,0,0,0,0,0,0,0,0,FALSE,0,2023,2023-2024
ND,2024-03-31,inter-ui,38,0,1,0,0,1,0,0,0,0,1,41,39,39,FALSE,0.951219512195122,2023,2023-2024
ND,2024-03-31,intra-total,370,3,1,0,1,1,1,0,0,0,20,397,390,393,FALSE,0.98992443324937,2023,2023-2024
ND,2024-03-31,intra-ucfe,1,0,0,0,0,0,0,0,0,0,0,1,1,1,FALSE,1,2023,2023-2024
ND,2024-03-31,intra-ucx,1,0,0,0,0,0,0,0,0,0,0,1,1,1,FALSE,1,2023,2023-2024
ND,2024-03-31,intra-ui,368,3,1,0,1,1,1,0,0,0,20,395,388,391,FALSE,0.989873417721519,2023,2023-2024
ND,2024-04-30,inter-total,41,3,0,0,0,0,0,0,0,0,2,46,43,46,FALSE,1,2023,2023-2024
ND,2024-04-30,inter-ucfe,0,0,0,0,0,0,0,0,0,0,0,0,0,0,FALSE,0,2023,2023-2024
ND,2024-04-30,inter-ucx,0,0,0,0,0,0,0,0,0,0,0,0,0,0,FALSE,0,2023,2023-2024
ND,2024-04-30,inter-ui,41,3,0,0,0,0,0,0,0,0,2,46,43,46,FALSE,1,2023,2023-2024
ND,2024-04-30,intra-total,276,5,0,2,1,2,0,0,0,0,20,306,296,301,FALSE,0.983660130718954,2023,2023-2024
ND,2024-04-30,intra-ucfe,4,0,0,0,0,0,0,0,0,0,0,4,4,4,FALSE,1,2023,2023-2024
ND,2024-04-30,intra-ucx,0,0,0,0,0,0,0,0,0,0,1,1,1,1,FALSE,1,2023,2023-2024
ND,2024-04-30,intra-ui,272,5,0,2,1,2,0,0,0,0,19,301,291,296,FALSE,0.983388704318937,2023,2023-2024
ND,2024-05-31,inter-total,43,4,0,1,0,0,0,0,0,0,4,52,47,51,FALSE,0.980769230769231,2023,2023-2024
ND,2024-05-31,inter-ucfe,0,0,0,0,0,0,0,0,0,0,0,0,0,0,FALSE,0,2023,2023-2024
ND,2024-05-31,inter-ucx,0,0,0,0,0,0,0,0,0,0,0,0,0,0,FALSE,0,2023,2023-2024
ND,2024-05-31,inter-ui,43,4,0,1,0,0,0,0,0,0,4,52,47,51,FALSE,0.980769230769231,2023,2023-2024
ND,2024-05-31,intra-total,204,3,2,2,0,0,1,1,0,0,23,236,227,230,FALSE,0.974576271186441,2023,2023-2024
ND,2024-05-31,intra-ucfe,1,0,0,0,0,0,0,0,0,0,0,1,1,1,FALSE,1,2023,2023-2024
ND,2024-05-31,intra-ucx,0,0,0,0,0,0,0,0,0,0,0,0,0,0,FALSE,0,2023,2023-2024
ND,2024-05-31,intra-ui,203,3,2,2,0,0,1,1,0,0,23,235,226,229,FALSE,0.974468085106383,2023,2023-2024
ND,2024-06-30,inter-total,33,0,1,1,0,0,0,0,0,0,2,37,35,35,FALSE,0.945945945945946,2023,2023-2024
ND,2024-06-30,inter-ucfe,0,0,0,0,0,0,0,0,0,0,0,0,0,0,FALSE,0,2023,2023-2024
ND,2024-06-30,inter-ucx,0,0,0,0,0,0,0,0,0,0,0,0,0,0,FALSE,0,2023,2023-2024
ND,2024-06-30,inter-ui,33,0,1,1,0,0,0,0,0,0,2,37,35,35,FALSE,0.945945945945946,2023,2023-2024
ND,2024-06-30,intra-total,617,3,2,3,1,0,0,0,0,0,22,648,639,642,FALSE,0.990740740740741,2023,2023-2024
ND,2024-06-30,intra-ucfe,16,0,0,0,1,0,0,0,0,0,1,18,17,17,FALSE,0.944444444444444,2023,2023-2024
ND,2024-06-30,intra-ucx,0,0,0,0,0,0,0,0,0,0,0,0,0,0,FALSE,0,2023,2023-2024
ND,2024-06-30,intra-ui,601,3,2,3,0,0,0,0,0,0,21,630,622,625,FALSE,0.992063492063492,2023,2023-2024
ND,2024-07-31,inter-total,45,0,0,0,0,0,0,0,1,0,2,48,47,47,FALSE,0.979166666666667,2024,2024-2025
ND,2024-07-31,inter-ucfe,0,0,0,0,0,0,0,0,0,0,0,0,0,0,FALSE,0,2024,2024-2025
ND,2024-07-31,inter-ucx,0,0,0,0,0,0,0,0,0,0,0,0,0,0,FALSE,0,2024,2024-2025
ND,2024-07-31,inter-ui,45,0,0,0,0,0,0,0,1,0,2,48,47,47,FALSE,0.979166666666667,2024,2024-2025
ND,2024-07-31,intra-total,1502,3,2,0,1,1,0,0,0,1,43,1553,1545,1548,FALSE,0.996780424983902,2024,2024-2025
ND,2024-07-31,intra-ucfe,125,0,0,0,0,0,0,0,0,0,3,128,128,128,FALSE,1,2024,2024-2025
ND,2024-07-31,intra-ucx,1,0,0,0,0,0,0,0,0,0,0,1,1,1,FALSE,1,2024,2024-2025
ND,2024-07-31,intra-ui,1376,3,2,0,1,1,0,0,0,1,40,1424,1416,1419,FALSE,0.996488764044944,2024,2024-2025
ND,2024-08-31,inter-total,30,0,0,0,0,0,0,0,0,0,1,31,31,31,FALSE,1,2024,2024-2025
ND,2024-08-31,inter-ucfe,0,0,0,0,0,0,0,0,0,0,0,0,0,0,FALSE,0,2024,2024-2025
ND,2024-08-31,inter-ucx,0,0,0,0,0,0,0,0,0,0,0,0,0,0,FALSE,0,2024,2024-2025
ND,2024-08-31,inter-ui,30,0,0,0,0,0,0,0,0,0,1,31,31,31,FALSE,1,2024,2024-2025
ND,2024-08-31,intra-total,338,4,1,2,1,0,0,0,0,0,20,366,358,362,FALSE,0.989071038251366,2024,2024-2025
ND,2024-08-31,intra-ucfe,7,0,0,0,0,0,0,0,0,0,1,8,8,8,FALSE,1,2024,2024-2025
ND,2024-08-31,intra-ucx,1,0,0,0,0,0,0,0,0,0,0,1,1,1,FALSE,1,2024,2024-2025
ND,2024-08-31,intra-ui,330,4,1,2,1,0,0,0,0,0,19,357,349,353,FALSE,0.988795518207283,2024,2024-2025
ND,2024-09-30,inter-total,24,2,2,0,0,0,0,0,0,0,0,28,24,26,FALSE,0.928571428571429,2024,2024-2025
ND,2024-09-30,inter-ucfe,0,0,0,0,0,0,0,0,0,0,0,0,0,0,FALSE,0,2024,2024-2025
ND,2024-09-30,inter-ucx,0,0,0,0,0,0,0,0,0,0,0,0,0,0,FALSE,0,2024,2024-2025
ND,2024-09-30,inter-ui,24,2,2,0,0,0,0,0,0,0,0,28,24,26,FALSE,0.928571428571429,2024,2024-2025
ND,2024-09-30,intra-total,420,8,2,0,0,0,0,0,0,0,22,452,442,450,FALSE,0.995575221238938,2024,2024-2025
ND,2024-09-30,intra-ucfe,2,0,0,0,0,0,0,0,0,0,0,2,2,2,FALSE,1,2024,2024-2025
ND,2024-09-30,intra-ucx,0,1,0,0,0,0,0,0,0,0,0,1,0,1,FALSE,1,2024,2024-2025
ND,2024-09-30,intra-ui,418,7,2,0,0,0,0,0,0,0,22,449,440,447,FALSE,0.99554565701559,2024,2024-2025
ND,2024-10-31,inter-total,33,0,0,0,1,0,0,0,0,0,4,38,37,37,FALSE,0.973684210526316,2024,2024-2025
ND,2024-10-31,inter-ucfe,0,0,0,0,0,0,0,0,0,0,0,0,0,0,FALSE,0,2024,2024-2025
ND,2024-10-31,inter-ucx,0,0,0,0,0,0,0,0,0,0,0,0,0,0,FALSE,0,2024,2024-2025
ND,2024-10-31,inter-ui,33,0,0,0,1,0,0,0,0,0,4,38,37,37,FALSE,0.973684210526316,2024,2024-2025
ND,2024-10-31,intra-total,174,4,3,1,0,0,0,0,0,0,19,201,193,197,FALSE,0.980099502487562,2024,2024-2025
ND,2024-10-31,intra-ucfe,1,0,0,0,0,0,0,0,0,0,0,1,1,1,FALSE,1,2024,2024-2025
ND,2024-10-31,intra-ucx,0,0,0,0,0,0,0,0,0,0,0,0,0,0,FALSE,0,2024,2024-2025
ND,2024-10-31,intra-ui,173,4,3,1,0,0,0,0,0,0,19,200,192,196,FALSE,0.98,2024,2024-2025
ND,2024-11-30,inter-total,133,1,0,0,0,0,0,0,0,0,8,142,141,142,FALSE,1,2024,2024-2025
ND,2024-11-30,inter-ucfe,0,0,0,0,0,0,0,0,0,0,0,0,0,0,FALSE,0,2024,2024-2025
ND,2024-11-30,inter-ucx,0,0,0,0,0,0,0,0,0,0,0,0,0,0,FALSE,0,2024,2024-2025
ND,2024-11-30,inter-ui,133,1,0,0,0,0,0,0,0,0,8,142,141,142,FALSE,1,2024,2024-2025
ND,2024-11-30,intra-total,612,13,7,2,2,0,0,0,1,0,47,684,659,672,FALSE,0.982456140350877,2024,2024-2025
ND,2024-11-30,intra-ucfe,2,0,0,0,0,0,0,0,0,0,0,2,2,2,FALSE,1,2024,2024-2025
ND,2024-11-30,intra-ucx,0,0,0,0,0,0,0,0,0,0,0,0,0,0,FALSE,0,2024,2024-2025
ND,2024-11-30,intra-ui,610,13,7,2,2,0,0,0,1,0,47,682,657,670,FALSE,0.982404692082111,2024,2024-2025
ND,2024-12-31,inter-total,217,4,1,0,1,0,0,0,0,0,15,238,232,236,FALSE,0.991596638655462,2024,2024-2025
ND,2024-12-31,inter-ucfe,0,0,0,0,0,0,0,0,0,0,0,0,0,0,FALSE,0,2024,2024-2025
ND,2024-12-31,inter-ucx,0,0,0,0,0,0,0,0,0,0,0,0,0,0,FALSE,0,2024,2024-2025
ND,2024-12-31,inter-ui,217,4,1,0,1,0,0,0,0,0,15,238,232,236,FALSE,0.991596638655462,2024,2024-2025
ND,2024-12-31,intra-total,2216,14,1,2,4,1,1,0,0,0,68,2307,2284,2298,FALSE,0.996098829648895,2024,2024-2025
ND,2024-12-31,intra-ucfe,3,0,0,0,0,1,0,0,0,0,0,4,3,3,FALSE,0.75,2024,2024-2025
ND,2024-12-31,intra-ucx,1,0,0,0,0,0,0,0,0,0,0,1,1,1,FALSE,1,2024,2024-2025
ND,2024-12-31,intra-ui,2212,14,1,2,4,0,1,0,0,0,68,2302,2280,2294,FALSE,0.996524761077324,2024,2024-2025
NE,2019-01-31,inter-total,29,8,4,7,2,1,0,0,0,0,13,64,42,50,FALSE,0.78125,2018,2018-2019
NE,2019-01-31,inter-ucfe,0,0,0,0,0,0,0,0,0,0,0,0,0,0,FALSE,0,2018,2018-2019
NE,2019-01-31,inter-ucx,0,0,0,0,0,0,0,0,0,0,0,0,0,0,FALSE,0,2018,2018-2019
NE,2019-01-31,inter-ui,29,8,4,7,2,1,0,0,0,0,13,64,42,50,FALSE,0.78125,2018,2018-2019
NE,2019-01-31,intra-total,2128,298,186,92,48,22,5,2,0,4,514,3299,2642,2940,FALSE,0.891179145195514,2018,2018-2019
NE,2019-01-31,intra-ucfe,40,11,2,3,0,0,0,0,0,0,35,91,75,86,FALSE,0.945054945054945,2018,2018-2019
NE,2019-01-31,intra-ucx,0,0,0,0,0,0,0,0,0,0,0,0,0,0,FALSE,0,2018,2018-2019
NE,2019-01-31,intra-ui,2088,287,184,89,48,22,5,2,0,4,479,3208,2567,2854,FALSE,0.889650872817955,2018,2018-2019
NE,2019-02-28,inter-total,26,6,6,1,1,1,1,0,0,0,17,59,43,49,FALSE,0.830508474576271,2018,2018-2019
NE,2019-02-28,inter-ucfe,0,0,0,0,0,0,0,0,0,0,0,0,0,0,FALSE,0,2018,2018-2019
NE,2019-02-28,inter-ucx,0,0,0,0,0,0,0,0,0,0,0,0,0,0,FALSE,0,2018,2018-2019
NE,2019-02-28,inter-ui,26,6,6,1,1,1,1,0,0,0,17,59,43,49,FALSE,0.830508474576271,2018,2018-2019
NE,2019-02-28,intra-total,1143,240,125,61,38,15,5,1,2,2,403,2035,1546,1786,FALSE,0.877641277641278,2018,2018-2019
NE,2019-02-28,intra-ucfe,2,3,2,1,2,0,0,0,0,0,0,10,2,5,FALSE,0.5,2018,2018-2019
NE,2019-02-28,intra-ucx,2,0,0,0,0,0,0,0,0,0,0,2,2,2,FALSE,1,2018,2018-2019
NE,2019-02-28,intra-ui,1139,237,123,60,36,15,5,1,2,2,403,2023,1542,1779,FALSE,0.879387048937222,2018,2018-2019
NE,2019-03-31,inter-total,30,6,3,3,1,0,1,0,0,0,12,56,42,48,FALSE,0.857142857142857,2018,2018-2019
NE,2019-03-31,inter-ucfe,0,0,0,0,0,0,0,0,0,0,0,0,0,0,FALSE,0,2018,2018-2019
NE,2019-03-31,inter-ucx,0,0,0,0,0,0,0,0,0,0,0,0,0,0,FALSE,0,2018,2018-2019
NE,2019-03-31,inter-ui,30,6,3,3,1,0,1,0,0,0,12,56,42,48,FALSE,0.857142857142857,2018,2018-2019
NE,2019-03-31,intra-total,681,88,44,35,21,5,7,2,2,6,225,1116,906,994,FALSE,0.89068100358423,2018,2018-2019
NE,2019-03-31,intra-ucfe,1,0,0,0,0,0,0,0,0,0,0,1,1,1,FALSE,1,2018,2018-2019
NE,2019-03-31,intra-ucx,3,0,0,0,0,0,0,0,0,0,0,3,3,3,FALSE,1,2018,2018-2019
NE,2019-03-31,intra-ui,677,88,44,35,21,5,7,2,2,6,225,1112,902,990,FALSE,0.890287769784173,2018,2018-2019
NE,2019-04-30,inter-total,21,1,0,1,0,0,1,0,0,1,7,32,28,29,FALSE,0.90625,2018,2018-2019
NE,2019-04-30,inter-ucfe,0,0,0,0,0,0,0,0,0,0,0,0,0,0,FALSE,0,2018,2018-2019
NE,2019-04-30,inter-ucx,0,0,0,0,0,0,0,0,0,0,0,0,0,0,FALSE,0,2018,2018-2019
NE,2019-04-30,inter-ui,21,1,0,1,0,0,1,0,0,1,7,32,28,29,FALSE,0.90625,2018,2018-2019
NE,2019-04-30,intra-total,560,54,23,12,10,2,2,2,0,4,222,891,782,836,FALSE,0.938271604938272,2018,2018-2019
NE,2019-04-30,intra-ucfe,0,1,0,1,0,0,0,0,0,0,2,4,2,3,FALSE,0.75,2018,2018-2019
NE,2019-04-30,intra-ucx,1,0,0,0,0,0,0,0,0,0,0,1,1,1,FALSE,1,2018,2018-2019
NE,2019-04-30,intra-ui,559,53,23,11,10,2,2,2,0,4,220,886,779,832,FALSE,0.939051918735892,2018,2018-2019
NE,2019-05-31,inter-total,15,0,0,1,3,2,0,0,0,0,10,31,25,25,FALSE,0.806451612903226,2018,2018-2019
NE,2019-05-31,inter-ucfe,0,0,0,0,0,0,0,0,0,0,0,0,0,0,FALSE,0,2018,2018-2019
NE,2019-05-31,inter-ucx,0,0,0,0,0,0,0,0,0,0,0,0,0,0,FALSE,0,2018,2018-2019
NE,2019-05-31,inter-ui,15,0,0,1,3,2,0,0,0,0,10,31,25,25,FALSE,0.806451612903226,2018,2018-2019
NE,2019-05-31,intra-total,560,36,11,16,7,8,8,3,0,2,172,823,732,768,FALSE,0.933171324422843,2018,2018-2019
NE,2019-05-31,intra-ucfe,1,0,0,0,0,0,0,0,0,0,1,2,2,2,FALSE,1,2018,2018-2019
NE,2019-05-31,intra-ucx,0,0,0,0,0,0,0,0,0,0,0,0,0,0,FALSE,0,2018,2018-2019
NE,2019-05-31,intra-ui,559,36,11,16,7,8,8,3,0,2,171,821,730,766,FALSE,0.933008526187576,2018,2018-2019
NE,2019-06-30,inter-total,19,2,0,1,0,0,0,3,0,0,10,35,29,31,FALSE,0.885714285714286,2018,2018-2019
NE,2019-06-30,inter-ucfe,0,0,0,0,0,0,0,0,0,0,0,0,0,0,FALSE,0,2018,2018-2019
NE,2019-06-30,inter-ucx,0,0,0,0,0,0,0,0,0,0,0,0,0,0,FALSE,0,2018,2018-2019
NE,2019-06-30,inter-ui,19,2,0,1,0,0,0,3,0,0,10,35,29,31,FALSE,0.885714285714286,2018,2018-2019
NE,2019-06-30,intra-total,968,41,10,3,5,10,7,3,3,3,253,1306,1221,1262,FALSE,0.966309341500766,2018,2018-2019
NE,2019-06-30,intra-ucfe,2,0,0,0,0,0,0,0,0,0,0,2,2,2,FALSE,1,2018,2018-2019
NE,2019-06-30,intra-ucx,2,0,0,0,0,0,0,0,0,0,0,2,2,2,FALSE,1,2018,2018-2019
NE,2019-06-30,intra-ui,964,41,10,3,5,10,7,3,3,3,253,1302,1217,1258,FALSE,0.966205837173579,2018,2018-2019
NE,2019-07-31,inter-total,33,4,2,2,0,0,1,0,0,0,13,55,46,50,FALSE,0.909090909090909,2019,2019-2020
NE,2019-07-31,inter-ucfe,0,0,0,0,0,0,0,0,0,0,0,0,0,0,FALSE,0,2019,2019-2020
NE,2019-07-31,inter-ucx,1,0,0,0,0,0,0,0,0,0,0,1,1,1,FALSE,1,2019,2019-2020
NE,2019-07-31,inter-ui,32,4,2,2,0,0,1,0,0,0,13,54,45,49,FALSE,0.907407407407407,2019,2019-2020
NE,2019-07-31,intra-total,808,77,23,8,8,10,6,9,2,1,279,1231,1087,1164,FALSE,0.94557270511779,2019,2019-2020
NE,2019-07-31,intra-ucfe,4,0,0,0,0,1,0,0,0,0,0,5,4,4,FALSE,0.8,2019,2019-2020
NE,2019-07-31,intra-ucx,2,0,0,0,0,0,0,0,0,0,0,2,2,2,FALSE,1,2019,2019-2020
NE,2019-07-31,intra-ui,802,77,23,8,8,9,6,9,2,1,279,1224,1081,1158,FALSE,0.946078431372549,2019,2019-2020
NE,2019-08-31,inter-total,28,3,1,0,0,1,0,1,0,0,10,44,38,41,FALSE,0.931818181818182,2019,2019-2020
NE,2019-08-31,inter-ucfe,0,0,0,0,0,0,0,0,0,0,0,0,0,0,FALSE,0,2019,2019-2020
NE,2019-08-31,inter-ucx,0,0,0,0,0,0,0,0,0,0,0,0,0,0,FALSE,0,2019,2019-2020
NE,2019-08-31,inter-ui,28,3,1,0,0,1,0,1,0,0,10,44,38,41,FALSE,0.931818181818182,2019,2019-2020
NE,2019-08-31,intra-total,463,40,14,5,5,10,5,4,3,3,190,742,653,693,FALSE,0.933962264150943,2019,2019-2020
NE,2019-08-31,intra-ucfe,1,0,0,0,0,0,0,0,0,0,0,1,1,1,FALSE,1,2019,2019-2020
NE,2019-08-31,intra-ucx,1,0,0,0,0,0,0,0,0,0,0,1,1,1,FALSE,1,2019,2019-2020
NE,2019-08-31,intra-ui,461,40,14,5,5,10,5,4,3,3,190,740,651,691,FALSE,0.933783783783784,2019,2019-2020
NE,2019-09-30,inter-total,16,0,1,1,0,0,0,0,1,1,15,35,31,31,FALSE,0.885714285714286,2019,2019-2020
NE,2019-09-30,inter-ucfe,0,0,0,0,0,0,0,0,0,0,0,0,0,0,FALSE,0,2019,2019-2020
NE,2019-09-30,inter-ucx,0,0,0,0,0,0,0,0,0,0,0,0,0,0,FALSE,0,2019,2019-2020
NE,2019-09-30,inter-ui,16,0,1,1,0,0,0,0,1,1,15,35,31,31,FALSE,0.885714285714286,2019,2019-2020
NE,2019-09-30,intra-total,434,32,7,9,7,1,2,0,0,3,150,645,584,616,FALSE,0.955038759689922,2019,2019-2020
NE,2019-09-30,intra-ucfe,2,0,0,0,0,0,0,0,0,1,1,4,3,3,FALSE,0.75,2019,2019-2020
NE,2019-09-30,intra-ucx,2,1,0,0,0,0,0,0,0,0,0,3,2,3,FALSE,1,2019,2019-2020
NE,2019-09-30,intra-ui,430,31,7,9,7,1,2,0,0,2,149,638,579,610,FALSE,0.956112852664577,2019,2019-2020
NE,2019-10-31,inter-total,11,5,1,1,0,0,1,2,0,2,8,31,19,24,FALSE,0.774193548387097,2019,2019-2020
NE,2019-10-31,inter-ucfe,0,0,0,0,0,0,0,0,0,0,0,0,0,0,FALSE,0,2019,2019-2020
NE,2019-10-31,inter-ucx,0,0,0,0,0,0,0,0,0,0,0,0,0,0,FALSE,0,2019,2019-2020
NE,2019-10-31,inter-ui,11,5,1,1,0,0,1,2,0,2,8,31,19,24,FALSE,0.774193548387097,2019,2019-2020
NE,2019-10-31,intra-total,216,83,32,17,4,9,4,1,0,5,222,593,438,521,FALSE,0.87858347386172,2019,2019-2020
NE,2019-10-31,intra-ucfe,0,0,0,0,0,0,0,0,0,0,0,0,0,0,FALSE,0,2019,2019-2020
NE,2019-10-31,intra-ucx,0,0,0,0,0,0,0,0,0,0,0,0,0,0,FALSE,0,2019,2019-2020
NE,2019-10-31,intra-ui,216,83,32,17,4,9,4,1,0,5,222,593,438,521,FALSE,0.87858347386172,2019,2019-2020
NE,2019-11-30,inter-total,38,12,5,1,0,0,1,0,0,1,16,74,54,66,FALSE,0.891891891891892,2019,2019-2020
NE,2019-11-30,inter-ucfe,0,0,0,0,0,0,0,0,0,0,0,0,0,0,FALSE,0,2019,2019-2020
NE,2019-11-30,inter-ucx,0,0,0,0,0,0,0,0,0,0,0,0,0,0,FALSE,0,2019,2019-2020
NE,2019-11-30,inter-ui,38,12,5,1,0,0,1,0,0,1,16,74,54,66,FALSE,0.891891891891892,2019,2019-2020
NE,2019-11-30,intra-total,299,141,65,39,18,9,5,4,2,2,186,770,485,626,FALSE,0.812987012987013,2019,2019-2020
NE,2019-11-30,intra-ucfe,0,1,1,0,0,0,0,0,0,0,2,4,2,3,FALSE,0.75,2019,2019-2020
NE,2019-11-30,intra-ucx,2,0,0,0,0,0,0,0,0,0,0,2,2,2,FALSE,1,2019,2019-2020
NE,2019-11-30,intra-ui,297,140,64,39,18,9,5,4,2,2,184,764,481,621,FALSE,0.81282722513089,2019,2019-2020
NE,2019-12-31,inter-total,51,21,7,5,2,3,4,1,0,0,44,138,95,116,FALSE,0.840579710144928,2019,2019-2020
NE,2019-12-31,inter-ucfe,0,0,0,0,0,0,0,0,0,0,1,1,1,1,FALSE,1,2019,2019-2020
NE,2019-12-31,inter-ucx,0,0,0,0,0,0,0,0,0,0,0,0,0,0,FALSE,0,2019,2019-2020
NE,2019-12-31,inter-ui,51,21,7,5,2,3,4,1,0,0,43,137,94,115,FALSE,0.839416058394161,2019,2019-2020
NE,2019-12-31,intra-total,602,193,64,19,14,9,5,4,3,2,421,1336,1023,1216,FALSE,0.910179640718563,2019,2019-2020
NE,2019-12-31,intra-ucfe,0,1,2,0,0,0,0,0,0,0,0,3,0,1,FALSE,0.333333333333333,2019,2019-2020
NE,2019-12-31,intra-ucx,0,0,0,0,0,0,0,0,0,0,0,0,0,0,FALSE,0,2019,2019-2020
NE,2019-12-31,intra-ui,602,192,62,19,14,9,5,4,3,2,421,1333,1023,1215,FALSE,0.911477869467367,2019,2019-2020
NE,2020-01-31,inter-total,62,41,19,7,6,3,1,2,1,3,64,209,126,167,FALSE,0.799043062200957,2019,2019-2020
NE,2020-01-31,inter-ucfe,0,0,0,0,0,0,0,0,0,0,0,0,0,0,FALSE,0,2019,2019-2020
NE,2020-01-31,inter-ucx,0,0,0,0,0,0,0,0,0,0,0,0,0,0,FALSE,0,2019,2019-2020
NE,2020-01-31,inter-ui,62,41,19,7,6,3,1,2,1,3,64,209,126,167,FALSE,0.799043062200957,2019,2019-2020
NE,2020-01-31,intra-total,1265,451,190,59,26,14,11,7,4,32,803,2862,2068,2519,FALSE,0.880153738644305,2019,2019-2020
NE,2020-01-31,intra-ucfe,0,1,0,0,0,0,1,0,0,0,0,2,0,1,FALSE,0.5,2019,2019-2020
NE,2020-01-31,intra-ucx,0,1,0,0,0,0,0,0,0,0,1,2,1,2,FALSE,1,2019,2019-2020
NE,2020-01-31,intra-ui,1265,449,190,59,26,14,10,7,4,32,802,2858,2067,2516,FALSE,0.880335899230231,2019,2019-2020
NE,2020-02-29,inter-total,57,33,15,8,4,3,1,0,0,0,40,161,97,130,FALSE,0.807453416149068,2019,2019-2020
NE,2020-02-29,inter-ucfe,0,0,0,0,0,0,0,0,0,0,1,1,1,1,FALSE,1,2019,2019-2020
NE,2020-02-29,inter-ucx,0,0,0,0,0,0,0,0,0,0,0,0,0,0,FALSE,0,2019,2019-2020
NE,2020-02-29,inter-ui,57,33,15,8,4,3,1,0,0,0,39,160,96,129,FALSE,0.80625,2019,2019-2020
NE,2020-02-29,intra-total,599,313,127,50,35,21,3,7,2,7,436,1600,1035,1348,FALSE,0.8425,2019,2019-2020
NE,2020-02-29,intra-ucfe,0,2,1,0,0,1,0,1,0,1,1,7,1,3,FALSE,0.428571428571429,2019,2019-2020
NE,2020-02-29,intra-ucx,0,1,0,0,0,0,0,0,0,0,3,4,3,4,FALSE,1,2019,2019-2020
NE,2020-02-29,intra-ui,599,310,126,50,35,20,3,6,2,6,432,1589,1031,1341,FALSE,0.84392699811202,2019,2019-2020
NE,2020-03-31,inter-total,50,10,6,3,0,1,2,1,0,0,19,92,69,79,FALSE,0.858695652173913,2019,2019-2020
NE,2020-03-31,inter-ucfe,1,0,0,0,0,0,0,0,0,0,0,1,1,1,FALSE,1,2019,2019-2020
NE,2020-03-31,inter-ucx,0,0,0,0,0,0,0,0,0,0,0,0,0,0,FALSE,0,2019,2019-2020
NE,2020-03-31,inter-ui,49,10,6,3,0,1,2,1,0,0,19,91,68,78,FALSE,0.857142857142857,2019,2019-2020
NE,2020-03-31,intra-total,3239,79,37,25,12,10,3,3,2,3,239,3652,3478,3557,FALSE,0.973986856516977,2019,2019-2020
NE,2020-03-31,intra-ucfe,4,0,0,0,0,0,0,0,0,0,3,7,7,7,FALSE,1,2019,2019-2020
NE,2020-03-31,intra-ucx,1,0,0,0,0,0,0,0,0,0,0,1,1,1,FALSE,1,2019,2019-2020
NE,2020-03-31,intra-ui,3234,79,37,25,12,10,3,3,2,3,236,3644,3470,3549,FALSE,0.973929747530187,2019,2019-2020
NE,2020-04-30,inter-total,139,28,23,3,0,0,0,2,0,0,117,312,256,284,FALSE,0.91025641025641,2019,2019-2020
NE,2020-04-30,inter-ucfe,0,0,0,0,0,0,0,0,0,0,2,2,2,2,FALSE,1,2019,2019-2020
NE,2020-04-30,inter-ucx,0,0,0,0,0,0,0,0,0,0,0,0,0,0,FALSE,0,2019,2019-2020
NE,2020-04-30,inter-ui,139,28,23,3,0,0,0,2,0,0,115,310,254,282,FALSE,0.909677419354839,2019,2019-2020
NE,2020-04-30,intra-total,13168,2027,2099,652,8,10,8,5,5,9,8420,26411,21588,23615,FALSE,0.894135019499451,2019,2019-2020
NE,2020-04-30,intra-ucfe,0,3,0,0,0,0,0,0,0,0,2,5,2,5,FALSE,1,2019,2019-2020
NE,2020-04-30,intra-ucx,0,1,0,1,1,0,0,0,0,0,2,5,2,3,FALSE,0.6,2019,2019-2020
NE,2020-04-30,intra-ui,13168,2023,2099,651,7,10,8,5,5,9,8416,26401,21584,23607,FALSE,0.894170675353206,2019,2019-2020
NE,2020-05-31,inter-total,284,48,65,73,28,17,1,0,2,2,94,614,378,426,FALSE,0.693811074918567,2019,2019-2020
NE,2020-05-31,inter-ucfe,0,0,0,0,0,0,0,0,0,0,0,0,0,0,FALSE,0,2019,2019-2020
NE,2020-05-31,inter-ucx,0,0,0,0,0,0,0,0,0,0,0,0,0,0,FALSE,0,2019,2019-2020
NE,2020-05-31,inter-ui,284,48,65,73,28,17,1,0,2,2,94,614,378,426,FALSE,0.693811074918567,2019,2019-2020
NE,2020-05-31,intra-total,9615,2621,3956,4710,2282,622,121,46,196,28,3986,28183,13601,16222,FALSE,0.575595216974772,2019,2019-2020
NE,2020-05-31,intra-ucfe,0,1,1,3,1,1,0,0,0,0,1,8,1,2,FALSE,0.25,2019,2019-2020
NE,2020-05-31,intra-ucx,0,1,2,4,2,2,0,0,0,0,0,11,0,1,FALSE,0.0909090909090909,2019,2019-2020
NE,2020-05-31,intra-ui,9615,2619,3953,4703,2279,619,121,46,196,28,3985,28164,13600,16219,FALSE,0.575877006107087,2019,2019-2020
NE,2020-06-30,inter-total,245,7,11,12,9,8,10,6,4,26,57,395,302,309,FALSE,0.782278481012658,2019,2019-2020
NE,2020-06-30,inter-ucfe,0,0,0,0,0,0,1,0,0,0,0,1,0,0,FALSE,0,2019,2019-2020
NE,2020-06-30,inter-ucx,0,0,0,0,0,0,0,0,0,0,0,0,0,0,FALSE,0,2019,2019-2020
NE,2020-06-30,inter-ui,245,7,11,12,9,8,9,6,4,26,57,394,302,309,FALSE,0.784263959390863,2019,2019-2020
NE,2020-06-30,intra-total,7241,357,226,198,172,180,209,217,239,314,1624,10977,8865,9222,FALSE,0.840120251434818,2019,2019-2020
NE,2020-06-30,intra-ucfe,0,0,0,0,0,0,0,0,0,0,1,1,1,1,FALSE,1,2019,2019-2020
NE,2020-06-30,intra-ucx,3,5,3,1,0,2,3,1,2,0,1,21,4,9,FALSE,0.428571428571429,2019,2019-2020
NE,2020-06-30,intra-ui,7238,352,223,197,172,178,206,216,237,314,1622,10955,8860,9212,FALSE,0.840894568690096,2019,2019-2020
NE,2020-07-31,inter-total,50,13,3,3,2,2,1,1,0,58,24,157,74,87,FALSE,0.554140127388535,2020,2020-2021
NE,2020-07-31,inter-ucfe,0,0,0,0,0,0,0,0,0,0,0,0,0,0,FALSE,0,2020,2020-2021
NE,2020-07-31,inter-ucx,0,0,0,0,0,0,0,0,0,0,1,1,1,1,FALSE,1,2020,2020-2021
NE,2020-07-31,inter-ui,50,13,3,3,2,2,1,1,0,58,23,156,73,86,FALSE,0.551282051282051,2020,2020-2021
NE,2020-07-31,intra-total,1439,333,142,97,56,56,44,33,68,1009,706,3983,2145,2478,FALSE,0.622144112478032,2020,2020-2021
NE,2020-07-31,intra-ucfe,0,0,0,0,0,0,0,0,0,0,0,0,0,0,FALSE,0,2020,2020-2021
NE,2020-07-31,intra-ucx,3,2,0,2,0,0,0,0,0,2,2,11,5,7,FALSE,0.636363636363636,2020,2020-2021
NE,2020-07-31,intra-ui,1436,331,142,95,56,56,44,33,68,1007,704,3972,2140,2471,FALSE,0.622104733131924,2020,2020-2021
NE,2020-08-31,inter-total,10,9,20,10,8,2,3,2,3,20,14,101,24,33,FALSE,0.326732673267327,2020,2020-2021
NE,2020-08-31,inter-ucfe,0,0,0,0,0,0,0,0,0,0,0,0,0,0,FALSE,0,2020,2020-2021
NE,2020-08-31,inter-ucx,0,0,0,0,0,0,0,0,0,0,0,0,0,0,FALSE,0,2020,2020-2021
NE,2020-08-31,inter-ui,10,9,20,10,8,2,3,2,3,20,14,101,24,33,FALSE,0.326732673267327,2020,2020-2021
NE,2020-08-31,intra-total,124,154,312,311,177,109,60,28,17,176,87,1555,211,365,FALSE,0.234726688102894,2020,2020-2021
NE,2020-08-31,intra-ucfe,0,1,1,1,0,0,0,0,0,2,0,5,0,1,FALSE,0.2,2020,2020-2021
NE,2020-08-31,intra-ucx,0,0,0,0,1,1,0,0,0,0,0,2,0,0,FALSE,0,2020,2020-2021
NE,2020-08-31,intra-ui,124,153,311,310,176,108,60,28,17,174,87,1548,211,364,FALSE,0.235142118863049,2020,2020-2021
NE,2020-09-30,inter-total,13,10,6,6,11,9,6,3,9,12,15,100,28,38,FALSE,0.38,2020,2020-2021
NE,2020-09-30,inter-ucfe,0,0,0,0,0,1,0,0,0,0,0,1,0,0,FALSE,0,2020,2020-2021
NE,2020-09-30,inter-ucx,0,0,0,0,0,0,0,0,0,0,0,0,0,0,FALSE,0,2020,2020-2021
NE,2020-09-30,inter-ui,13,10,6,6,11,8,6,3,9,12,15,99,28,38,FALSE,0.383838383838384,2020,2020-2021
NE,2020-09-30,intra-total,246,266,118,176,132,135,112,89,59,222,291,1846,537,803,FALSE,0.434994582881907,2020,2020-2021
NE,2020-09-30,intra-ucfe,0,1,0,0,0,0,0,0,2,6,0,9,0,1,FALSE,0.111111111111111,2020,2020-2021
NE,2020-09-30,intra-ucx,0,0,0,0,0,0,1,0,0,2,0,3,0,0,FALSE,0,2020,2020-2021
NE,2020-09-30,intra-ui,246,265,118,176,132,135,111,89,57,214,291,1834,537,802,FALSE,0.437295528898582,2020,2020-2021
NE,2020-10-31,inter-total,28,7,6,2,1,2,3,3,3,13,19,87,47,54,FALSE,0.620689655172414,2020,2020-2021
NE,2020-10-31,inter-ucfe,0,0,0,0,0,0,0,0,0,0,0,0,0,0,FALSE,0,2020,2020-2021
NE,2020-10-31,inter-ucx,0,0,0,0,0,0,0,0,0,0,0,0,0,0,FALSE,0,2020,2020-2021
NE,2020-10-31,inter-ui,28,7,6,2,1,2,3,3,3,13,19,87,47,54,FALSE,0.620689655172414,2020,2020-2021
NE,2020-10-31,intra-total,477,139,94,58,41,45,48,40,20,168,257,1387,734,873,FALSE,0.629416005767844,2020,2020-2021
NE,2020-10-31,intra-ucfe,0,2,0,0,2,0,0,0,0,6,0,10,0,2,FALSE,0.2,2020,2020-2021
NE,2020-10-31,intra-ucx,0,0,0,1,0,0,0,0,0,0,0,1,0,0,FALSE,0,2020,2020-2021
NE,2020-10-31,intra-ui,477,137,94,57,39,45,48,40,20,162,257,1376,734,871,FALSE,0.632994186046512,2020,2020-2021
NE,2020-11-30,inter-total,35,6,3,0,3,0,3,0,0,5,17,72,52,58,FALSE,0.805555555555556,2020,2020-2021
NE,2020-11-30,inter-ucfe,0,0,0,0,0,0,0,0,0,0,0,0,0,0,FALSE,0,2020,2020-2021
NE,2020-11-30,inter-ucx,0,0,0,0,0,0,0,0,0,0,0,0,0,0,FALSE,0,2020,2020-2021
NE,2020-11-30,inter-ui,35,6,3,0,3,0,3,0,0,5,17,72,52,58,FALSE,0.805555555555556,2020,2020-2021
NE,2020-11-30,intra-total,727,87,39,12,10,3,8,2,3,165,292,1348,1019,1106,FALSE,0.820474777448071,2020,2020-2021
NE,2020-11-30,intra-ucfe,0,0,1,0,0,0,0,0,0,1,1,3,1,1,FALSE,0.333333333333333,2020,2020-2021
NE,2020-11-30,intra-ucx,0,0,0,0,0,0,0,0,0,2,0,2,0,0,FALSE,0,2020,2020-2021
NE,2020-11-30,intra-ui,727,87,38,12,10,3,8,2,3,162,291,1343,1018,1105,FALSE,0.822784810126582,2020,2020-2021
NE,2020-12-31,inter-total,74,10,2,3,0,2,0,0,0,8,27,126,101,111,FALSE,0.880952380952381,2020,2020-2021
NE,2020-12-31,inter-ucfe,0,0,0,0,0,0,0,0,0,0,0,0,0,0,FALSE,0,2020,2020-2021
NE,2020-12-31,inter-ucx,0,0,0,0,0,0,0,0,0,0,0,0,0,0,FALSE,0,2020,2020-2021
NE,2020-12-31,inter-ui,74,10,2,3,0,2,0,0,0,8,27,126,101,111,FALSE,0.880952380952381,2020,2020-2021
NE,2020-12-31,intra-total,1495,114,45,17,9,5,6,3,1,101,441,2237,1936,2050,FALSE,0.916405900759946,2020,2020-2021
NE,2020-12-31,intra-ucfe,2,1,1,0,0,0,0,0,0,1,0,5,2,3,FALSE,0.6,2020,2020-2021
NE,2020-12-31,intra-ucx,0,0,0,0,0,0,0,0,0,0,2,2,2,2,FALSE,1,2020,2020-2021
NE,2020-12-31,intra-ui,1493,113,44,17,9,5,6,3,1,100,439,2230,1932,2045,FALSE,0.917040358744395,2020,2020-2021
NE,2021-01-31,inter-total,97,10,9,2,1,1,1,0,0,14,29,164,126,136,FALSE,0.829268292682927,2020,2020-2021
NE,2021-01-31,inter-ucfe,0,0,0,0,0,0,0,0,0,0,0,0,0,0,FALSE,0,2020,2020-2021
NE,2021-01-31,inter-ucx,0,0,0,0,0,0,0,0,0,0,1,1,1,1,FALSE,1,2020,2020-2021
NE,2021-01-31,inter-ui,97,10,9,2,1,1,1,0,0,14,28,163,125,135,FALSE,0.828220858895705,2020,2020-2021
NE,2021-01-31,intra-total,2152,197,66,31,14,16,13,9,6,94,674,3272,2826,3023,FALSE,0.923899755501223,2020,2020-2021
NE,2021-01-31,intra-ucfe,0,0,0,0,0,0,0,0,0,1,2,3,2,2,FALSE,0.666666666666667,2020,2020-2021
NE,2021-01-31,intra-ucx,0,0,0,0,0,0,0,0,0,1,0,1,0,0,FALSE,0,2020,2020-2021
NE,2021-01-31,intra-ui,2152,197,66,31,14,16,13,9,6,92,672,3268,2824,3021,FALSE,0.924418604651163,2020,2020-2021
NE,2021-02-28,inter-total,48,16,7,12,4,1,0,0,0,11,20,119,68,84,FALSE,0.705882352941177,2020,2020-2021
NE,2021-02-28,inter-ucfe,0,0,0,0,0,0,0,0,0,0,0,0,0,0,FALSE,0,2020,2020-2021
NE,2021-02-28,inter-ucx,0,0,0,0,0,0,0,0,0,0,0,0,0,0,FALSE,0,2020,2020-2021
NE,2021-02-28,inter-ui,48,16,7,12,4,1,0,0,0,11,20,119,68,84,FALSE,0.705882352941177,2020,2020-2021
NE,2021-02-28,intra-total,1232,205,171,153,77,22,15,4,6,75,324,2284,1556,1761,FALSE,0.771015761821366,2020,2020-2021
NE,2021-02-28,intra-ucfe,0,0,0,0,0,0,0,0,0,1,0,1,0,0,FALSE,0,2020,2020-2021
NE,2021-02-28,intra-ucx,0,0,0,0,0,0,0,0,0,0,0,0,0,0,FALSE,0,2020,2020-2021
NE,2021-02-28,intra-ui,1232,205,171,153,77,22,15,4,6,74,324,2283,1556,1761,FALSE,0.771353482260184,2020,2020-2021
NE,2021-03-31,inter-total,36,2,6,4,1,3,0,0,1,15,14,82,50,52,FALSE,0.634146341463415,2020,2020-2021
NE,2021-03-31,inter-ucfe,0,0,0,0,0,0,0,0,0,0,0,0,0,0,FALSE,0,2020,2020-2021
NE,2021-03-31,inter-ucx,0,0,0,0,0,0,0,0,0,0,0,0,0,0,FALSE,0,2020,2020-2021
NE,2021-03-31,inter-ui,36,2,6,4,1,3,0,0,1,15,14,82,50,52,FALSE,0.634146341463415,2020,2020-2021
NE,2021-03-31,intra-total,631,89,54,54,34,27,18,14,15,126,226,1288,857,946,FALSE,0.734472049689441,2020,2020-2021
NE,2021-03-31,intra-ucfe,0,0,0,0,0,0,1,0,0,5,0,6,0,0,FALSE,0,2020,2020-2021
NE,2021-03-31,intra-ucx,2,0,0,0,0,0,0,0,0,1,0,3,2,2,FALSE,0.666666666666667,2020,2020-2021
NE,2021-03-31,intra-ui,629,89,54,54,34,27,17,14,15,120,226,1279,855,944,FALSE,0.73807662236122,2020,2020-2021
NE,2021-04-30,inter-total,27,11,0,0,3,5,0,3,0,22,3,74,30,41,FALSE,0.554054054054054,2020,2020-2021
NE,2021-04-30,inter-ucfe,0,0,0,0,0,0,0,0,0,0,0,0,0,0,FALSE,0,2020,2020-2021
NE,2021-04-30,inter-ucx,0,0,0,0,0,0,0,1,0,0,0,1,0,0,FALSE,0,2020,2020-2021
NE,2021-04-30,inter-ui,27,11,0,0,3,5,0,2,0,22,3,73,30,41,FALSE,0.561643835616438,2020,2020-2021
NE,2021-04-30,intra-total,773,97,72,34,36,58,30,20,9,166,287,1582,1060,1157,FALSE,0.731352718078382,2020,2020-2021
NE,2021-04-30,intra-ucfe,0,1,0,0,0,0,0,0,0,0,0,1,0,1,FALSE,1,2020,2020-2021
NE,2021-04-30,intra-ucx,0,1,0,0,0,0,1,0,0,0,0,2,0,1,FALSE,0.5,2020,2020-2021
NE,2021-04-30,intra-ui,773,95,72,34,36,58,29,20,9,166,287,1579,1060,1155,FALSE,0.731475617479417,2020,2020-2021
NE,2021-05-31,inter-total,32,2,5,4,4,1,2,1,0,32,5,88,37,39,FALSE,0.443181818181818,2020,2020-2021
NE,2021-05-31,inter-ucfe,0,0,0,0,0,0,0,0,0,1,0,1,0,0,FALSE,0,2020,2020-2021
NE,2021-05-31,inter-ucx,0,0,0,0,0,0,0,0,0,0,0,0,0,0,FALSE,0,2020,2020-2021
NE,2021-05-31,inter-ui,32,2,5,4,4,1,2,1,0,31,5,87,37,39,FALSE,0.448275862068966,2020,2020-2021
NE,2021-05-31,intra-total,692,105,76,75,58,42,38,29,35,626,280,2056,972,1077,FALSE,0.523832684824903,2020,2020-2021
NE,2021-05-31,intra-ucfe,1,0,0,0,0,0,0,0,0,3,0,4,1,1,FALSE,0.25,2020,2020-2021
NE,2021-05-31,intra-ucx,1,0,0,0,0,0,0,0,0,0,0,1,1,1,FALSE,1,2020,2020-2021
NE,2021-05-31,intra-ui,690,105,76,75,58,42,38,29,35,623,280,2051,970,1075,FALSE,0.524134568503169,2020,2020-2021
NE,2021-06-30,inter-total,25,5,0,1,2,1,1,2,2,16,14,69,39,44,FALSE,0.63768115942029,2020,2020-2021
NE,2021-06-30,inter-ucfe,0,0,0,0,0,0,0,0,0,0,0,0,0,0,FALSE,0,2020,2020-2021
NE,2021-06-30,inter-ucx,0,0,0,0,0,0,0,0,0,0,0,0,0,0,FALSE,0,2020,2020-2021
NE,2021-06-30,inter-ui,25,5,0,1,2,1,1,2,2,16,14,69,39,44,FALSE,0.63768115942029,2020,2020-2021
NE,2021-06-30,intra-total,923,110,55,17,18,18,18,11,8,164,308,1650,1231,1341,FALSE,0.812727272727273,2020,2020-2021
NE,2021-06-30,intra-ucfe,0,1,1,0,0,1,0,0,1,2,0,6,0,1,FALSE,0.166666666666667,2020,2020-2021
NE,2021-06-30,intra-ucx,1,0,0,0,1,0,0,0,0,1,0,3,1,1,FALSE,0.333333333333333,2020,2020-2021
NE,2021-06-30,intra-ui,922,109,54,17,17,17,18,11,7,161,308,1641,1230,1339,FALSE,0.815965874466789,2020,2020-2021
NE,2021-07-31,inter-total,23,12,2,3,2,3,2,1,0,4,21,73,44,56,FALSE,0.767123287671233,2021,2021-2022
NE,2021-07-31,inter-ucfe,0,0,0,0,0,0,0,0,0,0,0,0,0,0,FALSE,0,2021,2021-2022
NE,2021-07-31,inter-ucx,0,0,0,0,0,0,0,0,0,0,0,0,0,0,FALSE,0,2021,2021-2022
NE,2021-07-31,inter-ui,23,12,2,3,2,3,2,1,0,4,21,73,44,56,FALSE,0.767123287671233,2021,2021-2022
NE,2021-07-31,intra-total,546,196,61,25,25,18,9,8,2,89,265,1244,811,1007,FALSE,0.809485530546624,2021,2021-2022
NE,2021-07-31,intra-ucfe,0,1,0,0,0,0,0,0,0,0,0,1,0,1,FALSE,1,2021,2021-2022
NE,2021-07-31,intra-ucx,1,0,0,0,0,0,0,0,0,0,0,1,1,1,FALSE,1,2021,2021-2022
NE,2021-07-31,intra-ui,545,195,61,25,25,18,9,8,2,89,265,1242,810,1005,FALSE,0.809178743961353,2021,2021-2022
NE,2021-08-31,inter-total,6,5,1,0,0,2,2,0,0,14,8,38,14,19,FALSE,0.5,2021,2021-2022
NE,2021-08-31,inter-ucfe,0,0,0,0,0,0,0,0,0,0,0,0,0,0,FALSE,0,2021,2021-2022
NE,2021-08-31,inter-ucx,0,0,0,0,0,0,0,0,0,0,0,0,0,0,FALSE,0,2021,2021-2022
NE,2021-08-31,inter-ui,6,5,1,0,0,2,2,0,0,14,8,38,14,19,FALSE,0.5,2021,2021-2022
NE,2021-08-31,intra-total,311,90,62,40,25,16,12,2,6,110,206,880,517,607,FALSE,0.689772727272727,2021,2021-2022
NE,2021-08-31,intra-ucfe,0,0,1,0,1,1,1,0,0,0,1,5,1,1,FALSE,0.2,2021,2021-2022
NE,2021-08-31,intra-ucx,0,0,0,0,0,0,0,0,0,0,0,0,0,0,FALSE,0,2021,2021-2022
NE,2021-08-31,intra-ui,311,90,61,40,24,15,11,2,6,110,205,875,516,606,FALSE,0.692571428571429,2021,2021-2022
NE,2021-09-30,inter-total,8,9,1,2,0,0,0,1,1,6,10,38,18,27,FALSE,0.710526315789474,2021,2021-2022
NE,2021-09-30,inter-ucfe,0,0,0,0,0,0,0,0,0,0,0,0,0,0,FALSE,0,2021,2021-2022
NE,2021-09-30,inter-ucx,0,0,0,0,0,0,0,0,0,0,0,0,0,0,FALSE,0,2021,2021-2022
NE,2021-09-30,inter-ui,8,9,1,2,0,0,0,1,1,6,10,38,18,27,FALSE,0.710526315789474,2021,2021-2022
NE,2021-09-30,intra-total,178,114,44,33,21,12,5,11,8,56,142,624,320,434,FALSE,0.69551282051282,2021,2021-2022
NE,2021-09-30,intra-ucfe,1,1,0,0,0,0,0,1,0,2,0,5,1,2,FALSE,0.4,2021,2021-2022
NE,2021-09-30,intra-ucx,0,0,0,0,0,0,0,0,0,0,0,0,0,0,FALSE,0,2021,2021-2022
NE,2021-09-30,intra-ui,177,113,44,33,21,12,5,10,8,54,142,619,319,432,FALSE,0.697899838449112,2021,2021-2022
NE,2021-10-31,inter-total,6,10,7,3,2,0,2,0,0,5,4,39,10,20,FALSE,0.512820512820513,2021,2021-2022
NE,2021-10-31,inter-ucfe,0,0,0,0,0,0,0,0,0,0,0,0,0,0,FALSE,0,2021,2021-2022
NE,2021-10-31,inter-ucx,0,0,0,0,0,0,0,0,0,0,0,0,0,0,FALSE,0,2021,2021-2022
NE,2021-10-31,inter-ui,6,10,7,3,2,0,2,0,0,5,4,39,10,20,FALSE,0.512820512820513,2021,2021-2022
NE,2021-10-31,intra-total,148,78,44,34,8,6,8,4,7,56,125,518,273,351,FALSE,0.677606177606178,2021,2021-2022
NE,2021-10-31,intra-ucfe,1,0,0,0,0,0,0,0,0,1,0,2,1,1,FALSE,0.5,2021,2021-2022
NE,2021-10-31,intra-ucx,0,0,1,0,0,0,0,0,0,0,1,2,1,1,FALSE,0.5,2021,2021-2022
NE,2021-10-31,intra-ui,147,78,43,34,8,6,8,4,7,55,124,514,271,349,FALSE,0.678988326848249,2021,2021-2022
NE,2021-11-30,inter-total,11,2,7,2,0,2,0,0,2,5,8,39,19,21,FALSE,0.538461538461538,2021,2021-2022
NE,2021-11-30,inter-ucfe,0,0,0,0,0,0,0,0,0,1,0,1,0,0,FALSE,0,2021,2021-2022
NE,2021-11-30,inter-ucx,0,0,0,0,0,0,0,0,0,0,0,0,0,0,FALSE,0,2021,2021-2022
NE,2021-11-30,inter-ui,11,2,7,2,0,2,0,0,2,4,8,38,19,21,FALSE,0.552631578947369,2021,2021-2022
NE,2021-11-30,intra-total,209,67,35,21,13,8,6,8,6,42,137,552,346,413,FALSE,0.748188405797102,2021,2021-2022
NE,2021-11-30,intra-ucfe,2,1,1,0,0,0,0,0,0,0,1,5,3,4,FALSE,0.8,2021,2021-2022
NE,2021-11-30,intra-ucx,0,0,0,0,0,0,0,0,0,0,0,0,0,0,FALSE,0,2021,2021-2022
NE,2021-11-30,intra-ui,207,66,34,21,13,8,6,8,6,42,136,547,343,409,FALSE,0.747714808043876,2021,2021-2022
NE,2021-12-31,inter-total,15,6,5,6,3,2,2,2,0,6,18,65,33,39,FALSE,0.6,2021,2021-2022
NE,2021-12-31,inter-ucfe,0,0,0,0,0,0,0,0,0,0,0,0,0,0,FALSE,0,2021,2021-2022
NE,2021-12-31,inter-ucx,0,0,0,0,0,0,0,0,0,0,0,0,0,0,FALSE,0,2021,2021-2022
NE,2021-12-31,inter-ui,15,6,5,6,3,2,2,2,0,6,18,65,33,39,FALSE,0.6,2021,2021-2022
NE,2021-12-31,intra-total,419,94,51,35,24,13,10,3,1,34,236,920,655,749,FALSE,0.814130434782609,2021,2021-2022
NE,2021-12-31,intra-ucfe,1,1,0,0,0,0,0,0,0,2,1,5,2,3,FALSE,0.6,2021,2021-2022
NE,2021-12-31,intra-ucx,0,0,0,0,0,0,0,0,0,0,0,0,0,0,FALSE,0,2021,2021-2022
NE,2021-12-31,intra-ui,418,93,51,35,24,13,10,3,1,32,235,915,653,746,FALSE,0.815300546448088,2021,2021-2022
NE,2022-01-31,inter-total,32,13,1,5,2,1,0,0,0,0,29,83,61,74,FALSE,0.891566265060241,2021,2021-2022
NE,2022-01-31,inter-ucfe,0,0,0,1,0,0,0,0,0,0,0,1,0,0,FALSE,0,2021,2021-2022
NE,2022-01-31,inter-ucx,0,0,0,0,0,0,0,0,0,0,0,0,0,0,FALSE,0,2021,2021-2022
NE,2022-01-31,inter-ui,32,13,1,4,2,1,0,0,0,0,29,82,61,74,FALSE,0.902439024390244,2021,2021-2022
NE,2022-01-31,intra-total,796,183,76,33,27,9,9,8,6,24,510,1681,1306,1489,FALSE,0.885782272456871,2021,2021-2022
NE,2022-01-31,intra-ucfe,0,0,0,0,0,0,0,0,0,0,1,1,1,1,FALSE,1,2021,2021-2022
NE,2022-01-31,intra-ucx,0,0,0,1,0,0,0,0,0,0,0,1,0,0,FALSE,0,2021,2021-2022
NE,2022-01-31,intra-ui,796,183,76,32,27,9,9,8,6,24,509,1679,1305,1488,FALSE,0.886241810601548,2021,2021-2022
NE,2022-02-28,inter-total,30,5,3,2,2,2,5,1,2,1,24,77,54,59,FALSE,0.766233766233766,2021,2021-2022
NE,2022-02-28,inter-ucfe,0,0,0,0,0,0,0,0,0,0,0,0,0,0,FALSE,0,2021,2021-2022
NE,2022-02-28,inter-ucx,0,0,0,0,0,0,0,0,0,0,0,0,0,0,FALSE,0,2021,2021-2022
NE,2022-02-28,inter-ui,30,5,3,2,2,2,5,1,2,1,24,77,54,59,FALSE,0.766233766233766,2021,2021-2022
NE,2022-02-28,intra-total,516,122,77,43,34,29,18,2,8,21,264,1134,780,902,FALSE,0.795414462081129,2021,2021-2022
NE,2022-02-28,intra-ucfe,0,0,0,0,0,0,0,0,0,2,0,2,0,0,FALSE,0,2021,2021-2022
NE,2022-02-28,intra-ucx,0,1,0,1,0,0,0,0,0,0,0,2,0,1,FALSE,0.5,2021,2021-2022
NE,2022-02-28,intra-ui,516,121,77,42,34,29,18,2,8,19,264,1130,780,901,FALSE,0.797345132743363,2021,2021-2022
NE,2022-03-31,inter-total,6,5,1,1,1,1,2,2,1,8,5,33,11,16,FALSE,0.484848484848485,2021,2021-2022
NE,2022-03-31,inter-ucfe,0,0,0,0,0,0,0,0,0,0,0,0,0,0,FALSE,0,2021,2021-2022
NE,2022-03-31,inter-ucx,0,0,0,0,0,0,0,0,0,0,0,0,0,0,FALSE,0,2021,2021-2022
NE,2022-03-31,inter-ui,6,5,1,1,1,1,2,2,1,8,5,33,11,16,FALSE,0.484848484848485,2021,2021-2022
NE,2022-03-31,intra-total,377,57,40,31,15,18,18,14,17,55,157,799,534,591,FALSE,0.739674593241552,2021,2021-2022
NE,2022-03-31,intra-ucfe,0,0,1,0,0,1,0,1,0,0,0,3,0,0,FALSE,0,2021,2021-2022
NE,2022-03-31,intra-ucx,0,0,0,1,0,0,0,0,0,0,0,1,0,0,FALSE,0,2021,2021-2022
NE,2022-03-31,intra-ui,377,57,39,30,15,17,18,13,17,55,157,795,534,591,FALSE,0.743396226415094,2021,2021-2022
NE,2022-04-30,inter-total,4,3,2,1,0,0,0,1,0,3,7,21,11,14,FALSE,0.666666666666667,2021,2021-2022
NE,2022-04-30,inter-ucfe,0,0,0,0,0,0,0,0,0,0,0,0,0,0,FALSE,0,2021,2021-2022
NE,2022-04-30,inter-ucx,0,0,0,0,0,0,0,0,0,0,0,0,0,0,FALSE,0,2021,2021-2022
NE,2022-04-30,inter-ui,4,3,2,1,0,0,0,1,0,3,7,21,11,14,FALSE,0.666666666666667,2021,2021-2022
NE,2022-04-30,intra-total,226,49,49,16,22,5,10,6,8,32,135,558,361,410,FALSE,0.734767025089606,2021,2021-2022
NE,2022-04-30,intra-ucfe,0,0,0,0,0,0,0,0,0,1,0,1,0,0,FALSE,0,2021,2021-2022
NE,2022-04-30,intra-ucx,2,0,0,0,0,0,0,0,0,0,0,2,2,2,FALSE,1,2021,2021-2022
NE,2022-04-30,intra-ui,224,49,49,16,22,5,10,6,8,31,135,555,359,408,FALSE,0.735135135135135,2021,2021-2022
NE,2022-05-31,inter-total,12,1,2,1,0,1,0,0,0,4,8,29,20,21,FALSE,0.724137931034483,2021,2021-2022
NE,2022-05-31,inter-ucfe,0,0,0,0,0,0,0,0,0,0,0,0,0,0,FALSE,0,2021,2021-2022
NE,2022-05-31,inter-ucx,0,0,0,0,0,0,0,0,0,0,0,0,0,0,FALSE,0,2021,2021-2022
NE,2022-05-31,inter-ui,12,1,2,1,0,1,0,0,0,4,8,29,20,21,FALSE,0.724137931034483,2021,2021-2022
NE,2022-05-31,intra-total,340,56,32,23,11,11,5,2,1,24,198,703,538,594,FALSE,0.844950213371266,2021,2021-2022
NE,2022-05-31,intra-ucfe,0,0,0,0,0,0,0,0,0,1,0,1,0,0,FALSE,0,2021,2021-2022
NE,2022-05-31,intra-ucx,0,0,0,0,0,0,0,0,0,0,0,0,0,0,FALSE,0,2021,2021-2022
NE,2022-05-31,intra-ui,340,56,32,23,11,11,5,2,1,23,198,702,538,594,FALSE,0.846153846153846,2021,2021-2022
NE,2022-06-30,inter-total,9,4,3,0,0,0,0,0,0,1,7,24,16,20,FALSE,0.833333333333333,2021,2021-2022
NE,2022-06-30,inter-ucfe,0,0,0,0,0,0,0,0,0,0,0,0,0,0,FALSE,0,2021,2021-2022
NE,2022-06-30,inter-ucx,0,0,0,0,0,0,0,0,0,0,0,0,0,0,FALSE,0,2021,2021-2022
NE,2022-06-30,inter-ui,9,4,3,0,0,0,0,0,0,1,7,24,16,20,FALSE,0.833333333333333,2021,2021-2022
NE,2022-06-30,intra-total,503,59,24,14,15,3,4,4,0,32,233,891,736,795,FALSE,0.892255892255892,2021,2021-2022
NE,2022-06-30,intra-ucfe,1,0,0,0,0,0,0,0,0,0,0,1,1,1,FALSE,1,2021,2021-2022
NE,2022-06-30,intra-ucx,0,0,0,0,0,0,0,0,0,0,0,0,0,0,FALSE,0,2021,2021-2022
NE,2022-06-30,intra-ui,502,59,24,14,15,3,4,4,0,32,233,890,735,794,FALSE,0.892134831460674,2021,2021-2022
NE,2022-07-31,inter-total,9,9,3,3,3,1,1,1,1,3,6,40,15,24,FALSE,0.6,2022,2022-2023
NE,2022-07-31,inter-ucfe,0,0,0,0,0,0,0,0,0,0,0,0,0,0,FALSE,0,2022,2022-2023
NE,2022-07-31,inter-ucx,0,0,0,0,0,0,0,0,0,0,0,0,0,0,FALSE,0,2022,2022-2023
NE,2022-07-31,inter-ui,9,9,3,3,3,1,1,1,1,3,6,40,15,24,FALSE,0.6,2022,2022-2023
NE,2022-07-31,intra-total,182,154,76,48,28,20,8,0,2,14,259,791,441,595,FALSE,0.752212389380531,2022,2022-2023
NE,2022-07-31,intra-ucfe,0,0,2,0,0,0,0,0,0,0,0,2,0,0,FALSE,0,2022,2022-2023
NE,2022-07-31,intra-ucx,0,0,0,0,0,0,0,0,0,0,0,0,0,0,FALSE,0,2022,2022-2023
NE,2022-07-31,intra-ui,182,154,74,48,28,20,8,0,2,14,259,789,441,595,FALSE,0.754119138149556,2022,2022-2023
NE,2022-08-31,inter-total,6,10,1,2,1,1,1,1,0,2,5,30,11,21,FALSE,0.7,2022,2022-2023
NE,2022-08-31,inter-ucfe,0,0,0,0,0,0,0,0,0,0,0,0,0,0,FALSE,0,2022,2022-2023
NE,2022-08-31,inter-ucx,0,0,0,0,0,0,0,0,0,0,0,0,0,0,FALSE,0,2022,2022-2023
NE,2022-08-31,inter-ui,6,10,1,2,1,1,1,1,0,2,5,30,11,21,FALSE,0.7,2022,2022-2023
NE,2022-08-31,intra-total,227,127,53,37,28,23,7,10,5,23,227,767,454,581,FALSE,0.757496740547588,2022,2022-2023
NE,2022-08-31,intra-ucfe,0,0,0,0,0,0,0,0,0,1,0,1,0,0,FALSE,0,2022,2022-2023
NE,2022-08-31,intra-ucx,0,0,0,0,0,0,0,1,0,0,0,1,0,0,FALSE,0,2022,2022-2023
NE,2022-08-31,intra-ui,227,127,53,37,28,23,7,9,5,22,227,765,454,581,FALSE,0.759477124183007,2022,2022-2023
NE,2022-09-30,inter-total,10,5,2,1,0,1,0,0,0,2,12,33,22,27,FALSE,0.818181818181818,2022,2022-2023
NE,2022-09-30,inter-ucfe,0,0,0,0,0,0,0,0,0,0,1,1,1,1,FALSE,1,2022,2022-2023
NE,2022-09-30,inter-ucx,0,0,0,0,0,0,0,0,0,0,0,0,0,0,FALSE,0,2022,2022-2023
NE,2022-09-30,inter-ui,10,5,2,1,0,1,0,0,0,2,11,32,21,26,FALSE,0.8125,2022,2022-2023
NE,2022-09-30,intra-total,130,66,54,18,13,6,6,6,4,16,127,446,257,323,FALSE,0.724215246636771,2022,2022-2023
NE,2022-09-30,intra-ucfe,0,0,1,1,1,0,0,0,0,2,0,5,0,0,FALSE,0,2022,2022-2023
NE,2022-09-30,intra-ucx,0,0,1,0,0,0,0,0,0,0,0,1,0,0,FALSE,0,2022,2022-2023
NE,2022-09-30,intra-ui,130,66,52,17,12,6,6,6,4,14,127,440,257,323,FALSE,0.734090909090909,2022,2022-2023
NE,2022-10-31,inter-total,15,3,1,1,1,0,0,0,0,0,6,27,21,24,FALSE,0.888888888888889,2022,2022-2023
NE,2022-10-31,inter-ucfe,1,0,0,0,0,0,0,0,0,0,0,1,1,1,FALSE,1,2022,2022-2023
NE,2022-10-31,inter-ucx,0,0,0,0,0,0,0,0,0,0,0,0,0,0,FALSE,0,2022,2022-2023
NE,2022-10-31,inter-ui,14,3,1,1,1,0,0,0,0,0,6,26,20,23,FALSE,0.884615384615385,2022,2022-2023
NE,2022-10-31,intra-total,254,46,44,24,11,17,10,2,5,11,140,564,394,440,FALSE,0.780141843971631,2022,2022-2023
NE,2022-10-31,intra-ucfe,0,0,0,1,0,0,0,0,1,0,0,2,0,0,FALSE,0,2022,2022-2023
NE,2022-10-31,intra-ucx,0,0,0,0,0,0,0,0,0,0,2,2,2,2,FALSE,1,2022,2022-2023
NE,2022-10-31,intra-ui,254,46,44,23,11,17,10,2,4,11,138,560,392,438,FALSE,0.782142857142857,2022,2022-2023
NE,2022-11-30,inter-total,13,1,1,1,0,0,1,0,1,0,10,28,23,24,FALSE,0.857142857142857,2022,2022-2023
NE,2022-11-30,inter-ucfe,0,0,0,0,0,0,0,0,0,0,0,0,0,0,FALSE,0,2022,2022-2023
NE,2022-11-30,inter-ucx,0,0,0,0,0,0,0,0,0,0,0,0,0,0,FALSE,0,2022,2022-2023
NE,2022-11-30,inter-ui,13,1,1,1,0,0,1,0,1,0,10,28,23,24,FALSE,0.857142857142857,2022,2022-2023
NE,2022-11-30,intra-total,202,59,28,10,16,22,22,11,9,12,172,563,374,433,FALSE,0.769094138543517,2022,2022-2023
NE,2022-11-30,intra-ucfe,0,0,0,0,0,0,0,0,0,0,0,0,0,0,FALSE,0,2022,2022-2023
NE,2022-11-30,intra-ucx,0,0,0,0,0,0,0,0,0,0,0,0,0,0,FALSE,0,2022,2022-2023
NE,2022-11-30,intra-ui,202,59,28,10,16,22,22,11,9,12,172,563,374,433,FALSE,0.769094138543517,2022,2022-2023
NE,2022-12-31,inter-total,24,10,5,2,4,3,0,0,0,1,16,65,40,50,FALSE,0.769230769230769,2022,2022-2023
NE,2022-12-31,inter-ucfe,0,0,0,0,0,0,0,0,0,0,0,0,0,0,FALSE,0,2022,2022-2023
NE,2022-12-31,inter-ucx,0,0,0,0,0,0,0,0,0,0,0,0,0,0,FALSE,0,2022,2022-2023
NE,2022-12-31,inter-ui,24,10,5,2,4,3,0,0,0,1,16,65,40,50,FALSE,0.769230769230769,2022,2022-2023
NE,2022-12-31,intra-total,519,95,52,34,14,13,4,3,3,11,254,1002,773,868,FALSE,0.86626746506986,2022,2022-2023
NE,2022-12-31,intra-ucfe,0,0,0,0,0,1,0,0,0,1,0,2,0,0,FALSE,0,2022,2022-2023
NE,2022-12-31,intra-ucx,1,0,0,0,0,0,0,0,0,0,0,1,1,1,FALSE,1,2022,2022-2023
NE,2022-12-31,intra-ui,518,95,52,34,14,12,4,3,3,10,254,999,772,867,FALSE,0.867867867867868,2022,2022-2023
NE,2023-01-31,inter-total,37,13,8,2,4,1,1,0,0,3,24,93,61,74,FALSE,0.795698924731183,2022,2022-2023
NE,2023-01-31,inter-ucfe,0,0,0,0,0,0,0,0,0,0,0,0,0,0,FALSE,0,2022,2022-2023
NE,2023-01-31,inter-ucx,0,0,0,0,0,0,0,0,0,0,0,0,0,0,FALSE,0,2022,2022-2023
NE,2023-01-31,inter-ui,37,13,8,2,4,1,1,0,0,3,24,93,61,74,FALSE,0.795698924731183,2022,2022-2023
NE,2023-01-31,intra-total,1018,284,169,76,42,20,12,6,6,20,752,2405,1770,2054,FALSE,0.854054054054054,2022,2022-2023
NE,2023-01-31,intra-ucfe,0,0,0,0,0,0,0,0,0,0,1,1,1,1,FALSE,1,2022,2022-2023
NE,2023-01-31,intra-ucx,0,0,0,0,0,0,0,0,0,1,0,1,0,0,FALSE,0,2022,2022-2023
NE,2023-01-31,intra-ui,1018,284,169,76,42,20,12,6,6,19,751,2403,1769,2053,FALSE,0.854348730753225,2022,2022-2023
NE,2023-02-28,inter-total,30,13,10,6,3,1,0,2,3,3,26,97,56,69,FALSE,0.711340206185567,2022,2022-2023
NE,2023-02-28,inter-ucfe,0,0,0,0,0,0,0,0,0,1,0,1,0,0,FALSE,0,2022,2022-2023
NE,2023-02-28,inter-ucx,0,0,0,0,0,0,0,0,0,0,0,0,0,0,FALSE,0,2022,2022-2023
NE,2023-02-28,inter-ui,30,13,10,6,3,1,0,2,3,2,26,96,56,69,FALSE,0.71875,2022,2022-2023
NE,2023-02-28,intra-total,324,219,174,94,60,49,16,5,4,7,279,1231,603,822,FALSE,0.667749796913079,2022,2022-2023
NE,2023-02-28,intra-ucfe,0,0,0,0,0,0,0,0,1,2,0,3,0,0,FALSE,0,2022,2022-2023
NE,2023-02-28,intra-ucx,0,0,0,0,0,0,0,0,0,0,0,0,0,0,FALSE,0,2022,2022-2023
NE,2023-02-28,intra-ui,324,219,174,94,60,49,16,5,3,5,279,1228,603,822,FALSE,0.669381107491857,2022,2022-2023
NE,2023-03-31,inter-total,17,20,10,6,2,1,2,0,1,4,12,75,29,49,FALSE,0.653333333333333,2022,2022-2023
NE,2023-03-31,inter-ucfe,0,0,0,0,0,0,0,0,0,0,0,0,0,0,FALSE,0,2022,2022-2023
NE,2023-03-31,inter-ucx,0,0,0,0,0,0,0,0,0,0,0,0,0,0,FALSE,0,2022,2022-2023
NE,2023-03-31,inter-ui,17,20,10,6,2,1,2,0,1,4,12,75,29,49,FALSE,0.653333333333333,2022,2022-2023
NE,2023-03-31,intra-total,296,255,125,60,45,25,17,6,4,13,230,1076,526,781,FALSE,0.725836431226766,2022,2022-2023
NE,2023-03-31,intra-ucfe,0,0,0,0,0,0,0,0,0,0,0,0,0,0,FALSE,0,2022,2022-2023
NE,2023-03-31,intra-ucx,1,0,0,0,0,0,0,0,0,0,0,1,1,1,FALSE,1,2022,2022-2023
NE,2023-03-31,intra-ui,295,255,125,60,45,25,17,6,4,13,230,1075,525,780,FALSE,0.725581395348837,2022,2022-2023
NE,2023-04-30,inter-total,12,7,4,2,2,2,1,0,1,0,11,42,23,30,FALSE,0.714285714285714,2022,2022-2023
NE,2023-04-30,inter-ucfe,0,0,0,0,0,0,0,0,0,0,0,0,0,0,FALSE,0,2022,2022-2023
NE,2023-04-30,inter-ucx,0,0,0,0,0,0,0,0,0,0,0,0,0,0,FALSE,0,2022,2022-2023
NE,2023-04-30,inter-ui,12,7,4,2,2,2,1,0,1,0,11,42,23,30,FALSE,0.714285714285714,2022,2022-2023
NE,2023-04-30,intra-total,235,91,34,16,14,8,9,10,11,25,173,626,408,499,FALSE,0.797124600638978,2022,2022-2023
NE,2023-04-30,intra-ucfe,0,0,0,0,0,0,0,0,0,0,0,0,0,0,FALSE,0,2022,2022-2023
NE,2023-04-30,intra-ucx,0,0,0,0,0,0,0,1,0,1,0,2,0,0,FALSE,0,2022,2022-2023
NE,2023-04-30,intra-ui,235,91,34,16,14,8,9,9,11,24,173,624,408,499,FALSE,0.799679487179487,2022,2022-2023
NE,2023-05-31,inter-total,35,6,2,2,0,0,0,0,0,3,5,53,40,46,FALSE,0.867924528301887,2022,2022-2023
NE,2023-05-31,inter-ucfe,0,0,0,0,0,0,0,0,0,1,0,1,0,0,FALSE,0,2022,2022-2023
NE,2023-05-31,inter-ucx,0,0,0,0,0,0,0,0,0,0,0,0,0,0,FALSE,0,2022,2022-2023
NE,2023-05-31,inter-ui,35,6,2,2,0,0,0,0,0,2,5,52,40,46,FALSE,0.884615384615385,2022,2022-2023
NE,2023-05-31,intra-total,447,30,23,9,9,7,3,7,1,16,172,724,619,649,FALSE,0.896408839779006,2022,2022-2023
NE,2023-05-31,intra-ucfe,0,0,0,0,1,0,0,0,0,0,1,2,1,1,FALSE,0.5,2022,2022-2023
NE,2023-05-31,intra-ucx,0,1,0,0,0,0,0,0,0,0,0,1,0,1,FALSE,1,2022,2022-2023
NE,2023-05-31,intra-ui,447,29,23,9,8,7,3,7,1,16,171,721,618,647,FALSE,0.897364771151179,2022,2022-2023
NE,2023-06-30,inter-total,32,3,2,2,1,1,0,1,0,4,13,59,45,48,FALSE,0.813559322033898,2022,2022-2023
NE,2023-06-30,inter-ucfe,0,0,0,1,0,0,0,0,0,1,0,2,0,0,FALSE,0,2022,2022-2023
NE,2023-06-30,inter-ucx,0,0,0,0,0,0,0,0,0,0,0,0,0,0,FALSE,0,2022,2022-2023
NE,2023-06-30,inter-ui,32,3,2,1,1,1,0,1,0,3,13,57,45,48,FALSE,0.842105263157895,2022,2022-2023
NE,2023-06-30,intra-total,761,69,16,9,8,4,1,2,1,18,203,1092,964,1033,FALSE,0.945970695970696,2022,2022-2023
NE,2023-06-30,intra-ucfe,0,0,0,0,0,0,0,0,0,0,1,1,1,1,FALSE,1,2022,2022-2023
NE,2023-06-30,intra-ucx,0,0,0,0,0,0,0,0,0,0,0,0,0,0,FALSE,0,2022,2022-2023
NE,2023-06-30,intra-ui,761,69,16,9,8,4,1,2,1,18,202,1091,963,1032,FALSE,0.945921173235564,2022,2022-2023
NE,2023-07-31,inter-total,30,4,1,1,1,2,1,1,0,2,18,61,48,52,FALSE,0.852459016393443,2023,2023-2024
NE,2023-07-31,inter-ucfe,0,0,0,0,0,0,0,0,0,0,0,0,0,0,FALSE,0,2023,2023-2024
NE,2023-07-31,inter-ucx,0,0,0,0,0,0,0,0,0,0,0,0,0,0,FALSE,0,2023,2023-2024
NE,2023-07-31,inter-ui,30,4,1,1,1,2,1,1,0,2,18,61,48,52,FALSE,0.852459016393443,2023,2023-2024
NE,2023-07-31,intra-total,639,77,18,11,9,10,6,3,3,12,257,1045,896,973,FALSE,0.9311004784689,2023,2023-2024
NE,2023-07-31,intra-ucfe,0,0,0,0,0,0,0,0,0,0,0,0,0,0,FALSE,0,2023,2023-2024
NE,2023-07-31,intra-ucx,1,0,0,0,0,0,0,0,0,0,0,1,1,1,FALSE,1,2023,2023-2024
NE,2023-07-31,intra-ui,638,77,18,11,9,10,6,3,3,12,257,1044,895,972,FALSE,0.931034482758621,2023,2023-2024
NE,2023-08-31,inter-total,31,3,0,4,1,2,1,0,1,1,12,56,43,46,FALSE,0.821428571428571,2023,2023-2024
NE,2023-08-31,inter-ucfe,0,0,0,0,0,0,0,0,0,0,0,0,0,0,FALSE,0,2023,2023-2024
NE,2023-08-31,inter-ucx,0,0,0,0,0,0,0,0,0,0,0,0,0,0,FALSE,0,2023,2023-2024
NE,2023-08-31,inter-ui,31,3,0,4,1,2,1,0,1,1,12,56,43,46,FALSE,0.821428571428571,2023,2023-2024
NE,2023-08-31,intra-total,408,45,20,9,14,11,3,3,2,6,176,697,584,629,FALSE,0.902439024390244,2023,2023-2024
NE,2023-08-31,intra-ucfe,0,1,0,0,0,0,0,0,0,0,0,1,0,1,FALSE,1,2023,2023-2024
NE,2023-08-31,intra-ucx,1,0,0,0,0,0,0,0,0,0,0,1,1,1,FALSE,1,2023,2023-2024
NE,2023-08-31,intra-ui,407,44,20,9,14,11,3,3,2,6,176,695,583,627,FALSE,0.902158273381295,2023,2023-2024
NE,2023-09-30,inter-total,18,2,0,3,2,1,0,0,0,4,14,44,32,34,FALSE,0.772727272727273,2023,2023-2024
NE,2023-09-30,inter-ucfe,0,0,0,0,0,0,0,0,0,0,0,0,0,0,FALSE,0,2023,2023-2024
NE,2023-09-30,inter-ucx,0,0,0,0,0,0,0,0,0,0,0,0,0,0,FALSE,0,2023,2023-2024
NE,2023-09-30,inter-ui,18,2,0,3,2,1,0,0,0,4,14,44,32,34,FALSE,0.772727272727273,2023,2023-2024
NE,2023-09-30,intra-total,326,28,11,7,11,5,5,3,0,9,174,579,500,528,FALSE,0.911917098445596,2023,2023-2024
NE,2023-09-30,intra-ucfe,0,0,0,0,0,1,0,0,0,0,0,1,0,0,FALSE,0,2023,2023-2024
NE,2023-09-30,intra-ucx,1,0,0,0,0,0,0,0,0,0,0,1,1,1,FALSE,1,2023,2023-2024
NE,2023-09-30,intra-ui,325,28,11,7,11,4,5,3,0,9,174,577,499,527,FALSE,0.913344887348354,2023,2023-2024
NE,2023-10-31,inter-total,25,1,2,3,0,3,1,0,0,2,9,46,34,35,FALSE,0.760869565217391,2023,2023-2024
NE,2023-10-31,inter-ucfe,0,0,0,0,0,0,0,0,0,0,0,0,0,0,FALSE,0,2023,2023-2024
NE,2023-10-31,inter-ucx,0,0,0,0,0,0,0,0,0,0,0,0,0,0,FALSE,0,2023,2023-2024
NE,2023-10-31,inter-ui,25,1,2,3,0,3,1,0,0,2,9,46,34,35,FALSE,0.760869565217391,2023,2023-2024
NE,2023-10-31,intra-total,479,28,9,5,15,3,9,4,0,5,129,686,608,636,FALSE,0.927113702623907,2023,2023-2024
NE,2023-10-31,intra-ucfe,1,0,0,0,0,0,0,0,0,0,0,1,1,1,FALSE,1,2023,2023-2024
NE,2023-10-31,intra-ucx,1,0,0,0,0,0,0,0,0,0,0,1,1,1,FALSE,1,2023,2023-2024
NE,2023-10-31,intra-ui,477,28,9,5,15,3,9,4,0,5,129,684,606,634,FALSE,0.926900584795322,2023,2023-2024
NE,2023-11-30,inter-total,37,7,5,2,0,0,1,0,0,1,21,74,58,65,FALSE,0.878378378378378,2023,2023-2024
NE,2023-11-30,inter-ucfe,0,0,1,0,0,0,0,0,0,0,0,1,0,0,FALSE,0,2023,2023-2024
NE,2023-11-30,inter-ucx,0,0,0,0,0,0,0,0,0,0,0,0,0,0,FALSE,0,2023,2023-2024
NE,2023-11-30,inter-ui,37,7,4,2,0,0,1,0,0,1,21,73,58,65,FALSE,0.89041095890411,2023,2023-2024
NE,2023-11-30,intra-total,433,52,12,4,8,6,3,0,2,4,223,747,656,708,FALSE,0.947791164658635,2023,2023-2024
NE,2023-11-30,intra-ucfe,2,0,0,0,0,0,0,0,0,0,0,2,2,2,FALSE,1,2023,2023-2024
NE,2023-11-30,intra-ucx,1,0,0,0,1,0,0,0,0,0,0,2,1,1,FALSE,0.5,2023,2023-2024
NE,2023-11-30,intra-ui,430,52,12,4,7,6,3,0,2,4,223,743,653,705,FALSE,0.94885598923284,2023,2023-2024
NE,2023-12-31,inter-total,65,3,1,2,0,1,1,0,0,1,23,97,88,91,FALSE,0.938144329896907,2023,2023-2024
NE,2023-12-31,inter-ucfe,0,0,1,0,0,0,0,0,0,0,0,1,0,0,FALSE,0,2023,2023-2024
NE,2023-12-31,inter-ucx,0,0,0,0,0,0,0,0,0,0,0,0,0,0,FALSE,0,2023,2023-2024
NE,2023-12-31,inter-ui,65,3,0,2,0,1,1,0,0,1,23,96,88,91,FALSE,0.947916666666667,2023,2023-2024
NE,2023-12-31,intra-total,931,28,20,7,9,9,5,3,2,5,212,1231,1143,1171,FALSE,0.951259138911454,2023,2023-2024
NE,2023-12-31,intra-ucfe,0,1,0,0,0,0,0,0,0,0,0,1,0,1,FALSE,1,2023,2023-2024
NE,2023-12-31,intra-ucx,1,0,0,0,0,0,0,0,0,0,0,1,1,1,FALSE,1,2023,2023-2024
NE,2023-12-31,intra-ui,930,27,20,7,9,9,5,3,2,5,212,1229,1142,1169,FALSE,0.951179820992677,2023,2023-2024
NE,2024-01-31,inter-total,44,11,1,4,0,0,0,1,2,0,73,136,117,128,FALSE,0.941176470588235,2023,2023-2024
NE,2024-01-31,inter-ucfe,0,0,0,1,0,0,0,0,0,0,0,1,0,0,FALSE,0,2023,2023-2024
NE,2024-01-31,inter-ucx,0,0,0,0,0,0,0,0,0,0,0,0,0,0,FALSE,0,2023,2023-2024
NE,2024-01-31,inter-ui,44,11,1,3,0,0,0,1,2,0,73,135,117,128,FALSE,0.948148148148148,2023,2023-2024
NE,2024-01-31,intra-total,1281,172,49,16,5,10,6,3,2,5,1165,2714,2446,2618,FALSE,0.964627855563744,2023,2023-2024
NE,2024-01-31,intra-ucfe,1,0,0,0,0,0,0,0,0,0,0,1,1,1,FALSE,1,2023,2023-2024
NE,2024-01-31,intra-ucx,2,0,0,0,0,0,0,0,0,0,0,2,2,2,FALSE,1,2023,2023-2024
NE,2024-01-31,intra-ui,1278,172,49,16,5,10,6,3,2,5,1165,2711,2443,2615,FALSE,0.964588712652158,2023,2023-2024
NE,2024-02-29,inter-total,33,6,2,1,1,1,1,1,0,0,45,91,78,84,FALSE,0.923076923076923,2023,2023-2024
NE,2024-02-29,inter-ucfe,0,0,1,0,0,0,0,0,0,0,1,2,1,1,FALSE,0.5,2023,2023-2024
NE,2024-02-29,inter-ucx,0,0,0,0,0,0,0,0,0,0,0,0,0,0,FALSE,0,2023,2023-2024
NE,2024-02-29,inter-ui,33,6,1,1,1,1,1,1,0,0,44,89,77,83,FALSE,0.932584269662921,2023,2023-2024
NE,2024-02-29,intra-total,794,78,40,18,13,7,8,7,5,6,670,1646,1464,1542,FALSE,0.93681652490887,2023,2023-2024
NE,2024-02-29,intra-ucfe,2,0,2,0,0,0,0,0,0,0,0,4,2,2,FALSE,0.5,2023,2023-2024
NE,2024-02-29,intra-ucx,1,0,1,0,0,0,0,0,0,0,0,2,1,1,FALSE,0.5,2023,2023-2024
NE,2024-02-29,intra-ui,791,78,37,18,13,7,8,7,5,6,670,1640,1461,1539,FALSE,0.938414634146341,2023,2023-2024
NE,2024-03-31,inter-total,22,0,1,1,0,3,2,0,0,2,12,43,34,34,FALSE,0.790697674418605,2023,2023-2024
NE,2024-03-31,inter-ucfe,0,0,0,0,0,1,0,0,0,0,0,1,0,0,FALSE,0,2023,2023-2024
NE,2024-03-31,inter-ucx,0,0,0,0,0,0,0,0,0,0,0,0,0,0,FALSE,0,2023,2023-2024
NE,2024-03-31,inter-ui,22,0,1,1,0,2,2,0,0,2,12,42,34,34,FALSE,0.80952380952381,2023,2023-2024
NE,2024-03-31,intra-total,508,37,10,9,7,9,11,8,8,7,176,790,684,721,FALSE,0.912658227848101,2023,2023-2024
NE,2024-03-31,intra-ucfe,0,0,0,0,0,0,0,0,0,0,0,0,0,0,FALSE,0,2023,2023-2024
NE,2024-03-31,intra-ucx,1,0,0,0,0,0,0,0,0,0,0,1,1,1,FALSE,1,2023,2023-2024
NE,2024-03-31,intra-ui,507,37,10,9,7,9,11,8,8,7,176,789,683,720,FALSE,0.91254752851711,2023,2023-2024
NE,2024-04-30,inter-total,25,2,0,0,2,0,0,0,0,2,13,44,38,40,FALSE,0.909090909090909,2023,2023-2024
NE,2024-04-30,inter-ucfe,0,0,0,0,1,0,0,0,0,0,0,1,0,0,FALSE,0,2023,2023-2024
NE,2024-04-30,inter-ucx,0,0,0,0,0,0,0,0,0,0,0,0,0,0,FALSE,0,2023,2023-2024
NE,2024-04-30,inter-ui,25,2,0,0,1,0,0,0,0,2,13,43,38,40,FALSE,0.930232558139535,2023,2023-2024
NE,2024-04-30,intra-total,382,23,3,3,6,6,6,8,3,11,173,624,555,578,FALSE,0.926282051282051,2023,2023-2024
NE,2024-04-30,intra-ucfe,0,0,0,0,0,1,1,0,0,0,0,2,0,0,FALSE,0,2023,2023-2024
NE,2024-04-30,intra-ucx,0,0,0,0,0,0,0,0,0,0,0,0,0,0,FALSE,0,2023,2023-2024
NE,2024-04-30,intra-ui,382,23,3,3,6,5,5,8,3,11,173,622,555,578,FALSE,0.929260450160772,2023,2023-2024
NE,2024-05-31,inter-total,15,2,0,1,0,0,0,0,1,1,15,35,30,32,FALSE,0.914285714285714,2023,2023-2024
NE,2024-05-31,inter-ucfe,0,0,0,0,0,0,0,0,0,0,0,0,0,0,FALSE,0,2023,2023-2024
NE,2024-05-31,inter-ucx,0,0,0,0,0,0,0,0,0,0,0,0,0,0,FALSE,0,2023,2023-2024
NE,2024-05-31,inter-ui,15,2,0,1,0,0,0,0,1,1,15,35,30,32,FALSE,0.914285714285714,2023,2023-2024
NE,2024-05-31,intra-total,359,38,20,7,4,3,3,8,1,12,260,715,619,657,FALSE,0.918881118881119,2023,2023-2024
NE,2024-05-31,intra-ucfe,1,0,0,0,1,0,0,0,0,0,3,5,4,4,FALSE,0.8,2023,2023-2024
NE,2024-05-31,intra-ucx,1,0,0,0,0,0,0,0,0,0,0,1,1,1,FALSE,1,2023,2023-2024
NE,2024-05-31,intra-ui,357,38,20,7,3,3,3,8,1,12,257,709,614,652,FALSE,0.919605077574048,2023,2023-2024
NE,2024-06-30,inter-total,24,3,3,0,1,0,2,0,0,0,29,62,53,56,FALSE,0.903225806451613,2023,2023-2024
NE,2024-06-30,inter-ucfe,1,0,0,0,0,0,0,0,0,0,1,2,2,2,FALSE,1,2023,2023-2024
NE,2024-06-30,inter-ucx,0,0,0,0,0,0,0,0,0,0,0,0,0,0,FALSE,0,2023,2023-2024
NE,2024-06-30,inter-ui,23,3,3,0,1,0,2,0,0,0,28,60,51,54,FALSE,0.9,2023,2023-2024
NE,2024-06-30,intra-total,601,82,11,4,3,6,4,5,5,10,520,1251,1121,1203,FALSE,0.961630695443645,2023,2023-2024
NE,2024-06-30,intra-ucfe,0,0,0,0,0,0,0,0,0,0,0,0,0,0,FALSE,0,2023,2023-2024
NE,2024-06-30,intra-ucx,1,3,0,0,0,0,0,0,0,0,2,6,3,6,FALSE,1,2023,2023-2024
NE,2024-06-30,intra-ui,600,79,11,4,3,6,4,5,5,10,518,1245,1118,1197,FALSE,0.96144578313253,2023,2023-2024
NE,2024-07-31,inter-total,36,2,2,1,1,1,0,0,0,0,12,55,48,50,FALSE,0.909090909090909,2024,2024-2025
NE,2024-07-31,inter-ucfe,0,0,0,0,0,0,0,0,0,0,0,0,0,0,FALSE,0,2024,2024-2025
NE,2024-07-31,inter-ucx,0,0,0,0,0,0,0,0,0,0,0,0,0,0,FALSE,0,2024,2024-2025
NE,2024-07-31,inter-ui,36,2,2,1,1,1,0,0,0,0,12,55,48,50,FALSE,0.909090909090909,2024,2024-2025
NE,2024-07-31,intra-total,736,53,16,15,9,8,4,4,3,6,306,1160,1042,1095,FALSE,0.943965517241379,2024,2024-2025
NE,2024-07-31,intra-ucfe,1,0,0,0,0,0,0,0,0,0,1,2,2,2,FALSE,1,2024,2024-2025
NE,2024-07-31,intra-ucx,0,0,0,0,0,0,0,0,0,0,0,0,0,0,FALSE,0,2024,2024-2025
NE,2024-07-31,intra-ui,735,53,16,15,9,8,4,4,3,6,305,1158,1040,1093,FALSE,0.943868739205527,2024,2024-2025
NE,2024-08-31,inter-total,27,3,0,0,0,1,0,0,0,0,13,44,40,43,FALSE,0.977272727272727,2024,2024-2025
NE,2024-08-31,inter-ucfe,0,0,0,0,0,0,0,0,0,0,0,0,0,0,FALSE,0,2024,2024-2025
NE,2024-08-31,inter-ucx,0,0,0,0,0,0,0,0,0,0,0,0,0,0,FALSE,0,2024,2024-2025
NE,2024-08-31,inter-ui,27,3,0,0,0,1,0,0,0,0,13,44,40,43,FALSE,0.977272727272727,2024,2024-2025
NE,2024-08-31,intra-total,438,26,5,9,7,7,6,6,2,5,186,697,624,650,FALSE,0.932568149210904,2024,2024-2025
NE,2024-08-31,intra-ucfe,0,0,0,0,0,0,0,0,0,0,0,0,0,0,FALSE,0,2024,2024-2025
NE,2024-08-31,intra-ucx,1,0,0,0,0,0,0,0,0,0,0,1,1,1,FALSE,1,2024,2024-2025
NE,2024-08-31,intra-ui,437,26,5,9,7,7,6,6,2,5,186,696,623,649,FALSE,0.932471264367816,2024,2024-2025
NE,2024-09-30,inter-total,17,1,2,1,1,1,0,1,0,1,18,43,35,36,FALSE,0.837209302325582,2024,2024-2025
NE,2024-09-30,inter-ucfe,0,0,0,0,0,0,0,0,0,0,0,0,0,0,FALSE,0,2024,2024-2025
NE,2024-09-30,inter-ucx,0,0,0,0,0,0,0,0,0,0,0,0,0,0,FALSE,0,2024,2024-2025
NE,2024-09-30,inter-ui,17,1,2,1,1,1,0,1,0,1,18,43,35,36,FALSE,0.837209302325582,2024,2024-2025
NE,2024-09-30,intra-total,520,35,4,3,1,6,3,2,2,4,243,823,763,798,FALSE,0.969623329283111,2024,2024-2025
NE,2024-09-30,intra-ucfe,0,0,0,0,0,0,0,0,0,0,0,0,0,0,FALSE,0,2024,2024-2025
NE,2024-09-30,intra-ucx,1,0,0,0,0,0,0,0,0,0,1,2,2,2,FALSE,1,2024,2024-2025
NE,2024-09-30,intra-ui,519,35,4,3,1,6,3,2,2,4,242,821,761,796,FALSE,0.969549330085262,2024,2024-2025
NE,2024-10-31,inter-total,24,1,1,1,0,1,0,0,0,1,21,50,45,46,FALSE,0.92,2024,2024-2025
NE,2024-10-31,inter-ucfe,0,0,0,0,0,0,0,0,0,0,1,1,1,1,FALSE,1,2024,2024-2025
NE,2024-10-31,inter-ucx,0,0,0,0,0,0,0,0,0,0,0,0,0,0,FALSE,0,2024,2024-2025
NE,2024-10-31,inter-ui,24,1,1,1,0,1,0,0,0,1,20,49,44,45,FALSE,0.918367346938776,2024,2024-2025
NE,2024-10-31,intra-total,376,48,11,9,4,4,9,4,3,8,292,768,668,716,FALSE,0.932291666666667,2024,2024-2025
NE,2024-10-31,intra-ucfe,0,0,0,0,0,0,0,0,0,0,1,1,1,1,FALSE,1,2024,2024-2025
NE,2024-10-31,intra-ucx,0,0,0,0,0,0,0,0,0,0,0,0,0,0,FALSE,0,2024,2024-2025
NE,2024-10-31,intra-ui,376,48,11,9,4,4,9,4,3,8,291,767,667,715,FALSE,0.932203389830508,2024,2024-2025
NE,2024-11-30,inter-total,38,2,3,0,0,0,1,0,0,0,21,65,59,61,FALSE,0.938461538461539,2024,2024-2025
NE,2024-11-30,inter-ucfe,0,0,0,0,0,0,0,0,0,0,0,0,0,0,FALSE,0,2024,2024-2025
NE,2024-11-30,inter-ucx,0,0,0,0,0,0,0,0,0,0,0,0,0,0,FALSE,0,2024,2024-2025
NE,2024-11-30,inter-ui,38,2,3,0,0,0,1,0,0,0,21,65,59,61,FALSE,0.938461538461539,2024,2024-2025
NE,2024-11-30,intra-total,558,35,11,8,4,5,4,4,2,11,188,830,746,781,FALSE,0.940963855421687,2024,2024-2025
NE,2024-11-30,intra-ucfe,0,0,0,0,0,0,0,0,0,0,0,0,0,0,FALSE,0,2024,2024-2025
NE,2024-11-30,intra-ucx,0,0,0,1,0,0,0,0,0,0,0,1,0,0,FALSE,0,2024,2024-2025
NE,2024-11-30,intra-ui,558,35,11,7,4,5,4,4,2,11,188,829,746,781,FALSE,0.942098914354644,2024,2024-2025
NE,2024-12-31,inter-total,59,5,2,1,0,1,0,1,0,0,19,88,78,83,FALSE,0.943181818181818,2024,2024-2025
NE,2024-12-31,inter-ucfe,1,0,0,0,0,0,0,0,0,0,0,1,1,1,FALSE,1,2024,2024-2025
NE,2024-12-31,inter-ucx,0,0,0,0,0,0,0,0,0,0,0,0,0,0,FALSE,0,2024,2024-2025
NE,2024-12-31,inter-ui,58,5,2,1,0,1,0,1,0,0,19,87,77,82,FALSE,0.942528735632184,2024,2024-2025
NE,2024-12-31,intra-total,1114,40,12,5,4,2,5,6,5,10,342,1545,1456,1496,FALSE,0.968284789644013,2024,2024-2025
NE,2024-12-31,intra-ucfe,0,0,0,0,0,0,0,0,0,0,0,0,0,0,FALSE,0,2024,2024-2025
NE,2024-12-31,intra-ucx,0,0,0,0,0,0,0,0,0,0,1,1,1,1,FALSE,1,2024,2024-2025
NE,2024-12-31,intra-ui,1114,40,12,5,4,2,5,6,5,10,341,1544,1455,1495,FALSE,0.968264248704663,2024,2024-2025
NH,2019-01-31,inter-total,93,8,2,3,1,1,0,0,0,1,26,135,119,127,FALSE,0.940740740740741,2018,2018-2019
NH,2019-01-31,inter-ucfe,6,0,0,0,0,0,0,0,0,0,0,6,6,6,FALSE,1,2018,2018-2019
NH,2019-01-31,inter-ucx,0,0,0,0,0,0,0,0,0,0,0,0,0,0,FALSE,0,2018,2018-2019
NH,2019-01-31,inter-ui,87,8,2,3,1,1,0,0,0,1,26,129,113,121,FALSE,0.937984496124031,2018,2018-2019
NH,2019-01-31,intra-total,758,96,28,11,10,6,3,1,1,1,477,1392,1235,1331,FALSE,0.95617816091954,2018,2018-2019
NH,2019-01-31,intra-ucfe,56,5,2,0,0,0,0,0,0,0,28,91,84,89,FALSE,0.978021978021978,2018,2018-2019
NH,2019-01-31,intra-ucx,3,0,0,0,0,0,0,0,0,0,1,4,4,4,FALSE,1,2018,2018-2019
NH,2019-01-31,intra-ui,699,91,26,11,10,6,3,1,1,1,448,1297,1147,1238,FALSE,0.954510408635312,2018,2018-2019
NH,2019-02-28,inter-total,27,8,2,1,1,0,0,1,0,1,18,59,45,53,FALSE,0.898305084745763,2018,2018-2019
NH,2019-02-28,inter-ucfe,0,0,0,0,0,0,0,0,0,1,0,1,0,0,FALSE,0,2018,2018-2019
NH,2019-02-28,inter-ucx,0,0,0,0,0,0,0,0,0,0,0,0,0,0,FALSE,0,2018,2018-2019
NH,2019-02-28,inter-ui,27,8,2,1,1,0,0,1,0,0,18,58,45,53,FALSE,0.913793103448276,2018,2018-2019
NH,2019-02-28,intra-total,430,68,30,14,8,6,4,2,0,3,259,824,689,757,FALSE,0.918689320388349,2018,2018-2019
NH,2019-02-28,intra-ucfe,0,0,3,1,0,0,0,0,0,0,1,5,1,1,FALSE,0.2,2018,2018-2019
NH,2019-02-28,intra-ucx,0,0,0,0,0,0,0,0,0,0,1,1,1,1,FALSE,1,2018,2018-2019
NH,2019-02-28,intra-ui,430,68,27,13,8,6,4,2,0,3,257,818,687,755,FALSE,0.922982885085575,2018,2018-2019
NH,2019-03-31,inter-total,19,3,0,0,0,0,0,0,0,3,7,32,26,29,FALSE,0.90625,2018,2018-2019
NH,2019-03-31,inter-ucfe,0,0,0,0,0,0,0,0,0,0,0,0,0,0,FALSE,0,2018,2018-2019
NH,2019-03-31,inter-ucx,0,0,0,0,0,0,0,0,0,0,0,0,0,0,FALSE,0,2018,2018-2019
NH,2019-03-31,inter-ui,19,3,0,0,0,0,0,0,0,3,7,32,26,29,FALSE,0.90625,2018,2018-2019
NH,2019-03-31,intra-total,390,41,23,12,15,8,2,2,2,5,229,729,619,660,FALSE,0.905349794238683,2018,2018-2019
NH,2019-03-31,intra-ucfe,1,0,0,0,0,0,0,0,0,0,0,1,1,1,FALSE,1,2018,2018-2019
NH,2019-03-31,intra-ucx,1,0,0,0,0,0,0,0,0,0,0,1,1,1,FALSE,1,2018,2018-2019
NH,2019-03-31,intra-ui,388,41,23,12,15,8,2,2,2,5,229,727,617,658,FALSE,0.905089408528198,2018,2018-2019
NH,2019-04-30,inter-total,19,1,1,1,1,0,0,0,0,1,6,30,25,26,FALSE,0.866666666666667,2018,2018-2019
NH,2019-04-30,inter-ucfe,0,0,0,0,1,0,0,0,0,0,0,1,0,0,FALSE,0,2018,2018-2019
NH,2019-04-30,inter-ucx,0,0,0,0,0,0,0,0,0,0,0,0,0,0,FALSE,0,2018,2018-2019
NH,2019-04-30,inter-ui,19,1,1,1,0,0,0,0,0,1,6,29,25,26,FALSE,0.896551724137931,2018,2018-2019
NH,2019-04-30,intra-total,327,24,18,4,11,5,3,4,1,2,209,608,536,560,FALSE,0.921052631578947,2018,2018-2019
NH,2019-04-30,intra-ucfe,2,0,1,0,0,0,0,0,0,0,1,4,3,3,FALSE,0.75,2018,2018-2019
NH,2019-04-30,intra-ucx,0,0,0,0,0,0,0,0,0,0,0,0,0,0,FALSE,0,2018,2018-2019
NH,2019-04-30,intra-ui,325,24,17,4,11,5,3,4,1,2,208,604,533,557,FALSE,0.922185430463576,2018,2018-2019
NH,2019-05-31,inter-total,17,1,0,1,1,0,0,0,0,0,14,34,31,32,FALSE,0.941176470588235,2018,2018-2019
NH,2019-05-31,inter-ucfe,0,0,0,0,0,0,0,0,0,0,0,0,0,0,FALSE,0,2018,2018-2019
NH,2019-05-31,inter-ucx,0,0,0,0,0,0,0,0,0,0,0,0,0,0,FALSE,0,2018,2018-2019
NH,2019-05-31,inter-ui,17,1,0,1,1,0,0,0,0,0,14,34,31,32,FALSE,0.941176470588235,2018,2018-2019
NH,2019-05-31,intra-total,324,17,9,7,2,2,2,1,3,1,194,562,518,535,FALSE,0.951957295373665,2018,2018-2019
NH,2019-05-31,intra-ucfe,0,0,0,0,0,0,0,0,0,0,2,2,2,2,FALSE,1,2018,2018-2019
NH,2019-05-31,intra-ucx,0,0,0,0,0,0,0,0,0,0,0,0,0,0,FALSE,0,2018,2018-2019
NH,2019-05-31,intra-ui,324,17,9,7,2,2,2,1,3,1,192,560,516,533,FALSE,0.951785714285714,2018,2018-2019
NH,2019-06-30,inter-total,30,2,0,0,0,0,0,0,0,1,7,40,37,39,FALSE,0.975,2018,2018-2019
NH,2019-06-30,inter-ucfe,0,1,0,0,0,0,0,0,0,0,0,1,0,1,FALSE,1,2018,2018-2019
NH,2019-06-30,inter-ucx,0,0,0,0,0,0,0,0,0,0,0,0,0,0,FALSE,0,2018,2018-2019
NH,2019-06-30,inter-ui,30,1,0,0,0,0,0,0,0,1,7,39,37,38,FALSE,0.974358974358974,2018,2018-2019
NH,2019-06-30,intra-total,223,13,3,7,2,4,1,0,0,4,160,417,383,396,FALSE,0.949640287769784,2018,2018-2019
NH,2019-06-30,intra-ucfe,0,0,0,0,0,0,0,0,0,0,0,0,0,0,FALSE,0,2018,2018-2019
NH,2019-06-30,intra-ucx,0,0,0,0,0,0,0,0,0,0,0,0,0,0,FALSE,0,2018,2018-2019
NH,2019-06-30,intra-ui,223,13,3,7,2,4,1,0,0,4,160,417,383,396,FALSE,0.949640287769784,2018,2018-2019
NH,2019-07-31,inter-total,21,2,0,0,1,0,0,0,0,1,16,41,37,39,FALSE,0.951219512195122,2019,2019-2020
NH,2019-07-31,inter-ucfe,0,0,0,0,0,0,0,0,0,0,0,0,0,0,FALSE,0,2019,2019-2020
NH,2019-07-31,inter-ucx,0,0,0,0,0,0,0,0,0,0,0,0,0,0,FALSE,0,2019,2019-2020
NH,2019-07-31,inter-ui,21,2,0,0,1,0,0,0,0,1,16,41,37,39,FALSE,0.951219512195122,2019,2019-2020
NH,2019-07-31,intra-total,526,25,14,5,3,2,3,1,0,2,274,855,800,825,FALSE,0.964912280701754,2019,2019-2020
NH,2019-07-31,intra-ucfe,1,1,0,0,0,0,0,0,0,0,0,2,1,2,FALSE,1,2019,2019-2020
NH,2019-07-31,intra-ucx,1,0,0,0,0,0,0,0,0,0,0,1,1,1,FALSE,1,2019,2019-2020
NH,2019-07-31,intra-ui,524,24,14,5,3,2,3,1,0,2,274,852,798,822,FALSE,0.964788732394366,2019,2019-2020
NH,2019-08-31,inter-total,20,1,1,0,1,0,0,0,0,0,19,42,39,40,FALSE,0.952380952380952,2019,2019-2020
NH,2019-08-31,inter-ucfe,0,0,0,0,0,0,0,0,0,0,0,0,0,0,FALSE,0,2019,2019-2020
NH,2019-08-31,inter-ucx,0,0,0,0,0,0,0,0,0,0,0,0,0,0,FALSE,0,2019,2019-2020
NH,2019-08-31,inter-ui,20,1,1,0,1,0,0,0,0,0,19,42,39,40,FALSE,0.952380952380952,2019,2019-2020
NH,2019-08-31,intra-total,263,21,5,6,2,1,1,0,1,3,172,475,435,456,FALSE,0.96,2019,2019-2020
NH,2019-08-31,intra-ucfe,0,0,0,0,0,0,0,0,0,0,1,1,1,1,FALSE,1,2019,2019-2020
NH,2019-08-31,intra-ucx,1,0,0,0,0,0,0,0,0,0,1,2,2,2,FALSE,1,2019,2019-2020
NH,2019-08-31,intra-ui,262,21,5,6,2,1,1,0,1,3,170,472,432,453,FALSE,0.959745762711864,2019,2019-2020
NH,2019-09-30,inter-total,11,1,2,1,0,0,1,0,0,1,9,26,20,21,FALSE,0.807692307692308,2019,2019-2020
NH,2019-09-30,inter-ucfe,0,0,0,0,0,0,0,0,0,0,0,0,0,0,FALSE,0,2019,2019-2020
NH,2019-09-30,inter-ucx,0,0,0,0,0,0,0,0,0,0,0,0,0,0,FALSE,0,2019,2019-2020
NH,2019-09-30,inter-ui,11,1,2,1,0,0,1,0,0,1,9,26,20,21,FALSE,0.807692307692308,2019,2019-2020
NH,2019-09-30,intra-total,139,14,6,4,2,5,1,0,1,3,161,336,300,314,FALSE,0.934523809523809,2019,2019-2020
NH,2019-09-30,intra-ucfe,0,0,0,0,0,0,0,0,0,0,1,1,1,1,FALSE,1,2019,2019-2020
NH,2019-09-30,intra-ucx,1,0,0,0,0,0,0,0,0,0,0,1,1,1,FALSE,1,2019,2019-2020
NH,2019-09-30,intra-ui,138,14,6,4,2,5,1,0,1,3,160,334,298,312,FALSE,0.934131736526946,2019,2019-2020
NH,2019-10-31,inter-total,16,0,2,0,0,0,0,1,0,0,6,25,22,22,FALSE,0.88,2019,2019-2020
NH,2019-10-31,inter-ucfe,0,0,0,0,0,0,0,0,0,0,0,0,0,0,FALSE,0,2019,2019-2020
NH,2019-10-31,inter-ucx,0,0,0,0,0,0,0,0,0,0,0,0,0,0,FALSE,0,2019,2019-2020
NH,2019-10-31,inter-ui,16,0,2,0,0,0,0,1,0,0,6,25,22,22,FALSE,0.88,2019,2019-2020
NH,2019-10-31,intra-total,248,13,4,4,5,3,3,3,2,2,134,421,382,395,FALSE,0.938242280285036,2019,2019-2020
NH,2019-10-31,intra-ucfe,0,0,0,0,0,0,0,0,0,0,1,1,1,1,FALSE,1,2019,2019-2020
NH,2019-10-31,intra-ucx,1,0,0,0,0,0,0,0,0,0,1,2,2,2,FALSE,1,2019,2019-2020
NH,2019-10-31,intra-ui,247,13,4,4,5,3,3,3,2,2,132,418,379,392,FALSE,0.937799043062201,2019,2019-2020
NH,2019-11-30,inter-total,22,2,0,0,0,1,1,1,0,0,10,37,32,34,FALSE,0.918918918918919,2019,2019-2020
NH,2019-11-30,inter-ucfe,0,0,0,0,0,0,0,0,0,0,0,0,0,0,FALSE,0,2019,2019-2020
NH,2019-11-30,inter-ucx,0,0,0,0,0,0,0,0,0,0,0,0,0,0,FALSE,0,2019,2019-2020
NH,2019-11-30,inter-ui,22,2,0,0,0,1,1,1,0,0,10,37,32,34,FALSE,0.918918918918919,2019,2019-2020
NH,2019-11-30,intra-total,294,15,8,2,5,5,1,2,0,5,151,488,445,460,FALSE,0.942622950819672,2019,2019-2020
NH,2019-11-30,intra-ucfe,0,0,0,0,0,0,0,0,0,0,0,0,0,0,FALSE,0,2019,2019-2020
NH,2019-11-30,intra-ucx,1,0,0,0,0,0,0,0,0,0,0,1,1,1,FALSE,1,2019,2019-2020
NH,2019-11-30,intra-ui,293,15,8,2,5,5,1,2,0,5,151,487,444,459,FALSE,0.942505133470226,2019,2019-2020
NH,2019-12-31,inter-total,96,1,1,0,2,1,1,0,0,0,21,123,117,118,FALSE,0.959349593495935,2019,2019-2020
NH,2019-12-31,inter-ucfe,0,0,0,0,0,0,0,0,0,0,1,1,1,1,FALSE,1,2019,2019-2020
NH,2019-12-31,inter-ucx,0,0,0,0,0,0,0,0,0,0,0,0,0,0,FALSE,0,2019,2019-2020
NH,2019-12-31,inter-ui,96,1,1,0,2,1,1,0,0,0,20,122,116,117,FALSE,0.959016393442623,2019,2019-2020
NH,2019-12-31,intra-total,402,25,7,9,7,5,1,2,0,5,238,701,640,665,FALSE,0.948644793152639,2019,2019-2020
NH,2019-12-31,intra-ucfe,1,0,0,0,1,0,0,0,0,0,0,2,1,1,FALSE,0.5,2019,2019-2020
NH,2019-12-31,intra-ucx,0,0,0,0,0,0,0,0,0,0,0,0,0,0,FALSE,0,2019,2019-2020
NH,2019-12-31,intra-ui,401,25,7,9,6,5,1,2,0,5,238,699,639,664,FALSE,0.949928469241774,2019,2019-2020
NH,2020-01-31,inter-total,65,5,1,0,0,0,0,0,0,0,19,90,84,89,FALSE,0.988888888888889,2019,2019-2020
NH,2020-01-31,inter-ucfe,0,0,0,0,0,0,0,0,0,0,0,0,0,0,FALSE,0,2019,2019-2020
NH,2020-01-31,inter-ucx,0,0,0,0,0,0,0,0,0,0,0,0,0,0,FALSE,0,2019,2019-2020
NH,2020-01-31,inter-ui,65,5,1,0,0,0,0,0,0,0,19,90,84,89,FALSE,0.988888888888889,2019,2019-2020
NH,2020-01-31,intra-total,780,48,10,4,2,2,6,2,1,2,359,1216,1139,1187,FALSE,0.976151315789474,2019,2019-2020
NH,2020-01-31,intra-ucfe,1,0,0,0,0,0,0,0,0,0,0,1,1,1,FALSE,1,2019,2019-2020
NH,2020-01-31,intra-ucx,0,0,0,0,0,0,0,0,0,0,0,0,0,0,FALSE,0,2019,2019-2020
NH,2020-01-31,intra-ui,779,48,10,4,2,2,6,2,1,2,359,1215,1138,1186,FALSE,0.976131687242798,2019,2019-2020
NH,2020-02-29,inter-total,27,6,1,0,1,0,0,1,0,0,20,56,47,53,FALSE,0.946428571428571,2019,2019-2020
NH,2020-02-29,inter-ucfe,0,0,0,0,0,0,0,0,0,0,0,0,0,0,FALSE,0,2019,2019-2020
NH,2020-02-29,inter-ucx,0,0,0,0,0,0,0,0,0,0,0,0,0,0,FALSE,0,2019,2019-2020
NH,2020-02-29,inter-ui,27,6,1,0,1,0,0,1,0,0,20,56,47,53,FALSE,0.946428571428571,2019,2019-2020
NH,2020-02-29,intra-total,405,45,16,9,9,7,0,1,0,2,201,695,606,651,FALSE,0.936690647482014,2019,2019-2020
NH,2020-02-29,intra-ucfe,0,2,0,0,0,0,0,0,0,0,1,3,1,3,FALSE,1,2019,2019-2020
NH,2020-02-29,intra-ucx,0,0,0,0,0,0,0,0,0,0,0,0,0,0,FALSE,0,2019,2019-2020
NH,2020-02-29,intra-ui,405,43,16,9,9,7,0,1,0,2,200,692,605,648,FALSE,0.936416184971098,2019,2019-2020
NH,2020-03-31,inter-total,232,3,2,2,0,0,0,0,0,2,77,318,309,312,FALSE,0.981132075471698,2019,2019-2020
NH,2020-03-31,inter-ucfe,0,0,0,0,0,0,0,0,0,0,0,0,0,0,FALSE,0,2019,2019-2020
NH,2020-03-31,inter-ucx,0,0,0,0,0,0,0,0,0,0,0,0,0,0,FALSE,0,2019,2019-2020
NH,2020-03-31,inter-ui,232,3,2,2,0,0,0,0,0,2,77,318,309,312,FALSE,0.981132075471698,2019,2019-2020
NH,2020-03-31,intra-total,8959,29,22,15,6,1,4,2,0,4,4341,13383,13300,13329,FALSE,0.995965030262273,2019,2019-2020
NH,2020-03-31,intra-ucfe,1,0,0,0,0,0,0,0,0,0,1,2,2,2,FALSE,1,2019,2019-2020
NH,2020-03-31,intra-ucx,2,0,0,0,0,0,0,0,0,0,0,2,2,2,FALSE,1,2019,2019-2020
NH,2020-03-31,intra-ui,8956,29,22,15,6,1,4,2,0,4,4340,13379,13296,13325,FALSE,0.995963823903132,2019,2019-2020
NH,2020-04-30,inter-total,725,181,121,29,0,0,0,0,0,0,438,1494,1163,1344,FALSE,0.899598393574297,2019,2019-2020
NH,2020-04-30,inter-ucfe,0,0,0,0,0,0,0,0,0,0,0,0,0,0,FALSE,0,2019,2019-2020
NH,2020-04-30,inter-ucx,0,0,0,0,0,0,0,0,0,0,0,0,0,0,FALSE,0,2019,2019-2020
NH,2020-04-30,inter-ui,725,181,121,29,0,0,0,0,0,0,438,1494,1163,1344,FALSE,0.899598393574297,2019,2019-2020
NH,2020-04-30,intra-total,25658,8285,6025,1506,8,2,0,1,0,3,14607,56095,40265,48550,FALSE,0.865496033514573,2019,2019-2020
NH,2020-04-30,intra-ucfe,2,4,3,0,0,0,0,0,0,0,7,16,9,13,FALSE,0.8125,2019,2019-2020
NH,2020-04-30,intra-ucx,4,5,3,0,0,0,0,0,0,0,10,22,14,19,FALSE,0.863636363636364,2019,2019-2020
NH,2020-04-30,intra-ui,25652,8276,6019,1506,8,2,0,1,0,3,14590,56057,40242,48518,FALSE,0.865511889683715,2019,2019-2020
NH,2020-05-31,inter-total,313,152,162,139,75,43,27,9,0,0,216,1136,529,681,FALSE,0.599471830985916,2019,2019-2020
NH,2020-05-31,inter-ucfe,0,0,0,0,0,0,0,0,0,0,0,0,0,0,FALSE,0,2019,2019-2020
NH,2020-05-31,inter-ucx,0,0,0,0,0,0,0,0,0,0,0,0,0,0,FALSE,0,2019,2019-2020
NH,2020-05-31,inter-ui,313,152,162,139,75,43,27,9,0,0,216,1136,529,681,FALSE,0.599471830985916,2019,2019-2020
NH,2020-05-31,intra-total,8967,3249,3608,3119,1961,1350,1152,194,6,7,5509,29122,14476,17725,FALSE,0.608646384176911,2019,2019-2020
NH,2020-05-31,intra-ucfe,2,2,7,6,3,1,1,0,0,0,3,25,5,7,FALSE,0.28,2019,2019-2020
NH,2020-05-31,intra-ucx,2,1,4,1,1,0,1,0,0,0,6,16,8,9,FALSE,0.5625,2019,2019-2020
NH,2020-05-31,intra-ui,8963,3246,3597,3112,1957,1349,1150,194,6,7,5500,29081,14463,17709,FALSE,0.608954300058457,2019,2019-2020
NH,2020-06-30,inter-total,150,24,18,18,20,30,34,43,40,70,107,554,257,281,FALSE,0.507220216606498,2019,2019-2020
NH,2020-06-30,inter-ucfe,0,0,0,0,0,0,0,0,0,0,0,0,0,0,FALSE,0,2019,2019-2020
NH,2020-06-30,inter-ucx,0,0,0,0,0,0,0,0,0,0,0,0,0,0,FALSE,0,2019,2019-2020
NH,2020-06-30,inter-ui,150,24,18,18,20,30,34,43,40,70,107,554,257,281,FALSE,0.507220216606498,2019,2019-2020
NH,2020-06-30,intra-total,4290,638,369,284,377,507,755,979,1042,1335,2114,12690,6404,7042,FALSE,0.554925137903861,2019,2019-2020
NH,2020-06-30,intra-ucfe,2,0,2,3,0,1,5,3,1,0,3,20,5,5,FALSE,0.25,2019,2019-2020
NH,2020-06-30,intra-ucx,3,3,0,0,1,0,0,2,1,0,3,13,6,9,FALSE,0.692307692307692,2019,2019-2020
NH,2020-06-30,intra-ui,4285,635,367,281,376,506,750,974,1040,1335,2108,12657,6393,7028,FALSE,0.555265860788497,2019,2019-2020
NH,2020-07-31,inter-total,106,34,16,22,8,7,5,5,10,84,51,348,157,191,FALSE,0.548850574712644,2020,2020-2021
NH,2020-07-31,inter-ucfe,0,0,1,0,0,0,0,0,0,0,0,1,0,0,FALSE,0,2020,2020-2021
NH,2020-07-31,inter-ucx,0,0,0,0,0,0,0,0,0,0,0,0,0,0,FALSE,0,2020,2020-2021
NH,2020-07-31,inter-ui,106,34,15,22,8,7,5,5,10,84,51,347,157,191,FALSE,0.550432276657061,2020,2020-2021
NH,2020-07-31,intra-total,2363,483,358,251,146,61,67,40,60,750,989,5568,3352,3835,FALSE,0.688757183908046,2020,2020-2021
NH,2020-07-31,intra-ucfe,1,0,1,0,3,1,1,0,0,4,1,12,2,2,FALSE,0.166666666666667,2020,2020-2021
NH,2020-07-31,intra-ucx,2,2,1,1,0,0,0,0,0,0,4,10,6,8,FALSE,0.8,2020,2020-2021
NH,2020-07-31,intra-ui,2360,481,356,250,143,60,66,40,60,746,984,5546,3344,3825,FALSE,0.689686260367833,2020,2020-2021
NH,2020-08-31,inter-total,60,15,17,14,8,5,5,1,3,65,32,225,92,107,FALSE,0.475555555555556,2020,2020-2021
NH,2020-08-31,inter-ucfe,0,0,0,1,0,0,0,0,0,0,0,1,0,0,FALSE,0,2020,2020-2021
NH,2020-08-31,inter-ucx,0,0,0,0,0,0,0,0,0,0,0,0,0,0,FALSE,0,2020,2020-2021
NH,2020-08-31,inter-ui,60,15,17,13,8,5,5,1,3,65,32,224,92,107,FALSE,0.477678571428571,2020,2020-2021
NH,2020-08-31,intra-total,792,287,258,218,158,106,59,36,31,486,497,2928,1289,1576,FALSE,0.538251366120219,2020,2020-2021
NH,2020-08-31,intra-ucfe,0,1,1,2,0,0,0,0,0,2,0,6,0,1,FALSE,0.166666666666667,2020,2020-2021
NH,2020-08-31,intra-ucx,1,0,0,1,0,0,0,1,0,0,1,4,2,2,FALSE,0.5,2020,2020-2021
NH,2020-08-31,intra-ui,791,286,257,215,158,106,59,35,31,484,496,2918,1287,1573,FALSE,0.539067854694997,2020,2020-2021
NH,2020-09-30,inter-total,35,11,7,5,3,4,2,4,1,39,22,133,57,68,FALSE,0.511278195488722,2020,2020-2021
NH,2020-09-30,inter-ucfe,0,0,0,0,0,0,0,0,0,1,0,1,0,0,FALSE,0,2020,2020-2021
NH,2020-09-30,inter-ucx,0,0,0,0,0,0,1,0,0,1,0,2,0,0,FALSE,0,2020,2020-2021
NH,2020-09-30,inter-ui,35,11,7,5,3,4,1,4,1,37,22,130,57,68,FALSE,0.523076923076923,2020,2020-2021
NH,2020-09-30,intra-total,727,184,153,87,66,30,37,26,13,417,370,2110,1097,1281,FALSE,0.607109004739337,2020,2020-2021
NH,2020-09-30,intra-ucfe,1,0,0,2,0,0,1,1,0,1,0,6,1,1,FALSE,0.166666666666667,2020,2020-2021
NH,2020-09-30,intra-ucx,1,0,1,1,2,0,0,1,1,0,0,7,1,1,FALSE,0.142857142857143,2020,2020-2021
NH,2020-09-30,intra-ui,725,184,152,84,64,30,36,24,12,416,370,2097,1095,1279,FALSE,0.609918931807344,2020,2020-2021
NH,2020-10-31,inter-total,22,6,1,4,1,1,4,3,1,34,5,82,27,33,FALSE,0.402439024390244,2020,2020-2021
NH,2020-10-31,inter-ucfe,0,0,0,0,0,0,0,0,0,0,0,0,0,0,FALSE,0,2020,2020-2021
NH,2020-10-31,inter-ucx,0,0,1,0,0,0,0,0,0,1,0,2,0,0,FALSE,0,2020,2020-2021
NH,2020-10-31,inter-ui,22,6,0,4,1,1,4,3,1,33,5,80,27,33,FALSE,0.4125,2020,2020-2021
NH,2020-10-31,intra-total,440,85,68,38,36,26,14,7,22,288,179,1203,619,704,FALSE,0.58520365752286,2020,2020-2021
NH,2020-10-31,intra-ucfe,0,0,0,0,1,1,1,0,0,1,1,5,1,1,FALSE,0.2,2020,2020-2021
NH,2020-10-31,intra-ucx,2,2,0,0,0,0,1,0,0,0,0,5,2,4,FALSE,0.8,2020,2020-2021
NH,2020-10-31,intra-ui,438,83,68,38,35,25,12,7,22,287,178,1193,616,699,FALSE,0.585917854149204,2020,2020-2021
NH,2020-11-30,inter-total,24,5,2,4,2,4,1,3,0,22,13,80,37,42,FALSE,0.525,2020,2020-2021
NH,2020-11-30,inter-ucfe,0,0,0,0,0,0,0,0,0,0,0,0,0,0,FALSE,0,2020,2020-2021
NH,2020-11-30,inter-ucx,0,0,0,0,0,0,0,0,0,0,0,0,0,0,FALSE,0,2020,2020-2021
NH,2020-11-30,inter-ui,24,5,2,4,2,4,1,3,0,22,13,80,37,42,FALSE,0.525,2020,2020-2021
NH,2020-11-30,intra-total,400,63,59,51,43,29,20,23,15,126,241,1070,641,704,FALSE,0.657943925233645,2020,2020-2021
NH,2020-11-30,intra-ucfe,1,1,0,1,0,0,0,0,0,0,4,7,5,6,FALSE,0.857142857142857,2020,2020-2021
NH,2020-11-30,intra-ucx,1,0,0,0,0,0,0,0,0,2,2,5,3,3,FALSE,0.6,2020,2020-2021
NH,2020-11-30,intra-ui,398,62,59,50,43,29,20,23,15,124,235,1058,633,695,FALSE,0.656899810964083,2020,2020-2021
NH,2020-12-31,inter-total,61,3,7,3,5,1,1,4,0,19,30,134,91,94,FALSE,0.701492537313433,2020,2020-2021
NH,2020-12-31,inter-ucfe,0,0,0,0,0,0,0,0,0,0,0,0,0,0,FALSE,0,2020,2020-2021
NH,2020-12-31,inter-ucx,0,0,0,0,0,0,0,0,0,0,0,0,0,0,FALSE,0,2020,2020-2021
NH,2020-12-31,inter-ui,61,3,7,3,5,1,1,4,0,19,30,134,91,94,FALSE,0.701492537313433,2020,2020-2021
NH,2020-12-31,intra-total,960,68,84,82,59,33,27,23,33,172,474,2015,1434,1502,FALSE,0.745409429280397,2020,2020-2021
NH,2020-12-31,intra-ucfe,1,0,1,1,0,0,0,1,0,1,1,6,2,2,FALSE,0.333333333333333,2020,2020-2021
NH,2020-12-31,intra-ucx,1,0,0,0,0,0,0,1,0,3,1,6,2,2,FALSE,0.333333333333333,2020,2020-2021
NH,2020-12-31,intra-ui,958,68,83,81,59,33,27,21,33,168,472,2003,1430,1498,FALSE,0.747878182725911,2020,2020-2021
NH,2021-01-31,inter-total,79,9,9,5,6,5,3,2,1,18,27,164,106,115,FALSE,0.701219512195122,2020,2020-2021
NH,2021-01-31,inter-ucfe,0,0,0,0,0,0,0,0,0,1,0,1,0,0,FALSE,0,2020,2020-2021
NH,2021-01-31,inter-ucx,0,0,0,0,0,0,0,0,0,0,0,0,0,0,FALSE,0,2020,2020-2021
NH,2021-01-31,inter-ui,79,9,9,5,6,5,3,2,1,17,27,163,106,115,FALSE,0.705521472392638,2020,2020-2021
NH,2021-01-31,intra-total,1559,182,117,110,98,80,57,42,27,223,620,3115,2179,2361,FALSE,0.757945425361156,2020,2020-2021
NH,2021-01-31,intra-ucfe,1,0,0,0,0,1,0,0,1,1,3,7,4,4,FALSE,0.571428571428571,2020,2020-2021
NH,2021-01-31,intra-ucx,1,0,0,0,0,0,0,0,0,0,2,3,3,3,FALSE,1,2020,2020-2021
NH,2021-01-31,intra-ui,1557,182,117,110,98,79,57,42,26,222,615,3105,2172,2354,FALSE,0.758132045088567,2020,2020-2021
NH,2021-02-28,inter-total,20,6,12,4,10,4,5,5,5,36,24,131,44,50,FALSE,0.381679389312977,2020,2020-2021
NH,2021-02-28,inter-ucfe,0,0,0,0,0,0,0,0,0,0,0,0,0,0,FALSE,0,2020,2020-2021
NH,2021-02-28,inter-ucx,0,0,0,0,0,0,0,0,0,0,0,0,0,0,FALSE,0,2020,2020-2021
NH,2021-02-28,inter-ui,20,6,12,4,10,4,5,5,5,36,24,131,44,50,FALSE,0.381679389312977,2020,2020-2021
NH,2021-02-28,intra-total,534,206,178,175,123,87,84,78,64,261,497,2287,1031,1237,FALSE,0.540883253170092,2020,2020-2021
NH,2021-02-28,intra-ucfe,1,0,0,1,1,0,0,0,0,3,0,6,1,1,FALSE,0.166666666666667,2020,2020-2021
NH,2021-02-28,intra-ucx,0,0,0,0,0,0,0,0,0,1,2,3,2,2,FALSE,0.666666666666667,2020,2020-2021
NH,2021-02-28,intra-ui,533,206,178,174,122,87,84,78,64,257,495,2278,1028,1234,FALSE,0.541703248463565,2020,2020-2021
NH,2021-03-31,inter-total,9,13,7,6,4,9,8,2,3,24,12,97,21,34,FALSE,0.350515463917526,2020,2020-2021
NH,2021-03-31,inter-ucfe,0,0,0,0,0,0,0,0,0,0,0,0,0,0,FALSE,0,2020,2020-2021
NH,2021-03-31,inter-ucx,0,0,0,0,0,0,0,0,0,0,0,0,0,0,FALSE,0,2020,2020-2021
NH,2021-03-31,inter-ui,9,13,7,6,4,9,8,2,3,24,12,97,21,34,FALSE,0.350515463917526,2020,2020-2021
NH,2021-03-31,intra-total,185,310,136,99,139,156,115,66,47,177,380,1810,565,875,FALSE,0.483425414364641,2020,2020-2021
NH,2021-03-31,intra-ucfe,1,2,0,0,0,0,0,2,1,2,0,8,1,3,FALSE,0.375,2020,2020-2021
NH,2021-03-31,intra-ucx,1,0,1,2,0,0,1,0,0,1,1,7,2,2,FALSE,0.285714285714286,2020,2020-2021
NH,2021-03-31,intra-ui,183,308,135,97,139,156,114,64,46,174,379,1795,562,870,FALSE,0.484679665738162,2020,2020-2021
NH,2021-04-30,inter-total,37,17,10,7,3,4,0,0,1,10,52,141,89,106,FALSE,0.75177304964539,2020,2020-2021
NH,2021-04-30,inter-ucfe,0,0,0,0,0,0,0,0,0,0,0,0,0,0,FALSE,0,2020,2020-2021
NH,2021-04-30,inter-ucx,0,0,0,0,0,0,0,0,0,0,0,0,0,0,FALSE,0,2020,2020-2021
NH,2021-04-30,inter-ui,37,17,10,7,3,4,0,0,1,10,52,141,89,106,FALSE,0.75177304964539,2020,2020-2021
NH,2021-04-30,intra-total,939,501,117,143,80,63,36,30,16,136,1799,3860,2738,3239,FALSE,0.839119170984456,2020,2020-2021
NH,2021-04-30,intra-ucfe,1,0,1,1,0,0,0,0,0,3,6,12,7,7,FALSE,0.583333333333333,2020,2020-2021
NH,2021-04-30,intra-ucx,0,0,0,1,0,0,0,0,0,0,1,2,1,1,FALSE,0.5,2020,2020-2021
NH,2021-04-30,intra-ui,938,501,116,141,80,63,36,30,16,133,1792,3846,2730,3231,FALSE,0.84009360374415,2020,2020-2021
NH,2021-05-31,inter-total,18,4,2,2,2,2,4,0,2,6,7,49,25,29,FALSE,0.591836734693878,2020,2020-2021
NH,2021-05-31,inter-ucfe,0,0,0,0,0,0,0,0,0,0,0,0,0,0,FALSE,0,2020,2020-2021
NH,2021-05-31,inter-ucx,0,0,0,0,0,0,0,0,0,0,0,0,0,0,FALSE,0,2020,2020-2021
NH,2021-05-31,inter-ui,18,4,2,2,2,2,4,0,2,6,7,49,25,29,FALSE,0.591836734693878,2020,2020-2021
NH,2021-05-31,intra-total,624,88,77,109,112,107,71,29,22,218,248,1705,872,960,FALSE,0.563049853372434,2020,2020-2021
NH,2021-05-31,intra-ucfe,6,1,0,0,0,1,0,0,0,1,1,10,7,8,FALSE,0.8,2020,2020-2021
NH,2021-05-31,intra-ucx,0,0,0,0,0,0,0,0,0,1,0,1,0,0,FALSE,0,2020,2020-2021
NH,2021-05-31,intra-ui,618,87,77,109,112,106,71,29,22,216,247,1694,865,952,FALSE,0.56198347107438,2020,2020-2021
NH,2021-06-30,inter-total,21,2,5,3,5,3,5,4,1,19,12,80,33,35,FALSE,0.4375,2020,2020-2021
NH,2021-06-30,inter-ucfe,0,0,0,0,0,0,0,0,0,0,0,0,0,0,FALSE,0,2020,2020-2021
NH,2021-06-30,inter-ucx,0,0,0,0,0,0,0,0,0,0,0,0,0,0,FALSE,0,2020,2020-2021
NH,2021-06-30,inter-ui,21,2,5,3,5,3,5,4,1,19,12,80,33,35,FALSE,0.4375,2020,2020-2021
NH,2021-06-30,intra-total,512,61,54,75,80,80,51,40,40,136,130,1259,642,703,FALSE,0.558379666401906,2020,2020-2021
NH,2021-06-30,intra-ucfe,0,0,0,1,0,0,0,0,0,0,0,1,0,0,FALSE,0,2020,2020-2021
NH,2021-06-30,intra-ucx,0,0,0,0,0,0,0,0,0,1,1,2,1,1,FALSE,0.5,2020,2020-2021
NH,2021-06-30,intra-ui,512,61,54,74,80,80,51,40,40,135,129,1256,641,702,FALSE,0.558917197452229,2020,2020-2021
NH,2021-07-31,inter-total,17,2,4,2,2,4,3,2,0,21,6,63,23,25,FALSE,0.396825396825397,2021,2021-2022
NH,2021-07-31,inter-ucfe,0,0,0,0,0,0,0,0,0,0,0,0,0,0,FALSE,0,2021,2021-2022
NH,2021-07-31,inter-ucx,0,0,0,0,0,0,0,0,0,0,0,0,0,0,FALSE,0,2021,2021-2022
NH,2021-07-31,inter-ui,17,2,4,2,2,4,3,2,0,21,6,63,23,25,FALSE,0.396825396825397,2021,2021-2022
NH,2021-07-31,intra-total,345,115,113,64,38,42,33,18,30,282,229,1309,574,689,FALSE,0.526355996944232,2021,2021-2022
NH,2021-07-31,intra-ucfe,0,0,0,0,0,0,0,0,0,3,1,4,1,1,FALSE,0.25,2021,2021-2022
NH,2021-07-31,intra-ucx,1,0,0,0,0,0,0,0,0,2,0,3,1,1,FALSE,0.333333333333333,2021,2021-2022
NH,2021-07-31,intra-ui,344,115,113,64,38,42,33,18,30,277,228,1302,572,687,FALSE,0.527649769585254,2021,2021-2022
NH,2021-08-31,inter-total,10,1,1,0,7,1,4,1,2,20,4,51,14,15,FALSE,0.294117647058824,2021,2021-2022
NH,2021-08-31,inter-ucfe,0,0,0,0,0,0,0,0,0,0,0,0,0,0,FALSE,0,2021,2021-2022
NH,2021-08-31,inter-ucx,0,0,0,0,0,0,0,0,0,0,0,0,0,0,FALSE,0,2021,2021-2022
NH,2021-08-31,inter-ui,10,1,1,0,7,1,4,1,2,20,4,51,14,15,FALSE,0.294117647058824,2021,2021-2022
NH,2021-08-31,intra-total,132,34,44,54,43,44,37,34,29,282,50,783,182,216,FALSE,0.275862068965517,2021,2021-2022
NH,2021-08-31,intra-ucfe,0,0,0,0,0,0,0,0,0,1,0,1,0,0,FALSE,0,2021,2021-2022
NH,2021-08-31,intra-ucx,0,0,0,0,0,0,0,0,0,1,0,1,0,0,FALSE,0,2021,2021-2022
NH,2021-08-31,intra-ui,132,34,44,54,43,44,37,34,29,280,50,781,182,216,FALSE,0.276568501920615,2021,2021-2022
NH,2021-09-30,inter-total,4,2,6,3,0,1,1,0,1,15,1,34,5,7,FALSE,0.205882352941176,2021,2021-2022
NH,2021-09-30,inter-ucfe,0,0,0,0,0,0,0,0,0,0,0,0,0,0,FALSE,0,2021,2021-2022
NH,2021-09-30,inter-ucx,0,0,0,0,0,0,0,0,0,0,0,0,0,0,FALSE,0,2021,2021-2022
NH,2021-09-30,inter-ui,4,2,6,3,0,1,1,0,1,15,1,34,5,7,FALSE,0.205882352941176,2021,2021-2022
NH,2021-09-30,intra-total,80,66,44,26,35,28,36,19,22,307,38,701,118,184,FALSE,0.262482168330956,2021,2021-2022
NH,2021-09-30,intra-ucfe,0,0,0,0,0,0,0,0,0,0,0,0,0,0,FALSE,0,2021,2021-2022
NH,2021-09-30,intra-ucx,2,0,0,0,0,0,0,1,0,0,0,3,2,2,FALSE,0.666666666666667,2021,2021-2022
NH,2021-09-30,intra-ui,78,66,44,26,35,28,36,18,22,307,38,698,116,182,FALSE,0.260744985673352,2021,2021-2022
NH,2021-10-31,inter-total,3,2,1,1,1,1,2,0,0,17,1,29,4,6,FALSE,0.206896551724138,2021,2021-2022
NH,2021-10-31,inter-ucfe,0,0,0,0,0,0,0,0,0,1,0,1,0,0,FALSE,0,2021,2021-2022
NH,2021-10-31,inter-ucx,0,0,0,0,0,0,0,0,0,0,0,0,0,0,FALSE,0,2021,2021-2022
NH,2021-10-31,inter-ui,3,2,1,1,1,1,2,0,0,16,1,28,4,6,FALSE,0.214285714285714,2021,2021-2022
NH,2021-10-31,intra-total,60,46,35,29,29,11,11,6,12,275,33,547,93,139,FALSE,0.254113345521024,2021,2021-2022
NH,2021-10-31,intra-ucfe,0,0,0,0,0,0,0,0,0,2,0,2,0,0,FALSE,0,2021,2021-2022
NH,2021-10-31,intra-ucx,1,0,0,0,0,0,0,0,0,2,0,3,1,1,FALSE,0.333333333333333,2021,2021-2022
NH,2021-10-31,intra-ui,59,46,35,29,29,11,11,6,12,271,33,542,92,138,FALSE,0.254612546125461,2021,2021-2022
NH,2021-11-30,inter-total,5,1,3,0,0,1,1,0,0,9,4,24,9,10,FALSE,0.416666666666667,2021,2021-2022
NH,2021-11-30,inter-ucfe,0,0,0,0,0,0,0,0,0,0,0,0,0,0,FALSE,0,2021,2021-2022
NH,2021-11-30,inter-ucx,0,0,0,0,0,0,0,0,0,0,0,0,0,0,FALSE,0,2021,2021-2022
NH,2021-11-30,inter-ui,5,1,3,0,0,1,1,0,0,9,4,24,9,10,FALSE,0.416666666666667,2021,2021-2022
NH,2021-11-30,intra-total,84,51,37,20,24,13,6,8,6,171,42,462,126,177,FALSE,0.383116883116883,2021,2021-2022
NH,2021-11-30,intra-ucfe,0,0,0,0,0,0,0,1,0,2,0,3,0,0,FALSE,0,2021,2021-2022
NH,2021-11-30,intra-ucx,0,0,0,1,0,0,0,0,1,1,0,3,0,0,FALSE,0,2021,2021-2022
NH,2021-11-30,intra-ui,84,51,37,19,24,13,6,7,5,168,42,456,126,177,FALSE,0.388157894736842,2021,2021-2022
NH,2021-12-31,inter-total,28,10,2,3,1,0,0,1,0,18,10,73,38,48,FALSE,0.657534246575342,2021,2021-2022
NH,2021-12-31,inter-ucfe,0,0,0,0,0,0,0,0,0,0,1,1,1,1,FALSE,1,2021,2021-2022
NH,2021-12-31,inter-ucx,0,0,0,0,0,0,0,0,0,0,0,0,0,0,FALSE,0,2021,2021-2022
NH,2021-12-31,inter-ui,28,10,2,3,1,0,0,1,0,18,9,72,37,47,FALSE,0.652777777777778,2021,2021-2022
NH,2021-12-31,intra-total,159,60,48,42,11,13,8,10,6,234,64,655,223,283,FALSE,0.43206106870229,2021,2021-2022
NH,2021-12-31,intra-ucfe,0,0,0,0,0,0,0,1,0,1,0,2,0,0,FALSE,0,2021,2021-2022
NH,2021-12-31,intra-ucx,0,0,0,0,0,0,0,0,0,0,0,0,0,0,FALSE,0,2021,2021-2022
NH,2021-12-31,intra-ui,159,60,48,42,11,13,8,9,6,233,64,653,223,283,FALSE,0.433384379785605,2021,2021-2022
NH,2022-01-31,inter-total,41,3,3,5,4,2,0,0,1,8,8,75,49,52,FALSE,0.693333333333333,2021,2021-2022
NH,2022-01-31,inter-ucfe,0,0,0,0,0,0,0,0,0,0,0,0,0,0,FALSE,0,2021,2021-2022
NH,2022-01-31,inter-ucx,0,0,0,0,0,0,0,0,0,0,0,0,0,0,FALSE,0,2021,2021-2022
NH,2022-01-31,inter-ui,41,3,3,5,4,2,0,0,1,8,8,75,49,52,FALSE,0.693333333333333,2021,2021-2022
NH,2022-01-31,intra-total,351,85,53,37,23,13,6,5,5,142,175,895,526,611,FALSE,0.68268156424581,2021,2021-2022
NH,2022-01-31,intra-ucfe,0,0,0,0,0,0,0,0,0,2,0,2,0,0,FALSE,0,2021,2021-2022
NH,2022-01-31,intra-ucx,0,0,0,0,0,0,0,0,0,0,0,0,0,0,FALSE,0,2021,2021-2022
NH,2022-01-31,intra-ui,351,85,53,37,23,13,6,5,5,140,175,893,526,611,FALSE,0.68421052631579,2021,2021-2022
NH,2022-02-28,inter-total,12,4,4,4,1,1,0,1,0,6,5,38,17,21,FALSE,0.552631578947369,2021,2021-2022
NH,2022-02-28,inter-ucfe,0,0,0,0,0,0,0,0,0,0,0,0,0,0,FALSE,0,2021,2021-2022
NH,2022-02-28,inter-ucx,0,0,0,0,0,0,0,0,0,0,0,0,0,0,FALSE,0,2021,2021-2022
NH,2022-02-28,inter-ui,12,4,4,4,1,1,0,1,0,6,5,38,17,21,FALSE,0.552631578947369,2021,2021-2022
NH,2022-02-28,intra-total,274,70,41,23,12,10,8,5,9,59,122,633,396,466,FALSE,0.736176935229068,2021,2021-2022
NH,2022-02-28,intra-ucfe,0,0,0,0,0,0,0,1,0,4,0,5,0,0,FALSE,0,2021,2021-2022
NH,2022-02-28,intra-ucx,0,0,0,0,0,0,0,0,0,1,0,1,0,0,FALSE,0,2021,2021-2022
NH,2022-02-28,intra-ui,274,70,41,23,12,10,8,4,9,54,122,627,396,466,FALSE,0.743221690590112,2021,2021-2022
NH,2022-03-31,inter-total,8,5,1,0,1,1,2,1,1,4,4,28,12,17,FALSE,0.607142857142857,2021,2021-2022
NH,2022-03-31,inter-ucfe,0,0,0,0,0,0,0,0,0,0,0,0,0,0,FALSE,0,2021,2021-2022
NH,2022-03-31,inter-ucx,0,0,0,0,0,0,0,0,0,0,0,0,0,0,FALSE,0,2021,2021-2022
NH,2022-03-31,inter-ui,8,5,1,0,1,1,2,1,1,4,4,28,12,17,FALSE,0.607142857142857,2021,2021-2022
NH,2022-03-31,intra-total,186,83,36,17,14,11,4,4,3,59,145,562,331,414,FALSE,0.736654804270463,2021,2021-2022
NH,2022-03-31,intra-ucfe,0,0,0,0,0,0,0,0,0,0,1,1,1,1,FALSE,1,2021,2021-2022
NH,2022-03-31,intra-ucx,0,0,0,0,0,0,0,0,0,0,1,1,1,1,FALSE,1,2021,2021-2022
NH,2022-03-31,intra-ui,186,83,36,17,14,11,4,4,3,59,143,560,329,412,FALSE,0.735714285714286,2021,2021-2022
NH,2022-04-30,inter-total,11,5,1,0,0,1,1,0,1,4,6,30,17,22,FALSE,0.733333333333333,2021,2021-2022
NH,2022-04-30,inter-ucfe,0,0,0,0,0,0,0,0,0,0,0,0,0,0,FALSE,0,2021,2021-2022
NH,2022-04-30,inter-ucx,0,0,0,0,0,0,0,0,0,0,0,0,0,0,FALSE,0,2021,2021-2022
NH,2022-04-30,inter-ui,11,5,1,0,0,1,1,0,1,4,6,30,17,22,FALSE,0.733333333333333,2021,2021-2022
NH,2022-04-30,intra-total,136,34,25,5,4,3,4,3,3,42,89,348,225,259,FALSE,0.744252873563218,2021,2021-2022
NH,2022-04-30,intra-ucfe,0,0,0,0,0,0,0,0,0,0,1,1,1,1,FALSE,1,2021,2021-2022
NH,2022-04-30,intra-ucx,1,0,0,0,0,0,0,0,0,0,0,1,1,1,FALSE,1,2021,2021-2022
NH,2022-04-30,intra-ui,135,34,25,5,4,3,4,3,3,42,88,346,223,257,FALSE,0.742774566473988,2021,2021-2022
NH,2022-05-31,inter-total,6,1,2,0,1,0,0,0,0,8,1,19,7,8,FALSE,0.421052631578947,2021,2021-2022
NH,2022-05-31,inter-ucfe,0,0,0,0,0,0,0,0,0,0,0,0,0,0,FALSE,0,2021,2021-2022
NH,2022-05-31,inter-ucx,0,0,0,0,0,0,0,0,0,0,0,0,0,0,FALSE,0,2021,2021-2022
NH,2022-05-31,inter-ui,6,1,2,0,1,0,0,0,0,8,1,19,7,8,FALSE,0.421052631578947,2021,2021-2022
NH,2022-05-31,intra-total,149,49,17,14,4,4,2,6,2,50,126,423,275,324,FALSE,0.765957446808511,2021,2021-2022
NH,2022-05-31,intra-ucfe,0,0,0,0,0,0,0,0,0,0,0,0,0,0,FALSE,0,2021,2021-2022
NH,2022-05-31,intra-ucx,0,0,0,0,0,0,1,0,0,1,0,2,0,0,FALSE,0,2021,2021-2022
NH,2022-05-31,intra-ui,149,49,17,14,4,4,1,6,2,49,126,421,275,324,FALSE,0.769596199524941,2021,2021-2022
NH,2022-06-30,inter-total,15,1,3,2,2,1,2,1,0,5,0,32,15,16,FALSE,0.5,2021,2021-2022
NH,2022-06-30,inter-ucfe,0,0,0,0,0,0,0,0,0,0,0,0,0,0,FALSE,0,2021,2021-2022
NH,2022-06-30,inter-ucx,0,0,0,0,0,0,0,0,0,0,0,0,0,0,FALSE,0,2021,2021-2022
NH,2022-06-30,inter-ui,15,1,3,2,2,1,2,1,0,5,0,32,15,16,FALSE,0.5,2021,2021-2022
NH,2022-06-30,intra-total,122,36,25,15,9,9,4,3,2,48,82,355,204,240,FALSE,0.676056338028169,2021,2021-2022
NH,2022-06-30,intra-ucfe,0,1,0,0,0,0,0,0,0,1,0,2,0,1,FALSE,0.5,2021,2021-2022
NH,2022-06-30,intra-ucx,0,0,0,0,0,0,0,0,0,0,1,1,1,1,FALSE,1,2021,2021-2022
NH,2022-06-30,intra-ui,122,35,25,15,9,9,4,3,2,47,81,352,203,238,FALSE,0.676136363636364,2021,2021-2022
NH,2022-07-31,inter-total,23,1,1,2,1,0,0,0,0,0,4,32,27,28,FALSE,0.875,2022,2022-2023
NH,2022-07-31,inter-ucfe,0,0,0,0,0,0,0,0,0,0,0,0,0,0,FALSE,0,2022,2022-2023
NH,2022-07-31,inter-ucx,0,0,0,0,0,0,0,0,0,0,0,0,0,0,FALSE,0,2022,2022-2023
NH,2022-07-31,inter-ui,23,1,1,2,1,0,0,0,0,0,4,32,27,28,FALSE,0.875,2022,2022-2023
NH,2022-07-31,intra-total,410,54,30,7,8,6,2,3,3,38,186,747,596,650,FALSE,0.870147255689424,2022,2022-2023
NH,2022-07-31,intra-ucfe,1,0,1,0,0,0,0,0,0,2,0,4,1,1,FALSE,0.25,2022,2022-2023
NH,2022-07-31,intra-ucx,0,0,0,0,0,0,0,0,0,1,0,1,0,0,FALSE,0,2022,2022-2023
NH,2022-07-31,intra-ui,409,54,29,7,8,6,2,3,3,35,186,742,595,649,FALSE,0.87466307277628,2022,2022-2023
NH,2022-08-31,inter-total,14,1,1,2,0,2,0,0,0,3,10,33,24,25,FALSE,0.757575757575758,2022,2022-2023
NH,2022-08-31,inter-ucfe,0,0,0,0,0,0,0,0,0,0,0,0,0,0,FALSE,0,2022,2022-2023
NH,2022-08-31,inter-ucx,0,0,0,0,0,0,0,0,0,0,0,0,0,0,FALSE,0,2022,2022-2023
NH,2022-08-31,inter-ui,14,1,1,2,0,2,0,0,0,3,10,33,24,25,FALSE,0.757575757575758,2022,2022-2023
NH,2022-08-31,intra-total,229,38,50,27,12,12,13,9,6,55,119,570,348,386,FALSE,0.67719298245614,2022,2022-2023
NH,2022-08-31,intra-ucfe,0,0,0,0,0,0,0,0,0,0,0,0,0,0,FALSE,0,2022,2022-2023
NH,2022-08-31,intra-ucx,0,0,0,0,0,0,0,0,0,0,0,0,0,0,FALSE,0,2022,2022-2023
NH,2022-08-31,intra-ui,229,38,50,27,12,12,13,9,6,55,119,570,348,386,FALSE,0.67719298245614,2022,2022-2023
NH,2022-09-30,inter-total,4,1,1,0,0,0,0,1,0,2,8,17,12,13,FALSE,0.764705882352941,2022,2022-2023
NH,2022-09-30,inter-ucfe,0,0,0,0,0,0,0,0,0,0,0,0,0,0,FALSE,0,2022,2022-2023
NH,2022-09-30,inter-ucx,0,0,0,0,0,0,0,0,0,0,0,0,0,0,FALSE,0,2022,2022-2023
NH,2022-09-30,inter-ui,4,1,1,0,0,0,0,1,0,2,8,17,12,13,FALSE,0.764705882352941,2022,2022-2023
NH,2022-09-30,intra-total,99,40,25,9,10,5,6,3,7,19,105,328,204,244,FALSE,0.74390243902439,2022,2022-2023
NH,2022-09-30,intra-ucfe,0,0,0,0,0,0,0,0,0,0,1,1,1,1,FALSE,1,2022,2022-2023
NH,2022-09-30,intra-ucx,0,0,0,1,0,0,1,0,0,0,0,2,0,0,FALSE,0,2022,2022-2023
NH,2022-09-30,intra-ui,99,40,25,8,10,5,5,3,7,19,104,325,203,243,FALSE,0.747692307692308,2022,2022-2023
NH,2022-10-31,inter-total,3,1,1,1,0,0,1,0,1,3,0,11,3,4,FALSE,0.363636363636364,2022,2022-2023
NH,2022-10-31,inter-ucfe,0,0,0,0,0,0,0,0,0,0,0,0,0,0,FALSE,0,2022,2022-2023
NH,2022-10-31,inter-ucx,0,0,0,0,0,0,0,0,0,0,0,0,0,0,FALSE,0,2022,2022-2023
NH,2022-10-31,inter-ui,3,1,1,1,0,0,1,0,1,3,0,11,3,4,FALSE,0.363636363636364,2022,2022-2023
NH,2022-10-31,intra-total,95,29,8,11,4,5,5,5,2,21,78,263,173,202,FALSE,0.768060836501901,2022,2022-2023
NH,2022-10-31,intra-ucfe,0,0,0,0,0,1,0,0,0,0,0,1,0,0,FALSE,0,2022,2022-2023
NH,2022-10-31,intra-ucx,0,0,0,0,0,0,0,0,0,0,0,0,0,0,FALSE,0,2022,2022-2023
NH,2022-10-31,intra-ui,95,29,8,11,4,4,5,5,2,21,78,262,173,202,FALSE,0.770992366412214,2022,2022-2023
NH,2022-11-30,inter-total,10,3,0,0,0,1,0,0,0,1,6,21,16,19,FALSE,0.904761904761905,2022,2022-2023
NH,2022-11-30,inter-ucfe,0,0,0,0,0,0,0,0,0,0,1,1,1,1,FALSE,1,2022,2022-2023
NH,2022-11-30,inter-ucx,0,0,0,0,0,0,0,0,0,0,0,0,0,0,FALSE,0,2022,2022-2023
NH,2022-11-30,inter-ui,10,3,0,0,0,1,0,0,0,1,5,20,15,18,FALSE,0.9,2022,2022-2023
NH,2022-11-30,intra-total,166,44,12,10,5,5,2,2,1,12,120,379,286,330,FALSE,0.870712401055409,2022,2022-2023
NH,2022-11-30,intra-ucfe,0,0,0,0,0,0,0,0,0,0,2,2,2,2,FALSE,1,2022,2022-2023
NH,2022-11-30,intra-ucx,1,1,0,0,0,0,0,0,0,0,0,2,1,2,FALSE,1,2022,2022-2023
NH,2022-11-30,intra-ui,165,43,12,10,5,5,2,2,1,12,118,375,283,326,FALSE,0.869333333333333,2022,2022-2023
NH,2022-12-31,inter-total,43,3,2,0,0,0,1,0,1,5,7,62,50,53,FALSE,0.854838709677419,2022,2022-2023
NH,2022-12-31,inter-ucfe,0,0,0,0,0,0,0,0,0,0,0,0,0,0,FALSE,0,2022,2022-2023
NH,2022-12-31,inter-ucx,0,0,0,0,0,0,0,0,0,0,0,0,0,0,FALSE,0,2022,2022-2023
NH,2022-12-31,inter-ui,43,3,2,0,0,0,1,0,1,5,7,62,50,53,FALSE,0.854838709677419,2022,2022-2023
NH,2022-12-31,intra-total,226,38,21,9,9,5,4,3,3,26,117,461,343,381,FALSE,0.82646420824295,2022,2022-2023
NH,2022-12-31,intra-ucfe,0,1,1,0,0,0,0,0,0,0,0,2,0,1,FALSE,0.5,2022,2022-2023
NH,2022-12-31,intra-ucx,1,0,0,0,0,1,0,0,0,0,0,2,1,1,FALSE,0.5,2022,2022-2023
NH,2022-12-31,intra-ui,225,37,20,9,9,4,4,3,3,26,117,457,342,379,FALSE,0.829321663019694,2022,2022-2023
NH,2023-01-31,inter-total,47,3,2,3,1,3,2,0,0,1,22,84,69,72,FALSE,0.857142857142857,2022,2022-2023
NH,2023-01-31,inter-ucfe,0,0,0,0,0,0,0,0,0,0,0,0,0,0,FALSE,0,2022,2022-2023
NH,2023-01-31,inter-ucx,0,0,0,0,0,0,0,0,0,0,0,0,0,0,FALSE,0,2022,2022-2023
NH,2023-01-31,inter-ui,47,3,2,3,1,3,2,0,0,1,22,84,69,72,FALSE,0.857142857142857,2022,2022-2023
NH,2023-01-31,intra-total,410,75,19,12,12,7,6,1,0,17,231,790,641,716,FALSE,0.90632911392405,2022,2022-2023
NH,2023-01-31,intra-ucfe,1,0,0,0,0,0,0,0,0,0,0,1,1,1,FALSE,1,2022,2022-2023
NH,2023-01-31,intra-ucx,0,1,0,0,0,0,0,0,0,0,0,1,0,1,FALSE,1,2022,2022-2023
NH,2023-01-31,intra-ui,409,74,19,12,12,7,6,1,0,17,231,788,640,714,FALSE,0.906091370558376,2022,2022-2023
NH,2023-02-28,inter-total,17,5,8,3,0,1,2,2,0,2,3,43,20,25,FALSE,0.581395348837209,2022,2022-2023
NH,2023-02-28,inter-ucfe,0,0,0,0,0,0,0,0,0,0,0,0,0,0,FALSE,0,2022,2022-2023
NH,2023-02-28,inter-ucx,0,0,0,0,0,0,0,0,0,0,0,0,0,0,FALSE,0,2022,2022-2023
NH,2023-02-28,inter-ui,17,5,8,3,0,1,2,2,0,2,3,43,20,25,FALSE,0.581395348837209,2022,2022-2023
NH,2023-02-28,intra-total,274,42,19,13,6,4,2,1,1,10,140,512,414,456,FALSE,0.890625,2022,2022-2023
NH,2023-02-28,intra-ucfe,1,0,0,1,0,0,0,0,0,0,0,2,1,1,FALSE,0.5,2022,2022-2023
NH,2023-02-28,intra-ucx,1,0,0,0,0,0,0,0,0,0,0,1,1,1,FALSE,1,2022,2022-2023
NH,2023-02-28,intra-ui,272,42,19,12,6,4,2,1,1,10,140,509,412,454,FALSE,0.891944990176817,2022,2022-2023
NH,2023-03-31,inter-total,13,2,1,1,1,1,1,2,0,3,11,36,24,26,FALSE,0.722222222222222,2022,2022-2023
NH,2023-03-31,inter-ucfe,0,0,0,0,0,0,0,0,0,0,0,0,0,0,FALSE,0,2022,2022-2023
NH,2023-03-31,inter-ucx,0,0,0,0,0,0,0,0,0,0,0,0,0,0,FALSE,0,2022,2022-2023
NH,2023-03-31,inter-ui,13,2,1,1,1,1,1,2,0,3,11,36,24,26,FALSE,0.722222222222222,2022,2022-2023
NH,2023-03-31,intra-total,260,63,20,11,8,10,4,7,0,8,155,546,415,478,FALSE,0.875457875457876,2022,2022-2023
NH,2023-03-31,intra-ucfe,0,1,0,0,0,0,0,0,0,0,0,1,0,1,FALSE,1,2022,2022-2023
NH,2023-03-31,intra-ucx,0,0,0,0,0,0,0,0,0,0,1,1,1,1,FALSE,1,2022,2022-2023
NH,2023-03-31,intra-ui,260,62,20,11,8,10,4,7,0,8,154,544,414,476,FALSE,0.875,2022,2022-2023
NH,2023-04-30,inter-total,8,1,0,1,1,1,0,0,1,1,3,17,11,12,FALSE,0.705882352941177,2022,2022-2023
NH,2023-04-30,inter-ucfe,0,0,0,0,0,0,0,0,0,0,0,0,0,0,FALSE,0,2022,2022-2023
NH,2023-04-30,inter-ucx,0,0,0,0,0,0,0,0,0,0,0,0,0,0,FALSE,0,2022,2022-2023
NH,2023-04-30,inter-ui,8,1,0,1,1,1,0,0,1,1,3,17,11,12,FALSE,0.705882352941177,2022,2022-2023
NH,2023-04-30,intra-total,144,43,12,10,6,9,4,2,0,7,117,354,261,304,FALSE,0.858757062146893,2022,2022-2023
NH,2023-04-30,intra-ucfe,0,0,0,0,0,0,0,0,0,1,0,1,0,0,FALSE,0,2022,2022-2023
NH,2023-04-30,intra-ucx,0,0,0,0,0,1,0,0,0,1,0,2,0,0,FALSE,0,2022,2022-2023
NH,2023-04-30,intra-ui,144,43,12,10,6,8,4,2,0,5,117,351,261,304,FALSE,0.866096866096866,2022,2022-2023
NH,2023-05-31,inter-total,14,2,0,1,1,0,1,0,0,2,12,33,26,28,FALSE,0.848484848484848,2022,2022-2023
NH,2023-05-31,inter-ucfe,0,0,0,0,0,0,0,0,0,0,0,0,0,0,FALSE,0,2022,2022-2023
NH,2023-05-31,inter-ucx,0,0,0,0,0,0,0,0,0,0,0,0,0,0,FALSE,0,2022,2022-2023
NH,2023-05-31,inter-ui,14,2,0,1,1,0,1,0,0,2,12,33,26,28,FALSE,0.848484848484848,2022,2022-2023
NH,2023-05-31,intra-total,214,53,12,11,10,7,5,6,2,12,165,497,379,432,FALSE,0.869215291750503,2022,2022-2023
NH,2023-05-31,intra-ucfe,0,0,0,0,0,0,0,0,0,0,0,0,0,0,FALSE,0,2022,2022-2023
NH,2023-05-31,intra-ucx,0,0,0,0,0,0,0,0,0,0,0,0,0,0,FALSE,0,2022,2022-2023
NH,2023-05-31,intra-ui,214,53,12,11,10,7,5,6,2,12,165,497,379,432,FALSE,0.869215291750503,2022,2022-2023
NH,2023-06-30,inter-total,8,2,0,0,0,0,0,1,0,2,6,19,14,16,FALSE,0.842105263157895,2022,2022-2023
NH,2023-06-30,inter-ucfe,0,0,0,0,0,0,0,0,0,0,0,0,0,0,FALSE,0,2022,2022-2023
NH,2023-06-30,inter-ucx,0,0,0,0,0,0,0,0,0,0,0,0,0,0,FALSE,0,2022,2022-2023
NH,2023-06-30,inter-ui,8,2,0,0,0,0,0,1,0,2,6,19,14,16,FALSE,0.842105263157895,2022,2022-2023
NH,2023-06-30,intra-total,228,19,13,6,5,3,3,5,4,6,136,428,364,383,FALSE,0.894859813084112,2022,2022-2023
NH,2023-06-30,intra-ucfe,0,0,0,0,0,0,0,0,0,0,0,0,0,0,FALSE,0,2022,2022-2023
NH,2023-06-30,intra-ucx,0,0,0,0,0,0,0,0,0,0,0,0,0,0,FALSE,0,2022,2022-2023
NH,2023-06-30,intra-ui,228,19,13,6,5,3,3,5,4,6,136,428,364,383,FALSE,0.894859813084112,2022,2022-2023
NH,2023-07-31,inter-total,15,1,0,0,1,1,0,0,0,3,7,28,22,23,FALSE,0.821428571428571,2023,2023-2024
NH,2023-07-31,inter-ucfe,0,0,0,0,0,0,0,0,0,0,0,0,0,0,FALSE,0,2023,2023-2024
NH,2023-07-31,inter-ucx,0,0,0,0,0,0,0,0,0,0,0,0,0,0,FALSE,0,2023,2023-2024
NH,2023-07-31,inter-ui,15,1,0,0,1,1,0,0,0,3,7,28,22,23,FALSE,0.821428571428571,2023,2023-2024
NH,2023-07-31,intra-total,523,60,16,5,0,1,5,3,1,6,215,835,738,798,FALSE,0.955688622754491,2023,2023-2024
NH,2023-07-31,intra-ucfe,0,0,0,0,0,0,0,0,0,0,0,0,0,0,FALSE,0,2023,2023-2024
NH,2023-07-31,intra-ucx,0,0,0,0,0,0,0,0,0,0,0,0,0,0,FALSE,0,2023,2023-2024
NH,2023-07-31,intra-ui,523,60,16,5,0,1,5,3,1,6,215,835,738,798,FALSE,0.955688622754491,2023,2023-2024
NH,2023-08-31,inter-total,10,3,1,1,1,2,0,0,1,2,11,32,21,24,FALSE,0.75,2023,2023-2024
NH,2023-08-31,inter-ucfe,0,0,0,0,0,0,0,0,0,0,0,0,0,0,FALSE,0,2023,2023-2024
NH,2023-08-31,inter-ucx,0,0,0,0,0,0,0,0,0,0,0,0,0,0,FALSE,0,2023,2023-2024
NH,2023-08-31,inter-ui,10,3,1,1,1,2,0,0,1,2,11,32,21,24,FALSE,0.75,2023,2023-2024
NH,2023-08-31,intra-total,265,30,12,8,7,9,5,3,5,5,117,466,382,412,FALSE,0.88412017167382,2023,2023-2024
NH,2023-08-31,intra-ucfe,0,0,0,0,0,0,0,0,0,0,0,0,0,0,FALSE,0,2023,2023-2024
NH,2023-08-31,intra-ucx,1,0,0,0,0,0,0,0,0,0,0,1,1,1,FALSE,1,2023,2023-2024
NH,2023-08-31,intra-ui,264,30,12,8,7,9,5,3,5,5,117,465,381,411,FALSE,0.883870967741936,2023,2023-2024
NH,2023-09-30,inter-total,8,1,2,0,1,1,0,0,0,0,10,23,18,19,FALSE,0.826086956521739,2023,2023-2024
NH,2023-09-30,inter-ucfe,0,0,0,0,0,0,0,0,0,0,0,0,0,0,FALSE,0,2023,2023-2024
NH,2023-09-30,inter-ucx,0,0,0,0,0,0,0,0,0,0,0,0,0,0,FALSE,0,2023,2023-2024
NH,2023-09-30,inter-ui,8,1,2,0,1,1,0,0,0,0,10,23,18,19,FALSE,0.826086956521739,2023,2023-2024
NH,2023-09-30,intra-total,132,42,9,11,5,6,2,4,1,18,125,355,257,299,FALSE,0.842253521126761,2023,2023-2024
NH,2023-09-30,intra-ucfe,0,0,0,0,0,0,0,1,0,0,0,1,0,0,FALSE,0,2023,2023-2024
NH,2023-09-30,intra-ucx,0,0,0,0,0,0,0,0,0,0,0,0,0,0,FALSE,0,2023,2023-2024
NH,2023-09-30,intra-ui,132,42,9,11,5,6,2,3,1,18,125,354,257,299,FALSE,0.844632768361582,2023,2023-2024
NH,2023-10-31,inter-total,11,1,2,0,0,0,0,0,0,2,10,26,21,22,FALSE,0.846153846153846,2023,2023-2024
NH,2023-10-31,inter-ucfe,0,0,0,0,0,0,0,0,0,0,0,0,0,0,FALSE,0,2023,2023-2024
NH,2023-10-31,inter-ucx,0,0,0,0,0,0,0,0,0,0,0,0,0,0,FALSE,0,2023,2023-2024
NH,2023-10-31,inter-ui,11,1,2,0,0,0,0,0,0,2,10,26,21,22,FALSE,0.846153846153846,2023,2023-2024
NH,2023-10-31,intra-total,164,29,12,7,10,6,3,2,0,9,151,393,315,344,FALSE,0.875318066157761,2023,2023-2024
NH,2023-10-31,intra-ucfe,0,1,0,0,0,0,0,0,0,0,0,1,0,1,FALSE,1,2023,2023-2024
NH,2023-10-31,intra-ucx,0,0,0,0,0,0,0,1,0,0,0,1,0,0,FALSE,0,2023,2023-2024
NH,2023-10-31,intra-ui,164,28,12,7,10,6,3,1,0,9,151,391,315,343,FALSE,0.877237851662404,2023,2023-2024
NH,2023-11-30,inter-total,23,3,0,0,1,1,0,1,0,2,8,39,31,34,FALSE,0.871794871794872,2023,2023-2024
NH,2023-11-30,inter-ucfe,1,0,0,0,0,0,0,0,0,0,0,1,1,1,FALSE,1,2023,2023-2024
NH,2023-11-30,inter-ucx,0,0,0,0,0,0,0,0,0,0,0,0,0,0,FALSE,0,2023,2023-2024
NH,2023-11-30,inter-ui,22,3,0,0,1,1,0,1,0,2,8,38,30,33,FALSE,0.868421052631579,2023,2023-2024
NH,2023-11-30,intra-total,195,37,13,4,5,5,3,3,2,12,179,458,374,411,FALSE,0.897379912663756,2023,2023-2024
NH,2023-11-30,intra-ucfe,3,0,0,0,0,0,0,0,0,1,0,4,3,3,FALSE,0.75,2023,2023-2024
NH,2023-11-30,intra-ucx,0,0,0,0,0,0,0,0,0,0,0,0,0,0,FALSE,0,2023,2023-2024
NH,2023-11-30,intra-ui,192,37,13,4,5,5,3,3,2,11,179,454,371,408,FALSE,0.898678414096916,2023,2023-2024
NH,2023-12-31,inter-total,61,2,5,1,3,1,1,0,0,3,9,86,70,72,FALSE,0.837209302325582,2023,2023-2024
NH,2023-12-31,inter-ucfe,1,0,0,0,0,0,0,0,0,0,0,1,1,1,FALSE,1,2023,2023-2024
NH,2023-12-31,inter-ucx,0,0,0,0,0,0,0,0,0,0,0,0,0,0,FALSE,0,2023,2023-2024
NH,2023-12-31,inter-ui,60,2,5,1,3,1,1,0,0,3,9,85,69,71,FALSE,0.835294117647059,2023,2023-2024
NH,2023-12-31,intra-total,261,37,14,6,6,5,6,1,0,7,153,496,414,451,FALSE,0.909274193548387,2023,2023-2024
NH,2023-12-31,intra-ucfe,1,0,0,0,0,0,0,0,0,0,0,1,1,1,FALSE,1,2023,2023-2024
NH,2023-12-31,intra-ucx,1,0,0,0,0,0,0,0,0,0,0,1,1,1,FALSE,1,2023,2023-2024
NH,2023-12-31,intra-ui,259,37,14,6,6,5,6,1,0,7,153,494,412,449,FALSE,0.908906882591093,2023,2023-2024
NH,2024-01-31,inter-total,45,1,7,5,1,0,0,0,0,0,23,82,68,69,FALSE,0.841463414634146,2023,2023-2024
NH,2024-01-31,inter-ucfe,1,0,0,0,0,0,0,0,0,0,0,1,1,1,FALSE,1,2023,2023-2024
NH,2024-01-31,inter-ucx,0,0,0,0,0,0,0,0,0,0,0,0,0,0,FALSE,0,2023,2023-2024
NH,2024-01-31,inter-ui,44,1,7,5,1,0,0,0,0,0,23,81,67,68,FALSE,0.839506172839506,2023,2023-2024
NH,2024-01-31,intra-total,423,62,21,11,6,7,1,3,4,5,275,818,698,760,FALSE,0.929095354523227,2023,2023-2024
NH,2024-01-31,intra-ucfe,0,0,0,0,0,0,0,0,0,0,1,1,1,1,FALSE,1,2023,2023-2024
NH,2024-01-31,intra-ucx,2,0,0,0,0,0,0,0,0,0,1,3,3,3,FALSE,1,2023,2023-2024
NH,2024-01-31,intra-ui,421,62,21,11,6,7,1,3,4,5,273,814,694,756,FALSE,0.928746928746929,2023,2023-2024
NH,2024-02-29,inter-total,27,1,6,0,1,2,2,1,0,0,15,55,42,43,FALSE,0.781818181818182,2023,2023-2024
NH,2024-02-29,inter-ucfe,0,0,0,0,0,0,0,0,0,0,0,0,0,0,FALSE,0,2023,2023-2024
NH,2024-02-29,inter-ucx,0,0,0,0,0,0,0,0,0,0,0,0,0,0,FALSE,0,2023,2023-2024
NH,2024-02-29,inter-ui,27,1,6,0,1,2,2,1,0,0,15,55,42,43,FALSE,0.781818181818182,2023,2023-2024
NH,2024-02-29,intra-total,380,41,9,8,7,4,3,0,4,5,190,651,570,611,FALSE,0.938556067588326,2023,2023-2024
NH,2024-02-29,intra-ucfe,3,0,0,1,0,0,0,0,0,0,0,4,3,3,FALSE,0.75,2023,2023-2024
NH,2024-02-29,intra-ucx,0,0,0,0,0,0,0,0,0,0,1,1,1,1,FALSE,1,2023,2023-2024
NH,2024-02-29,intra-ui,377,41,9,7,7,4,3,0,4,5,189,646,566,607,FALSE,0.939628482972136,2023,2023-2024
NH,2024-03-31,inter-total,18,2,1,1,0,0,0,0,0,2,12,36,30,32,FALSE,0.888888888888889,2023,2023-2024
NH,2024-03-31,inter-ucfe,0,0,0,0,0,0,0,0,0,0,0,0,0,0,FALSE,0,2023,2023-2024
NH,2024-03-31,inter-ucx,0,0,0,0,0,0,0,0,0,0,0,0,0,0,FALSE,0,2023,2023-2024
NH,2024-03-31,inter-ui,18,2,1,1,0,0,0,0,0,2,12,36,30,32,FALSE,0.888888888888889,2023,2023-2024
NH,2024-03-31,intra-total,301,30,12,9,2,5,8,2,2,6,183,560,484,514,FALSE,0.917857142857143,2023,2023-2024
NH,2024-03-31,intra-ucfe,0,0,0,0,0,0,0,0,0,0,1,1,1,1,FALSE,1,2023,2023-2024
NH,2024-03-31,intra-ucx,0,0,0,0,0,0,0,0,0,0,0,0,0,0,FALSE,0,2023,2023-2024
NH,2024-03-31,intra-ui,301,30,12,9,2,5,8,2,2,6,182,559,483,513,FALSE,0.917710196779964,2023,2023-2024
NH,2024-04-30,inter-total,14,4,1,1,1,0,0,0,0,2,7,30,21,25,FALSE,0.833333333333333,2023,2023-2024
NH,2024-04-30,inter-ucfe,0,0,0,0,0,0,0,0,0,0,0,0,0,0,FALSE,0,2023,2023-2024
NH,2024-04-30,inter-ucx,0,0,0,0,0,0,0,0,0,0,0,0,0,0,FALSE,0,2023,2023-2024
NH,2024-04-30,inter-ui,14,4,1,1,1,0,0,0,0,2,7,30,21,25,FALSE,0.833333333333333,2023,2023-2024
NH,2024-04-30,intra-total,221,36,13,3,7,6,4,4,6,12,174,486,395,431,FALSE,0.886831275720165,2023,2023-2024
NH,2024-04-30,intra-ucfe,0,1,0,0,0,0,0,0,0,0,0,1,0,1,FALSE,1,2023,2023-2024
NH,2024-04-30,intra-ucx,1,1,0,0,0,0,0,0,0,0,1,3,2,3,FALSE,1,2023,2023-2024
NH,2024-04-30,intra-ui,220,34,13,3,7,6,4,4,6,12,173,482,393,427,FALSE,0.885892116182573,2023,2023-2024
NH,2024-05-31,inter-total,9,3,0,0,2,0,1,0,0,0,8,23,17,20,FALSE,0.869565217391304,2023,2023-2024
NH,2024-05-31,inter-ucfe,0,0,0,0,0,0,0,0,0,0,0,0,0,0,FALSE,0,2023,2023-2024
NH,2024-05-31,inter-ucx,0,0,0,0,0,0,0,0,0,0,0,0,0,0,FALSE,0,2023,2023-2024
NH,2024-05-31,inter-ui,9,3,0,0,2,0,1,0,0,0,8,23,17,20,FALSE,0.869565217391304,2023,2023-2024
NH,2024-05-31,intra-total,272,42,11,8,5,4,2,1,3,7,218,573,490,532,FALSE,0.928446771378709,2023,2023-2024
NH,2024-05-31,intra-ucfe,0,0,0,0,0,0,0,0,0,0,1,1,1,1,FALSE,1,2023,2023-2024
NH,2024-05-31,intra-ucx,0,0,0,0,0,0,0,0,0,0,2,2,2,2,FALSE,1,2023,2023-2024
NH,2024-05-31,intra-ui,272,42,11,8,5,4,2,1,3,7,215,570,487,529,FALSE,0.928070175438597,2023,2023-2024
NH,2024-06-30,inter-total,14,4,2,0,0,1,0,0,0,0,7,28,21,25,FALSE,0.892857142857143,2023,2023-2024
NH,2024-06-30,inter-ucfe,0,0,0,0,0,0,0,0,0,0,0,0,0,0,FALSE,0,2023,2023-2024
NH,2024-06-30,inter-ucx,0,0,0,0,0,0,0,0,0,0,0,0,0,0,FALSE,0,2023,2023-2024
NH,2024-06-30,inter-ui,14,4,2,0,0,1,0,0,0,0,7,28,21,25,FALSE,0.892857142857143,2023,2023-2024
NH,2024-06-30,intra-total,196,30,4,3,7,5,5,3,1,12,131,397,327,357,FALSE,0.899244332493703,2023,2023-2024
NH,2024-06-30,intra-ucfe,0,0,0,0,0,0,0,0,0,0,0,0,0,0,FALSE,0,2023,2023-2024
NH,2024-06-30,intra-ucx,1,0,0,0,0,0,0,0,0,0,0,1,1,1,FALSE,1,2023,2023-2024
NH,2024-06-30,intra-ui,195,30,4,3,7,5,5,3,1,12,131,396,326,356,FALSE,0.898989898989899,2023,2023-2024
NH,2024-07-31,inter-total,6,3,0,1,1,1,1,2,0,4,4,23,10,13,FALSE,0.565217391304348,2024,2024-2025
NH,2024-07-31,inter-ucfe,0,0,0,0,0,0,0,1,0,0,0,1,0,0,FALSE,0,2024,2024-2025
NH,2024-07-31,inter-ucx,0,0,0,0,0,0,0,0,0,0,0,0,0,0,FALSE,0,2024,2024-2025
NH,2024-07-31,inter-ui,6,3,0,1,1,1,1,1,0,4,4,22,10,13,FALSE,0.590909090909091,2024,2024-2025
NH,2024-07-31,intra-total,395,97,38,10,7,4,6,4,3,19,302,885,697,794,FALSE,0.897175141242938,2024,2024-2025
NH,2024-07-31,intra-ucfe,1,0,0,0,0,0,0,0,0,2,0,3,1,1,FALSE,0.333333333333333,2024,2024-2025
NH,2024-07-31,intra-ucx,0,0,0,0,0,0,0,0,0,0,0,0,0,0,FALSE,0,2024,2024-2025
NH,2024-07-31,intra-ui,394,97,38,10,7,4,6,4,3,17,302,882,696,793,FALSE,0.899092970521542,2024,2024-2025
NH,2024-08-31,inter-total,9,1,2,3,3,2,0,0,0,3,9,32,18,19,FALSE,0.59375,2024,2024-2025
NH,2024-08-31,inter-ucfe,0,0,0,0,0,0,0,0,0,0,0,0,0,0,FALSE,0,2024,2024-2025
NH,2024-08-31,inter-ucx,1,0,0,0,0,0,0,0,0,0,0,1,1,1,FALSE,1,2024,2024-2025
NH,2024-08-31,inter-ui,8,1,2,3,3,2,0,0,0,3,9,31,17,18,FALSE,0.580645161290323,2024,2024-2025
NH,2024-08-31,intra-total,230,50,47,37,21,11,12,6,1,9,129,553,359,409,FALSE,0.739602169981917,2024,2024-2025
NH,2024-08-31,intra-ucfe,0,0,0,0,0,1,0,0,0,0,0,1,0,0,FALSE,0,2024,2024-2025
NH,2024-08-31,intra-ucx,1,0,0,0,0,0,1,0,0,0,0,2,1,1,FALSE,0.5,2024,2024-2025
NH,2024-08-31,intra-ui,229,50,47,37,21,10,11,6,1,9,129,550,358,408,FALSE,0.741818181818182,2024,2024-2025
NH,2024-09-30,inter-total,10,4,0,0,0,1,1,1,0,1,2,20,12,16,FALSE,0.8,2024,2024-2025
NH,2024-09-30,inter-ucfe,0,0,0,0,0,0,0,0,0,0,0,0,0,0,FALSE,0,2024,2024-2025
NH,2024-09-30,inter-ucx,0,0,0,0,0,0,0,0,0,0,0,0,0,0,FALSE,0,2024,2024-2025
NH,2024-09-30,inter-ui,10,4,0,0,0,1,1,1,0,1,2,20,12,16,FALSE,0.8,2024,2024-2025
NH,2024-09-30,intra-total,124,72,24,16,16,9,5,5,2,11,147,431,271,343,FALSE,0.795823665893272,2024,2024-2025
NH,2024-09-30,intra-ucfe,0,0,0,0,0,0,0,0,0,0,0,0,0,0,FALSE,0,2024,2024-2025
NH,2024-09-30,intra-ucx,0,0,0,0,0,0,0,0,0,0,1,1,1,1,FALSE,1,2024,2024-2025
NH,2024-09-30,intra-ui,124,72,24,16,16,9,5,5,2,11,146,430,270,342,FALSE,0.795348837209302,2024,2024-2025
NH,2024-10-31,inter-total,10,0,2,1,2,0,1,0,1,2,6,25,16,16,FALSE,0.64,2024,2024-2025
NH,2024-10-31,inter-ucfe,0,0,0,0,0,0,0,0,0,0,0,0,0,0,FALSE,0,2024,2024-2025
NH,2024-10-31,inter-ucx,0,0,0,0,0,0,0,0,0,0,0,0,0,0,FALSE,0,2024,2024-2025
NH,2024-10-31,inter-ui,10,0,2,1,2,0,1,0,1,2,6,25,16,16,FALSE,0.64,2024,2024-2025
NH,2024-10-31,intra-total,191,44,18,7,7,2,7,4,3,7,152,442,343,387,FALSE,0.875565610859729,2024,2024-2025
NH,2024-10-31,intra-ucfe,0,0,0,0,0,0,0,0,0,0,0,0,0,0,FALSE,0,2024,2024-2025
NH,2024-10-31,intra-ucx,0,0,0,0,0,0,0,0,0,0,1,1,1,1,FALSE,1,2024,2024-2025
NH,2024-10-31,intra-ui,191,44,18,7,7,2,7,4,3,7,151,441,342,386,FALSE,0.875283446712018,2024,2024-2025
NH,2024-11-30,inter-total,18,2,0,2,1,0,1,0,0,1,8,33,26,28,FALSE,0.848484848484848,2024,2024-2025
NH,2024-11-30,inter-ucfe,0,0,0,0,0,0,0,0,0,0,0,0,0,0,FALSE,0,2024,2024-2025
NH,2024-11-30,inter-ucx,0,0,0,0,0,0,0,0,0,0,0,0,0,0,FALSE,0,2024,2024-2025
NH,2024-11-30,inter-ui,18,2,0,2,1,0,1,0,0,1,8,33,26,28,FALSE,0.848484848484848,2024,2024-2025
NH,2024-11-30,intra-total,164,34,21,10,7,4,4,0,3,14,138,399,302,336,FALSE,0.842105263157895,2024,2024-2025
NH,2024-11-30,intra-ucfe,0,0,0,0,0,0,0,0,0,0,0,0,0,0,FALSE,0,2024,2024-2025
NH,2024-11-30,intra-ucx,0,0,0,0,0,0,0,0,0,0,0,0,0,0,FALSE,0,2024,2024-2025
NH,2024-11-30,intra-ui,164,34,21,10,7,4,4,0,3,14,138,399,302,336,FALSE,0.842105263157895,2024,2024-2025
NH,2024-12-31,inter-total,73,4,2,2,2,0,1,1,0,2,28,115,101,105,FALSE,0.91304347826087,2024,2024-2025
NH,2024-12-31,inter-ucfe,0,0,0,0,0,0,0,0,0,0,0,0,0,0,FALSE,0,2024,2024-2025
NH,2024-12-31,inter-ucx,0,0,0,0,0,0,0,0,0,0,0,0,0,0,FALSE,0,2024,2024-2025
NH,2024-12-31,inter-ui,73,4,2,2,2,0,1,1,0,2,28,115,101,105,FALSE,0.91304347826087,2024,2024-2025
NH,2024-12-31,intra-total,229,72,30,7,8,3,2,0,3,3,158,515,387,459,FALSE,0.89126213592233,2024,2024-2025
NH,2024-12-31,intra-ucfe,3,0,0,0,0,0,0,0,0,0,0,3,3,3,FALSE,1,2024,2024-2025
NH,2024-12-31,intra-ucx,0,0,0,0,0,0,0,0,0,0,0,0,0,0,FALSE,0,2024,2024-2025
NH,2024-12-31,intra-ui,226,72,30,7,8,3,2,0,3,3,158,512,384,456,FALSE,0.890625,2024,2024-2025
NJ,2019-01-31,inter-total,205,215,106,45,18,8,7,7,3,12,323,949,528,743,TRUE,0.556375131717597,2018,2018-2019
NJ,2019-01-31,inter-ucfe,0,1,9,0,0,0,0,0,0,1,0,11,0,1,TRUE,0,2018,2018-2019
NJ,2019-01-31,inter-ucx,0,1,0,0,0,1,0,0,0,0,0,2,0,1,TRUE,0,2018,2018-2019
NJ,2019-01-31,inter-ui,205,213,97,45,18,7,7,7,3,11,323,936,528,741,TRUE,0.564102564102564,2018,2018-2019
NJ,2019-01-31,intra-total,12158,6088,2796,868,396,221,143,111,86,199,13963,37029,26121,32209,TRUE,0.705420076156526,2018,2018-2019
NJ,2019-01-31,intra-ucfe,7,146,290,14,2,2,1,0,0,0,17,479,24,170,TRUE,0.0501043841336117,2018,2018-2019
NJ,2019-01-31,intra-ucx,11,5,3,5,2,0,1,0,0,1,8,36,19,24,TRUE,0.527777777777778,2018,2018-2019
NJ,2019-01-31,intra-ui,12140,5937,2503,849,392,219,141,111,86,198,13938,36514,26078,32015,TRUE,0.714191816837377,2018,2018-2019
NJ,2019-02-28,inter-total,132,142,79,33,22,11,7,10,8,12,204,660,336,478,TRUE,0.509090909090909,2018,2018-2019
NJ,2019-02-28,inter-ucfe,0,0,2,0,0,1,1,0,0,0,0,4,0,0,TRUE,0,2018,2018-2019
NJ,2019-02-28,inter-ucx,0,1,0,0,0,0,0,0,0,0,0,1,0,1,TRUE,0,2018,2018-2019
NJ,2019-02-28,inter-ui,132,141,77,33,22,10,6,10,8,12,204,655,336,477,TRUE,0.512977099236641,2018,2018-2019
NJ,2019-02-28,intra-total,6114,4473,1751,862,568,337,186,119,73,176,8058,22717,14172,18645,TRUE,0.623849980191046,2018,2018-2019
NJ,2019-02-28,intra-ucfe,3,9,5,10,4,5,3,1,0,2,5,47,8,17,TRUE,0.170212765957447,2018,2018-2019
NJ,2019-02-28,intra-ucx,3,13,4,5,4,0,1,0,0,2,13,45,16,29,TRUE,0.355555555555556,2018,2018-2019
NJ,2019-02-28,intra-ui,6108,4451,1742,847,560,332,182,118,73,172,8040,22625,14148,18599,TRUE,0.625325966850829,2018,2018-2019
NJ,2019-03-31,inter-total,102,97,33,18,10,9,7,6,5,18,166,471,268,365,TRUE,0.569002123142251,2018,2018-2019
NJ,2019-03-31,inter-ucfe,0,0,0,0,0,1,0,1,0,1,1,4,1,1,TRUE,0.25,2018,2018-2019
NJ,2019-03-31,inter-ucx,0,0,0,0,0,0,0,0,0,0,0,0,0,0,TRUE,0,2018,2018-2019
NJ,2019-03-31,inter-ui,102,97,33,18,10,8,7,5,5,17,165,467,267,364,TRUE,0.571734475374732,2018,2018-2019
NJ,2019-03-31,intra-total,4472,3339,977,446,350,252,177,136,103,233,6497,16982,10969,14308,TRUE,0.645919208573784,2018,2018-2019
NJ,2019-03-31,intra-ucfe,4,7,0,1,4,0,3,3,0,3,9,34,13,20,TRUE,0.382352941176471,2018,2018-2019
NJ,2019-03-31,intra-ucx,7,11,3,2,2,0,2,1,0,2,16,46,23,34,TRUE,0.5,2018,2018-2019
NJ,2019-03-31,intra-ui,4461,3321,974,443,344,252,172,132,103,228,6472,16902,10933,14254,TRUE,0.64684652703822,2018,2018-2019
NJ,2019-04-30,inter-total,97,89,23,12,7,8,3,4,1,7,144,395,241,330,TRUE,0.610126582278481,2018,2018-2019
NJ,2019-04-30,inter-ucfe,0,2,0,0,0,0,0,0,0,0,0,2,0,2,TRUE,0,2018,2018-2019
NJ,2019-04-30,inter-ucx,0,1,0,0,0,0,0,0,0,0,0,1,0,1,TRUE,0,2018,2018-2019
NJ,2019-04-30,inter-ui,97,86,23,12,7,8,3,4,1,7,144,392,241,327,TRUE,0.614795918367347,2018,2018-2019
NJ,2019-04-30,intra-total,4325,2982,778,349,263,165,122,82,53,252,5859,15230,10184,13166,TRUE,0.668680236375575,2018,2018-2019
NJ,2019-04-30,intra-ucfe,2,6,2,2,0,0,1,1,0,3,11,28,13,19,TRUE,0.464285714285714,2018,2018-2019
NJ,2019-04-30,intra-ucx,5,8,2,3,3,1,0,0,2,1,14,39,19,27,TRUE,0.487179487179487,2018,2018-2019
NJ,2019-04-30,intra-ui,4318,2968,774,344,260,164,121,81,51,248,5834,15163,10152,13120,TRUE,0.669524500428675,2018,2018-2019
NJ,2019-05-31,inter-total,95,74,22,10,11,7,4,1,4,15,178,421,273,347,TRUE,0.648456057007126,2018,2018-2019
NJ,2019-05-31,inter-ucfe,0,0,1,0,0,0,0,0,0,0,1,2,1,1,TRUE,0.5,2018,2018-2019
NJ,2019-05-31,inter-ucx,1,1,0,0,0,0,0,0,0,0,0,2,1,2,TRUE,0.5,2018,2018-2019
NJ,2019-05-31,inter-ui,94,73,21,10,11,7,4,1,4,15,177,417,271,344,TRUE,0.649880095923261,2018,2018-2019
NJ,2019-05-31,intra-total,4750,2864,828,358,248,164,99,68,45,195,6442,16061,11192,14056,TRUE,0.696843284976029,2018,2018-2019
NJ,2019-05-31,intra-ucfe,3,8,8,1,0,1,1,1,0,0,6,29,9,17,TRUE,0.310344827586207,2018,2018-2019
NJ,2019-05-31,intra-ucx,11,9,5,1,2,1,0,0,0,0,8,37,19,28,TRUE,0.513513513513514,2018,2018-2019
NJ,2019-05-31,intra-ui,4736,2847,815,356,246,162,98,67,45,195,6428,15995,11164,14011,TRUE,0.697968115035949,2018,2018-2019
NJ,2019-06-30,inter-total,95,89,33,13,10,4,5,1,0,4,216,470,311,400,TRUE,0.661702127659575,2018,2018-2019
NJ,2019-06-30,inter-ucfe,0,2,0,0,0,0,0,0,0,0,1,3,1,3,TRUE,0.333333333333333,2018,2018-2019
NJ,2019-06-30,inter-ucx,0,0,0,0,0,0,0,0,0,0,0,0,0,0,TRUE,0,2018,2018-2019
NJ,2019-06-30,inter-ui,95,87,33,13,10,4,5,1,0,4,215,467,310,397,TRUE,0.663811563169165,2018,2018-2019
NJ,2019-06-30,intra-total,5601,2541,648,307,189,147,76,51,31,113,6106,15810,11707,14248,TRUE,0.740480708412397,2018,2018-2019
NJ,2019-06-30,intra-ucfe,2,6,3,1,0,0,0,0,1,2,9,24,11,17,TRUE,0.458333333333333,2018,2018-2019
NJ,2019-06-30,intra-ucx,7,13,5,3,0,1,0,0,0,0,14,43,21,34,TRUE,0.488372093023256,2018,2018-2019
NJ,2019-06-30,intra-ui,5592,2522,640,303,189,146,76,51,30,111,6083,15743,11675,14197,TRUE,0.741599441021406,2018,2018-2019
NJ,2019-07-31,inter-total,102,104,24,12,3,6,2,1,1,3,180,438,282,386,TRUE,0.643835616438356,2019,2019-2020
NJ,2019-07-31,inter-ucfe,1,2,0,2,0,0,0,0,0,0,0,5,1,3,TRUE,0.2,2019,2019-2020
NJ,2019-07-31,inter-ucx,0,0,0,0,0,0,0,0,0,0,0,0,0,0,TRUE,0,2019,2019-2020
NJ,2019-07-31,inter-ui,101,102,24,10,3,6,2,1,1,3,180,433,281,383,TRUE,0.648960739030023,2019,2019-2020
NJ,2019-07-31,intra-total,8633,5605,1553,497,209,138,91,53,36,140,11539,28494,20172,25777,TRUE,0.707938513371236,2019,2019-2020
NJ,2019-07-31,intra-ucfe,0,3,2,2,1,0,0,0,0,0,7,15,7,10,TRUE,0.466666666666667,2019,2019-2020
NJ,2019-07-31,intra-ucx,12,7,2,4,1,0,0,0,0,1,7,34,19,26,TRUE,0.558823529411765,2019,2019-2020
NJ,2019-07-31,intra-ui,8621,5595,1549,491,207,138,91,53,36,139,11525,28445,20146,25741,TRUE,0.708243979609773,2019,2019-2020
NJ,2019-08-31,inter-total,102,67,30,18,9,10,6,5,1,6,199,453,301,368,TRUE,0.664459161147903,2019,2019-2020
NJ,2019-08-31,inter-ucfe,0,1,0,0,0,0,0,0,0,0,0,1,0,1,TRUE,0,2019,2019-2020
NJ,2019-08-31,inter-ucx,2,1,1,0,0,0,0,0,0,0,1,5,3,4,TRUE,0.6,2019,2019-2020
NJ,2019-08-31,inter-ui,100,65,29,18,9,10,6,5,1,6,198,447,298,363,TRUE,0.666666666666667,2019,2019-2020
NJ,2019-08-31,intra-total,5081,3204,1005,739,556,339,237,94,25,146,7035,18461,12116,15320,TRUE,0.656302475488868,2019,2019-2020
NJ,2019-08-31,intra-ucfe,3,4,3,0,1,0,0,0,0,3,11,25,14,18,TRUE,0.56,2019,2019-2020
NJ,2019-08-31,intra-ucx,9,8,2,1,2,0,0,0,0,3,10,35,19,27,TRUE,0.542857142857143,2019,2019-2020
NJ,2019-08-31,intra-ui,5069,3192,1000,738,553,339,237,94,25,140,7014,18401,12083,15275,TRUE,0.656649095157872,2019,2019-2020
NJ,2019-09-30,inter-total,83,66,25,9,7,8,1,2,4,4,129,338,212,278,TRUE,0.627218934911243,2019,2019-2020
NJ,2019-09-30,inter-ucfe,0,0,0,0,0,0,0,0,0,0,0,0,0,0,TRUE,0,2019,2019-2020
NJ,2019-09-30,inter-ucx,0,1,0,0,0,0,0,0,0,0,0,1,0,1,TRUE,0,2019,2019-2020
NJ,2019-09-30,inter-ui,83,65,25,9,7,8,1,2,4,4,129,337,212,277,TRUE,0.629080118694362,2019,2019-2020
NJ,2019-09-30,intra-total,3830,2960,756,307,185,123,110,101,80,178,5794,14424,9624,12584,TRUE,0.667221297836938,2019,2019-2020
NJ,2019-09-30,intra-ucfe,3,9,0,3,0,0,1,1,0,2,10,29,13,22,TRUE,0.448275862068966,2019,2019-2020
NJ,2019-09-30,intra-ucx,9,9,3,4,1,1,1,0,0,1,22,51,31,40,TRUE,0.607843137254902,2019,2019-2020
NJ,2019-09-30,intra-ui,3818,2942,753,300,184,122,108,100,80,175,5762,14344,9580,12522,TRUE,0.667875069715561,2019,2019-2020
NJ,2019-10-31,inter-total,200,150,46,16,11,3,2,2,4,14,389,837,589,739,TRUE,0.703703703703704,2019,2019-2020
NJ,2019-10-31,inter-ucfe,1,0,0,0,0,0,0,0,0,0,1,2,2,2,TRUE,1,2019,2019-2020
NJ,2019-10-31,inter-ucx,0,0,0,0,0,0,0,0,0,0,2,2,2,2,TRUE,1,2019,2019-2020
NJ,2019-10-31,inter-ui,199,150,46,16,11,3,2,2,4,14,386,833,585,735,TRUE,0.702280912364946,2019,2019-2020
NJ,2019-10-31,intra-total,4062,3053,789,299,197,146,123,79,44,187,7152,16131,11214,14267,TRUE,0.695183187651107,2019,2019-2020
NJ,2019-10-31,intra-ucfe,3,11,4,1,0,1,0,0,0,0,21,41,24,35,TRUE,0.585365853658537,2019,2019-2020
NJ,2019-10-31,intra-ucx,10,3,1,2,0,0,0,1,0,0,23,40,33,36,TRUE,0.825,2019,2019-2020
NJ,2019-10-31,intra-ui,4049,3039,784,296,197,145,123,78,44,187,7108,16050,11157,14196,TRUE,0.695140186915888,2019,2019-2020
NJ,2019-11-30,inter-total,215,175,69,23,17,9,2,5,3,7,460,985,675,850,TRUE,0.685279187817259,2019,2019-2020
NJ,2019-11-30,inter-ucfe,0,0,0,0,0,0,0,0,0,0,0,0,0,0,TRUE,0,2019,2019-2020
NJ,2019-11-30,inter-ucx,0,0,0,0,0,0,0,0,0,0,0,0,0,0,TRUE,0,2019,2019-2020
NJ,2019-11-30,inter-ui,215,175,69,23,17,9,2,5,3,7,460,985,675,850,TRUE,0.685279187817259,2019,2019-2020
NJ,2019-11-30,intra-total,4919,3079,698,319,169,127,102,77,35,124,6808,16457,11727,14806,TRUE,0.712584310627697,2019,2019-2020
NJ,2019-11-30,intra-ucfe,1,13,1,0,1,0,1,0,0,0,20,37,21,34,TRUE,0.567567567567568,2019,2019-2020
NJ,2019-11-30,intra-ucx,11,7,2,3,1,1,0,0,0,1,12,38,23,30,TRUE,0.605263157894737,2019,2019-2020
NJ,2019-11-30,intra-ui,4907,3059,695,316,167,126,101,77,35,123,6776,16382,11683,14742,TRUE,0.713160786228788,2019,2019-2020
NJ,2019-12-31,inter-total,271,171,45,23,10,4,6,5,4,11,315,865,586,757,TRUE,0.677456647398844,2019,2019-2020
NJ,2019-12-31,inter-ucfe,0,1,1,0,0,0,0,0,0,0,0,2,0,1,TRUE,0,2019,2019-2020
NJ,2019-12-31,inter-ucx,0,2,0,0,0,0,0,0,0,0,0,2,0,2,TRUE,0,2019,2019-2020
NJ,2019-12-31,inter-ui,271,168,44,23,10,4,6,5,4,11,315,861,586,754,TRUE,0.680603948896632,2019,2019-2020
NJ,2019-12-31,intra-total,11313,4053,1084,347,176,118,104,70,48,142,7851,25306,19164,23217,TRUE,0.757290761084328,2019,2019-2020
NJ,2019-12-31,intra-ucfe,6,20,4,3,0,2,1,0,1,1,24,62,30,50,TRUE,0.483870967741936,2019,2019-2020
NJ,2019-12-31,intra-ucx,9,10,2,2,0,0,1,0,0,0,7,31,16,26,TRUE,0.516129032258065,2019,2019-2020
NJ,2019-12-31,intra-ui,11298,4023,1078,342,176,116,102,70,47,141,7820,25213,19118,23141,TRUE,0.758259627969698,2019,2019-2020
NJ,2020-01-31,inter-total,182,196,78,38,11,6,6,4,4,17,297,839,479,675,TRUE,0.570917759237187,2019,2019-2020
NJ,2020-01-31,inter-ucfe,0,0,0,0,0,0,0,0,0,0,0,0,0,0,TRUE,0,2019,2019-2020
NJ,2020-01-31,inter-ucx,2,0,1,0,0,0,0,0,0,0,0,3,2,2,TRUE,0.666666666666667,2019,2019-2020
NJ,2020-01-31,inter-ui,180,196,77,38,11,6,6,4,4,17,297,836,477,673,TRUE,0.570574162679426,2019,2019-2020
NJ,2020-01-31,intra-total,12604,6149,2314,751,321,194,141,98,80,196,12829,35677,25433,31582,TRUE,0.712868234436752,2019,2019-2020
NJ,2020-01-31,intra-ucfe,3,7,6,2,0,0,0,0,0,3,17,38,20,27,TRUE,0.526315789473684,2019,2019-2020
NJ,2020-01-31,intra-ucx,12,11,4,2,0,0,0,0,0,0,20,49,32,43,TRUE,0.653061224489796,2019,2019-2020
NJ,2020-01-31,intra-ui,12589,6131,2304,747,321,194,141,98,80,193,12792,35590,25381,31512,TRUE,0.713149761168868,2019,2019-2020
NJ,2020-02-29,inter-total,133,111,56,27,16,12,10,4,4,11,182,566,315,426,TRUE,0.556537102473498,2019,2019-2020
NJ,2020-02-29,inter-ucfe,0,0,0,0,0,0,1,0,0,1,0,2,0,0,TRUE,0,2019,2019-2020
NJ,2020-02-29,inter-ucx,0,0,0,1,0,0,0,0,0,0,1,2,1,1,TRUE,0.5,2019,2019-2020
NJ,2020-02-29,inter-ui,133,111,56,26,16,12,9,4,4,10,181,562,314,425,TRUE,0.558718861209964,2019,2019-2020
NJ,2020-02-29,intra-total,6649,4195,2011,770,449,248,183,108,85,210,6978,21886,13627,17822,TRUE,0.622635474732706,2019,2019-2020
NJ,2020-02-29,intra-ucfe,2,9,5,4,0,0,0,0,0,1,2,23,4,13,TRUE,0.173913043478261,2019,2019-2020
NJ,2020-02-29,intra-ucx,11,14,16,7,6,1,0,0,0,1,32,88,43,57,TRUE,0.488636363636364,2019,2019-2020
NJ,2020-02-29,intra-ui,6636,4172,1990,759,443,247,183,108,85,208,6944,21775,13580,17752,TRUE,0.623650975889782,2019,2019-2020
NJ,2020-03-31,inter-total,201,77,24,16,12,4,7,5,2,13,254,615,455,532,TRUE,0.739837398373984,2019,2019-2020
NJ,2020-03-31,inter-ucfe,0,0,0,0,0,0,0,0,0,0,0,0,0,0,TRUE,0,2019,2019-2020
NJ,2020-03-31,inter-ucx,0,0,0,0,0,0,0,0,0,1,1,2,1,1,TRUE,0.5,2019,2019-2020
NJ,2020-03-31,inter-ui,201,77,24,16,12,4,7,5,2,12,253,613,454,531,TRUE,0.740619902120718,2019,2019-2020
NJ,2020-03-31,intra-total,67446,3723,994,387,210,188,153,100,86,195,17966,91448,85412,89135,TRUE,0.933995276003849,2019,2019-2020
NJ,2020-03-31,intra-ucfe,3,13,2,0,1,0,3,1,1,0,10,34,13,26,TRUE,0.382352941176471,2019,2019-2020
NJ,2020-03-31,intra-ucx,18,5,7,8,2,1,0,0,0,2,22,65,40,45,TRUE,0.615384615384615,2019,2019-2020
NJ,2020-03-31,intra-ui,67425,3705,985,379,207,187,150,99,85,193,17934,91349,85359,89064,TRUE,0.934427306264984,2019,2019-2020
NJ,2020-04-30,inter-total,131,769,458,100,38,4,1,0,1,10,483,1995,614,1383,TRUE,0.307769423558897,2019,2019-2020
NJ,2020-04-30,inter-ucfe,0,0,0,0,0,0,0,0,0,0,1,1,1,1,TRUE,1,2019,2019-2020
NJ,2020-04-30,inter-ucx,0,0,0,0,0,0,0,0,0,0,0,0,0,0,TRUE,0,2019,2019-2020
NJ,2020-04-30,inter-ui,131,769,458,100,38,4,1,0,1,10,482,1994,613,1382,TRUE,0.307422266800401,2019,2019-2020
NJ,2020-04-30,intra-total,123428,59779,20193,6882,2315,131,100,90,89,213,103892,317112,227320,287099,TRUE,0.716844521809329,2019,2019-2020
NJ,2020-04-30,intra-ucfe,3,14,7,2,3,0,0,0,0,0,7,36,10,24,TRUE,0.277777777777778,2019,2019-2020
NJ,2020-04-30,intra-ucx,4,3,4,5,2,0,1,0,0,0,4,23,8,11,TRUE,0.347826086956522,2019,2019-2020
NJ,2020-04-30,intra-ui,123421,59762,20182,6875,2310,131,99,90,89,213,103881,317053,227302,287064,TRUE,0.71692114567596,2019,2019-2020
NJ,2020-05-31,inter-total,75,111,326,390,342,197,153,81,44,15,75,1809,150,261,TRUE,0.0829187396351576,2019,2019-2020
NJ,2020-05-31,inter-ucfe,0,0,0,0,0,0,0,0,0,0,0,0,0,0,TRUE,0,2019,2019-2020
NJ,2020-05-31,inter-ucx,0,0,1,0,0,0,0,0,0,0,0,1,0,0,TRUE,0,2019,2019-2020
NJ,2020-05-31,inter-ui,75,111,325,390,342,197,153,81,44,15,75,1808,150,261,TRUE,0.0829646017699115,2019,2019-2020
NJ,2020-05-31,intra-total,33626,12592,11733,12598,10613,6508,3925,2021,983,434,21184,116217,54810,67402,TRUE,0.471617749554712,2019,2019-2020
NJ,2020-05-31,intra-ucfe,4,5,7,9,3,1,8,2,2,1,6,48,10,15,TRUE,0.208333333333333,2019,2019-2020
NJ,2020-05-31,intra-ucx,2,8,7,7,2,9,5,6,0,4,4,54,6,14,TRUE,0.111111111111111,2019,2019-2020
NJ,2020-05-31,intra-ui,33620,12579,11719,12582,10608,6498,3912,2013,981,429,21174,116115,54794,67373,TRUE,0.471894242776558,2019,2019-2020
NJ,2020-06-30,inter-total,61,18,29,44,240,271,116,145,148,296,32,1400,93,111,TRUE,0.0664285714285714,2019,2019-2020
NJ,2020-06-30,inter-ucfe,0,0,0,0,0,0,0,0,0,0,0,0,0,0,TRUE,0,2019,2019-2020
NJ,2020-06-30,inter-ucx,0,1,0,0,0,0,0,0,0,0,0,1,0,1,TRUE,0,2019,2019-2020
NJ,2020-06-30,inter-ui,61,17,29,44,240,271,116,145,148,296,32,1399,93,110,TRUE,0.0664760543245175,2019,2019-2020
NJ,2020-06-30,intra-total,17815,2707,1522,1285,3539,3799,2066,1823,1842,5728,7364,49490,25179,27886,TRUE,0.508769448373409,2019,2019-2020
NJ,2020-06-30,intra-ucfe,1,2,0,4,3,0,5,5,2,11,1,34,2,4,TRUE,0.0588235294117647,2019,2019-2020
NJ,2020-06-30,intra-ucx,0,19,12,10,5,0,7,1,0,8,9,71,9,28,TRUE,0.126760563380282,2019,2019-2020
NJ,2020-06-30,intra-ui,17814,2686,1510,1271,3531,3799,2054,1817,1840,5709,7354,49385,25168,27854,TRUE,0.509628429685127,2019,2019-2020
NJ,2020-07-31,inter-total,67,54,44,32,23,99,143,101,78,478,61,1180,128,182,TRUE,0.108474576271186,2020,2020-2021
NJ,2020-07-31,inter-ucfe,0,0,0,0,0,1,0,0,0,0,0,1,0,0,TRUE,0,2020,2020-2021
NJ,2020-07-31,inter-ucx,0,1,0,0,0,1,0,0,0,1,0,3,0,1,TRUE,0,2020,2020-2021
NJ,2020-07-31,inter-ui,67,53,44,32,23,97,143,101,78,477,61,1176,128,181,TRUE,0.108843537414966,2020,2020-2021
NJ,2020-07-31,intra-total,31354,3205,1743,935,822,1642,2099,1326,986,7122,11596,62830,42950,46155,TRUE,0.683590641413338,2020,2020-2021
NJ,2020-07-31,intra-ucfe,1,3,3,3,3,3,0,4,0,21,5,46,6,9,TRUE,0.130434782608696,2020,2020-2021
NJ,2020-07-31,intra-ucx,2,9,4,3,7,11,6,7,14,32,8,103,10,19,TRUE,0.0970873786407767,2020,2020-2021
NJ,2020-07-31,intra-ui,31351,3193,1736,929,812,1628,2093,1315,972,7069,11583,62681,42934,46127,TRUE,0.684960354812463,2020,2020-2021
NJ,2020-08-31,inter-total,35,15,19,17,50,106,167,135,82,399,17,1042,52,67,TRUE,0.0499040307101727,2020,2020-2021
NJ,2020-08-31,inter-ucfe,0,0,0,0,0,0,0,0,0,1,0,1,0,0,TRUE,0,2020,2020-2021
NJ,2020-08-31,inter-ucx,0,0,0,0,0,0,0,0,0,2,0,2,0,0,TRUE,0,2020,2020-2021
NJ,2020-08-31,inter-ui,35,15,19,17,50,106,167,135,82,396,17,1039,52,67,TRUE,0.0500481231953802,2020,2020-2021
NJ,2020-08-31,intra-total,8291,1379,951,985,1036,2433,3556,2368,964,5889,3733,31585,12024,13403,TRUE,0.380687034984961,2020,2020-2021
NJ,2020-08-31,intra-ucfe,7,5,2,1,1,1,2,3,2,11,3,38,10,15,TRUE,0.263157894736842,2020,2020-2021
NJ,2020-08-31,intra-ucx,1,12,11,3,3,1,3,6,3,30,3,76,4,16,TRUE,0.0526315789473684,2020,2020-2021
NJ,2020-08-31,intra-ui,8283,1362,938,981,1032,2431,3551,2359,959,5848,3727,31471,12010,13372,TRUE,0.381621175050046,2020,2020-2021
NJ,2020-09-30,inter-total,35,36,51,51,93,105,133,86,61,280,44,975,79,115,TRUE,0.081025641025641,2020,2020-2021
NJ,2020-09-30,inter-ucfe,0,0,0,0,0,0,0,0,0,0,0,0,0,0,TRUE,0,2020,2020-2021
NJ,2020-09-30,inter-ucx,0,0,0,0,0,0,0,0,0,1,0,1,0,0,TRUE,0,2020,2020-2021
NJ,2020-09-30,inter-ui,35,36,51,51,93,105,133,86,61,279,44,974,79,115,TRUE,0.0811088295687885,2020,2020-2021
NJ,2020-09-30,intra-total,6191,1060,868,872,1158,1678,1890,1452,872,5412,2864,24317,9055,10115,TRUE,0.372373236830201,2020,2020-2021
NJ,2020-09-30,intra-ucfe,0,3,0,1,2,2,4,3,7,8,2,32,2,5,TRUE,0.0625,2020,2020-2021
NJ,2020-09-30,intra-ucx,2,10,8,10,5,6,5,1,1,20,4,72,6,16,TRUE,0.0833333333333333,2020,2020-2021
NJ,2020-09-30,intra-ui,6189,1047,860,861,1151,1670,1881,1448,864,5384,2858,24213,9047,10094,TRUE,0.373642258291001,2020,2020-2021
NJ,2020-10-31,inter-total,116,96,74,48,26,20,28,17,23,192,110,750,226,322,TRUE,0.301333333333333,2020,2020-2021
NJ,2020-10-31,inter-ucfe,0,0,0,0,0,0,0,0,0,1,0,1,0,0,TRUE,0,2020,2020-2021
NJ,2020-10-31,inter-ucx,0,0,1,0,0,0,0,0,0,0,0,1,0,0,TRUE,0,2020,2020-2021
NJ,2020-10-31,inter-ui,116,96,73,48,26,20,28,17,23,191,110,748,226,322,TRUE,0.302139037433155,2020,2020-2021
NJ,2020-10-31,intra-total,6226,1457,842,565,433,356,306,339,220,5476,3492,19712,9718,11175,TRUE,0.492999188311688,2020,2020-2021
NJ,2020-10-31,intra-ucfe,0,4,1,1,0,0,0,1,0,10,9,26,9,13,TRUE,0.346153846153846,2020,2020-2021
NJ,2020-10-31,intra-ucx,0,12,13,8,5,4,4,3,4,18,11,82,11,23,TRUE,0.134146341463415,2020,2020-2021
NJ,2020-10-31,intra-ui,6226,1441,828,556,428,352,302,335,216,5448,3472,19604,9698,11139,TRUE,0.494694960212202,2020,2020-2021
NJ,2020-11-30,inter-total,105,68,57,37,47,24,14,15,4,141,90,602,195,263,TRUE,0.323920265780731,2020,2020-2021
NJ,2020-11-30,inter-ucfe,0,0,0,0,0,0,0,0,0,0,2,2,2,2,TRUE,1,2020,2020-2021
NJ,2020-11-30,inter-ucx,0,0,0,0,0,0,0,0,0,0,0,0,0,0,TRUE,0,2020,2020-2021
NJ,2020-11-30,inter-ui,105,68,57,37,47,24,14,15,4,141,88,600,193,261,TRUE,0.321666666666667,2020,2020-2021
NJ,2020-11-30,intra-total,4861,1200,553,374,232,181,129,141,137,2889,2680,13377,7541,8741,TRUE,0.563728788218584,2020,2020-2021
NJ,2020-11-30,intra-ucfe,3,9,3,6,5,2,3,0,0,17,9,57,12,21,TRUE,0.210526315789474,2020,2020-2021
NJ,2020-11-30,intra-ucx,0,1,3,5,7,3,2,3,1,15,0,40,0,1,TRUE,0,2020,2020-2021
NJ,2020-11-30,intra-ui,4858,1190,547,363,220,176,124,138,136,2857,2671,13280,7529,8719,TRUE,0.566942771084337,2020,2020-2021
NJ,2020-12-31,inter-total,108,59,27,16,29,26,18,13,20,112,67,495,175,234,TRUE,0.353535353535354,2020,2020-2021
NJ,2020-12-31,inter-ucfe,0,0,0,0,0,0,0,0,1,0,0,1,0,0,TRUE,0,2020,2020-2021
NJ,2020-12-31,inter-ucx,0,0,0,0,0,0,0,0,0,1,0,1,0,0,TRUE,0,2020,2020-2021
NJ,2020-12-31,inter-ui,108,59,27,16,29,26,18,13,19,111,67,493,175,234,TRUE,0.354969574036511,2020,2020-2021
NJ,2020-12-31,intra-total,7289,1104,564,384,258,245,175,159,133,2645,3151,16107,10440,11544,TRUE,0.648165393928106,2020,2020-2021
NJ,2020-12-31,intra-ucfe,2,10,12,13,4,4,2,1,2,15,5,70,7,17,TRUE,0.1,2020,2020-2021
NJ,2020-12-31,intra-ucx,0,3,2,3,4,4,5,2,0,11,3,37,3,6,TRUE,0.0810810810810811,2020,2020-2021
NJ,2020-12-31,intra-ui,7287,1091,550,368,250,237,168,156,131,2619,3143,16000,10430,11521,TRUE,0.651875,2020,2020-2021
NJ,2021-01-31,inter-total,81,48,56,26,10,20,8,14,9,130,64,466,145,193,TRUE,0.311158798283262,2020,2020-2021
NJ,2021-01-31,inter-ucfe,0,0,0,0,0,0,0,0,0,0,0,0,0,0,TRUE,0,2020,2020-2021
NJ,2021-01-31,inter-ucx,0,0,0,0,0,0,0,0,0,0,0,0,0,0,TRUE,0,2020,2020-2021
NJ,2021-01-31,inter-ui,81,48,56,26,10,20,8,14,9,130,64,466,145,193,TRUE,0.311158798283262,2020,2020-2021
NJ,2021-01-31,intra-total,9392,1760,901,568,359,243,215,166,167,2187,5601,21559,14993,16753,TRUE,0.69544041931444,2020,2020-2021
NJ,2021-01-31,intra-ucfe,0,11,7,2,1,3,3,3,1,30,9,70,9,20,TRUE,0.128571428571429,2020,2020-2021
NJ,2021-01-31,intra-ucx,0,0,5,1,1,1,1,0,1,9,3,22,3,3,TRUE,0.136363636363636,2020,2020-2021
NJ,2021-01-31,intra-ui,9392,1749,889,565,357,239,211,163,165,2148,5589,21467,14981,16730,TRUE,0.697861834443565,2020,2020-2021
NJ,2021-02-28,inter-total,41,22,29,33,28,15,14,9,12,186,36,425,77,99,TRUE,0.181176470588235,2020,2020-2021
NJ,2021-02-28,inter-ucfe,0,0,0,0,0,0,0,0,0,3,0,3,0,0,TRUE,0,2020,2020-2021
NJ,2021-02-28,inter-ucx,0,0,0,0,0,0,0,0,0,0,0,0,0,0,TRUE,0,2020,2020-2021
NJ,2021-02-28,inter-ui,41,22,29,33,28,15,14,9,12,183,36,422,77,99,TRUE,0.182464454976303,2020,2020-2021
NJ,2021-02-28,intra-total,6437,1070,658,572,516,422,318,239,178,2542,3106,16058,9543,10613,TRUE,0.594283223315481,2020,2020-2021
NJ,2021-02-28,intra-ucfe,3,11,7,6,2,5,2,0,1,18,5,60,8,19,TRUE,0.133333333333333,2020,2020-2021
NJ,2021-02-28,intra-ucx,1,4,1,2,5,2,2,3,0,13,4,37,5,9,TRUE,0.135135135135135,2020,2020-2021
NJ,2021-02-28,intra-ui,6433,1055,650,564,509,415,314,236,177,2511,3097,15961,9530,10585,TRUE,0.597080383434622,2020,2020-2021
NJ,2021-03-31,inter-total,48,20,30,25,16,21,20,16,24,159,19,398,67,87,TRUE,0.168341708542714,2020,2020-2021
NJ,2021-03-31,inter-ucfe,0,0,0,0,0,0,0,0,0,0,0,0,0,0,TRUE,0,2020,2020-2021
NJ,2021-03-31,inter-ucx,0,0,0,0,0,0,0,0,0,0,0,0,0,0,TRUE,0,2020,2020-2021
NJ,2021-03-31,inter-ui,48,20,30,25,16,21,20,16,24,159,19,398,67,87,TRUE,0.168341708542714,2020,2020-2021
NJ,2021-03-31,intra-total,15293,794,549,496,450,410,427,441,440,3548,2491,25339,17784,18578,TRUE,0.701843008800663,2020,2020-2021
NJ,2021-03-31,intra-ucfe,4,4,5,2,3,1,2,0,2,17,1,41,5,9,TRUE,0.121951219512195,2020,2020-2021
NJ,2021-03-31,intra-ucx,2,5,11,6,1,0,0,0,2,16,0,43,2,7,TRUE,0.0465116279069768,2020,2020-2021
NJ,2021-03-31,intra-ui,15287,785,533,488,446,409,425,441,436,3515,2490,25255,17777,18562,TRUE,0.703900217778658,2020,2020-2021
NJ,2021-04-30,inter-total,251,73,35,29,16,9,12,10,5,124,102,666,353,426,TRUE,0.53003003003003,2020,2020-2021
NJ,2021-04-30,inter-ucfe,0,0,0,0,0,0,0,1,0,1,0,2,0,0,TRUE,0,2020,2020-2021
NJ,2021-04-30,inter-ucx,0,0,0,0,0,0,0,0,0,0,0,0,0,0,TRUE,0,2020,2020-2021
NJ,2021-04-30,inter-ui,251,73,35,29,16,9,12,9,5,123,102,664,353,426,TRUE,0.531626506024096,2020,2020-2021
NJ,2021-04-30,intra-total,21228,3148,1124,612,374,225,204,197,209,3649,6372,37342,27600,30748,TRUE,0.739114134218842,2020,2020-2021
NJ,2021-04-30,intra-ucfe,0,0,2,1,0,0,0,1,0,19,4,27,4,4,TRUE,0.148148148148148,2020,2020-2021
NJ,2021-04-30,intra-ucx,0,10,10,3,3,0,0,0,1,9,4,40,4,14,TRUE,0.1,2020,2020-2021
NJ,2021-04-30,intra-ui,21228,3138,1112,608,371,225,204,196,208,3621,6364,37275,27592,30730,TRUE,0.740228034875922,2020,2020-2021
NJ,2021-05-31,inter-total,123,22,23,18,21,16,10,6,2,95,37,373,160,182,TRUE,0.428954423592493,2020,2020-2021
NJ,2021-05-31,inter-ucfe,0,0,0,0,0,0,0,0,0,0,0,0,0,0,TRUE,0,2020,2020-2021
NJ,2021-05-31,inter-ucx,0,0,0,0,0,0,0,0,0,0,0,0,0,0,TRUE,0,2020,2020-2021
NJ,2021-05-31,inter-ui,123,22,23,18,21,16,10,6,2,95,37,373,160,182,TRUE,0.428954423592493,2020,2020-2021
NJ,2021-05-31,intra-total,14160,1634,942,681,530,450,334,272,180,2552,3062,24797,17222,18856,TRUE,0.694519498326411,2020,2020-2021
NJ,2021-05-31,intra-ucfe,2,6,8,3,0,0,0,0,1,15,7,42,9,15,TRUE,0.214285714285714,2020,2020-2021
NJ,2021-05-31,intra-ucx,1,5,6,1,1,2,0,0,3,13,3,35,4,9,TRUE,0.114285714285714,2020,2020-2021
NJ,2021-05-31,intra-ui,14157,1623,928,677,529,448,334,272,176,2524,3052,24720,17209,18832,TRUE,0.696156957928803,2020,2020-2021
NJ,2021-06-30,inter-total,81,52,58,54,29,35,34,22,7,142,21,535,102,154,TRUE,0.190654205607477,2020,2020-2021
NJ,2021-06-30,inter-ucfe,0,0,0,0,0,0,0,0,0,1,0,1,0,0,TRUE,0,2020,2020-2021
NJ,2021-06-30,inter-ucx,0,0,0,0,0,0,0,0,0,0,0,0,0,0,TRUE,0,2020,2020-2021
NJ,2021-06-30,inter-ui,81,52,58,54,29,35,34,22,7,141,21,534,102,154,TRUE,0.191011235955056,2020,2020-2021
NJ,2021-06-30,intra-total,9963,1401,1503,923,545,438,345,256,269,2817,2676,21136,12639,14040,TRUE,0.597984481453444,2020,2020-2021
NJ,2021-06-30,intra-ucfe,0,8,3,6,3,3,1,1,2,20,8,55,8,16,TRUE,0.145454545454545,2020,2020-2021
NJ,2021-06-30,intra-ucx,1,10,4,9,8,5,3,0,1,10,2,53,3,13,TRUE,0.0566037735849057,2020,2020-2021
NJ,2021-06-30,intra-ui,9962,1383,1496,908,534,430,341,255,266,2787,2666,21028,12628,14011,TRUE,0.600532623169108,2020,2020-2021
NJ,2021-07-31,inter-total,107,35,78,54,40,20,21,13,6,152,37,563,144,179,TRUE,0.255772646536412,2021,2021-2022
NJ,2021-07-31,inter-ucfe,0,0,0,0,0,0,0,0,0,1,0,1,0,0,TRUE,0,2021,2021-2022
NJ,2021-07-31,inter-ucx,0,0,0,0,0,0,0,0,0,0,0,0,0,0,TRUE,0,2021,2021-2022
NJ,2021-07-31,inter-ui,107,35,78,54,40,20,21,13,6,151,37,562,144,179,TRUE,0.256227758007117,2021,2021-2022
NJ,2021-07-31,intra-total,13931,1446,1388,1420,751,441,312,276,232,3891,3581,27669,17512,18958,TRUE,0.632910477429614,2021,2021-2022
NJ,2021-07-31,intra-ucfe,3,5,2,3,2,6,3,2,1,22,4,53,7,12,TRUE,0.132075471698113,2021,2021-2022
NJ,2021-07-31,intra-ucx,3,2,9,8,4,1,0,1,1,13,4,46,7,9,TRUE,0.152173913043478,2021,2021-2022
NJ,2021-07-31,intra-ui,13925,1439,1377,1409,745,434,309,273,230,3856,3573,27570,17498,18937,TRUE,0.634675371780921,2021,2021-2022
NJ,2021-08-31,inter-total,28,19,26,50,29,16,12,7,5,115,22,329,50,69,TRUE,0.151975683890578,2021,2021-2022
NJ,2021-08-31,inter-ucfe,0,0,1,0,0,0,0,0,0,0,0,1,0,0,TRUE,0,2021,2021-2022
NJ,2021-08-31,inter-ucx,0,0,0,0,0,0,0,0,0,0,0,0,0,0,TRUE,0,2021,2021-2022
NJ,2021-08-31,inter-ui,28,19,25,50,29,16,12,7,5,115,22,328,50,69,TRUE,0.152439024390244,2021,2021-2022
NJ,2021-08-31,intra-total,2522,1079,777,901,730,498,354,247,165,2793,1908,11974,4430,5509,TRUE,0.369968264573242,2021,2021-2022
NJ,2021-08-31,intra-ucfe,1,5,2,2,2,1,0,1,0,14,1,29,2,7,TRUE,0.0689655172413793,2021,2021-2022
NJ,2021-08-31,intra-ucx,3,2,5,6,3,0,0,0,0,5,4,28,7,9,TRUE,0.25,2021,2021-2022
NJ,2021-08-31,intra-ui,2518,1072,770,893,725,497,354,246,165,2774,1903,11917,4421,5493,TRUE,0.370982629856508,2021,2021-2022
NJ,2021-09-30,inter-total,246,30,21,19,12,12,7,10,14,83,38,492,284,314,TRUE,0.577235772357724,2021,2021-2022
NJ,2021-09-30,inter-ucfe,0,0,0,0,0,0,1,0,0,0,1,2,1,1,TRUE,0.5,2021,2021-2022
NJ,2021-09-30,inter-ucx,1,0,0,0,0,0,0,0,0,0,0,1,1,1,TRUE,1,2021,2021-2022
NJ,2021-09-30,inter-ui,245,30,21,19,12,12,6,10,14,83,37,489,282,312,TRUE,0.576687116564417,2021,2021-2022
NJ,2021-09-30,intra-total,10901,1117,708,599,398,301,255,224,178,2273,2116,19070,13017,14134,TRUE,0.682590456213949,2021,2021-2022
NJ,2021-09-30,intra-ucfe,1,2,1,2,0,0,1,0,1,11,0,19,1,3,TRUE,0.0526315789473684,2021,2021-2022
NJ,2021-09-30,intra-ucx,1,4,11,6,2,1,2,0,1,7,2,37,3,7,TRUE,0.0810810810810811,2021,2021-2022
NJ,2021-09-30,intra-ui,10899,1111,696,591,396,300,252,224,176,2255,2114,19014,13013,14124,TRUE,0.684390449142737,2021,2021-2022
NJ,2021-10-31,inter-total,22,19,35,22,19,11,5,5,11,101,20,270,42,61,TRUE,0.155555555555556,2021,2021-2022
NJ,2021-10-31,inter-ucfe,0,0,1,0,0,0,0,0,1,1,0,3,0,0,TRUE,0,2021,2021-2022
NJ,2021-10-31,inter-ucx,0,0,0,0,0,0,0,0,0,0,0,0,0,0,TRUE,0,2021,2021-2022
NJ,2021-10-31,inter-ui,22,19,34,22,19,11,5,5,10,100,20,267,42,61,TRUE,0.157303370786517,2021,2021-2022
NJ,2021-10-31,intra-total,1123,652,773,583,427,296,222,158,167,2419,773,7593,1896,2548,TRUE,0.249703674436981,2021,2021-2022
NJ,2021-10-31,intra-ucfe,0,3,7,1,0,0,1,0,1,8,4,25,4,7,TRUE,0.16,2021,2021-2022
NJ,2021-10-31,intra-ucx,0,6,6,2,6,2,2,0,0,9,2,35,2,8,TRUE,0.0571428571428571,2021,2021-2022
NJ,2021-10-31,intra-ui,1123,643,760,580,421,294,219,158,166,2402,767,7533,1890,2533,TRUE,0.25089605734767,2021,2021-2022
NJ,2021-11-30,inter-total,20,34,19,20,16,8,12,10,6,91,27,263,47,81,TRUE,0.178707224334601,2021,2021-2022
NJ,2021-11-30,inter-ucfe,0,0,0,0,0,0,0,0,0,1,0,1,0,0,TRUE,0,2021,2021-2022
NJ,2021-11-30,inter-ucx,0,1,0,0,0,0,0,0,0,0,0,1,0,1,TRUE,0,2021,2021-2022
NJ,2021-11-30,inter-ui,20,33,19,20,16,8,12,10,6,90,27,261,47,80,TRUE,0.18007662835249,2021,2021-2022
NJ,2021-11-30,intra-total,1407,666,599,411,372,290,267,253,251,2416,1007,7939,2414,3080,TRUE,0.30406852248394,2021,2021-2022
NJ,2021-11-30,intra-ucfe,0,6,6,6,2,0,1,1,1,8,0,31,0,6,TRUE,0,2021,2021-2022
NJ,2021-11-30,intra-ucx,3,3,2,4,1,0,0,0,0,13,3,29,6,9,TRUE,0.206896551724138,2021,2021-2022
NJ,2021-11-30,intra-ui,1404,657,591,401,369,290,266,252,250,2395,1004,7879,2408,3065,TRUE,0.30562254093159,2021,2021-2022
NJ,2021-12-31,inter-total,36,27,19,18,23,23,11,12,20,130,51,370,87,114,TRUE,0.235135135135135,2021,2021-2022
NJ,2021-12-31,inter-ucfe,0,0,0,0,0,0,0,0,0,1,0,1,0,0,TRUE,0,2021,2021-2022
NJ,2021-12-31,inter-ucx,0,0,0,0,0,0,0,0,0,0,0,0,0,0,TRUE,0,2021,2021-2022
NJ,2021-12-31,inter-ui,36,27,19,18,23,23,11,12,20,129,51,369,87,114,TRUE,0.235772357723577,2021,2021-2022
NJ,2021-12-31,intra-total,2297,936,589,452,357,289,269,227,255,3263,1719,10653,4016,4952,TRUE,0.376983009480897,2021,2021-2022
NJ,2021-12-31,intra-ucfe,1,2,2,6,2,0,1,0,2,14,6,36,7,9,TRUE,0.194444444444444,2021,2021-2022
NJ,2021-12-31,intra-ucx,1,3,4,0,0,0,2,2,1,13,4,30,5,8,TRUE,0.166666666666667,2021,2021-2022
NJ,2021-12-31,intra-ui,2295,931,583,446,355,289,266,225,252,3236,1709,10587,4004,4935,TRUE,0.378199678851422,2021,2021-2022
NJ,2022-01-31,inter-total,28,32,39,18,25,16,9,10,16,173,34,400,62,94,TRUE,0.155,2021,2021-2022
NJ,2022-01-31,inter-ucfe,0,1,1,0,0,0,0,0,1,1,0,4,0,1,TRUE,0,2021,2021-2022
NJ,2022-01-31,inter-ucx,0,0,0,0,0,0,0,0,0,0,0,0,0,0,TRUE,0,2021,2021-2022
NJ,2022-01-31,inter-ui,28,31,38,18,25,16,9,10,15,172,34,396,62,93,TRUE,0.156565656565657,2021,2021-2022
NJ,2022-01-31,intra-total,3792,2009,1233,751,471,407,387,342,330,4832,3219,17773,7011,9020,TRUE,0.394474765093119,2021,2021-2022
NJ,2022-01-31,intra-ucfe,0,2,2,1,0,0,1,1,0,14,3,24,3,5,TRUE,0.125,2021,2021-2022
NJ,2022-01-31,intra-ucx,0,0,0,0,4,2,3,0,0,14,0,23,0,0,TRUE,0,2021,2021-2022
NJ,2022-01-31,intra-ui,3792,2007,1231,750,467,405,383,341,330,4804,3216,17726,7008,9015,TRUE,0.395351461130543,2021,2021-2022
NJ,2022-02-28,inter-total,19,12,20,38,34,23,12,19,20,367,21,585,40,52,TRUE,0.0683760683760684,2021,2021-2022
NJ,2022-02-28,inter-ucfe,0,0,0,0,1,1,0,0,0,3,0,5,0,0,TRUE,0,2021,2021-2022
NJ,2022-02-28,inter-ucx,1,0,0,0,0,0,0,0,0,1,0,2,1,1,TRUE,0.5,2021,2021-2022
NJ,2022-02-28,inter-ui,18,12,20,38,33,22,12,19,20,363,21,578,39,51,TRUE,0.0674740484429066,2021,2021-2022
NJ,2022-02-28,intra-total,1780,1053,1049,1270,991,751,551,522,565,6471,1513,16516,3293,4346,TRUE,0.199382417050133,2021,2021-2022
NJ,2022-02-28,intra-ucfe,0,0,1,3,2,3,2,3,2,25,1,42,1,1,TRUE,0.0238095238095238,2021,2021-2022
NJ,2022-02-28,intra-ucx,0,0,0,0,7,0,2,2,2,6,0,19,0,0,TRUE,0,2021,2021-2022
NJ,2022-02-28,intra-ui,1780,1053,1048,1267,982,748,547,517,561,6440,1512,16455,3292,4345,TRUE,0.200060771801884,2021,2021-2022
NJ,2022-03-31,inter-total,22,31,30,49,29,32,22,37,23,400,20,695,42,73,TRUE,0.060431654676259,2021,2021-2022
NJ,2022-03-31,inter-ucfe,0,0,0,1,0,0,0,1,0,3,0,5,0,0,TRUE,0,2021,2021-2022
NJ,2022-03-31,inter-ucx,0,0,0,0,0,0,0,0,0,1,0,1,0,0,TRUE,0,2021,2021-2022
NJ,2022-03-31,inter-ui,22,31,30,48,29,32,22,36,23,396,20,689,42,73,TRUE,0.0609579100145138,2021,2021-2022
NJ,2022-03-31,intra-total,1575,929,1128,1289,1193,1099,1176,1432,1261,10574,1322,22978,2897,3826,TRUE,0.12607711724258,2021,2021-2022
NJ,2022-03-31,intra-ucfe,0,1,2,1,1,3,3,3,4,40,0,58,0,1,TRUE,0,2021,2021-2022
NJ,2022-03-31,intra-ucx,0,4,3,4,5,2,1,3,1,29,5,57,5,9,TRUE,0.087719298245614,2021,2021-2022
NJ,2022-03-31,intra-ui,1575,924,1123,1284,1187,1094,1172,1426,1256,10505,1317,22863,2892,3816,TRUE,0.126492586274767,2021,2021-2022
NJ,2022-04-30,inter-total,28,34,19,14,11,8,15,10,8,171,36,354,64,98,TRUE,0.180790960451977,2021,2021-2022
NJ,2022-04-30,inter-ucfe,0,0,0,0,0,0,0,0,0,1,0,1,0,0,TRUE,0,2021,2021-2022
NJ,2022-04-30,inter-ucx,0,0,0,0,0,0,0,0,0,0,0,0,0,0,TRUE,0,2021,2021-2022
NJ,2022-04-30,inter-ui,28,34,19,14,11,8,15,10,8,170,36,353,64,98,TRUE,0.181303116147309,2021,2021-2022
NJ,2022-04-30,intra-total,1869,1055,702,560,446,406,348,343,320,5053,1597,12699,3466,4521,TRUE,0.27293487676195,2021,2021-2022
NJ,2022-04-30,intra-ucfe,0,0,1,1,3,1,1,0,1,29,1,38,1,1,TRUE,0.0263157894736842,2021,2021-2022
NJ,2022-04-30,intra-ucx,3,4,4,4,6,2,0,0,0,6,5,34,8,12,TRUE,0.235294117647059,2021,2021-2022
NJ,2022-04-30,intra-ui,1866,1051,697,555,437,403,347,343,319,5018,1591,12627,3457,4508,TRUE,0.273778411340778,2021,2021-2022
NJ,2022-05-31,inter-total,34,43,30,18,21,12,16,11,9,185,35,414,69,112,TRUE,0.166666666666667,2021,2021-2022
NJ,2022-05-31,inter-ucfe,0,0,0,1,1,0,1,0,0,2,0,5,0,0,TRUE,0,2021,2021-2022
NJ,2022-05-31,inter-ucx,0,0,0,0,0,0,0,0,0,0,0,0,0,0,TRUE,0,2021,2021-2022
NJ,2022-05-31,inter-ui,34,43,30,17,20,12,15,11,9,183,35,409,69,112,TRUE,0.168704156479218,2021,2021-2022
NJ,2022-05-31,intra-total,1943,1084,875,614,523,485,394,364,330,4969,1321,12902,3264,4348,TRUE,0.252984033483181,2021,2021-2022
NJ,2022-05-31,intra-ucfe,0,5,1,2,1,2,0,1,1,23,3,39,3,8,TRUE,0.0769230769230769,2021,2021-2022
NJ,2022-05-31,intra-ucx,2,9,0,3,5,3,1,1,1,11,2,38,4,13,TRUE,0.105263157894737,2021,2021-2022
NJ,2022-05-31,intra-ui,1941,1070,874,609,517,480,393,362,328,4935,1316,12825,3257,4327,TRUE,0.253957115009747,2021,2021-2022
NJ,2022-06-30,inter-total,63,39,39,34,28,16,14,12,17,206,53,521,116,155,TRUE,0.222648752399232,2021,2021-2022
NJ,2022-06-30,inter-ucfe,0,0,0,0,0,0,0,2,0,1,0,3,0,0,TRUE,0,2021,2021-2022
NJ,2022-06-30,inter-ucx,0,0,1,0,0,0,2,0,0,0,0,3,0,0,TRUE,0,2021,2021-2022
NJ,2022-06-30,inter-ui,63,39,38,34,28,16,12,10,17,205,53,515,116,155,TRUE,0.225242718446602,2021,2021-2022
NJ,2022-06-30,intra-total,3312,969,796,625,572,464,441,453,442,4917,1606,14597,4918,5887,TRUE,0.336918544906488,2021,2021-2022
NJ,2022-06-30,intra-ucfe,4,15,2,2,0,1,1,3,1,9,4,42,8,23,TRUE,0.19047619047619,2021,2021-2022
NJ,2022-06-30,intra-ucx,1,5,3,2,2,2,2,1,0,11,5,34,6,11,TRUE,0.176470588235294,2021,2021-2022
NJ,2022-06-30,intra-ui,3307,949,791,621,570,461,438,449,441,4897,1597,14521,4904,5853,TRUE,0.337717788031127,2021,2021-2022
NJ,2022-07-31,inter-total,60,51,35,29,16,12,17,18,11,154,51,454,111,162,TRUE,0.244493392070485,2022,2022-2023
NJ,2022-07-31,inter-ucfe,0,0,0,1,0,0,0,0,0,0,0,1,0,0,TRUE,0,2022,2022-2023
NJ,2022-07-31,inter-ucx,0,0,0,0,0,0,0,0,0,0,0,0,0,0,TRUE,0,2022,2022-2023
NJ,2022-07-31,inter-ui,60,51,35,28,16,12,17,18,11,154,51,453,111,162,TRUE,0.245033112582781,2022,2022-2023
NJ,2022-07-31,intra-total,4738,2094,1651,1047,692,552,466,455,393,4219,3126,19433,7864,9958,TRUE,0.40467246436474,2022,2022-2023
NJ,2022-07-31,intra-ucfe,0,5,2,1,3,2,3,3,1,17,2,39,2,7,TRUE,0.0512820512820513,2022,2022-2023
NJ,2022-07-31,intra-ucx,2,1,4,2,1,2,3,2,1,5,7,30,9,10,TRUE,0.3,2022,2022-2023
NJ,2022-07-31,intra-ui,4736,2088,1645,1044,688,548,460,450,391,4197,3117,19364,7853,9941,TRUE,0.405546374715968,2022,2022-2023
NJ,2022-08-31,inter-total,90,44,43,42,36,29,25,14,9,209,59,600,149,193,TRUE,0.248333333333333,2022,2022-2023
NJ,2022-08-31,inter-ucfe,0,0,2,1,0,1,0,0,0,0,0,4,0,0,TRUE,0,2022,2022-2023
NJ,2022-08-31,inter-ucx,0,0,0,0,0,0,0,0,0,1,0,1,0,0,TRUE,0,2022,2022-2023
NJ,2022-08-31,inter-ui,90,44,41,41,36,28,25,14,9,208,59,595,149,193,TRUE,0.250420168067227,2022,2022-2023
NJ,2022-08-31,intra-total,3857,1428,1449,1551,1466,1125,847,590,427,4172,2153,19065,6010,7438,TRUE,0.315237345921846,2022,2022-2023
NJ,2022-08-31,intra-ucfe,2,4,0,3,3,5,3,3,1,15,3,42,5,9,TRUE,0.119047619047619,2022,2022-2023
NJ,2022-08-31,intra-ucx,4,4,5,1,4,1,1,2,0,12,2,36,6,10,TRUE,0.166666666666667,2022,2022-2023
NJ,2022-08-31,intra-ui,3851,1420,1444,1547,1459,1119,843,585,426,4145,2148,18987,5999,7419,TRUE,0.315953020487702,2022,2022-2023
NJ,2022-09-30,inter-total,85,48,38,39,15,18,17,7,13,131,67,478,152,200,TRUE,0.317991631799163,2022,2022-2023
NJ,2022-09-30,inter-ucfe,0,0,0,0,0,0,0,0,1,1,0,2,0,0,TRUE,0,2022,2022-2023
NJ,2022-09-30,inter-ucx,0,0,0,0,0,0,0,0,0,0,0,0,0,0,TRUE,0,2022,2022-2023
NJ,2022-09-30,inter-ui,85,48,38,39,15,18,17,7,12,130,67,476,152,200,TRUE,0.319327731092437,2022,2022-2023
NJ,2022-09-30,intra-total,3253,1557,1266,993,662,482,423,412,346,3498,2113,15005,5366,6923,TRUE,0.357614128623792,2022,2022-2023
NJ,2022-09-30,intra-ucfe,1,7,5,4,2,0,2,3,3,12,4,43,5,12,TRUE,0.116279069767442,2022,2022-2023
NJ,2022-09-30,intra-ucx,1,5,5,5,2,3,1,0,1,10,1,34,2,7,TRUE,0.0588235294117647,2022,2022-2023
NJ,2022-09-30,intra-ui,3251,1545,1256,984,658,479,420,409,342,3476,2108,14928,5359,6904,TRUE,0.358989817792069,2022,2022-2023
NJ,2022-10-31,inter-total,93,69,47,20,8,13,12,14,8,96,102,482,195,264,TRUE,0.404564315352697,2022,2022-2023
NJ,2022-10-31,inter-ucfe,0,1,1,0,0,0,0,0,0,1,0,3,0,1,TRUE,0,2022,2022-2023
NJ,2022-10-31,inter-ucx,0,0,1,0,0,0,0,0,0,0,0,1,0,0,TRUE,0,2022,2022-2023
NJ,2022-10-31,inter-ui,93,68,45,20,8,13,12,14,8,95,102,478,195,263,TRUE,0.407949790794979,2022,2022-2023
NJ,2022-10-31,intra-total,3495,1615,1048,641,507,370,328,268,243,3312,2356,14183,5851,7466,TRUE,0.412536134809279,2022,2022-2023
NJ,2022-10-31,intra-ucfe,2,5,2,2,0,1,0,0,0,18,2,32,4,9,TRUE,0.125,2022,2022-2023
NJ,2022-10-31,intra-ucx,4,11,3,3,1,1,4,3,0,9,3,42,7,18,TRUE,0.166666666666667,2022,2022-2023
NJ,2022-10-31,intra-ui,3489,1599,1043,636,506,368,324,265,243,3285,2351,14109,5840,7439,TRUE,0.413920192784747,2022,2022-2023
NJ,2022-11-30,inter-total,171,115,97,52,34,24,12,13,12,98,151,779,322,437,TRUE,0.413350449293967,2022,2022-2023
NJ,2022-11-30,inter-ucfe,0,0,1,1,0,0,0,0,1,0,0,3,0,0,TRUE,0,2022,2022-2023
NJ,2022-11-30,inter-ucx,0,0,0,0,0,0,0,0,0,0,0,0,0,0,TRUE,0,2022,2022-2023
NJ,2022-11-30,inter-ui,171,115,96,51,34,24,12,13,11,98,151,776,322,437,TRUE,0.414948453608247,2022,2022-2023
NJ,2022-11-30,intra-total,5160,2055,1316,759,520,362,318,237,186,2075,3073,16061,8233,10288,TRUE,0.51260818130876,2022,2022-2023
NJ,2022-11-30,intra-ucfe,2,10,8,1,1,0,2,1,1,15,7,48,9,19,TRUE,0.1875,2022,2022-2023
NJ,2022-11-30,intra-ucx,1,9,1,1,1,1,2,2,0,4,0,22,1,10,TRUE,0.0454545454545455,2022,2022-2023
NJ,2022-11-30,intra-ui,5157,2036,1307,757,518,361,314,234,185,2056,3066,15991,8223,10259,TRUE,0.514226752548308,2022,2022-2023
NJ,2022-12-31,inter-total,192,81,56,39,36,26,31,21,11,83,133,709,325,406,TRUE,0.458392101551481,2022,2022-2023
NJ,2022-12-31,inter-ucfe,0,1,0,0,0,0,0,0,0,0,0,1,0,1,TRUE,0,2022,2022-2023
NJ,2022-12-31,inter-ucx,0,1,1,0,0,0,0,0,0,1,0,3,0,1,TRUE,0,2022,2022-2023
NJ,2022-12-31,inter-ui,192,79,55,39,36,26,31,21,11,82,133,705,325,404,TRUE,0.460992907801419,2022,2022-2023
NJ,2022-12-31,intra-total,7871,2310,1314,858,574,441,369,291,253,2263,3754,20298,11625,13935,TRUE,0.572716523795448,2022,2022-2023
NJ,2022-12-31,intra-ucfe,1,17,5,2,2,5,2,2,3,6,2,47,3,20,TRUE,0.0638297872340426,2022,2022-2023
NJ,2022-12-31,intra-ucx,3,7,3,0,5,0,0,0,0,4,4,26,7,14,TRUE,0.269230769230769,2022,2022-2023
NJ,2022-12-31,intra-ui,7867,2286,1306,856,567,436,367,289,250,2253,3748,20225,11615,13901,TRUE,0.574289245982695,2022,2022-2023
NJ,2023-01-31,inter-total,192,95,56,31,21,12,16,16,14,80,130,663,322,417,TRUE,0.485671191553545,2022,2022-2023
NJ,2023-01-31,inter-ucfe,0,1,0,0,0,0,0,0,0,0,0,1,0,1,TRUE,0,2022,2022-2023
NJ,2023-01-31,inter-ucx,0,0,0,0,0,0,0,0,0,0,0,0,0,0,TRUE,0,2022,2022-2023
NJ,2023-01-31,inter-ui,192,94,56,31,21,12,16,16,14,80,130,662,322,416,TRUE,0.486404833836858,2022,2022-2023
NJ,2023-01-31,intra-total,12506,3811,2123,1145,725,498,376,260,234,2218,5996,29892,18502,22313,TRUE,0.618961595075606,2022,2022-2023
NJ,2023-01-31,intra-ucfe,0,10,5,6,1,2,2,0,0,6,8,40,8,18,TRUE,0.2,2022,2022-2023
NJ,2023-01-31,intra-ucx,4,4,1,2,3,0,3,0,0,4,9,30,13,17,TRUE,0.433333333333333,2022,2022-2023
NJ,2023-01-31,intra-ui,12502,3797,2117,1137,721,496,371,260,234,2208,5979,29822,18481,22278,TRUE,0.619710281000604,2022,2022-2023
NJ,2023-02-28,inter-total,134,69,48,52,23,22,10,11,11,74,91,545,225,294,TRUE,0.412844036697248,2022,2022-2023
NJ,2023-02-28,inter-ucfe,0,1,0,0,0,0,0,0,0,0,1,2,1,2,TRUE,0.5,2022,2022-2023
NJ,2023-02-28,inter-ucx,0,0,0,0,0,0,0,0,0,0,0,0,0,0,TRUE,0,2022,2022-2023
NJ,2023-02-28,inter-ui,134,68,48,52,23,22,10,11,11,74,90,543,224,292,TRUE,0.412523020257827,2022,2022-2023
NJ,2023-02-28,intra-total,7604,2972,1887,1245,899,597,486,370,255,1833,3698,21846,11302,14274,TRUE,0.517348713723336,2022,2022-2023
NJ,2023-02-28,intra-ucfe,6,17,5,3,2,1,1,2,0,7,9,53,15,32,TRUE,0.283018867924528,2022,2022-2023
NJ,2023-02-28,intra-ucx,0,4,5,5,2,0,1,0,1,1,7,26,7,11,TRUE,0.269230769230769,2022,2022-2023
NJ,2023-02-28,intra-ui,7598,2951,1877,1237,895,596,484,368,254,1825,3682,21767,11280,14231,TRUE,0.518215647539854,2022,2022-2023
NJ,2023-03-31,inter-total,118,67,65,29,19,17,18,15,11,73,96,528,214,281,TRUE,0.40530303030303,2022,2022-2023
NJ,2023-03-31,inter-ucfe,0,0,0,1,0,0,0,0,0,0,0,1,0,0,TRUE,0,2022,2022-2023
NJ,2023-03-31,inter-ucx,0,1,1,0,0,0,0,0,0,0,1,3,1,2,TRUE,0.333333333333333,2022,2022-2023
NJ,2023-03-31,inter-ui,118,66,64,28,19,17,18,15,11,73,95,524,213,279,TRUE,0.406488549618321,2022,2022-2023
NJ,2023-03-31,intra-total,6437,2579,1983,1166,787,623,537,446,391,2492,3074,20515,9511,12090,TRUE,0.463611991225932,2022,2022-2023
NJ,2023-03-31,intra-ucfe,6,13,6,5,4,1,2,1,2,7,3,50,9,22,TRUE,0.18,2022,2022-2023
NJ,2023-03-31,intra-ucx,7,7,3,2,1,1,0,1,2,7,6,37,13,20,TRUE,0.351351351351351,2022,2022-2023
NJ,2023-03-31,intra-ui,6424,2559,1974,1159,782,621,535,444,387,2478,3065,20428,9489,12048,TRUE,0.46450949676914,2022,2022-2023
NJ,2023-04-30,inter-total,130,70,49,32,19,12,7,6,4,75,98,502,228,298,TRUE,0.454183266932271,2022,2022-2023
NJ,2023-04-30,inter-ucfe,0,1,0,0,1,0,0,0,0,0,0,2,0,1,TRUE,0,2022,2022-2023
NJ,2023-04-30,inter-ucx,0,2,0,1,0,0,0,0,0,0,0,3,0,2,TRUE,0,2022,2022-2023
NJ,2023-04-30,inter-ui,130,67,49,31,18,12,7,6,4,75,98,497,228,295,TRUE,0.458752515090543,2022,2022-2023
NJ,2023-04-30,intra-total,6098,2323,1158,653,459,339,264,205,190,1995,3363,17047,9461,11784,TRUE,0.554995013785417,2022,2022-2023
NJ,2023-04-30,intra-ucfe,7,9,7,5,4,3,1,1,2,3,9,51,16,25,TRUE,0.313725490196078,2022,2022-2023
NJ,2023-04-30,intra-ucx,2,7,3,3,0,1,0,0,0,5,6,27,8,15,TRUE,0.296296296296296,2022,2022-2023
NJ,2023-04-30,intra-ui,6089,2307,1148,645,455,335,263,204,188,1987,3348,16969,9437,11744,TRUE,0.556131769697684,2022,2022-2023
NJ,2023-05-31,inter-total,121,51,54,26,22,9,10,6,13,57,91,460,212,263,TRUE,0.460869565217391,2022,2022-2023
NJ,2023-05-31,inter-ucfe,0,0,0,0,0,0,0,0,0,1,0,1,0,0,TRUE,0,2022,2022-2023
NJ,2023-05-31,inter-ucx,0,0,0,0,0,0,0,0,0,0,0,0,0,0,TRUE,0,2022,2022-2023
NJ,2023-05-31,inter-ui,121,51,54,26,22,9,10,6,13,56,91,459,212,263,TRUE,0.461873638344227,2022,2022-2023
NJ,2023-05-31,intra-total,5855,2149,1199,792,527,378,253,196,179,1811,3206,16545,9061,11210,TRUE,0.547657902689634,2022,2022-2023
NJ,2023-05-31,intra-ucfe,4,8,7,5,2,0,1,1,0,3,5,36,9,17,TRUE,0.25,2022,2022-2023
NJ,2023-05-31,intra-ucx,5,3,2,2,2,3,1,1,0,5,6,30,11,14,TRUE,0.366666666666667,2022,2022-2023
NJ,2023-05-31,intra-ui,5846,2138,1190,785,523,375,251,194,179,1803,3195,16479,9041,11179,TRUE,0.548637660052188,2022,2022-2023
NJ,2023-06-30,inter-total,55,75,39,17,15,14,14,7,6,46,48,336,103,178,TRUE,0.306547619047619,2022,2022-2023
NJ,2023-06-30,inter-ucfe,0,0,0,0,0,1,1,0,0,0,0,2,0,0,TRUE,0,2022,2022-2023
NJ,2023-06-30,inter-ucx,0,0,0,0,0,0,0,0,0,0,0,0,0,0,TRUE,0,2022,2022-2023
NJ,2023-06-30,inter-ui,55,75,39,17,15,13,13,7,6,46,48,334,103,178,TRUE,0.308383233532934,2022,2022-2023
NJ,2023-06-30,intra-total,5337,2296,1267,742,435,315,251,211,155,1438,3067,15514,8404,10700,TRUE,0.541704267113575,2022,2022-2023
NJ,2023-06-30,intra-ucfe,1,6,3,1,0,1,1,0,0,6,7,26,8,14,TRUE,0.307692307692308,2022,2022-2023
NJ,2023-06-30,intra-ucx,3,5,3,3,0,0,1,0,0,5,6,26,9,14,TRUE,0.346153846153846,2022,2022-2023
NJ,2023-06-30,intra-ui,5333,2285,1261,738,435,314,249,211,155,1427,3054,15462,8387,10672,TRUE,0.542426594231018,2022,2022-2023
NJ,2023-07-31,inter-total,54,68,44,29,19,15,10,11,8,42,63,363,117,185,TRUE,0.322314049586777,2023,2023-2024
NJ,2023-07-31,inter-ucfe,0,0,1,1,0,0,0,0,0,1,0,3,0,0,TRUE,0,2023,2023-2024
NJ,2023-07-31,inter-ucx,0,0,0,0,0,0,0,0,0,0,0,0,0,0,TRUE,0,2023,2023-2024
NJ,2023-07-31,inter-ui,54,68,43,28,19,15,10,11,8,41,63,360,117,185,TRUE,0.325,2023,2023-2024
NJ,2023-07-31,intra-total,8073,4060,2556,1357,725,462,304,204,191,1247,5149,24328,13222,17282,TRUE,0.543488983886879,2023,2023-2024
NJ,2023-07-31,intra-ucfe,0,5,8,0,2,2,1,2,1,6,4,31,4,9,TRUE,0.129032258064516,2023,2023-2024
NJ,2023-07-31,intra-ucx,4,4,4,1,1,0,2,0,0,2,3,21,7,11,TRUE,0.333333333333333,2023,2023-2024
NJ,2023-07-31,intra-ui,8069,4051,2544,1356,722,460,301,202,190,1239,5142,24276,13211,17262,TRUE,0.544200032954358,2023,2023-2024
NJ,2023-08-31,inter-total,95,55,41,32,37,20,18,18,6,53,59,434,154,209,TRUE,0.354838709677419,2023,2023-2024
NJ,2023-08-31,inter-ucfe,0,1,0,0,0,1,0,0,0,0,0,2,0,1,TRUE,0,2023,2023-2024
NJ,2023-08-31,inter-ucx,0,0,0,0,0,0,0,0,0,0,0,0,0,0,TRUE,0,2023,2023-2024
NJ,2023-08-31,inter-ui,95,54,41,32,37,19,18,18,6,53,59,432,154,208,TRUE,0.356481481481481,2023,2023-2024
NJ,2023-08-31,intra-total,7496,3178,1992,1404,1178,907,605,453,271,1408,3731,22623,11227,14405,TRUE,0.496264863192326,2023,2023-2024
NJ,2023-08-31,intra-ucfe,1,6,5,3,1,2,4,1,0,5,5,33,6,12,TRUE,0.181818181818182,2023,2023-2024
NJ,2023-08-31,intra-ucx,4,6,7,1,5,1,1,1,0,5,2,33,6,12,TRUE,0.181818181818182,2023,2023-2024
NJ,2023-08-31,intra-ui,7491,3166,1980,1400,1172,904,600,451,271,1398,3724,22557,11215,14381,TRUE,0.497184909340781,2023,2023-2024
NJ,2023-09-30,inter-total,80,58,53,18,6,7,6,7,5,39,86,365,166,224,TRUE,0.454794520547945,2023,2023-2024
NJ,2023-09-30,inter-ucfe,0,0,0,0,0,0,0,0,0,0,0,0,0,0,TRUE,0,2023,2023-2024
NJ,2023-09-30,inter-ucx,0,2,1,0,0,0,0,0,0,0,0,3,0,2,TRUE,0,2023,2023-2024
NJ,2023-09-30,inter-ui,80,56,52,18,6,7,6,7,5,39,86,362,166,222,TRUE,0.458563535911602,2023,2023-2024
NJ,2023-09-30,intra-total,4894,2326,1458,875,622,464,359,318,311,1509,2931,16067,7825,10151,TRUE,0.487023090807245,2023,2023-2024
NJ,2023-09-30,intra-ucfe,5,4,3,3,1,2,2,2,1,8,8,39,13,17,TRUE,0.333333333333333,2023,2023-2024
NJ,2023-09-30,intra-ucx,1,6,2,4,1,2,3,0,1,3,4,27,5,11,TRUE,0.185185185185185,2023,2023-2024
NJ,2023-09-30,intra-ui,4888,2316,1453,868,620,460,354,316,309,1498,2919,16001,7807,10123,TRUE,0.487907005812137,2023,2023-2024
NJ,2023-10-31,inter-total,106,86,61,27,12,7,8,7,4,35,141,494,247,333,TRUE,0.5,2023,2023-2024
NJ,2023-10-31,inter-ucfe,0,0,0,1,0,0,1,0,0,0,0,2,0,0,TRUE,0,2023,2023-2024
NJ,2023-10-31,inter-ucx,0,0,1,0,0,0,0,0,0,0,0,1,0,0,TRUE,0,2023,2023-2024
NJ,2023-10-31,inter-ui,106,86,60,26,12,7,7,7,4,35,141,491,247,333,TRUE,0.503054989816701,2023,2023-2024
NJ,2023-10-31,intra-total,4212,2467,1290,632,491,321,271,210,160,1281,4550,15885,8762,11229,TRUE,0.551589549889833,2023,2023-2024
NJ,2023-10-31,intra-ucfe,4,6,6,9,3,0,1,1,0,3,10,43,14,20,TRUE,0.325581395348837,2023,2023-2024
NJ,2023-10-31,intra-ucx,3,4,2,2,3,3,2,0,1,4,7,31,10,14,TRUE,0.32258064516129,2023,2023-2024
NJ,2023-10-31,intra-ui,4205,2457,1282,621,485,318,268,209,159,1274,4533,15811,8738,11195,TRUE,0.552653216115363,2023,2023-2024
NJ,2023-11-30,inter-total,124,141,93,52,32,22,8,5,6,28,240,751,364,505,TRUE,0.484687083888149,2023,2023-2024
NJ,2023-11-30,inter-ucfe,0,0,0,0,0,0,0,1,0,0,0,1,0,0,TRUE,0,2023,2023-2024
NJ,2023-11-30,inter-ucx,0,0,0,0,0,0,0,0,0,0,0,0,0,0,TRUE,0,2023,2023-2024
NJ,2023-11-30,inter-ui,124,141,93,52,32,22,8,4,6,28,240,750,364,505,TRUE,0.485333333333333,2023,2023-2024
NJ,2023-11-30,intra-total,4888,3071,1548,756,503,278,202,147,100,887,6574,18954,11462,14533,TRUE,0.604727234356864,2023,2023-2024
NJ,2023-11-30,intra-ucfe,3,4,8,2,3,0,0,0,0,2,4,26,7,11,TRUE,0.269230769230769,2023,2023-2024
NJ,2023-11-30,intra-ucx,3,3,5,7,1,1,0,2,0,3,9,34,12,15,TRUE,0.352941176470588,2023,2023-2024
NJ,2023-11-30,intra-ui,4882,3064,1535,747,499,277,202,145,100,882,6561,18894,11443,14507,TRUE,0.605642002752196,2023,2023-2024
NJ,2023-12-31,inter-total,87,80,49,23,23,10,14,6,9,28,133,462,220,300,TRUE,0.476190476190476,2023,2023-2024
NJ,2023-12-31,inter-ucfe,0,0,0,0,0,0,0,0,0,0,0,0,0,0,TRUE,0,2023,2023-2024
NJ,2023-12-31,inter-ucx,0,0,0,0,0,0,0,0,0,0,0,0,0,0,TRUE,0,2023,2023-2024
NJ,2023-12-31,inter-ui,87,80,49,23,23,10,14,6,9,28,133,462,220,300,TRUE,0.476190476190476,2023,2023-2024
NJ,2023-12-31,intra-total,7461,2631,1450,755,492,302,236,159,103,804,6428,20821,13889,16520,TRUE,0.667066903606935,2023,2023-2024
NJ,2023-12-31,intra-ucfe,4,8,3,3,4,1,1,0,2,4,9,39,13,21,TRUE,0.333333333333333,2023,2023-2024
NJ,2023-12-31,intra-ucx,2,4,7,4,4,1,1,0,2,1,3,29,5,9,TRUE,0.172413793103448,2023,2023-2024
NJ,2023-12-31,intra-ui,7455,2619,1440,748,484,300,234,159,99,799,6416,20753,13871,16490,TRUE,0.668385293692478,2023,2023-2024
NJ,2024-01-31,inter-total,106,68,42,31,26,17,7,10,9,41,149,506,255,323,TRUE,0.503952569169961,2023,2023-2024
NJ,2024-01-31,inter-ucfe,0,0,0,0,0,0,0,0,0,0,0,0,0,0,TRUE,0,2023,2023-2024
NJ,2024-01-31,inter-ucx,0,0,0,0,0,0,0,0,0,0,1,1,1,1,TRUE,1,2023,2023-2024
NJ,2024-01-31,inter-ui,106,68,42,31,26,17,7,10,9,41,148,505,254,322,TRUE,0.502970297029703,2023,2023-2024
NJ,2024-01-31,intra-total,9398,4510,2623,1252,706,486,309,237,179,912,12177,32789,21575,26085,TRUE,0.657995059318674,2023,2023-2024
NJ,2024-01-31,intra-ucfe,1,9,6,6,2,4,0,0,0,5,5,38,6,15,TRUE,0.157894736842105,2023,2023-2024
NJ,2024-01-31,intra-ucx,5,2,6,2,2,3,2,0,1,2,5,30,10,12,TRUE,0.333333333333333,2023,2023-2024
NJ,2024-01-31,intra-ui,9392,4499,2611,1244,702,479,307,237,178,905,12167,32721,21559,26058,TRUE,0.658873506310932,2023,2023-2024
NJ,2024-02-29,inter-total,112,82,61,36,23,17,12,7,8,46,124,528,236,318,TRUE,0.446969696969697,2023,2023-2024
NJ,2024-02-29,inter-ucfe,0,0,0,0,0,0,0,0,0,0,0,0,0,0,TRUE,0,2023,2023-2024
NJ,2024-02-29,inter-ucx,0,1,0,0,0,0,0,0,0,0,0,1,0,1,TRUE,0,2023,2023-2024
NJ,2024-02-29,inter-ui,112,81,61,36,23,17,12,7,8,46,124,527,236,317,TRUE,0.447817836812144,2023,2023-2024
NJ,2024-02-29,intra-total,4784,3573,2399,1288,1009,690,385,343,223,1044,7359,23097,12143,15716,TRUE,0.525739273498723,2023,2023-2024
NJ,2024-02-29,intra-ucfe,2,3,6,4,3,4,0,0,0,5,4,31,6,9,TRUE,0.193548387096774,2023,2023-2024
NJ,2024-02-29,intra-ucx,1,8,8,4,0,2,0,0,0,4,5,32,6,14,TRUE,0.1875,2023,2023-2024
NJ,2024-02-29,intra-ui,4781,3562,2385,1280,1006,684,385,343,223,1035,7350,23034,12131,15693,TRUE,0.52665624728662,2023,2023-2024
NJ,2024-03-31,inter-total,84,99,59,24,8,10,11,5,5,31,132,468,216,315,TRUE,0.461538461538462,2023,2023-2024
NJ,2024-03-31,inter-ucfe,0,0,1,1,0,0,0,0,0,0,0,2,0,0,TRUE,0,2023,2023-2024
NJ,2024-03-31,inter-ucx,0,0,0,0,0,0,0,0,0,0,1,1,1,1,TRUE,1,2023,2023-2024
NJ,2024-03-31,inter-ui,84,99,58,23,8,10,11,5,5,31,131,465,215,314,TRUE,0.462365591397849,2023,2023-2024
NJ,2024-03-31,intra-total,4261,3082,1892,1112,709,485,363,294,249,1187,6036,19670,10297,13379,TRUE,0.523487544483986,2023,2023-2024
NJ,2024-03-31,intra-ucfe,6,6,4,4,3,0,2,0,1,1,4,31,10,16,TRUE,0.32258064516129,2023,2023-2024
NJ,2024-03-31,intra-ucx,4,5,4,2,3,3,0,0,0,4,5,30,9,14,TRUE,0.3,2023,2023-2024
NJ,2024-03-31,intra-ui,4251,3071,1884,1106,703,482,361,294,248,1182,6027,19609,10278,13349,TRUE,0.524147075322556,2023,2023-2024
NJ,2024-04-30,inter-total,72,70,44,20,15,11,5,6,6,29,108,386,180,250,TRUE,0.466321243523316,2023,2023-2024
NJ,2024-04-30,inter-ucfe,0,0,0,0,0,0,0,0,0,1,1,2,1,1,TRUE,0.5,2023,2023-2024
NJ,2024-04-30,inter-ucx,0,0,0,0,0,0,0,0,0,1,0,1,0,0,TRUE,0,2023,2023-2024
NJ,2024-04-30,inter-ui,72,70,44,20,15,11,5,6,6,27,107,383,179,249,TRUE,0.467362924281984,2023,2023-2024
NJ,2024-04-30,intra-total,3931,3131,1939,981,577,344,259,189,170,1151,5609,18281,9540,12671,TRUE,0.521853290301406,2023,2023-2024
NJ,2024-04-30,intra-ucfe,2,3,5,1,3,2,1,0,0,7,6,30,8,11,TRUE,0.266666666666667,2023,2023-2024
NJ,2024-04-30,intra-ucx,2,8,8,3,1,0,0,0,1,4,11,38,13,21,TRUE,0.342105263157895,2023,2023-2024
NJ,2024-04-30,intra-ui,3927,3120,1926,977,573,342,258,189,169,1140,5592,18213,9519,12639,TRUE,0.522648657552298,2023,2023-2024
NJ,2024-05-31,inter-total,56,72,37,17,22,7,3,6,3,33,161,417,217,289,TRUE,0.520383693045564,2023,2023-2024
NJ,2024-05-31,inter-ucfe,0,0,1,1,0,0,0,0,0,0,0,2,0,0,TRUE,0,2023,2023-2024
NJ,2024-05-31,inter-ucx,0,0,0,0,0,0,0,0,0,0,0,0,0,0,TRUE,0,2023,2023-2024
NJ,2024-05-31,inter-ui,56,72,36,16,22,7,3,6,3,33,161,415,217,289,TRUE,0.52289156626506,2023,2023-2024
NJ,2024-05-31,intra-total,3649,3040,1539,749,483,286,198,146,109,891,7268,18358,10917,13957,TRUE,0.59467262229001,2023,2023-2024
NJ,2024-05-31,intra-ucfe,3,10,5,4,2,1,4,2,1,3,10,45,13,23,TRUE,0.288888888888889,2023,2023-2024
NJ,2024-05-31,intra-ucx,2,3,2,1,1,0,0,1,0,2,9,21,11,14,TRUE,0.523809523809524,2023,2023-2024
NJ,2024-05-31,intra-ui,3644,3027,1532,744,480,285,194,143,108,886,7249,18292,10893,13920,TRUE,0.59550623223267,2023,2023-2024
NJ,2024-06-30,inter-total,62,84,48,17,7,5,7,5,2,26,139,402,201,285,TRUE,0.5,2023,2023-2024
NJ,2024-06-30,inter-ucfe,0,0,0,0,0,0,0,0,0,0,0,0,0,0,TRUE,0,2023,2023-2024
NJ,2024-06-30,inter-ucx,0,0,0,0,0,0,0,0,0,0,1,1,1,1,TRUE,1,2023,2023-2024
NJ,2024-06-30,inter-ui,62,84,48,17,7,5,7,5,2,26,138,401,200,284,TRUE,0.498753117206983,2023,2023-2024
NJ,2024-06-30,intra-total,5475,2762,1260,579,320,186,117,105,73,665,6203,17745,11678,14440,TRUE,0.658100873485489,2023,2023-2024
NJ,2024-06-30,intra-ucfe,2,2,4,0,0,0,0,2,0,6,5,21,7,9,TRUE,0.333333333333333,2023,2023-2024
NJ,2024-06-30,intra-ucx,2,1,3,1,1,0,0,0,0,1,5,14,7,8,TRUE,0.5,2023,2023-2024
NJ,2024-06-30,intra-ui,5471,2759,1253,578,319,186,117,103,73,658,6193,17710,11664,14423,TRUE,0.658610954263128,2023,2023-2024
NJ,2024-07-31,inter-total,69,63,72,30,15,10,2,5,2,17,131,416,200,263,TRUE,0.480769230769231,2024,2024-2025
NJ,2024-07-31,inter-ucfe,0,0,0,0,0,0,0,0,0,0,0,0,0,0,TRUE,0,2024,2024-2025
NJ,2024-07-31,inter-ucx,0,0,0,0,0,0,0,0,0,0,0,0,0,0,TRUE,0,2024,2024-2025
NJ,2024-07-31,inter-ui,69,63,72,30,15,10,2,5,2,17,131,416,200,263,TRUE,0.480769230769231,2024,2024-2025
NJ,2024-07-31,intra-total,6524,4535,2871,1135,546,225,160,90,77,651,11674,28488,18198,22733,TRUE,0.638795282224094,2024,2024-2025
NJ,2024-07-31,intra-ucfe,5,5,8,1,1,2,0,0,0,2,7,31,12,17,TRUE,0.387096774193548,2024,2024-2025
NJ,2024-07-31,intra-ucx,7,9,4,1,0,0,0,0,1,1,9,32,16,25,TRUE,0.5,2024,2024-2025
NJ,2024-07-31,intra-ui,6512,4521,2859,1133,545,223,160,90,76,648,11658,28425,18170,22691,TRUE,0.639226033421284,2024,2024-2025
NJ,2024-08-31,inter-total,63,68,57,34,17,16,6,5,0,18,149,433,212,280,TRUE,0.489607390300231,2024,2024-2025
NJ,2024-08-31,inter-ucfe,0,0,1,1,0,0,0,0,0,0,0,2,0,0,TRUE,0,2024,2024-2025
NJ,2024-08-31,inter-ucx,0,0,0,0,0,0,0,0,0,0,0,0,0,0,TRUE,0,2024,2024-2025
NJ,2024-08-31,inter-ui,63,68,56,33,17,16,6,5,0,18,149,431,212,280,TRUE,0.491879350348028,2024,2024-2025
NJ,2024-08-31,intra-total,4119,2934,2268,1408,915,584,378,190,81,691,6570,20138,10689,13623,TRUE,0.530787565796008,2024,2024-2025
NJ,2024-08-31,intra-ucfe,2,5,6,6,1,2,0,1,1,1,7,32,9,14,TRUE,0.28125,2024,2024-2025
NJ,2024-08-31,intra-ucx,2,7,9,2,1,1,0,0,0,2,5,29,7,14,TRUE,0.241379310344828,2024,2024-2025
NJ,2024-08-31,intra-ui,4115,2922,2253,1400,913,581,378,189,80,688,6558,20077,10673,13595,TRUE,0.531603327190317,2024,2024-2025
NJ,2024-09-30,inter-total,66,59,49,23,17,10,7,5,8,20,137,401,203,262,TRUE,0.506234413965087,2024,2024-2025
NJ,2024-09-30,inter-ucfe,0,1,0,0,0,0,1,0,0,1,0,3,0,1,TRUE,0,2024,2024-2025
NJ,2024-09-30,inter-ucx,0,0,0,0,0,0,0,0,0,0,0,0,0,0,TRUE,0,2024,2024-2025
NJ,2024-09-30,inter-ui,66,58,49,23,17,10,6,5,8,19,137,398,203,261,TRUE,0.510050251256281,2024,2024-2025
NJ,2024-09-30,intra-total,3475,2524,1774,1057,626,332,213,158,160,728,5181,16228,8656,11180,TRUE,0.533399063347301,2024,2024-2025
NJ,2024-09-30,intra-ucfe,1,2,5,4,0,4,0,0,0,3,1,20,2,4,TRUE,0.1,2024,2024-2025
NJ,2024-09-30,intra-ucx,1,8,6,1,2,1,0,0,2,0,4,25,5,13,TRUE,0.2,2024,2024-2025
NJ,2024-09-30,intra-ui,3473,2514,1763,1052,624,327,213,158,158,725,5176,16183,8649,11163,TRUE,0.534449731199407,2024,2024-2025
NJ,2024-10-31,inter-total,112,123,54,32,20,8,3,5,3,26,234,620,346,469,TRUE,0.558064516129032,2024,2024-2025
NJ,2024-10-31,inter-ucfe,0,0,1,0,1,0,0,0,0,0,0,2,0,0,TRUE,0,2024,2024-2025
NJ,2024-10-31,inter-ucx,0,0,0,0,0,0,0,0,0,0,0,0,0,0,TRUE,0,2024,2024-2025
NJ,2024-10-31,inter-ui,112,123,53,32,19,8,3,5,3,26,234,618,346,469,TRUE,0.559870550161812,2024,2024-2025
NJ,2024-10-31,intra-total,3293,3182,1726,837,474,257,205,147,86,749,7148,18104,10441,13623,TRUE,0.576723376049492,2024,2024-2025
NJ,2024-10-31,intra-ucfe,4,6,10,5,3,0,2,1,0,2,5,38,9,15,TRUE,0.236842105263158,2024,2024-2025
NJ,2024-10-31,intra-ucx,6,11,5,3,3,1,1,0,0,0,13,43,19,30,TRUE,0.441860465116279,2024,2024-2025
NJ,2024-10-31,intra-ui,3283,3165,1711,829,468,256,202,146,86,747,7130,18023,10413,13578,TRUE,0.577761748876436,2024,2024-2025
NJ,2024-11-30,inter-total,132,152,66,39,19,19,5,7,4,8,293,744,425,577,TRUE,0.571236559139785,2024,2024-2025
NJ,2024-11-30,inter-ucfe,0,1,0,0,0,0,0,0,0,0,0,1,0,1,TRUE,0,2024,2024-2025
NJ,2024-11-30,inter-ucx,0,0,0,0,0,0,0,0,0,0,2,2,2,2,TRUE,1,2024,2024-2025
NJ,2024-11-30,inter-ui,132,151,66,39,19,19,5,7,4,8,291,741,423,574,TRUE,0.57085020242915,2024,2024-2025
NJ,2024-11-30,intra-total,4331,2585,1214,579,314,220,124,84,63,533,7258,17305,11589,14174,TRUE,0.669690840797457,2024,2024-2025
NJ,2024-11-30,intra-ucfe,3,24,6,4,2,1,0,0,1,3,7,51,10,34,TRUE,0.196078431372549,2024,2024-2025
NJ,2024-11-30,intra-ucx,7,7,4,2,1,1,0,1,0,1,6,30,13,20,TRUE,0.433333333333333,2024,2024-2025
NJ,2024-11-30,intra-ui,4321,2554,1204,573,311,218,124,83,62,529,7245,17224,11566,14120,TRUE,0.671504876915931,2024,2024-2025
NJ,2024-12-31,inter-total,149,100,52,25,30,9,11,9,6,29,176,596,325,425,TRUE,0.545302013422819,2024,2024-2025
NJ,2024-12-31,inter-ucfe,2,0,0,0,0,0,0,0,0,0,0,2,2,2,TRUE,1,2024,2024-2025
NJ,2024-12-31,inter-ucx,0,0,0,0,0,0,0,0,0,0,0,0,0,0,TRUE,0,2024,2024-2025
NJ,2024-12-31,inter-ui,147,100,52,25,30,9,11,9,6,29,176,594,323,423,TRUE,0.543771043771044,2024,2024-2025
NJ,2024-12-31,intra-total,7870,3068,1328,631,354,233,147,108,73,566,8003,22381,15873,18941,TRUE,0.709217639962468,2024,2024-2025
NJ,2024-12-31,intra-ucfe,3,12,5,1,2,1,0,0,0,2,9,35,12,24,TRUE,0.342857142857143,2024,2024-2025
NJ,2024-12-31,intra-ucx,3,4,3,4,3,0,0,0,2,3,12,34,15,19,TRUE,0.441176470588235,2024,2024-2025
NJ,2024-12-31,intra-ui,7864,3052,1320,626,349,232,147,108,71,561,7982,22312,15846,18898,TRUE,0.710200788813195,2024,2024-2025
NM,2019-01-31,inter-total,85,6,0,2,0,0,0,0,1,0,10,104,95,101,FALSE,0.971153846153846,2018,2018-2019
NM,2019-01-31,inter-ucfe,8,1,0,0,0,0,0,0,0,0,1,10,9,10,FALSE,1,2018,2018-2019
NM,2019-01-31,inter-ucx,0,0,0,0,0,0,0,0,0,0,0,0,0,0,FALSE,0,2018,2018-2019
NM,2019-01-31,inter-ui,77,5,0,2,0,0,0,0,1,0,9,94,86,91,FALSE,0.968085106382979,2018,2018-2019
NM,2019-01-31,intra-total,2543,92,29,13,15,8,4,2,1,6,359,3072,2902,2994,FALSE,0.974609375,2018,2018-2019
NM,2019-01-31,intra-ucfe,318,22,2,1,0,2,0,0,0,0,93,438,411,433,FALSE,0.988584474885845,2018,2018-2019
NM,2019-01-31,intra-ucx,8,1,0,0,0,0,0,0,0,0,1,10,9,10,FALSE,1,2018,2018-2019
NM,2019-01-31,intra-ui,2217,69,27,12,15,6,4,2,1,6,265,2624,2482,2551,FALSE,0.972179878048781,2018,2018-2019
NM,2019-02-28,inter-total,51,2,1,2,0,1,0,0,0,0,9,66,60,62,FALSE,0.939393939393939,2018,2018-2019
NM,2019-02-28,inter-ucfe,2,0,1,0,0,0,0,0,0,0,0,3,2,2,FALSE,0.666666666666667,2018,2018-2019
NM,2019-02-28,inter-ucx,0,0,0,0,0,0,0,0,0,0,0,0,0,0,FALSE,0,2018,2018-2019
NM,2019-02-28,inter-ui,49,2,0,2,0,1,0,0,0,0,9,63,58,60,FALSE,0.952380952380952,2018,2018-2019
NM,2019-02-28,intra-total,1527,75,32,16,6,2,6,5,3,10,194,1876,1721,1796,FALSE,0.957356076759062,2018,2018-2019
NM,2019-02-28,intra-ucfe,19,3,3,1,0,0,0,0,0,1,17,44,36,39,FALSE,0.886363636363636,2018,2018-2019
NM,2019-02-28,intra-ucx,6,0,0,0,0,0,0,0,0,0,1,7,7,7,FALSE,1,2018,2018-2019
NM,2019-02-28,intra-ui,1502,72,29,15,6,2,6,5,3,9,176,1825,1678,1750,FALSE,0.958904109589041,2018,2018-2019
NM,2019-03-31,inter-total,40,4,0,1,0,0,1,1,0,1,6,54,46,50,FALSE,0.925925925925926,2018,2018-2019
NM,2019-03-31,inter-ucfe,1,0,0,0,0,0,0,0,0,0,1,2,2,2,FALSE,1,2018,2018-2019
NM,2019-03-31,inter-ucx,1,0,0,0,0,0,0,0,0,0,0,1,1,1,FALSE,1,2018,2018-2019
NM,2019-03-31,inter-ui,38,4,0,1,0,0,1,1,0,1,5,51,43,47,FALSE,0.92156862745098,2018,2018-2019
NM,2019-03-31,intra-total,1211,31,21,17,13,6,7,5,1,4,126,1442,1337,1368,FALSE,0.948682385575589,2018,2018-2019
NM,2019-03-31,intra-ucfe,13,0,0,1,0,0,2,2,0,1,1,20,14,14,FALSE,0.7,2018,2018-2019
NM,2019-03-31,intra-ucx,9,0,0,0,0,0,0,0,0,0,0,9,9,9,FALSE,1,2018,2018-2019
NM,2019-03-31,intra-ui,1189,31,21,16,13,6,5,3,1,3,125,1413,1314,1345,FALSE,0.951875442321302,2018,2018-2019
NM,2019-04-30,inter-total,41,3,1,0,0,0,0,0,0,0,8,53,49,52,FALSE,0.981132075471698,2018,2018-2019
NM,2019-04-30,inter-ucfe,0,0,0,0,0,0,0,0,0,0,0,0,0,0,FALSE,0,2018,2018-2019
NM,2019-04-30,inter-ucx,0,0,0,0,0,0,0,0,0,0,0,0,0,0,FALSE,0,2018,2018-2019
NM,2019-04-30,inter-ui,41,3,1,0,0,0,0,0,0,0,8,53,49,52,FALSE,0.981132075471698,2018,2018-2019
NM,2019-04-30,intra-total,1228,50,14,13,13,3,4,1,2,5,169,1502,1397,1447,FALSE,0.963382157123835,2018,2018-2019
NM,2019-04-30,intra-ucfe,1,1,0,1,1,0,1,0,0,1,5,11,6,7,FALSE,0.636363636363636,2018,2018-2019
NM,2019-04-30,intra-ucx,9,0,0,1,0,0,0,0,0,0,1,11,10,10,FALSE,0.909090909090909,2018,2018-2019
NM,2019-04-30,intra-ui,1218,49,14,11,12,3,3,1,2,4,163,1480,1381,1430,FALSE,0.966216216216216,2018,2018-2019
NM,2019-05-31,inter-total,37,2,3,1,0,0,1,0,0,0,5,49,42,44,FALSE,0.897959183673469,2018,2018-2019
NM,2019-05-31,inter-ucfe,0,0,1,0,0,0,1,0,0,0,0,2,0,0,FALSE,0,2018,2018-2019
NM,2019-05-31,inter-ucx,0,0,0,0,0,0,0,0,0,0,0,0,0,0,FALSE,0,2018,2018-2019
NM,2019-05-31,inter-ui,37,2,2,1,0,0,0,0,0,0,5,47,42,44,FALSE,0.936170212765957,2018,2018-2019
NM,2019-05-31,intra-total,1036,76,33,12,8,2,4,1,0,8,193,1373,1229,1305,FALSE,0.95047341587764,2018,2018-2019
NM,2019-05-31,intra-ucfe,2,4,0,0,1,1,0,0,0,0,2,10,4,8,FALSE,0.8,2018,2018-2019
NM,2019-05-31,intra-ucx,4,0,0,0,1,0,0,0,0,0,0,5,4,4,FALSE,0.8,2018,2018-2019
NM,2019-05-31,intra-ui,1030,72,33,12,6,1,4,1,0,8,191,1358,1221,1293,FALSE,0.952135493372607,2018,2018-2019
NM,2019-06-30,inter-total,45,3,1,1,0,0,0,0,1,1,6,58,51,54,FALSE,0.931034482758621,2018,2018-2019
NM,2019-06-30,inter-ucfe,0,0,0,0,0,0,0,0,0,0,0,0,0,0,FALSE,0,2018,2018-2019
NM,2019-06-30,inter-ucx,0,0,0,0,0,0,0,0,0,0,0,0,0,0,FALSE,0,2018,2018-2019
NM,2019-06-30,inter-ui,45,3,1,1,0,0,0,0,1,1,6,58,51,54,FALSE,0.931034482758621,2018,2018-2019
NM,2019-06-30,intra-total,1920,64,35,21,15,6,3,2,2,4,218,2290,2138,2202,FALSE,0.961572052401747,2018,2018-2019
NM,2019-06-30,intra-ucfe,16,2,1,1,0,0,0,1,0,0,4,25,20,22,FALSE,0.88,2018,2018-2019
NM,2019-06-30,intra-ucx,6,0,0,0,0,0,0,0,0,0,2,8,8,8,FALSE,1,2018,2018-2019
NM,2019-06-30,intra-ui,1898,62,34,20,15,6,3,1,2,4,212,2257,2110,2172,FALSE,0.962339388568897,2018,2018-2019
NM,2019-07-31,inter-total,51,1,2,0,1,0,0,0,0,0,8,63,59,60,FALSE,0.952380952380952,2019,2019-2020
NM,2019-07-31,inter-ucfe,0,0,0,0,0,0,0,0,0,0,0,0,0,0,FALSE,0,2019,2019-2020
NM,2019-07-31,inter-ucx,0,0,0,0,0,0,0,0,0,0,0,0,0,0,FALSE,0,2019,2019-2020
NM,2019-07-31,inter-ui,51,1,2,0,1,0,0,0,0,0,8,63,59,60,FALSE,0.952380952380952,2019,2019-2020
NM,2019-07-31,intra-total,1336,58,24,22,13,10,6,3,1,6,191,1670,1527,1585,FALSE,0.949101796407186,2019,2019-2020
NM,2019-07-31,intra-ucfe,12,1,2,2,0,0,0,0,0,1,7,25,19,20,FALSE,0.8,2019,2019-2020
NM,2019-07-31,intra-ucx,5,0,1,0,0,0,0,0,0,0,1,7,6,6,FALSE,0.857142857142857,2019,2019-2020
NM,2019-07-31,intra-ui,1319,57,21,20,13,10,6,3,1,5,183,1638,1502,1559,FALSE,0.951770451770452,2019,2019-2020
NM,2019-08-31,inter-total,44,5,1,1,0,0,0,0,0,0,9,60,53,58,FALSE,0.966666666666667,2019,2019-2020
NM,2019-08-31,inter-ucfe,2,0,0,0,0,0,0,0,0,0,0,2,2,2,FALSE,1,2019,2019-2020
NM,2019-08-31,inter-ucx,0,0,0,0,0,0,0,0,0,0,0,0,0,0,FALSE,0,2019,2019-2020
NM,2019-08-31,inter-ui,42,5,1,1,0,0,0,0,0,0,9,58,51,56,FALSE,0.96551724137931,2019,2019-2020
NM,2019-08-31,intra-total,970,69,31,16,5,8,7,6,0,6,208,1326,1178,1247,FALSE,0.940422322775264,2019,2019-2020
NM,2019-08-31,intra-ucfe,7,3,0,2,0,0,0,1,0,1,1,15,8,11,FALSE,0.733333333333333,2019,2019-2020
NM,2019-08-31,intra-ucx,8,0,1,1,0,0,0,1,0,0,0,11,8,8,FALSE,0.727272727272727,2019,2019-2020
NM,2019-08-31,intra-ui,955,66,30,13,5,8,7,4,0,5,207,1300,1162,1228,FALSE,0.944615384615385,2019,2019-2020
NM,2019-09-30,inter-total,38,7,4,1,1,0,0,0,0,0,7,58,45,52,FALSE,0.896551724137931,2019,2019-2020
NM,2019-09-30,inter-ucfe,1,0,0,0,0,0,0,0,0,0,1,2,2,2,FALSE,1,2019,2019-2020
NM,2019-09-30,inter-ucx,0,0,0,0,0,0,0,0,0,0,0,0,0,0,FALSE,0,2019,2019-2020
NM,2019-09-30,inter-ui,37,7,4,1,1,0,0,0,0,0,6,56,43,50,FALSE,0.892857142857143,2019,2019-2020
NM,2019-09-30,intra-total,984,63,39,15,20,4,1,5,2,8,238,1379,1222,1285,FALSE,0.93183466279913,2019,2019-2020
NM,2019-09-30,intra-ucfe,6,3,1,1,0,0,0,0,0,1,0,12,6,9,FALSE,0.75,2019,2019-2020
NM,2019-09-30,intra-ucx,1,0,0,0,1,0,0,0,0,0,0,2,1,1,FALSE,0.5,2019,2019-2020
NM,2019-09-30,intra-ui,977,60,38,14,19,4,1,5,2,7,238,1365,1215,1275,FALSE,0.934065934065934,2019,2019-2020
NM,2019-10-31,inter-total,49,5,6,0,2,0,1,0,0,0,8,71,57,62,FALSE,0.873239436619718,2019,2019-2020
NM,2019-10-31,inter-ucfe,9,2,0,0,0,0,0,0,0,0,0,11,9,11,FALSE,1,2019,2019-2020
NM,2019-10-31,inter-ucx,0,1,0,0,0,0,0,0,0,0,0,1,0,1,FALSE,1,2019,2019-2020
NM,2019-10-31,inter-ui,40,2,6,0,2,0,1,0,0,0,8,59,48,50,FALSE,0.847457627118644,2019,2019-2020
NM,2019-10-31,intra-total,1045,88,37,13,12,13,5,6,3,12,222,1456,1267,1355,FALSE,0.930631868131868,2019,2019-2020
NM,2019-10-31,intra-ucfe,51,0,0,1,0,0,0,0,0,0,7,59,58,58,FALSE,0.983050847457627,2019,2019-2020
NM,2019-10-31,intra-ucx,9,1,0,1,0,0,0,0,0,0,0,11,9,10,FALSE,0.909090909090909,2019,2019-2020
NM,2019-10-31,intra-ui,985,87,37,11,12,13,5,6,3,12,215,1386,1200,1287,FALSE,0.928571428571429,2019,2019-2020
NM,2019-11-30,inter-total,59,7,2,1,2,1,0,0,1,0,8,81,67,74,FALSE,0.91358024691358,2019,2019-2020
NM,2019-11-30,inter-ucfe,4,2,0,0,0,1,0,0,0,0,1,8,5,7,FALSE,0.875,2019,2019-2020
NM,2019-11-30,inter-ucx,0,0,0,0,0,0,0,0,0,0,0,0,0,0,FALSE,0,2019,2019-2020
NM,2019-11-30,inter-ui,55,5,2,1,2,0,0,0,1,0,7,73,62,67,FALSE,0.917808219178082,2019,2019-2020
NM,2019-11-30,intra-total,1319,127,76,38,18,6,4,1,1,6,237,1833,1556,1683,FALSE,0.918166939443535,2019,2019-2020
NM,2019-11-30,intra-ucfe,48,3,3,0,2,1,0,0,0,1,9,67,57,60,FALSE,0.895522388059702,2019,2019-2020
NM,2019-11-30,intra-ucx,8,0,0,1,0,0,0,0,0,0,0,9,8,8,FALSE,0.888888888888889,2019,2019-2020
NM,2019-11-30,intra-ui,1263,124,73,37,16,5,4,1,1,5,228,1757,1491,1615,FALSE,0.919180421172453,2019,2019-2020
NM,2019-12-31,inter-total,69,2,6,3,2,1,3,1,1,1,18,107,87,89,FALSE,0.831775700934579,2019,2019-2020
NM,2019-12-31,inter-ucfe,5,0,0,0,0,1,0,0,0,0,4,10,9,9,FALSE,0.9,2019,2019-2020
NM,2019-12-31,inter-ucx,1,0,0,0,0,0,0,0,0,0,0,1,1,1,FALSE,1,2019,2019-2020
NM,2019-12-31,inter-ui,63,2,6,3,2,0,3,1,1,1,14,96,77,79,FALSE,0.822916666666667,2019,2019-2020
NM,2019-12-31,intra-total,1499,115,70,74,35,19,9,4,3,11,280,2119,1779,1894,FALSE,0.893817838603115,2019,2019-2020
NM,2019-12-31,intra-ucfe,47,3,2,1,0,0,1,1,0,0,19,74,66,69,FALSE,0.932432432432432,2019,2019-2020
NM,2019-12-31,intra-ucx,7,1,0,0,0,0,0,0,0,0,1,9,8,9,FALSE,1,2019,2019-2020
NM,2019-12-31,intra-ui,1445,111,68,73,35,19,8,3,3,11,260,2036,1705,1816,FALSE,0.891944990176817,2019,2019-2020
NM,2020-01-31,inter-total,69,3,3,1,0,1,0,0,0,0,12,89,81,84,FALSE,0.943820224719101,2019,2019-2020
NM,2020-01-31,inter-ucfe,6,1,0,0,0,0,0,0,0,0,2,9,8,9,FALSE,1,2019,2019-2020
NM,2020-01-31,inter-ucx,0,0,0,0,0,0,0,0,0,0,0,0,0,0,FALSE,0,2019,2019-2020
NM,2020-01-31,inter-ui,63,2,3,1,0,1,0,0,0,0,10,80,73,75,FALSE,0.9375,2019,2019-2020
NM,2020-01-31,intra-total,1717,100,53,50,27,11,10,6,6,17,283,2280,2000,2100,FALSE,0.921052631578947,2019,2019-2020
NM,2020-01-31,intra-ucfe,45,3,0,1,1,0,0,0,0,0,10,60,55,58,FALSE,0.966666666666667,2019,2019-2020
NM,2020-01-31,intra-ucx,4,1,0,1,0,0,0,0,0,0,2,8,6,7,FALSE,0.875,2019,2019-2020
NM,2020-01-31,intra-ui,1668,96,53,48,26,11,10,6,6,17,271,2212,1939,2035,FALSE,0.91998191681736,2019,2019-2020
NM,2020-02-29,inter-total,51,8,1,1,2,0,0,2,1,0,8,74,59,67,FALSE,0.905405405405405,2019,2019-2020
NM,2020-02-29,inter-ucfe,0,1,0,0,0,0,0,0,0,0,2,3,2,3,FALSE,1,2019,2019-2020
NM,2020-02-29,inter-ucx,0,0,0,0,0,0,0,0,0,0,0,0,0,0,FALSE,0,2019,2019-2020
NM,2020-02-29,inter-ui,51,7,1,1,2,0,0,2,1,0,6,71,57,64,FALSE,0.901408450704225,2019,2019-2020
NM,2020-02-29,intra-total,1088,164,89,41,20,11,4,5,1,8,273,1704,1361,1525,FALSE,0.894953051643192,2019,2019-2020
NM,2020-02-29,intra-ucfe,10,1,2,0,0,0,0,0,0,0,2,15,12,13,FALSE,0.866666666666667,2019,2019-2020
NM,2020-02-29,intra-ucx,3,2,0,0,0,0,0,0,0,0,1,6,4,6,FALSE,1,2019,2019-2020
NM,2020-02-29,intra-ui,1075,161,87,41,20,11,4,5,1,8,270,1683,1345,1506,FALSE,0.894830659536542,2019,2019-2020
NM,2020-03-31,inter-total,106,4,2,1,1,1,2,0,0,1,15,133,121,125,FALSE,0.93984962406015,2019,2019-2020
NM,2020-03-31,inter-ucfe,0,0,0,0,0,0,0,0,0,0,1,1,1,1,FALSE,1,2019,2019-2020
NM,2020-03-31,inter-ucx,0,0,0,0,0,0,0,0,0,0,0,0,0,0,FALSE,0,2019,2019-2020
NM,2020-03-31,inter-ui,106,4,2,1,1,1,2,0,0,1,14,132,120,124,FALSE,0.939393939393939,2019,2019-2020
NM,2020-03-31,intra-total,6984,130,76,54,61,24,26,11,2,11,425,7804,7409,7539,FALSE,0.96604305484367,2019,2019-2020
NM,2020-03-31,intra-ucfe,4,0,0,0,2,0,0,0,0,0,1,7,5,5,FALSE,0.714285714285714,2019,2019-2020
NM,2020-03-31,intra-ucx,5,0,1,0,0,0,1,0,0,1,0,8,5,5,FALSE,0.625,2019,2019-2020
NM,2020-03-31,intra-ui,6975,130,75,54,59,24,25,11,2,10,424,7789,7399,7529,FALSE,0.96661959173193,2019,2019-2020
NM,2020-04-30,inter-total,110,4,2,1,1,1,1,0,0,1,16,137,126,130,FALSE,0.948905109489051,2019,2019-2020
NM,2020-04-30,inter-ucfe,0,0,0,0,0,0,0,0,0,0,1,1,1,1,FALSE,1,2019,2019-2020
NM,2020-04-30,inter-ucx,0,0,0,0,0,0,0,0,0,0,0,0,0,0,FALSE,0,2019,2019-2020
NM,2020-04-30,inter-ui,110,4,2,1,1,1,1,0,0,1,15,136,125,129,FALSE,0.948529411764706,2019,2019-2020
NM,2020-04-30,intra-total,6980,130,76,54,61,24,27,11,2,11,424,7800,7404,7534,FALSE,0.965897435897436,2019,2019-2020
NM,2020-04-30,intra-ucfe,4,0,0,0,2,0,0,0,0,0,1,7,5,5,FALSE,0.714285714285714,2019,2019-2020
NM,2020-04-30,intra-ucx,5,0,1,0,0,0,1,0,0,1,0,8,5,5,FALSE,0.625,2019,2019-2020
NM,2020-04-30,intra-ui,6971,130,75,54,59,24,26,11,2,10,423,7785,7394,7524,FALSE,0.966473988439306,2019,2019-2020
NM,2020-05-31,inter-total,626,58,42,49,42,37,17,10,4,1,141,1027,767,825,FALSE,0.803310613437196,2019,2019-2020
NM,2020-05-31,inter-ucfe,0,0,0,1,1,0,0,0,0,0,0,2,0,0,FALSE,0,2019,2019-2020
NM,2020-05-31,inter-ucx,0,1,0,0,0,0,0,0,0,0,0,1,0,1,FALSE,1,2019,2019-2020
NM,2020-05-31,inter-ui,626,57,42,48,41,37,17,10,4,1,141,1024,767,824,FALSE,0.8046875,2019,2019-2020
NM,2020-05-31,intra-total,13237,2371,1374,1489,1389,1079,590,247,84,46,3906,25812,17143,19514,FALSE,0.756004958933829,2019,2019-2020
NM,2020-05-31,intra-ucfe,4,2,5,3,4,4,2,0,1,1,8,34,12,14,FALSE,0.411764705882353,2019,2019-2020
NM,2020-05-31,intra-ucx,2,3,4,0,1,2,2,0,0,0,4,18,6,9,FALSE,0.5,2019,2019-2020
NM,2020-05-31,intra-ui,13231,2366,1365,1486,1384,1073,586,247,83,45,3894,25760,17125,19491,FALSE,0.756638198757764,2019,2019-2020
NM,2020-06-30,inter-total,186,77,36,22,27,22,22,19,13,28,86,538,272,349,FALSE,0.648698884758364,2019,2019-2020
NM,2020-06-30,inter-ucfe,0,0,0,1,0,0,0,1,1,0,1,4,1,1,FALSE,0.25,2019,2019-2020
NM,2020-06-30,inter-ucx,0,0,0,0,0,0,0,0,0,0,0,0,0,0,FALSE,0,2019,2019-2020
NM,2020-06-30,inter-ui,186,77,36,21,27,22,22,18,12,28,85,534,271,348,FALSE,0.651685393258427,2019,2019-2020
NM,2020-06-30,intra-total,5381,1620,693,489,456,495,573,507,407,693,2114,13428,7495,9115,FALSE,0.678805481084302,2019,2019-2020
NM,2020-06-30,intra-ucfe,11,11,4,5,3,3,2,1,0,3,15,58,26,37,FALSE,0.637931034482759,2019,2019-2020
NM,2020-06-30,intra-ucx,3,7,2,3,2,0,2,0,1,0,5,25,8,15,FALSE,0.6,2019,2019-2020
NM,2020-06-30,intra-ui,5367,1602,687,481,451,492,569,506,406,690,2094,13345,7461,9063,FALSE,0.679130760584489,2019,2019-2020
NM,2020-07-31,inter-total,98,32,30,25,20,9,11,8,5,36,54,328,152,184,FALSE,0.560975609756098,2020,2020-2021
NM,2020-07-31,inter-ucfe,0,0,0,0,0,0,0,0,0,1,1,2,1,1,FALSE,0.5,2020,2020-2021
NM,2020-07-31,inter-ucx,0,0,0,0,0,0,0,0,0,0,0,0,0,0,FALSE,0,2020,2020-2021
NM,2020-07-31,inter-ui,98,32,30,25,20,9,11,8,5,35,53,326,151,183,FALSE,0.561349693251534,2020,2020-2021
NM,2020-07-31,intra-total,4907,669,464,289,230,167,166,180,167,1098,1048,9385,5955,6624,FALSE,0.705807139051678,2020,2020-2021
NM,2020-07-31,intra-ucfe,16,4,7,6,7,1,0,2,0,1,10,54,26,30,FALSE,0.555555555555556,2020,2020-2021
NM,2020-07-31,intra-ucx,6,2,3,1,1,1,0,2,0,4,7,27,13,15,FALSE,0.555555555555556,2020,2020-2021
NM,2020-07-31,intra-ui,4885,663,454,282,222,165,166,176,167,1093,1031,9304,5916,6579,FALSE,0.707115219260533,2020,2020-2021
NM,2020-08-31,inter-total,82,17,11,17,16,15,13,8,11,32,26,248,108,125,FALSE,0.504032258064516,2020,2020-2021
NM,2020-08-31,inter-ucfe,0,0,0,0,0,0,0,0,1,0,1,2,1,1,FALSE,0.5,2020,2020-2021
NM,2020-08-31,inter-ucx,0,0,0,0,0,0,0,0,0,0,0,0,0,0,FALSE,0,2020,2020-2021
NM,2020-08-31,inter-ui,82,17,11,17,16,15,13,8,10,32,25,246,107,124,FALSE,0.504065040650406,2020,2020-2021
NM,2020-08-31,intra-total,3550,541,517,437,386,275,238,168,83,522,956,7673,4506,5047,FALSE,0.65776098005995,2020,2020-2021
NM,2020-08-31,intra-ucfe,27,17,9,2,2,3,0,0,3,10,68,141,95,112,FALSE,0.794326241134752,2020,2020-2021
NM,2020-08-31,intra-ucx,6,0,4,1,0,1,1,0,0,1,3,17,9,9,FALSE,0.529411764705882,2020,2020-2021
NM,2020-08-31,intra-ui,3517,524,504,434,384,271,237,168,80,511,885,7515,4402,4926,FALSE,0.655489021956088,2020,2020-2021
NM,2020-09-30,inter-total,58,20,18,15,13,13,14,10,7,48,25,241,83,103,FALSE,0.427385892116183,2020,2020-2021
NM,2020-09-30,inter-ucfe,0,0,0,0,0,0,0,0,0,0,0,0,0,0,FALSE,0,2020,2020-2021
NM,2020-09-30,inter-ucx,0,0,0,0,1,0,0,0,0,0,0,1,0,0,FALSE,0,2020,2020-2021
NM,2020-09-30,inter-ui,58,20,18,15,12,13,14,10,7,48,25,240,83,103,FALSE,0.429166666666667,2020,2020-2021
NM,2020-09-30,intra-total,1730,245,311,261,213,241,194,107,82,474,478,4336,2208,2453,FALSE,0.565728782287823,2020,2020-2021
NM,2020-09-30,intra-ucfe,6,5,10,7,10,9,5,1,0,14,12,79,18,23,FALSE,0.291139240506329,2020,2020-2021
NM,2020-09-30,intra-ucx,4,1,1,1,0,0,0,0,0,0,3,10,7,8,FALSE,0.8,2020,2020-2021
NM,2020-09-30,intra-ui,1720,239,300,253,203,232,189,106,82,460,463,4247,2183,2422,FALSE,0.570284906993172,2020,2020-2021
NM,2020-10-31,inter-total,46,7,11,5,7,5,7,5,6,37,16,152,62,69,FALSE,0.453947368421053,2020,2020-2021
NM,2020-10-31,inter-ucfe,1,0,0,0,0,0,1,0,1,0,0,3,1,1,FALSE,0.333333333333333,2020,2020-2021
NM,2020-10-31,inter-ucx,0,0,0,0,0,0,0,0,0,0,0,0,0,0,FALSE,0,2020,2020-2021
NM,2020-10-31,inter-ui,45,7,11,5,7,5,6,5,5,37,16,149,61,68,FALSE,0.456375838926175,2020,2020-2021
NM,2020-10-31,intra-total,1841,237,162,147,149,152,140,112,97,580,362,3979,2203,2440,FALSE,0.613219401859764,2020,2020-2021
NM,2020-10-31,intra-ucfe,12,1,7,3,1,2,3,0,1,7,9,46,21,22,FALSE,0.478260869565217,2020,2020-2021
NM,2020-10-31,intra-ucx,12,2,1,0,0,0,0,0,0,2,3,20,15,17,FALSE,0.85,2020,2020-2021
NM,2020-10-31,intra-ui,1817,234,154,144,148,150,137,112,96,571,350,3913,2167,2401,FALSE,0.613595706618963,2020,2020-2021
NM,2020-11-30,inter-total,40,8,10,5,8,6,4,8,6,45,13,153,53,61,FALSE,0.398692810457516,2020,2020-2021
NM,2020-11-30,inter-ucfe,2,2,2,0,0,2,0,1,0,0,0,9,2,4,FALSE,0.444444444444444,2020,2020-2021
NM,2020-11-30,inter-ucx,0,0,0,0,0,0,0,0,0,0,0,0,0,0,FALSE,0,2020,2020-2021
NM,2020-11-30,inter-ui,38,6,8,5,8,4,4,7,6,45,13,144,51,57,FALSE,0.395833333333333,2020,2020-2021
NM,2020-11-30,intra-total,2504,280,150,146,127,103,65,66,44,560,734,4779,3238,3518,FALSE,0.736137267210714,2020,2020-2021
NM,2020-11-30,intra-ucfe,13,13,7,4,8,7,1,1,2,7,20,83,33,46,FALSE,0.55421686746988,2020,2020-2021
NM,2020-11-30,intra-ucx,6,3,1,0,0,1,0,1,0,0,3,15,9,12,FALSE,0.8,2020,2020-2021
NM,2020-11-30,intra-ui,2485,264,142,142,119,95,64,64,42,553,711,4681,3196,3460,FALSE,0.739158299508652,2020,2020-2021
NM,2020-12-31,inter-total,35,4,5,1,3,5,4,6,4,55,11,133,46,50,FALSE,0.37593984962406,2020,2020-2021
NM,2020-12-31,inter-ucfe,1,0,1,1,0,0,1,0,1,1,0,6,1,1,FALSE,0.166666666666667,2020,2020-2021
NM,2020-12-31,inter-ucx,0,0,0,0,1,0,0,0,0,0,0,1,0,0,FALSE,0,2020,2020-2021
NM,2020-12-31,inter-ui,34,4,4,0,2,5,3,6,3,54,11,126,45,49,FALSE,0.388888888888889,2020,2020-2021
NM,2020-12-31,intra-total,3003,329,252,206,176,121,114,86,56,988,1526,6857,4529,4858,FALSE,0.708473093189441,2020,2020-2021
NM,2020-12-31,intra-ucfe,19,24,3,4,4,1,6,3,5,6,31,106,50,74,FALSE,0.69811320754717,2020,2020-2021
NM,2020-12-31,intra-ucx,4,3,0,1,0,0,1,0,0,1,0,10,4,7,FALSE,0.7,2020,2020-2021
NM,2020-12-31,intra-ui,2980,302,249,201,172,120,107,83,51,981,1495,6741,4475,4777,FALSE,0.708648568461653,2020,2020-2021
NM,2021-01-31,inter-total,38,6,6,10,7,3,7,0,3,37,14,131,52,58,FALSE,0.442748091603053,2020,2020-2021
NM,2021-01-31,inter-ucfe,0,0,0,1,1,1,1,0,0,1,2,7,2,2,FALSE,0.285714285714286,2020,2020-2021
NM,2021-01-31,inter-ucx,0,0,0,0,0,0,0,0,0,0,0,0,0,0,FALSE,0,2020,2020-2021
NM,2021-01-31,inter-ui,38,6,6,9,6,2,6,0,3,36,12,124,50,56,FALSE,0.451612903225806,2020,2020-2021
NM,2021-01-31,intra-total,2012,225,151,126,180,200,181,147,96,560,722,4600,2734,2959,FALSE,0.643260869565217,2020,2020-2021
NM,2021-01-31,intra-ucfe,31,13,7,2,7,6,3,5,2,18,35,129,66,79,FALSE,0.612403100775194,2020,2020-2021
NM,2021-01-31,intra-ucx,6,2,0,0,0,2,0,0,0,0,3,13,9,11,FALSE,0.846153846153846,2020,2020-2021
NM,2021-01-31,intra-ui,1975,210,144,124,173,192,178,142,94,542,684,4458,2659,2869,FALSE,0.643562135486765,2020,2020-2021
NM,2021-02-28,inter-total,37,7,3,5,4,6,6,6,4,44,10,132,47,54,FALSE,0.409090909090909,2020,2020-2021
NM,2021-02-28,inter-ucfe,0,0,0,0,0,0,0,1,0,1,0,2,0,0,FALSE,0,2020,2020-2021
NM,2021-02-28,inter-ucx,0,0,0,0,0,0,0,0,0,0,0,0,0,0,FALSE,0,2020,2020-2021
NM,2021-02-28,inter-ui,37,7,3,5,4,6,6,5,4,43,10,130,47,54,FALSE,0.415384615384615,2020,2020-2021
NM,2021-02-28,intra-total,1441,214,160,148,155,136,103,97,94,628,412,3588,1853,2067,FALSE,0.576086956521739,2020,2020-2021
NM,2021-02-28,intra-ucfe,9,2,3,8,3,0,3,0,2,16,10,56,19,21,FALSE,0.375,2020,2020-2021
NM,2021-02-28,intra-ucx,7,0,0,0,0,0,0,0,0,3,3,13,10,10,FALSE,0.769230769230769,2020,2020-2021
NM,2021-02-28,intra-ui,1425,212,157,140,152,136,100,97,92,609,399,3519,1824,2036,FALSE,0.578573458368855,2020,2020-2021
NM,2021-03-31,inter-total,25,8,7,10,6,12,7,8,9,83,11,186,36,44,FALSE,0.236559139784946,2020,2020-2021
NM,2021-03-31,inter-ucfe,0,0,0,0,0,0,0,0,0,2,0,2,0,0,FALSE,0,2020,2020-2021
NM,2021-03-31,inter-ucx,0,0,0,0,0,0,0,0,0,0,0,0,0,0,FALSE,0,2020,2020-2021
NM,2021-03-31,inter-ui,25,8,7,10,6,12,7,8,9,81,11,184,36,44,FALSE,0.239130434782609,2020,2020-2021
NM,2021-03-31,intra-total,1628,258,247,154,150,123,134,108,104,737,407,4050,2035,2293,FALSE,0.566172839506173,2020,2020-2021
NM,2021-03-31,intra-ucfe,5,1,2,0,4,3,2,4,2,18,5,46,10,11,FALSE,0.239130434782609,2020,2020-2021
NM,2021-03-31,intra-ucx,4,1,1,1,1,0,0,0,0,6,0,14,4,5,FALSE,0.357142857142857,2020,2020-2021
NM,2021-03-31,intra-ui,1619,256,244,153,145,120,132,104,102,713,402,3990,2021,2277,FALSE,0.570676691729323,2020,2020-2021
NM,2021-04-30,inter-total,36,3,13,3,8,8,8,7,6,77,24,193,60,63,FALSE,0.326424870466321,2020,2020-2021
NM,2021-04-30,inter-ucfe,0,0,0,0,1,0,0,0,0,0,0,1,0,0,FALSE,0,2020,2020-2021
NM,2021-04-30,inter-ucx,0,0,0,0,0,0,0,0,0,0,0,0,0,0,FALSE,0,2020,2020-2021
NM,2021-04-30,inter-ui,36,3,13,3,7,8,8,7,6,77,24,192,60,63,FALSE,0.328125,2020,2020-2021
NM,2021-04-30,intra-total,4224,314,195,149,106,101,64,58,67,1368,1255,7901,5479,5793,FALSE,0.733198329325402,2020,2020-2021
NM,2021-04-30,intra-ucfe,2,1,1,0,1,1,0,0,0,21,4,31,6,7,FALSE,0.225806451612903,2020,2020-2021
NM,2021-04-30,intra-ucx,2,1,0,1,0,0,0,0,0,2,3,9,5,6,FALSE,0.666666666666667,2020,2020-2021
NM,2021-04-30,intra-ui,4220,312,194,148,105,100,64,58,67,1345,1248,7861,5468,5780,FALSE,0.735275410253149,2020,2020-2021
NM,2021-05-31,inter-total,46,12,4,4,5,4,0,1,4,43,17,140,63,75,FALSE,0.535714285714286,2020,2020-2021
NM,2021-05-31,inter-ucfe,0,1,0,0,0,0,0,0,0,1,0,2,0,1,FALSE,0.5,2020,2020-2021
NM,2021-05-31,inter-ucx,0,0,0,0,0,0,0,0,0,0,0,0,0,0,FALSE,0,2020,2020-2021
NM,2021-05-31,inter-ui,46,11,4,4,5,4,0,1,4,42,17,138,63,74,FALSE,0.536231884057971,2020,2020-2021
NM,2021-05-31,intra-total,2132,180,191,162,165,108,91,53,36,430,627,4175,2759,2939,FALSE,0.703952095808383,2020,2020-2021
NM,2021-05-31,intra-ucfe,2,0,0,0,0,1,0,0,0,5,5,13,7,7,FALSE,0.538461538461538,2020,2020-2021
NM,2021-05-31,intra-ucx,7,2,0,0,0,0,0,0,0,0,2,11,9,11,FALSE,1,2020,2020-2021
NM,2021-05-31,intra-ui,2123,178,191,162,165,107,91,53,36,425,620,4151,2743,2921,FALSE,0.703685858829198,2020,2020-2021
NM,2021-06-30,inter-total,38,10,5,6,4,3,1,3,4,27,14,115,52,62,FALSE,0.539130434782609,2020,2020-2021
NM,2021-06-30,inter-ucfe,0,0,0,0,0,0,0,0,0,0,0,0,0,0,FALSE,0,2020,2020-2021
NM,2021-06-30,inter-ucx,0,0,0,0,0,0,0,0,0,0,0,0,0,0,FALSE,0,2020,2020-2021
NM,2021-06-30,inter-ui,38,10,5,6,4,3,1,3,4,27,14,115,52,62,FALSE,0.539130434782609,2020,2020-2021
NM,2021-06-30,intra-total,1179,134,101,109,112,86,75,77,59,351,426,2709,1605,1739,FALSE,0.641934293097084,2020,2020-2021
NM,2021-06-30,intra-ucfe,4,3,2,0,1,0,0,0,0,8,3,21,7,10,FALSE,0.476190476190476,2020,2020-2021
NM,2021-06-30,intra-ucx,2,3,0,0,0,0,0,0,0,3,3,11,5,8,FALSE,0.727272727272727,2020,2020-2021
NM,2021-06-30,intra-ui,1173,128,99,109,111,86,75,77,59,340,420,2677,1593,1721,FALSE,0.642883825177438,2020,2020-2021
NM,2021-07-31,inter-total,41,4,4,2,5,4,3,4,2,21,16,106,57,61,FALSE,0.575471698113208,2021,2021-2022
NM,2021-07-31,inter-ucfe,1,0,0,0,0,0,0,0,0,0,0,1,1,1,FALSE,1,2021,2021-2022
NM,2021-07-31,inter-ucx,0,0,0,0,0,0,0,0,0,0,0,0,0,0,FALSE,0,2021,2021-2022
NM,2021-07-31,inter-ui,40,4,4,2,5,4,3,4,2,21,16,105,56,60,FALSE,0.571428571428571,2021,2021-2022
NM,2021-07-31,intra-total,1254,115,84,78,88,82,81,66,61,438,466,2813,1720,1835,FALSE,0.652328474937789,2021,2021-2022
NM,2021-07-31,intra-ucfe,10,3,0,0,0,1,1,1,1,10,8,35,18,21,FALSE,0.6,2021,2021-2022
NM,2021-07-31,intra-ucx,4,1,1,0,0,0,1,0,0,1,1,9,5,6,FALSE,0.666666666666667,2021,2021-2022
NM,2021-07-31,intra-ui,1240,111,83,78,88,81,79,65,60,427,457,2769,1697,1808,FALSE,0.652943300830625,2021,2021-2022
NM,2021-08-31,inter-total,21,9,9,7,8,2,4,3,1,22,15,101,36,45,FALSE,0.445544554455446,2021,2021-2022
NM,2021-08-31,inter-ucfe,0,0,0,0,0,1,0,0,0,0,0,1,0,0,FALSE,0,2021,2021-2022
NM,2021-08-31,inter-ucx,0,0,0,0,0,0,0,0,0,0,0,0,0,0,FALSE,0,2021,2021-2022
NM,2021-08-31,inter-ui,21,9,9,7,8,1,4,3,1,22,15,100,36,45,FALSE,0.45,2021,2021-2022
NM,2021-08-31,intra-total,829,120,129,99,94,102,79,61,85,540,362,2500,1191,1311,FALSE,0.5244,2021,2021-2022
NM,2021-08-31,intra-ucfe,3,5,1,0,0,1,1,0,1,6,2,20,5,10,FALSE,0.5,2021,2021-2022
NM,2021-08-31,intra-ucx,3,0,1,0,0,0,0,1,0,2,2,9,5,5,FALSE,0.555555555555556,2021,2021-2022
NM,2021-08-31,intra-ui,823,115,127,99,94,101,78,60,84,532,358,2471,1181,1296,FALSE,0.524484014569,2021,2021-2022
NM,2021-09-30,inter-total,31,1,2,3,3,5,8,0,2,19,5,79,36,37,FALSE,0.468354430379747,2021,2021-2022
NM,2021-09-30,inter-ucfe,0,0,0,0,0,0,0,0,0,0,0,0,0,0,FALSE,0,2021,2021-2022
NM,2021-09-30,inter-ucx,0,0,0,0,0,0,0,0,0,0,0,0,0,0,FALSE,0,2021,2021-2022
NM,2021-09-30,inter-ui,31,1,2,3,3,5,8,0,2,19,5,79,36,37,FALSE,0.468354430379747,2021,2021-2022
NM,2021-09-30,intra-total,1898,52,31,40,53,55,44,49,55,386,157,2820,2055,2107,FALSE,0.747163120567376,2021,2021-2022
NM,2021-09-30,intra-ucfe,7,2,0,0,0,0,0,0,1,3,0,13,7,9,FALSE,0.692307692307692,2021,2021-2022
NM,2021-09-30,intra-ucx,2,2,0,0,0,0,0,0,0,0,1,5,3,5,FALSE,1,2021,2021-2022
NM,2021-09-30,intra-ui,1889,48,31,40,53,55,44,49,54,383,156,2802,2045,2093,FALSE,0.746966452533904,2021,2021-2022
NM,2021-10-31,inter-total,27,6,1,1,3,0,1,1,1,23,7,71,34,40,FALSE,0.563380281690141,2021,2021-2022
NM,2021-10-31,inter-ucfe,0,0,0,0,0,0,0,0,0,1,1,2,1,1,FALSE,0.5,2021,2021-2022
NM,2021-10-31,inter-ucx,0,0,0,0,0,0,0,0,0,0,0,0,0,0,FALSE,0,2021,2021-2022
NM,2021-10-31,inter-ui,27,6,1,1,3,0,1,1,1,22,6,69,33,39,FALSE,0.565217391304348,2021,2021-2022
NM,2021-10-31,intra-total,809,85,67,60,55,50,68,52,48,665,145,2104,954,1039,FALSE,0.493821292775665,2021,2021-2022
NM,2021-10-31,intra-ucfe,19,4,2,0,0,0,1,0,0,5,8,39,27,31,FALSE,0.794871794871795,2021,2021-2022
NM,2021-10-31,intra-ucx,4,2,0,1,1,0,0,0,0,1,0,9,4,6,FALSE,0.666666666666667,2021,2021-2022
NM,2021-10-31,intra-ui,786,79,65,59,54,50,67,52,48,659,137,2056,923,1002,FALSE,0.487354085603113,2021,2021-2022
NM,2021-11-30,inter-total,60,3,1,1,0,3,1,1,0,28,14,112,74,77,FALSE,0.6875,2021,2021-2022
NM,2021-11-30,inter-ucfe,3,1,0,0,0,0,0,0,0,0,1,5,4,5,FALSE,1,2021,2021-2022
NM,2021-11-30,inter-ucx,0,0,0,0,0,0,0,0,0,0,0,0,0,0,FALSE,0,2021,2021-2022
NM,2021-11-30,inter-ui,57,2,1,1,0,3,1,1,0,28,13,107,70,72,FALSE,0.672897196261682,2021,2021-2022
NM,2021-11-30,intra-total,832,83,65,60,44,47,35,34,31,615,119,1965,951,1034,FALSE,0.526208651399491,2021,2021-2022
NM,2021-11-30,intra-ucfe,29,5,2,2,1,4,0,0,0,12,12,67,41,46,FALSE,0.686567164179104,2021,2021-2022
NM,2021-11-30,intra-ucx,1,1,0,0,0,0,0,0,0,1,0,3,1,2,FALSE,0.666666666666667,2021,2021-2022
NM,2021-11-30,intra-ui,802,77,63,58,43,43,35,34,31,602,107,1895,909,986,FALSE,0.520316622691293,2021,2021-2022
NM,2021-12-31,inter-total,58,2,5,3,4,3,1,1,0,21,9,107,67,69,FALSE,0.644859813084112,2021,2021-2022
NM,2021-12-31,inter-ucfe,4,0,0,0,0,0,0,0,0,0,0,4,4,4,FALSE,1,2021,2021-2022
NM,2021-12-31,inter-ucx,0,0,0,0,0,0,0,0,0,0,0,0,0,0,FALSE,0,2021,2021-2022
NM,2021-12-31,inter-ui,54,2,5,3,4,3,1,1,0,21,9,103,63,65,FALSE,0.631067961165049,2021,2021-2022
NM,2021-12-31,intra-total,918,109,75,90,55,52,32,27,18,706,104,2186,1022,1131,FALSE,0.517383348581885,2021,2021-2022
NM,2021-12-31,intra-ucfe,29,8,1,5,1,2,3,0,0,6,11,66,40,48,FALSE,0.727272727272727,2021,2021-2022
NM,2021-12-31,intra-ucx,4,1,1,0,0,0,0,0,0,0,1,7,5,6,FALSE,0.857142857142857,2021,2021-2022
NM,2021-12-31,intra-ui,885,100,73,85,54,50,29,27,18,700,92,2113,977,1077,FALSE,0.50970184571699,2021,2021-2022
NM,2022-01-31,inter-total,48,5,3,1,5,1,1,1,0,41,13,119,61,66,FALSE,0.554621848739496,2021,2021-2022
NM,2022-01-31,inter-ucfe,4,0,0,0,0,0,0,0,0,1,1,6,5,5,FALSE,0.833333333333333,2021,2021-2022
NM,2022-01-31,inter-ucx,0,0,0,0,0,0,0,0,0,0,0,0,0,0,FALSE,0,2021,2021-2022
NM,2022-01-31,inter-ui,44,5,3,1,5,1,1,1,0,40,12,113,56,61,FALSE,0.539823008849558,2021,2021-2022
NM,2022-01-31,intra-total,1167,86,100,69,68,54,35,29,14,549,173,2344,1340,1426,FALSE,0.608361774744027,2021,2021-2022
NM,2022-01-31,intra-ucfe,18,2,6,3,0,1,1,0,0,7,12,50,30,32,FALSE,0.64,2021,2021-2022
NM,2022-01-31,intra-ucx,1,0,0,0,0,0,0,0,0,0,1,2,2,2,FALSE,1,2021,2021-2022
NM,2022-01-31,intra-ui,1148,84,94,66,68,53,34,29,14,542,160,2292,1308,1392,FALSE,0.607329842931937,2021,2021-2022
NM,2022-02-28,inter-total,43,7,8,2,2,4,4,4,0,64,15,153,58,65,FALSE,0.42483660130719,2021,2021-2022
NM,2022-02-28,inter-ucfe,0,0,0,0,0,1,0,0,0,1,0,2,0,0,FALSE,0,2021,2021-2022
NM,2022-02-28,inter-ucx,0,0,0,0,0,0,0,0,0,0,0,0,0,0,FALSE,0,2021,2021-2022
NM,2022-02-28,inter-ui,43,7,8,2,2,3,4,4,0,63,15,151,58,65,FALSE,0.43046357615894,2021,2021-2022
NM,2022-02-28,intra-total,920,124,137,105,69,54,41,52,27,1544,181,3254,1101,1225,FALSE,0.376459741856177,2021,2021-2022
NM,2022-02-28,intra-ucfe,12,5,3,4,2,1,0,0,0,14,3,44,15,20,FALSE,0.454545454545455,2021,2021-2022
NM,2022-02-28,intra-ucx,3,0,1,0,0,0,1,0,0,1,0,6,3,3,FALSE,0.5,2021,2021-2022
NM,2022-02-28,intra-ui,905,119,133,101,67,53,40,52,27,1529,178,3204,1083,1202,FALSE,0.375156054931336,2021,2021-2022
NM,2022-03-31,inter-total,28,2,0,2,1,2,2,1,0,25,6,69,34,36,FALSE,0.521739130434783,2021,2021-2022
NM,2022-03-31,inter-ucfe,1,0,0,0,0,1,0,0,0,1,0,3,1,1,FALSE,0.333333333333333,2021,2021-2022
NM,2022-03-31,inter-ucx,0,0,0,0,0,0,0,0,0,0,0,0,0,0,FALSE,0,2021,2021-2022
NM,2022-03-31,inter-ui,27,2,0,2,1,1,2,1,0,24,6,66,33,35,FALSE,0.53030303030303,2021,2021-2022
NM,2022-03-31,intra-total,605,84,45,44,46,59,30,29,23,401,119,1485,724,808,FALSE,0.544107744107744,2021,2021-2022
NM,2022-03-31,intra-ucfe,5,1,0,1,0,2,1,1,3,1,2,17,7,8,FALSE,0.470588235294118,2021,2021-2022
NM,2022-03-31,intra-ucx,6,0,0,0,0,0,0,0,0,1,1,8,7,7,FALSE,0.875,2021,2021-2022
NM,2022-03-31,intra-ui,594,83,45,43,46,57,29,28,20,399,116,1460,710,793,FALSE,0.543150684931507,2021,2021-2022
NM,2022-04-30,inter-total,29,3,7,11,2,0,5,3,1,17,11,89,40,43,FALSE,0.48314606741573,2021,2021-2022
NM,2022-04-30,inter-ucfe,0,0,0,0,0,0,0,1,0,1,0,2,0,0,FALSE,0,2021,2021-2022
NM,2022-04-30,inter-ucx,0,0,0,0,0,0,0,0,0,0,0,0,0,0,FALSE,0,2021,2021-2022
NM,2022-04-30,inter-ui,29,3,7,11,2,0,5,2,1,16,11,87,40,43,FALSE,0.494252873563218,2021,2021-2022
NM,2022-04-30,intra-total,553,78,54,64,53,50,45,32,19,261,114,1323,667,745,FALSE,0.563114134542706,2021,2021-2022
NM,2022-04-30,intra-ucfe,1,1,1,0,0,0,0,1,0,7,1,12,2,3,FALSE,0.25,2021,2021-2022
NM,2022-04-30,intra-ucx,3,0,0,0,1,0,0,0,0,0,0,4,3,3,FALSE,0.75,2021,2021-2022
NM,2022-04-30,intra-ui,549,77,53,64,52,50,45,31,19,254,113,1307,662,739,FALSE,0.565416985462892,2021,2021-2022
NM,2022-05-31,inter-total,26,4,0,3,2,1,1,2,4,10,4,57,30,34,FALSE,0.596491228070175,2021,2021-2022
NM,2022-05-31,inter-ucfe,0,0,0,0,0,0,0,0,0,1,0,1,0,0,FALSE,0,2021,2021-2022
NM,2022-05-31,inter-ucx,0,0,0,0,0,0,0,0,0,0,0,0,0,0,FALSE,0,2021,2021-2022
NM,2022-05-31,inter-ui,26,4,0,3,2,1,1,2,4,9,4,56,30,34,FALSE,0.607142857142857,2021,2021-2022
NM,2022-05-31,intra-total,765,76,60,76,65,50,33,32,34,200,124,1515,889,965,FALSE,0.636963696369637,2021,2021-2022
NM,2022-05-31,intra-ucfe,2,0,0,0,0,1,0,1,0,4,1,9,3,3,FALSE,0.333333333333333,2021,2021-2022
NM,2022-05-31,intra-ucx,2,0,1,1,0,1,0,0,0,1,0,6,2,2,FALSE,0.333333333333333,2021,2021-2022
NM,2022-05-31,intra-ui,761,76,59,75,65,48,33,31,34,195,123,1500,884,960,FALSE,0.64,2021,2021-2022
NM,2022-06-30,inter-total,28,2,3,4,2,4,1,3,1,3,8,59,36,38,FALSE,0.64406779661017,2021,2021-2022
NM,2022-06-30,inter-ucfe,0,0,0,0,0,0,0,0,0,2,0,2,0,0,FALSE,0,2021,2021-2022
NM,2022-06-30,inter-ucx,0,0,0,0,0,0,0,0,0,0,0,0,0,0,FALSE,0,2021,2021-2022
NM,2022-06-30,inter-ui,28,2,3,4,2,4,1,3,1,1,8,57,36,38,FALSE,0.666666666666667,2021,2021-2022
NM,2022-06-30,intra-total,804,82,60,67,76,51,49,39,33,192,138,1591,942,1024,FALSE,0.643620364550597,2021,2021-2022
NM,2022-06-30,intra-ucfe,3,1,0,2,1,1,1,0,0,5,1,15,4,5,FALSE,0.333333333333333,2021,2021-2022
NM,2022-06-30,intra-ucx,1,0,1,1,0,0,0,0,0,0,1,4,2,2,FALSE,0.5,2021,2021-2022
NM,2022-06-30,intra-ui,800,81,59,64,75,50,48,39,33,187,136,1572,936,1017,FALSE,0.646946564885496,2021,2021-2022
NM,2022-07-31,inter-total,22,6,1,3,5,5,5,1,0,1,7,56,29,35,FALSE,0.625,2022,2022-2023
NM,2022-07-31,inter-ucfe,0,0,0,0,0,0,0,0,0,0,0,0,0,0,FALSE,0,2022,2022-2023
NM,2022-07-31,inter-ucx,0,0,0,0,0,0,0,0,0,0,0,0,0,0,FALSE,0,2022,2022-2023
NM,2022-07-31,inter-ui,22,6,1,3,5,5,5,1,0,1,7,56,29,35,FALSE,0.625,2022,2022-2023
NM,2022-07-31,intra-total,721,79,66,91,69,48,58,48,47,167,130,1524,851,930,FALSE,0.610236220472441,2022,2022-2023
NM,2022-07-31,intra-ucfe,0,3,2,3,0,0,1,0,2,2,4,17,4,7,FALSE,0.411764705882353,2022,2022-2023
NM,2022-07-31,intra-ucx,0,1,0,0,0,0,0,0,0,2,0,3,0,1,FALSE,0.333333333333333,2022,2022-2023
NM,2022-07-31,intra-ui,721,75,64,88,69,48,57,48,45,163,126,1504,847,922,FALSE,0.613031914893617,2022,2022-2023
NM,2022-08-31,inter-total,15,2,5,6,5,1,4,5,0,10,3,56,18,20,FALSE,0.357142857142857,2022,2022-2023
NM,2022-08-31,inter-ucfe,0,0,1,2,0,0,0,0,0,1,0,4,0,0,FALSE,0,2022,2022-2023
NM,2022-08-31,inter-ucx,0,0,0,0,0,0,0,0,0,0,0,0,0,0,FALSE,0,2022,2022-2023
NM,2022-08-31,inter-ui,15,2,4,4,5,1,4,5,0,9,3,52,18,20,FALSE,0.384615384615385,2022,2022-2023
NM,2022-08-31,intra-total,567,89,87,88,70,85,68,44,35,264,111,1508,678,767,FALSE,0.508620689655172,2022,2022-2023
NM,2022-08-31,intra-ucfe,4,1,1,1,1,1,2,1,0,5,2,19,6,7,FALSE,0.368421052631579,2022,2022-2023
NM,2022-08-31,intra-ucx,3,0,0,0,0,0,0,0,0,1,0,4,3,3,FALSE,0.75,2022,2022-2023
NM,2022-08-31,intra-ui,560,88,86,87,69,84,66,43,35,258,109,1485,669,757,FALSE,0.50976430976431,2022,2022-2023
NM,2022-09-30,inter-total,13,4,1,2,3,0,2,2,2,5,5,39,18,22,FALSE,0.564102564102564,2022,2022-2023
NM,2022-09-30,inter-ucfe,0,0,0,0,0,0,0,0,0,0,0,0,0,0,FALSE,0,2022,2022-2023
NM,2022-09-30,inter-ucx,0,0,0,0,0,0,0,0,0,0,0,0,0,0,FALSE,0,2022,2022-2023
NM,2022-09-30,inter-ui,13,4,1,2,3,0,2,2,2,5,5,39,18,22,FALSE,0.564102564102564,2022,2022-2023
NM,2022-09-30,intra-total,525,63,56,60,63,58,53,50,39,230,104,1301,629,692,FALSE,0.531898539584935,2022,2022-2023
NM,2022-09-30,intra-ucfe,2,0,1,0,0,0,0,4,0,6,2,15,4,4,FALSE,0.266666666666667,2022,2022-2023
NM,2022-09-30,intra-ucx,0,0,0,0,1,1,1,0,0,0,1,4,1,1,FALSE,0.25,2022,2022-2023
NM,2022-09-30,intra-ui,523,63,55,60,62,57,52,46,39,224,101,1282,624,687,FALSE,0.53588143525741,2022,2022-2023
NM,2022-10-31,inter-total,25,3,3,0,2,3,1,3,1,10,10,61,35,38,FALSE,0.622950819672131,2022,2022-2023
NM,2022-10-31,inter-ucfe,3,1,1,0,0,0,0,0,0,0,1,6,4,5,FALSE,0.833333333333333,2022,2022-2023
NM,2022-10-31,inter-ucx,0,0,0,0,0,0,0,0,0,0,0,0,0,0,FALSE,0,2022,2022-2023
NM,2022-10-31,inter-ui,22,2,2,0,2,3,1,3,1,10,9,55,31,33,FALSE,0.6,2022,2022-2023
NM,2022-10-31,intra-total,779,47,41,58,57,55,47,38,31,238,99,1490,878,925,FALSE,0.620805369127517,2022,2022-2023
NM,2022-10-31,intra-ucfe,14,0,2,2,0,2,0,1,0,2,2,25,16,16,FALSE,0.64,2022,2022-2023
NM,2022-10-31,intra-ucx,2,0,0,1,0,0,0,0,0,0,1,4,3,3,FALSE,0.75,2022,2022-2023
NM,2022-10-31,intra-ui,763,47,39,55,57,53,47,37,31,236,96,1461,859,906,FALSE,0.620123203285421,2022,2022-2023
NM,2022-11-30,inter-total,46,2,3,2,4,0,2,0,1,3,9,72,55,57,FALSE,0.791666666666667,2022,2022-2023
NM,2022-11-30,inter-ucfe,6,1,0,0,0,0,1,0,0,0,0,8,6,7,FALSE,0.875,2022,2022-2023
NM,2022-11-30,inter-ucx,0,0,0,0,0,0,0,0,0,0,0,0,0,0,FALSE,0,2022,2022-2023
NM,2022-11-30,inter-ui,40,1,3,2,4,0,1,0,1,3,9,64,49,50,FALSE,0.78125,2022,2022-2023
NM,2022-11-30,intra-total,1056,73,61,43,49,31,42,38,34,240,163,1830,1219,1292,FALSE,0.706010928961749,2022,2022-2023
NM,2022-11-30,intra-ucfe,25,4,2,1,1,1,1,0,1,10,15,61,40,44,FALSE,0.721311475409836,2022,2022-2023
NM,2022-11-30,intra-ucx,1,0,0,0,1,0,1,0,0,0,0,3,1,1,FALSE,0.333333333333333,2022,2022-2023
NM,2022-11-30,intra-ui,1030,69,59,42,47,30,40,38,33,230,148,1766,1178,1247,FALSE,0.706115515288788,2022,2022-2023
NM,2022-12-31,inter-total,28,2,0,2,1,3,2,0,1,6,12,57,40,42,FALSE,0.736842105263158,2022,2022-2023
NM,2022-12-31,inter-ucfe,0,0,0,0,0,0,0,0,0,1,1,2,1,1,FALSE,0.5,2022,2022-2023
NM,2022-12-31,inter-ucx,0,0,0,0,0,0,0,0,0,0,0,0,0,0,FALSE,0,2022,2022-2023
NM,2022-12-31,inter-ui,28,2,0,2,1,3,2,0,1,5,11,55,39,41,FALSE,0.745454545454546,2022,2022-2023
NM,2022-12-31,intra-total,1011,97,73,72,53,53,31,33,21,244,165,1853,1176,1273,FALSE,0.686994063680518,2022,2022-2023
NM,2022-12-31,intra-ucfe,31,5,3,2,1,1,0,0,0,5,6,54,37,42,FALSE,0.777777777777778,2022,2022-2023
NM,2022-12-31,intra-ucx,4,0,0,0,0,0,0,0,0,0,1,5,5,5,FALSE,1,2022,2022-2023
NM,2022-12-31,intra-ui,976,92,70,70,52,52,31,33,21,239,158,1794,1134,1226,FALSE,0.683389074693423,2022,2022-2023
NM,2023-01-31,inter-total,34,5,2,2,0,2,2,5,1,8,13,74,47,52,FALSE,0.702702702702703,2022,2022-2023
NM,2023-01-31,inter-ucfe,0,1,1,0,0,0,0,0,0,0,0,2,0,1,FALSE,0.5,2022,2022-2023
NM,2023-01-31,inter-ucx,1,0,0,0,0,0,0,0,0,0,0,1,1,1,FALSE,1,2022,2022-2023
NM,2023-01-31,inter-ui,33,4,1,2,0,2,2,5,1,8,13,71,46,50,FALSE,0.704225352112676,2022,2022-2023
NM,2023-01-31,intra-total,1657,86,68,57,77,76,55,45,48,245,206,2620,1863,1949,FALSE,0.743893129770992,2022,2022-2023
NM,2023-01-31,intra-ucfe,13,3,3,1,1,0,1,0,0,0,8,30,21,24,FALSE,0.8,2022,2022-2023
NM,2023-01-31,intra-ucx,0,0,0,0,0,1,0,0,0,0,0,1,0,0,FALSE,0,2022,2022-2023
NM,2023-01-31,intra-ui,1644,83,65,56,76,75,54,45,48,245,198,2589,1842,1925,FALSE,0.743530320587099,2022,2022-2023
NM,2023-02-28,inter-total,38,1,4,3,1,2,1,2,1,6,4,63,42,43,FALSE,0.682539682539683,2022,2022-2023
NM,2023-02-28,inter-ucfe,0,0,0,0,0,0,0,0,0,0,1,1,1,1,FALSE,1,2022,2022-2023
NM,2023-02-28,inter-ucx,0,0,0,0,0,0,0,0,0,0,0,0,0,0,FALSE,0,2022,2022-2023
NM,2023-02-28,inter-ui,38,1,4,3,1,2,1,2,1,6,3,62,41,42,FALSE,0.67741935483871,2022,2022-2023
NM,2023-02-28,intra-total,934,104,103,95,90,68,60,64,33,202,207,1960,1141,1245,FALSE,0.635204081632653,2022,2022-2023
NM,2023-02-28,intra-ucfe,3,1,0,0,1,0,1,0,1,1,3,11,6,7,FALSE,0.636363636363636,2022,2022-2023
NM,2023-02-28,intra-ucx,2,1,0,1,0,0,0,0,0,0,1,5,3,4,FALSE,0.8,2022,2022-2023
NM,2023-02-28,intra-ui,929,102,103,94,89,68,59,64,32,201,203,1944,1132,1234,FALSE,0.63477366255144,2022,2022-2023
NM,2023-03-31,inter-total,21,5,3,0,2,3,1,0,0,6,7,48,28,33,FALSE,0.6875,2022,2022-2023
NM,2023-03-31,inter-ucfe,1,0,0,0,0,0,0,0,0,0,0,1,1,1,FALSE,1,2022,2022-2023
NM,2023-03-31,inter-ucx,0,0,0,0,0,0,0,0,0,0,0,0,0,0,FALSE,0,2022,2022-2023
NM,2023-03-31,inter-ui,20,5,3,0,2,3,1,0,0,6,7,47,27,32,FALSE,0.680851063829787,2022,2022-2023
NM,2023-03-31,intra-total,822,125,123,89,75,68,56,49,22,254,197,1880,1019,1144,FALSE,0.608510638297872,2022,2022-2023
NM,2023-03-31,intra-ucfe,5,1,0,2,0,0,1,1,0,6,0,16,5,6,FALSE,0.375,2022,2022-2023
NM,2023-03-31,intra-ucx,0,1,0,0,0,1,0,0,0,1,0,3,0,1,FALSE,0.333333333333333,2022,2022-2023
NM,2023-03-31,intra-ui,817,123,123,87,75,67,55,48,22,247,197,1861,1014,1137,FALSE,0.610961848468565,2022,2022-2023
NM,2023-04-30,inter-total,33,7,4,2,1,2,0,0,0,8,1,58,34,41,FALSE,0.706896551724138,2022,2022-2023
NM,2023-04-30,inter-ucfe,0,0,0,0,0,0,0,0,0,1,0,1,0,0,FALSE,0,2022,2022-2023
NM,2023-04-30,inter-ucx,0,0,0,0,0,0,0,0,0,0,0,0,0,0,FALSE,0,2022,2022-2023
NM,2023-04-30,inter-ui,33,7,4,2,1,2,0,0,0,7,1,57,34,41,FALSE,0.719298245614035,2022,2022-2023
NM,2023-04-30,intra-total,797,92,86,58,35,29,34,25,25,182,165,1528,962,1054,FALSE,0.68979057591623,2022,2022-2023
NM,2023-04-30,intra-ucfe,2,0,2,1,0,1,0,0,0,2,0,8,2,2,FALSE,0.25,2022,2022-2023
NM,2023-04-30,intra-ucx,7,0,0,0,0,0,0,0,0,0,2,9,9,9,FALSE,1,2022,2022-2023
NM,2023-04-30,intra-ui,788,92,84,57,35,28,34,25,25,180,163,1511,951,1043,FALSE,0.690271343481138,2022,2022-2023
NM,2023-05-31,inter-total,38,6,1,0,2,2,2,1,0,6,6,64,44,50,FALSE,0.78125,2022,2022-2023
NM,2023-05-31,inter-ucfe,0,0,0,0,0,0,0,0,0,0,0,0,0,0,FALSE,0,2022,2022-2023
NM,2023-05-31,inter-ucx,0,0,0,0,0,0,0,0,0,0,0,0,0,0,FALSE,0,2022,2022-2023
NM,2023-05-31,inter-ui,38,6,1,0,2,2,2,1,0,6,6,64,44,50,FALSE,0.78125,2022,2022-2023
NM,2023-05-31,intra-total,803,83,47,38,46,38,32,17,12,137,138,1391,941,1024,FALSE,0.736161035226456,2022,2022-2023
NM,2023-05-31,intra-ucfe,0,1,0,0,0,0,0,0,0,5,1,7,1,2,FALSE,0.285714285714286,2022,2022-2023
NM,2023-05-31,intra-ucx,3,0,1,0,0,0,0,0,0,1,0,5,3,3,FALSE,0.6,2022,2022-2023
NM,2023-05-31,intra-ui,800,82,46,38,46,38,32,17,12,131,137,1379,937,1019,FALSE,0.738941261783901,2022,2022-2023
NM,2023-06-30,inter-total,34,2,3,1,1,3,2,0,1,1,7,55,41,43,FALSE,0.781818181818182,2022,2022-2023
NM,2023-06-30,inter-ucfe,0,0,0,0,0,0,0,0,0,0,1,1,1,1,FALSE,1,2022,2022-2023
NM,2023-06-30,inter-ucx,0,0,0,0,0,0,0,0,0,0,0,0,0,0,FALSE,0,2022,2022-2023
NM,2023-06-30,inter-ui,34,2,3,1,1,3,2,0,1,1,6,54,40,42,FALSE,0.777777777777778,2022,2022-2023
NM,2023-06-30,intra-total,1114,60,32,39,44,66,76,53,30,100,138,1752,1252,1312,FALSE,0.748858447488584,2022,2022-2023
NM,2023-06-30,intra-ucfe,7,0,0,1,1,0,0,0,1,3,1,14,8,8,FALSE,0.571428571428571,2022,2022-2023
NM,2023-06-30,intra-ucx,4,1,0,0,0,0,0,0,0,1,0,6,4,5,FALSE,0.833333333333333,2022,2022-2023
NM,2023-06-30,intra-ui,1103,59,32,38,43,66,76,53,29,96,137,1732,1240,1299,FALSE,0.75,2022,2022-2023
NM,2023-07-31,inter-total,48,3,2,2,6,1,2,2,1,5,5,77,53,56,FALSE,0.727272727272727,2023,2023-2024
NM,2023-07-31,inter-ucfe,0,0,0,0,0,0,0,0,0,1,0,1,0,0,FALSE,0,2023,2023-2024
NM,2023-07-31,inter-ucx,0,0,0,0,0,0,0,0,0,0,0,0,0,0,FALSE,0,2023,2023-2024
NM,2023-07-31,inter-ui,48,3,2,2,6,1,2,2,1,4,5,76,53,56,FALSE,0.736842105263158,2023,2023-2024
NM,2023-07-31,intra-total,1065,69,46,59,66,41,65,48,46,260,137,1902,1202,1271,FALSE,0.668243953732913,2023,2023-2024
NM,2023-07-31,intra-ucfe,7,3,1,1,0,0,0,0,0,1,0,13,7,10,FALSE,0.769230769230769,2023,2023-2024
NM,2023-07-31,intra-ucx,4,1,1,0,1,0,0,0,0,0,1,8,5,6,FALSE,0.75,2023,2023-2024
NM,2023-07-31,intra-ui,1054,65,44,58,65,41,65,48,46,259,136,1881,1190,1255,FALSE,0.667198298777246,2023,2023-2024
NM,2023-08-31,inter-total,31,4,1,2,0,1,4,4,1,13,8,69,39,43,FALSE,0.623188405797102,2023,2023-2024
NM,2023-08-31,inter-ucfe,1,0,0,0,0,0,0,0,0,2,0,3,1,1,FALSE,0.333333333333333,2023,2023-2024
NM,2023-08-31,inter-ucx,0,0,0,0,0,0,0,0,0,0,0,0,0,0,FALSE,0,2023,2023-2024
NM,2023-08-31,inter-ui,30,4,1,2,0,1,4,4,1,11,8,66,38,42,FALSE,0.636363636363636,2023,2023-2024
NM,2023-08-31,intra-total,988,83,51,42,38,58,69,68,52,289,182,1920,1170,1253,FALSE,0.652604166666667,2023,2023-2024
NM,2023-08-31,intra-ucfe,0,1,0,1,1,1,1,0,0,1,2,8,2,3,FALSE,0.375,2023,2023-2024
NM,2023-08-31,intra-ucx,2,2,0,0,0,0,1,0,0,0,0,5,2,4,FALSE,0.8,2023,2023-2024
NM,2023-08-31,intra-ui,986,80,51,41,37,57,67,68,52,288,180,1907,1166,1246,FALSE,0.653382275825905,2023,2023-2024
NM,2023-09-30,inter-total,36,2,2,0,1,0,1,2,0,6,6,56,42,44,FALSE,0.785714285714286,2023,2023-2024
NM,2023-09-30,inter-ucfe,0,0,0,0,0,0,0,0,0,0,0,0,0,0,FALSE,0,2023,2023-2024
NM,2023-09-30,inter-ucx,0,0,0,0,0,0,0,0,0,0,0,0,0,0,FALSE,0,2023,2023-2024
NM,2023-09-30,inter-ui,36,2,2,0,1,0,1,2,0,6,6,56,42,44,FALSE,0.785714285714286,2023,2023-2024
NM,2023-09-30,intra-total,693,63,30,24,23,24,30,38,35,170,116,1246,809,872,FALSE,0.69983948635634,2023,2023-2024
NM,2023-09-30,intra-ucfe,2,0,0,0,0,0,1,0,0,1,1,5,3,3,FALSE,0.6,2023,2023-2024
NM,2023-09-30,intra-ucx,1,0,0,0,0,0,0,1,0,0,0,2,1,1,FALSE,0.5,2023,2023-2024
NM,2023-09-30,intra-ui,690,63,30,24,23,24,29,37,35,169,115,1239,805,868,FALSE,0.700564971751413,2023,2023-2024
NM,2023-10-31,inter-total,42,4,2,1,1,0,2,0,0,3,7,62,49,53,FALSE,0.854838709677419,2023,2023-2024
NM,2023-10-31,inter-ucfe,4,0,0,0,0,0,0,0,0,0,4,8,8,8,FALSE,1,2023,2023-2024
NM,2023-10-31,inter-ucx,0,0,0,0,0,0,0,0,0,0,0,0,0,0,FALSE,0,2023,2023-2024
NM,2023-10-31,inter-ui,38,4,2,1,1,0,2,0,0,3,3,54,41,45,FALSE,0.833333333333333,2023,2023-2024
NM,2023-10-31,intra-total,1067,86,50,33,17,16,13,23,26,209,181,1721,1248,1334,FALSE,0.775130737943056,2023,2023-2024
NM,2023-10-31,intra-ucfe,18,2,1,0,0,0,1,0,0,1,5,28,23,25,FALSE,0.892857142857143,2023,2023-2024
NM,2023-10-31,intra-ucx,6,1,0,0,0,0,0,0,0,0,0,7,6,7,FALSE,1,2023,2023-2024
NM,2023-10-31,intra-ui,1043,83,49,33,17,16,12,23,26,208,176,1686,1219,1302,FALSE,0.772241992882562,2023,2023-2024
NM,2023-11-30,inter-total,75,3,1,2,0,1,2,0,1,11,7,103,82,85,FALSE,0.825242718446602,2023,2023-2024
NM,2023-11-30,inter-ucfe,2,1,0,0,0,0,0,0,0,0,1,4,3,4,FALSE,1,2023,2023-2024
NM,2023-11-30,inter-ucx,0,0,0,0,0,0,0,0,0,0,0,0,0,0,FALSE,0,2023,2023-2024
NM,2023-11-30,inter-ui,73,2,1,2,0,1,2,0,1,11,6,99,79,81,FALSE,0.818181818181818,2023,2023-2024
NM,2023-11-30,intra-total,1001,87,51,19,17,17,15,16,20,280,170,1693,1171,1258,FALSE,0.743059657412877,2023,2023-2024
NM,2023-11-30,intra-ucfe,14,5,0,0,0,0,0,0,0,2,7,28,21,26,FALSE,0.928571428571429,2023,2023-2024
NM,2023-11-30,intra-ucx,4,0,0,0,0,0,0,0,0,1,0,5,4,4,FALSE,0.8,2023,2023-2024
NM,2023-11-30,intra-ui,983,82,51,19,17,17,15,16,20,277,163,1660,1146,1228,FALSE,0.739759036144578,2023,2023-2024
NM,2023-12-31,inter-total,70,6,3,0,3,2,2,3,2,14,13,118,83,89,FALSE,0.754237288135593,2023,2023-2024
NM,2023-12-31,inter-ucfe,1,0,1,0,1,0,0,0,0,1,1,5,2,2,FALSE,0.4,2023,2023-2024
NM,2023-12-31,inter-ucx,0,0,0,0,0,0,0,0,0,0,0,0,0,0,FALSE,0,2023,2023-2024
NM,2023-12-31,inter-ui,69,6,2,0,2,2,2,3,2,13,12,113,81,87,FALSE,0.769911504424779,2023,2023-2024
NM,2023-12-31,intra-total,1108,57,38,32,38,33,97,101,80,1138,126,2848,1234,1291,FALSE,0.453300561797753,2023,2023-2024
NM,2023-12-31,intra-ucfe,24,3,0,1,3,1,1,1,0,5,4,43,28,31,FALSE,0.72093023255814,2023,2023-2024
NM,2023-12-31,intra-ucx,5,0,0,0,0,0,1,0,0,2,0,8,5,5,FALSE,0.625,2023,2023-2024
NM,2023-12-31,intra-ui,1079,54,38,31,35,32,95,100,80,1131,122,2797,1201,1255,FALSE,0.448695030389703,2023,2023-2024
NM,2024-01-31,inter-total,65,4,3,3,2,4,1,3,1,8,7,101,72,76,FALSE,0.752475247524752,2023,2023-2024
NM,2024-01-31,inter-ucfe,1,1,0,0,0,0,0,0,0,0,0,2,1,2,FALSE,1,2023,2023-2024
NM,2024-01-31,inter-ucx,0,0,0,0,0,0,0,0,0,0,0,0,0,0,FALSE,0,2023,2023-2024
NM,2024-01-31,inter-ui,64,3,3,3,2,4,1,3,1,8,7,99,71,74,FALSE,0.747474747474748,2023,2023-2024
NM,2024-01-31,intra-total,1489,95,53,60,142,130,153,122,51,426,199,2920,1688,1783,FALSE,0.610616438356164,2023,2023-2024
NM,2024-01-31,intra-ucfe,14,3,2,0,0,0,1,1,1,2,4,28,18,21,FALSE,0.75,2023,2023-2024
NM,2024-01-31,intra-ucx,0,1,0,0,0,0,0,0,0,2,2,5,2,3,FALSE,0.6,2023,2023-2024
NM,2024-01-31,intra-ui,1475,91,51,60,142,130,152,121,50,422,193,2887,1668,1759,FALSE,0.609282992726013,2023,2023-2024
NM,2024-02-29,inter-total,52,5,3,2,1,2,0,1,1,9,8,84,60,65,FALSE,0.773809523809524,2023,2023-2024
NM,2024-02-29,inter-ucfe,1,2,0,0,0,0,0,0,0,1,0,4,1,3,FALSE,0.75,2023,2023-2024
NM,2024-02-29,inter-ucx,0,0,0,0,0,0,0,0,0,0,0,0,0,0,FALSE,0,2023,2023-2024
NM,2024-02-29,inter-ui,51,3,3,2,1,2,0,1,1,8,8,80,59,62,FALSE,0.775,2023,2023-2024
NM,2024-02-29,intra-total,1038,77,63,63,103,40,24,18,16,215,170,1827,1208,1285,FALSE,0.703338806787083,2023,2023-2024
NM,2024-02-29,intra-ucfe,8,4,0,0,0,1,0,0,0,6,1,20,9,13,FALSE,0.65,2023,2023-2024
NM,2024-02-29,intra-ucx,5,0,0,0,0,0,0,0,0,0,1,6,6,6,FALSE,1,2023,2023-2024
NM,2024-02-29,intra-ui,1025,73,63,63,103,39,24,18,16,209,168,1801,1193,1266,FALSE,0.70294280955025,2023,2023-2024
NM,2024-03-31,inter-total,56,4,1,2,1,1,3,0,2,3,11,84,67,71,FALSE,0.845238095238095,2023,2023-2024
NM,2024-03-31,inter-ucfe,0,0,0,0,0,0,0,0,0,0,0,0,0,0,FALSE,0,2023,2023-2024
NM,2024-03-31,inter-ucx,0,0,0,0,0,0,0,0,0,0,0,0,0,0,FALSE,0,2023,2023-2024
NM,2024-03-31,inter-ui,56,4,1,2,1,1,3,0,2,3,11,84,67,71,FALSE,0.845238095238095,2023,2023-2024
NM,2024-03-31,intra-total,948,75,47,40,42,39,50,44,25,108,178,1596,1126,1201,FALSE,0.75250626566416,2023,2023-2024
NM,2024-03-31,intra-ucfe,0,1,0,0,0,0,1,1,0,0,0,3,0,1,FALSE,0.333333333333333,2023,2023-2024
NM,2024-03-31,intra-ucx,5,0,0,0,0,0,0,0,0,0,2,7,7,7,FALSE,1,2023,2023-2024
NM,2024-03-31,intra-ui,943,74,47,40,42,39,49,43,25,108,176,1586,1119,1193,FALSE,0.752206809583859,2023,2023-2024
NM,2024-04-30,inter-total,43,1,1,1,0,0,4,0,2,6,7,65,50,51,FALSE,0.784615384615385,2023,2023-2024
NM,2024-04-30,inter-ucfe,0,0,0,0,0,0,0,0,1,0,0,1,0,0,FALSE,0,2023,2023-2024
NM,2024-04-30,inter-ucx,0,0,0,0,0,0,0,0,0,0,0,0,0,0,FALSE,0,2023,2023-2024
NM,2024-04-30,inter-ui,43,1,1,1,0,0,4,0,1,6,7,64,50,51,FALSE,0.796875,2023,2023-2024
NM,2024-04-30,intra-total,936,80,49,46,42,42,55,38,46,176,162,1672,1098,1178,FALSE,0.704545454545455,2023,2023-2024
NM,2024-04-30,intra-ucfe,0,1,1,1,0,0,0,0,0,1,1,5,1,2,FALSE,0.4,2023,2023-2024
NM,2024-04-30,intra-ucx,5,0,1,0,0,0,0,0,0,0,3,9,8,8,FALSE,0.888888888888889,2023,2023-2024
NM,2024-04-30,intra-ui,931,79,47,45,42,42,55,38,46,175,158,1658,1089,1168,FALSE,0.704463208685163,2023,2023-2024
NM,2024-05-31,inter-total,66,3,3,2,2,3,1,1,3,3,10,97,76,79,FALSE,0.814432989690722,2023,2023-2024
NM,2024-05-31,inter-ucfe,2,0,0,0,0,0,0,0,0,0,0,2,2,2,FALSE,1,2023,2023-2024
NM,2024-05-31,inter-ucx,0,0,0,0,0,0,0,0,0,0,0,0,0,0,FALSE,0,2023,2023-2024
NM,2024-05-31,inter-ui,64,3,3,2,2,3,1,1,3,3,10,95,74,77,FALSE,0.810526315789474,2023,2023-2024
NM,2024-05-31,intra-total,901,112,64,49,32,36,39,46,32,189,204,1704,1105,1217,FALSE,0.714201877934272,2023,2023-2024
NM,2024-05-31,intra-ucfe,2,2,2,2,0,1,0,0,0,0,1,10,3,5,FALSE,0.5,2023,2023-2024
NM,2024-05-31,intra-ucx,6,0,0,0,0,0,0,0,0,0,2,8,8,8,FALSE,1,2023,2023-2024
NM,2024-05-31,intra-ui,893,110,62,47,32,35,39,46,32,189,201,1686,1094,1204,FALSE,0.7141162514828,2023,2023-2024
NM,2024-06-30,inter-total,50,4,0,0,2,2,0,0,1,2,8,69,58,62,FALSE,0.898550724637681,2023,2023-2024
NM,2024-06-30,inter-ucfe,0,0,0,0,0,0,0,0,0,0,0,0,0,0,FALSE,0,2023,2023-2024
NM,2024-06-30,inter-ucx,0,0,0,0,0,0,0,0,0,0,0,0,0,0,FALSE,0,2023,2023-2024
NM,2024-06-30,inter-ui,50,4,0,0,2,2,0,0,1,2,8,69,58,62,FALSE,0.898550724637681,2023,2023-2024
NM,2024-06-30,intra-total,1410,94,69,34,25,23,21,22,18,145,208,2069,1618,1712,FALSE,0.827452875785404,2023,2023-2024
NM,2024-06-30,intra-ucfe,1,0,0,1,0,0,0,0,1,2,1,6,2,2,FALSE,0.333333333333333,2023,2023-2024
NM,2024-06-30,intra-ucx,2,0,0,0,0,0,0,0,0,1,0,3,2,2,FALSE,0.666666666666667,2023,2023-2024
NM,2024-06-30,intra-ui,1407,94,69,33,25,23,21,22,17,142,207,2060,1614,1708,FALSE,0.829126213592233,2023,2023-2024
NM,2024-07-31,inter-total,47,4,6,1,5,0,4,2,1,7,4,81,51,55,FALSE,0.679012345679012,2024,2024-2025
NM,2024-07-31,inter-ucfe,0,0,0,0,1,0,0,0,0,0,0,1,0,0,FALSE,0,2024,2024-2025
NM,2024-07-31,inter-ucx,0,0,0,0,0,0,0,0,0,0,0,0,0,0,FALSE,0,2024,2024-2025
NM,2024-07-31,inter-ui,47,4,6,1,4,0,4,2,1,7,4,80,51,55,FALSE,0.6875,2024,2024-2025
NM,2024-07-31,intra-total,1524,106,79,65,41,41,43,27,28,210,363,2527,1887,1993,FALSE,0.788682231895528,2024,2024-2025
NM,2024-07-31,intra-ucfe,1,0,2,2,2,0,2,2,0,2,0,13,1,1,FALSE,0.0769230769230769,2024,2024-2025
NM,2024-07-31,intra-ucx,4,2,0,0,1,0,0,0,0,0,0,7,4,6,FALSE,0.857142857142857,2024,2024-2025
NM,2024-07-31,intra-ui,1519,104,77,63,38,41,41,25,28,208,363,2507,1882,1986,FALSE,0.792181890706023,2024,2024-2025
NM,2024-08-31,inter-total,51,7,6,3,1,2,1,2,2,8,13,96,64,71,FALSE,0.739583333333333,2024,2024-2025
NM,2024-08-31,inter-ucfe,0,0,0,0,0,0,0,0,0,0,0,0,0,0,FALSE,0,2024,2024-2025
NM,2024-08-31,inter-ucx,0,0,0,0,0,0,0,0,0,0,0,0,0,0,FALSE,0,2024,2024-2025
NM,2024-08-31,inter-ui,51,7,6,3,1,2,1,2,2,8,13,96,64,71,FALSE,0.739583333333333,2024,2024-2025
NM,2024-08-31,intra-total,1197,162,92,58,50,56,67,61,46,288,275,2352,1472,1634,FALSE,0.694727891156463,2024,2024-2025
NM,2024-08-31,intra-ucfe,0,1,1,1,1,2,2,1,3,4,0,16,0,1,FALSE,0.0625,2024,2024-2025
NM,2024-08-31,intra-ucx,3,1,0,0,0,1,0,0,1,0,1,7,4,5,FALSE,0.714285714285714,2024,2024-2025
NM,2024-08-31,intra-ui,1194,160,91,57,49,53,65,60,42,284,274,2329,1468,1628,FALSE,0.699012451696007,2024,2024-2025
NM,2024-09-30,inter-total,47,3,4,1,3,0,2,2,0,5,11,78,58,61,FALSE,0.782051282051282,2024,2024-2025
NM,2024-09-30,inter-ucfe,0,0,0,0,0,0,0,0,0,0,0,0,0,0,FALSE,0,2024,2024-2025
NM,2024-09-30,inter-ucx,0,0,0,0,0,0,0,0,0,0,0,0,0,0,FALSE,0,2024,2024-2025
NM,2024-09-30,inter-ui,47,3,4,1,3,0,2,2,0,5,11,78,58,61,FALSE,0.782051282051282,2024,2024-2025
NM,2024-09-30,intra-total,901,92,74,54,47,55,34,40,24,244,163,1728,1064,1156,FALSE,0.668981481481482,2024,2024-2025
NM,2024-09-30,intra-ucfe,2,1,0,0,0,1,1,2,0,1,0,8,2,3,FALSE,0.375,2024,2024-2025
NM,2024-09-30,intra-ucx,3,0,0,1,0,0,0,0,0,0,0,4,3,3,FALSE,0.75,2024,2024-2025
NM,2024-09-30,intra-ui,896,91,74,53,47,54,33,38,24,243,163,1716,1059,1150,FALSE,0.67016317016317,2024,2024-2025
NM,2024-10-31,inter-total,43,1,1,1,1,0,2,1,1,5,1,57,44,45,FALSE,0.789473684210526,2024,2024-2025
NM,2024-10-31,inter-ucfe,0,0,0,0,0,0,0,0,0,0,0,0,0,0,FALSE,0,2024,2024-2025
NM,2024-10-31,inter-ucx,0,0,0,0,0,0,0,0,0,0,0,0,0,0,FALSE,0,2024,2024-2025
NM,2024-10-31,inter-ui,43,1,1,1,1,0,2,1,1,5,1,57,44,45,FALSE,0.789473684210526,2024,2024-2025
NM,2024-10-31,intra-total,1001,101,75,44,46,33,36,24,23,213,181,1777,1182,1283,FALSE,0.722003376477209,2024,2024-2025
NM,2024-10-31,intra-ucfe,2,1,1,0,0,1,0,0,0,1,3,9,5,6,FALSE,0.666666666666667,2024,2024-2025
NM,2024-10-31,intra-ucx,2,0,0,0,0,0,1,0,0,0,0,3,2,2,FALSE,0.666666666666667,2024,2024-2025
NM,2024-10-31,intra-ui,997,100,74,44,46,32,35,24,23,212,178,1765,1175,1275,FALSE,0.722379603399434,2024,2024-2025
NM,2024-12-31,inter-total,61,6,4,5,1,2,3,1,2,4,7,96,68,74,FALSE,0.770833333333333,2024,2024-2025
NM,2024-12-31,inter-ucfe,5,0,0,1,0,1,0,0,0,1,0,8,5,5,FALSE,0.625,2024,2024-2025
NM,2024-12-31,inter-ucx,0,0,0,0,0,0,0,0,0,0,0,0,0,0,FALSE,0,2024,2024-2025
NM,2024-12-31,inter-ui,56,6,4,4,1,1,3,1,2,3,7,88,63,69,FALSE,0.784090909090909,2024,2024-2025
NM,2024-12-31,intra-total,1230,110,110,74,66,40,40,47,36,200,211,2164,1441,1551,FALSE,0.716728280961183,2024,2024-2025
NM,2024-12-31,intra-ucfe,26,2,1,2,1,0,2,1,2,5,9,51,35,37,FALSE,0.725490196078431,2024,2024-2025
NM,2024-12-31,intra-ucx,3,0,0,0,1,0,0,0,0,0,0,4,3,3,FALSE,0.75,2024,2024-2025
NM,2024-12-31,intra-ui,1201,108,109,72,64,40,38,46,34,195,202,2109,1403,1511,FALSE,0.716453295400664,2024,2024-2025
NV,2019-01-31,inter-total,65,16,2,4,0,1,1,1,1,0,41,132,106,122,TRUE,0.803030303030303,2018,2018-2019
NV,2019-01-31,inter-ucfe,0,2,0,0,0,0,0,0,0,0,6,8,6,8,TRUE,0.75,2018,2018-2019
NV,2019-01-31,inter-ucx,0,0,0,0,0,0,0,0,0,0,0,0,0,0,TRUE,0,2018,2018-2019
NV,2019-01-31,inter-ui,65,14,2,4,0,1,1,1,1,0,35,124,100,114,TRUE,0.806451612903226,2018,2018-2019
NV,2019-01-31,intra-total,3335,656,152,53,24,21,24,32,35,59,1680,6071,5015,5671,TRUE,0.826058309998353,2018,2018-2019
NV,2019-01-31,intra-ucfe,43,23,6,0,1,0,1,0,0,0,147,221,190,213,TRUE,0.859728506787331,2018,2018-2019
NV,2019-01-31,intra-ucx,7,1,0,1,0,1,1,0,0,1,4,16,11,12,TRUE,0.6875,2018,2018-2019
NV,2019-01-31,intra-ui,3285,632,146,52,23,20,22,32,35,58,1529,5834,4814,5446,TRUE,0.825162838532739,2018,2018-2019
NV,2019-02-28,inter-total,36,6,8,4,3,2,1,2,0,2,15,79,51,57,TRUE,0.645569620253165,2018,2018-2019
NV,2019-02-28,inter-ucfe,0,0,1,0,1,0,0,0,0,0,0,2,0,0,TRUE,0,2018,2018-2019
NV,2019-02-28,inter-ucx,0,0,0,0,0,0,0,0,0,0,0,0,0,0,TRUE,0,2018,2018-2019
NV,2019-02-28,inter-ui,36,6,7,4,2,2,1,2,0,2,15,77,51,57,TRUE,0.662337662337662,2018,2018-2019
NV,2019-02-28,intra-total,2388,640,157,65,40,32,29,21,15,56,1109,4552,3497,4137,TRUE,0.76823374340949,2018,2018-2019
NV,2019-02-28,intra-ucfe,2,1,3,1,2,1,0,0,0,0,4,14,6,7,TRUE,0.428571428571429,2018,2018-2019
NV,2019-02-28,intra-ucx,7,0,0,1,0,0,0,0,0,0,3,11,10,10,TRUE,0.909090909090909,2018,2018-2019
NV,2019-02-28,intra-ui,2379,639,154,63,38,31,29,21,15,56,1102,4527,3481,4120,TRUE,0.768941904130771,2018,2018-2019
NV,2019-03-31,inter-total,36,19,3,4,1,0,3,2,0,3,25,96,61,80,TRUE,0.635416666666667,2018,2018-2019
NV,2019-03-31,inter-ucfe,0,0,0,0,0,0,0,0,0,0,1,1,1,1,TRUE,1,2018,2018-2019
NV,2019-03-31,inter-ucx,0,0,0,0,0,0,0,0,0,0,0,0,0,0,TRUE,0,2018,2018-2019
NV,2019-03-31,inter-ui,36,19,3,4,1,0,3,2,0,3,24,95,60,79,TRUE,0.631578947368421,2018,2018-2019
NV,2019-03-31,intra-total,2021,702,178,63,41,42,44,10,9,27,1011,4148,3032,3734,TRUE,0.730954676952748,2018,2018-2019
NV,2019-03-31,intra-ucfe,1,1,3,3,0,2,0,1,0,1,4,16,5,6,TRUE,0.3125,2018,2018-2019
NV,2019-03-31,intra-ucx,2,2,1,1,0,0,0,0,0,0,2,8,4,6,TRUE,0.5,2018,2018-2019
NV,2019-03-31,intra-ui,2018,699,174,59,41,40,44,9,9,26,1005,4124,3023,3722,TRUE,0.733026188166828,2018,2018-2019
NV,2019-04-30,inter-total,38,15,9,0,2,1,0,1,2,0,20,88,58,73,TRUE,0.659090909090909,2018,2018-2019
NV,2019-04-30,inter-ucfe,0,1,0,0,0,0,0,0,0,0,0,1,0,1,TRUE,0,2018,2018-2019
NV,2019-04-30,inter-ucx,0,0,0,0,0,0,0,0,0,0,0,0,0,0,TRUE,0,2018,2018-2019
NV,2019-04-30,inter-ui,38,14,9,0,2,1,0,1,2,0,20,87,58,72,TRUE,0.666666666666667,2018,2018-2019
NV,2019-04-30,intra-total,2138,690,147,45,45,42,40,17,13,39,950,4166,3088,3778,TRUE,0.741238598175708,2018,2018-2019
NV,2019-04-30,intra-ucfe,4,1,0,1,0,1,0,0,0,0,4,11,8,9,TRUE,0.727272727272727,2018,2018-2019
NV,2019-04-30,intra-ucx,6,0,1,1,1,0,0,0,0,0,2,11,8,8,TRUE,0.727272727272727,2018,2018-2019
NV,2019-04-30,intra-ui,2128,689,146,43,44,41,40,17,13,39,944,4144,3072,3761,TRUE,0.741312741312741,2018,2018-2019
NV,2019-05-31,inter-total,42,10,5,1,0,1,1,1,0,1,23,85,65,75,TRUE,0.764705882352941,2018,2018-2019
NV,2019-05-31,inter-ucfe,1,0,0,0,0,0,0,0,0,0,1,2,2,2,TRUE,1,2018,2018-2019
NV,2019-05-31,inter-ucx,0,0,0,0,0,0,0,0,0,0,0,0,0,0,TRUE,0,2018,2018-2019
NV,2019-05-31,inter-ui,41,10,5,1,0,1,1,1,0,1,22,83,63,73,TRUE,0.759036144578313,2018,2018-2019
NV,2019-05-31,intra-total,1981,691,146,64,32,39,41,18,6,23,987,4028,2968,3659,TRUE,0.736842105263158,2018,2018-2019
NV,2019-05-31,intra-ucfe,1,2,0,0,0,0,0,1,1,0,1,6,2,4,TRUE,0.333333333333333,2018,2018-2019
NV,2019-05-31,intra-ucx,6,0,0,0,0,0,0,0,0,0,3,9,9,9,TRUE,1,2018,2018-2019
NV,2019-05-31,intra-ui,1974,689,146,64,32,39,41,17,5,23,983,4013,2957,3646,TRUE,0.736855220533267,2018,2018-2019
NV,2019-06-30,inter-total,27,10,2,1,0,2,0,1,0,0,17,60,44,54,TRUE,0.733333333333333,2018,2018-2019
NV,2019-06-30,inter-ucfe,0,0,0,1,0,0,0,0,0,0,0,1,0,0,TRUE,0,2018,2018-2019
NV,2019-06-30,inter-ucx,0,0,0,0,0,0,0,0,0,0,0,0,0,0,TRUE,0,2018,2018-2019
NV,2019-06-30,inter-ui,27,10,2,0,0,2,0,1,0,0,17,59,44,54,TRUE,0.745762711864407,2018,2018-2019
NV,2019-06-30,intra-total,1976,623,117,51,32,34,35,10,5,16,920,3819,2896,3519,TRUE,0.758313694684472,2018,2018-2019
NV,2019-06-30,intra-ucfe,0,1,1,1,0,0,0,0,0,2,0,5,0,1,TRUE,0,2018,2018-2019
NV,2019-06-30,intra-ucx,6,2,1,0,0,0,0,0,0,0,3,12,9,11,TRUE,0.75,2018,2018-2019
NV,2019-06-30,intra-ui,1970,620,115,50,32,34,35,10,5,14,917,3802,2887,3507,TRUE,0.759337190952131,2018,2018-2019
NV,2019-07-31,inter-total,22,18,4,2,1,0,4,0,0,1,22,74,44,62,TRUE,0.594594594594595,2019,2019-2020
NV,2019-07-31,inter-ucfe,0,0,0,1,0,0,0,0,0,0,0,1,0,0,TRUE,0,2019,2019-2020
NV,2019-07-31,inter-ucx,0,0,0,0,0,0,0,0,0,0,0,0,0,0,TRUE,0,2019,2019-2020
NV,2019-07-31,inter-ui,22,18,4,1,1,0,4,0,0,1,22,73,44,62,TRUE,0.602739726027397,2019,2019-2020
NV,2019-07-31,intra-total,2443,768,155,54,34,34,24,19,14,27,1180,4752,3623,4391,TRUE,0.762415824915825,2019,2019-2020
NV,2019-07-31,intra-ucfe,1,2,0,0,0,0,0,0,1,0,1,5,2,4,TRUE,0.4,2019,2019-2020
NV,2019-07-31,intra-ucx,3,2,3,0,0,0,0,0,0,0,3,11,6,8,TRUE,0.545454545454545,2019,2019-2020
NV,2019-07-31,intra-ui,2439,764,152,54,34,34,24,19,13,27,1176,4736,3615,4379,TRUE,0.763302364864865,2019,2019-2020
NV,2019-08-31,inter-total,37,27,5,1,1,2,1,0,1,1,28,104,65,92,TRUE,0.625,2019,2019-2020
NV,2019-08-31,inter-ucfe,0,0,0,0,0,0,0,0,0,0,1,1,1,1,TRUE,1,2019,2019-2020
NV,2019-08-31,inter-ucx,0,0,0,0,0,0,0,0,0,0,0,0,0,0,TRUE,0,2019,2019-2020
NV,2019-08-31,inter-ui,37,27,5,1,1,2,1,0,1,1,27,103,64,91,TRUE,0.621359223300971,2019,2019-2020
NV,2019-08-31,intra-total,2006,715,152,67,49,40,32,13,7,23,1042,4146,3048,3763,TRUE,0.735166425470333,2019,2019-2020
NV,2019-08-31,intra-ucfe,2,2,0,1,0,0,1,0,0,0,0,6,2,4,TRUE,0.333333333333333,2019,2019-2020
NV,2019-08-31,intra-ucx,5,1,0,0,0,0,0,0,0,0,3,9,8,9,TRUE,0.888888888888889,2019,2019-2020
NV,2019-08-31,intra-ui,1999,712,152,66,49,40,31,13,7,23,1039,4131,3038,3750,TRUE,0.735415153715807,2019,2019-2020
NV,2019-09-30,inter-total,33,13,6,1,2,2,1,3,0,0,19,80,52,65,TRUE,0.65,2019,2019-2020
NV,2019-09-30,inter-ucfe,0,0,0,0,0,1,0,0,0,0,0,1,0,0,TRUE,0,2019,2019-2020
NV,2019-09-30,inter-ucx,0,0,0,0,0,0,0,0,0,0,0,0,0,0,TRUE,0,2019,2019-2020
NV,2019-09-30,inter-ui,33,13,6,1,2,1,1,3,0,0,19,79,52,65,TRUE,0.658227848101266,2019,2019-2020
NV,2019-09-30,intra-total,1770,649,124,55,32,42,30,16,12,24,1021,3775,2791,3440,TRUE,0.739337748344371,2019,2019-2020
NV,2019-09-30,intra-ucfe,2,0,1,1,0,0,0,0,0,0,1,5,3,3,TRUE,0.6,2019,2019-2020
NV,2019-09-30,intra-ucx,4,0,0,0,0,1,0,0,0,1,4,10,8,8,TRUE,0.8,2019,2019-2020
NV,2019-09-30,intra-ui,1764,649,123,54,32,41,30,16,12,23,1016,3760,2780,3429,TRUE,0.73936170212766,2019,2019-2020
NV,2019-10-31,inter-total,40,20,9,1,0,4,2,0,0,0,34,110,74,94,TRUE,0.672727272727273,2019,2019-2020
NV,2019-10-31,inter-ucfe,1,0,2,0,0,0,0,0,0,0,0,3,1,1,TRUE,0.333333333333333,2019,2019-2020
NV,2019-10-31,inter-ucx,0,0,0,0,0,0,0,0,0,0,0,0,0,0,TRUE,0,2019,2019-2020
NV,2019-10-31,inter-ui,39,20,7,1,0,4,2,0,0,0,34,107,73,93,TRUE,0.682242990654206,2019,2019-2020
NV,2019-10-31,intra-total,1895,663,128,56,35,54,22,10,5,23,1089,3980,2984,3647,TRUE,0.749748743718593,2019,2019-2020
NV,2019-10-31,intra-ucfe,5,1,1,2,1,0,0,0,1,0,2,13,7,8,TRUE,0.538461538461538,2019,2019-2020
NV,2019-10-31,intra-ucx,7,1,1,0,0,0,0,0,0,0,4,13,11,12,TRUE,0.846153846153846,2019,2019-2020
NV,2019-10-31,intra-ui,1883,661,126,54,34,54,22,10,4,23,1083,3954,2966,3627,TRUE,0.750126454223571,2019,2019-2020
NV,2019-11-30,inter-total,43,9,3,1,0,2,0,1,0,0,15,74,58,67,TRUE,0.783783783783784,2019,2019-2020
NV,2019-11-30,inter-ucfe,3,0,0,0,0,1,0,0,0,0,2,6,5,5,TRUE,0.833333333333333,2019,2019-2020
NV,2019-11-30,inter-ucx,0,0,0,0,0,0,0,0,0,0,0,0,0,0,TRUE,0,2019,2019-2020
NV,2019-11-30,inter-ui,40,9,3,1,0,1,0,1,0,0,13,68,53,62,TRUE,0.779411764705882,2019,2019-2020
NV,2019-11-30,intra-total,2166,561,149,40,34,27,21,16,3,20,1014,4051,3180,3741,TRUE,0.784991360157986,2019,2019-2020
NV,2019-11-30,intra-ucfe,7,1,2,0,0,0,0,1,0,0,17,28,24,25,TRUE,0.857142857142857,2019,2019-2020
NV,2019-11-30,intra-ucx,3,0,2,0,0,0,0,0,0,1,2,8,5,5,TRUE,0.625,2019,2019-2020
NV,2019-11-30,intra-ui,2156,560,145,40,34,27,21,15,3,19,995,4015,3151,3711,TRUE,0.78480697384807,2019,2019-2020
NV,2019-12-31,inter-total,59,17,11,2,1,0,4,2,1,1,32,130,91,108,TRUE,0.7,2019,2019-2020
NV,2019-12-31,inter-ucfe,3,1,0,0,0,0,0,0,0,0,2,6,5,6,TRUE,0.833333333333333,2019,2019-2020
NV,2019-12-31,inter-ucx,0,0,0,0,0,0,0,0,0,0,0,0,0,0,TRUE,0,2019,2019-2020
NV,2019-12-31,inter-ui,56,16,11,2,1,0,4,2,1,1,30,124,86,102,TRUE,0.693548387096774,2019,2019-2020
NV,2019-12-31,intra-total,3616,734,195,69,40,44,38,26,16,24,1583,6385,5199,5933,TRUE,0.81425215348473,2019,2019-2020
NV,2019-12-31,intra-ucfe,6,3,6,3,2,0,1,1,0,0,19,41,25,28,TRUE,0.609756097560976,2019,2019-2020
NV,2019-12-31,intra-ucx,2,1,2,1,0,0,0,0,0,0,6,12,8,9,TRUE,0.666666666666667,2019,2019-2020
NV,2019-12-31,intra-ui,3608,730,187,65,38,44,37,25,16,24,1558,6332,5166,5896,TRUE,0.815855969677827,2019,2019-2020
NV,2020-01-31,inter-total,53,16,5,4,1,1,0,0,1,1,28,110,81,97,TRUE,0.736363636363636,2019,2019-2020
NV,2020-01-31,inter-ucfe,3,1,0,0,0,0,0,0,0,0,3,7,6,7,TRUE,0.857142857142857,2019,2019-2020
NV,2020-01-31,inter-ucx,0,0,0,0,0,0,0,0,0,0,0,0,0,0,TRUE,0,2019,2019-2020
NV,2020-01-31,inter-ui,50,15,5,4,1,1,0,0,1,1,25,103,75,90,TRUE,0.728155339805825,2019,2019-2020
NV,2020-01-31,intra-total,2796,594,169,80,36,39,42,14,5,21,1393,5189,4189,4783,TRUE,0.807284640585855,2019,2019-2020
NV,2020-01-31,intra-ucfe,19,5,3,2,1,0,0,0,0,0,15,45,34,39,TRUE,0.755555555555556,2019,2019-2020
NV,2020-01-31,intra-ucx,4,7,0,0,0,0,0,0,0,0,3,14,7,14,TRUE,0.5,2019,2019-2020
NV,2020-01-31,intra-ui,2773,582,166,78,35,39,42,14,5,21,1375,5130,4148,4730,TRUE,0.808576998050682,2019,2019-2020
NV,2020-02-29,inter-total,34,20,4,4,1,3,3,0,0,0,20,89,54,74,TRUE,0.606741573033708,2019,2019-2020
NV,2020-02-29,inter-ucfe,0,1,0,1,0,1,0,0,0,0,0,3,0,1,TRUE,0,2019,2019-2020
NV,2020-02-29,inter-ucx,0,0,0,0,0,0,0,0,0,0,0,0,0,0,TRUE,0,2019,2019-2020
NV,2020-02-29,inter-ui,34,19,4,3,1,2,3,0,0,0,20,86,54,73,TRUE,0.627906976744186,2019,2019-2020
NV,2020-02-29,intra-total,2398,648,224,76,39,34,25,8,8,29,1249,4738,3647,4295,TRUE,0.769734065006332,2019,2019-2020
NV,2020-02-29,intra-ucfe,8,3,2,2,0,0,0,0,0,1,6,22,14,17,TRUE,0.636363636363636,2019,2019-2020
NV,2020-02-29,intra-ucx,2,2,0,0,0,0,0,0,0,0,2,6,4,6,TRUE,0.666666666666667,2019,2019-2020
NV,2020-02-29,intra-ui,2388,643,222,74,39,34,25,8,8,28,1241,4710,3629,4272,TRUE,0.770488322717622,2019,2019-2020
NV,2020-03-31,inter-total,308,7,11,6,3,1,0,2,0,1,45,384,353,360,TRUE,0.919270833333333,2019,2019-2020
NV,2020-03-31,inter-ucfe,1,0,1,0,0,0,0,0,0,0,0,2,1,1,TRUE,0.5,2019,2019-2020
NV,2020-03-31,inter-ucx,0,0,0,0,0,0,0,0,0,0,0,0,0,0,TRUE,0,2019,2019-2020
NV,2020-03-31,inter-ui,307,7,10,6,3,1,0,2,0,1,45,382,352,359,TRUE,0.921465968586387,2019,2019-2020
NV,2020-03-31,intra-total,55102,725,166,68,40,46,35,13,10,66,6578,62849,61680,62405,TRUE,0.981399863164092,2019,2019-2020
NV,2020-03-31,intra-ucfe,5,0,0,1,1,0,0,1,0,0,7,15,12,12,TRUE,0.8,2019,2019-2020
NV,2020-03-31,intra-ucx,1,0,0,0,0,1,0,0,0,0,0,2,1,1,TRUE,0.5,2019,2019-2020
NV,2020-03-31,intra-ui,55096,725,166,67,39,45,35,12,10,66,6571,62832,61667,62392,TRUE,0.981458492487904,2019,2019-2020
NV,2020-04-30,inter-total,1038,121,56,24,6,1,1,1,0,1,321,1570,1359,1480,TRUE,0.865605095541401,2019,2019-2020
NV,2020-04-30,inter-ucfe,1,0,0,0,0,0,0,0,0,0,0,1,1,1,TRUE,1,2019,2019-2020
NV,2020-04-30,inter-ucx,0,0,0,0,0,0,0,0,0,0,0,0,0,0,TRUE,0,2019,2019-2020
NV,2020-04-30,inter-ui,1037,121,56,24,6,1,1,1,0,1,321,1569,1358,1479,TRUE,0.865519439133206,2019,2019-2020
NV,2020-04-30,intra-total,108650,12320,8092,3574,657,53,49,17,10,120,37223,170765,145873,158193,TRUE,0.854232424677188,2019,2019-2020
NV,2020-04-30,intra-ucfe,8,1,0,0,1,0,0,0,0,0,8,18,16,17,TRUE,0.888888888888889,2019,2019-2020
NV,2020-04-30,intra-ucx,8,5,2,1,0,0,0,0,0,0,16,32,24,29,TRUE,0.75,2019,2019-2020
NV,2020-04-30,intra-ui,108634,12314,8090,3573,656,53,49,17,10,120,37199,170715,145833,158147,TRUE,0.854248308584483,2019,2019-2020
NV,2020-05-31,inter-total,423,32,73,112,115,139,97,55,22,5,109,1182,532,564,TRUE,0.450084602368866,2019,2019-2020
NV,2020-05-31,inter-ucfe,0,0,0,0,0,0,0,0,0,0,0,0,0,0,TRUE,0,2019,2019-2020
NV,2020-05-31,inter-ucx,0,0,0,0,0,0,0,0,0,0,0,0,0,0,TRUE,0,2019,2019-2020
NV,2020-05-31,inter-ui,423,32,73,112,115,139,97,55,22,5,109,1182,532,564,TRUE,0.450084602368866,2019,2019-2020
NV,2020-05-31,intra-total,33843,2930,4401,8246,8671,10793,8790,4070,1401,283,7978,91406,41821,44751,TRUE,0.457530140253375,2019,2019-2020
NV,2020-05-31,intra-ucfe,4,0,3,2,2,2,3,1,1,0,5,23,9,9,TRUE,0.391304347826087,2019,2019-2020
NV,2020-05-31,intra-ucx,15,5,2,3,3,1,1,3,1,0,5,39,20,25,TRUE,0.512820512820513,2019,2019-2020
NV,2020-05-31,intra-ui,33824,2925,4396,8241,8666,10790,8786,4066,1399,283,7968,91344,41792,44717,TRUE,0.457523208968296,2019,2019-2020
NV,2020-06-30,inter-total,108,13,19,41,34,25,73,82,116,191,41,743,149,162,TRUE,0.200538358008075,2019,2019-2020
NV,2020-06-30,inter-ucfe,0,0,0,0,0,0,0,0,0,1,0,1,0,0,TRUE,0,2019,2019-2020
NV,2020-06-30,inter-ucx,0,0,0,0,0,0,0,0,0,0,0,0,0,0,TRUE,0,2019,2019-2020
NV,2020-06-30,inter-ui,108,13,19,41,34,25,73,82,116,190,41,742,149,162,TRUE,0.200808625336927,2019,2019-2020
NV,2020-06-30,intra-total,10365,1182,1476,2499,2132,2396,4382,5632,6134,12810,2530,51538,12895,14077,TRUE,0.25020373316776,2019,2019-2020
NV,2020-06-30,intra-ucfe,4,0,0,2,1,1,3,2,1,6,0,20,4,4,TRUE,0.2,2019,2019-2020
NV,2020-06-30,intra-ucx,7,8,2,2,1,1,5,2,4,16,7,55,14,22,TRUE,0.254545454545455,2019,2019-2020
NV,2020-06-30,intra-ui,10354,1174,1474,2495,2130,2394,4374,5628,6129,12788,2523,51463,12877,14051,TRUE,0.250218603656996,2019,2019-2020
NV,2020-07-31,inter-total,82,13,6,2,7,6,7,9,9,473,26,640,108,121,TRUE,0.16875,2020,2020-2021
NV,2020-07-31,inter-ucfe,0,0,0,0,0,0,0,0,0,0,0,0,0,0,TRUE,0,2020,2020-2021
NV,2020-07-31,inter-ucx,0,0,0,0,0,0,1,0,0,0,0,1,0,0,TRUE,0,2020,2020-2021
NV,2020-07-31,inter-ui,82,13,6,2,7,6,6,9,9,473,26,639,108,121,TRUE,0.169014084507042,2020,2020-2021
NV,2020-07-31,intra-total,6876,591,379,436,370,309,381,392,564,28494,1295,40087,8171,8762,TRUE,0.203831666126176,2020,2020-2021
NV,2020-07-31,intra-ucfe,3,2,1,0,0,0,0,1,2,12,1,22,4,6,TRUE,0.181818181818182,2020,2020-2021
NV,2020-07-31,intra-ucx,5,1,1,3,2,1,4,0,3,22,5,47,10,11,TRUE,0.212765957446809,2020,2020-2021
NV,2020-07-31,intra-ui,6868,588,377,433,368,308,377,391,559,28460,1289,40018,8157,8745,TRUE,0.203833275026238,2020,2020-2021
NV,2020-08-31,inter-total,82,5,0,4,4,7,3,3,3,398,51,560,133,138,TRUE,0.2375,2020,2020-2021
NV,2020-08-31,inter-ucfe,0,0,0,0,0,0,0,0,0,0,0,0,0,0,TRUE,0,2020,2020-2021
NV,2020-08-31,inter-ucx,0,0,0,0,0,0,0,0,0,0,0,0,0,0,TRUE,0,2020,2020-2021
NV,2020-08-31,inter-ui,82,5,0,4,4,7,3,3,3,398,51,560,133,138,TRUE,0.2375,2020,2020-2021
NV,2020-08-31,intra-total,5313,374,247,217,156,165,129,127,157,14016,2282,23183,7595,7969,TRUE,0.32761074925592,2020,2020-2021
NV,2020-08-31,intra-ucfe,9,0,2,0,0,1,0,0,0,4,3,19,12,12,TRUE,0.631578947368421,2020,2020-2021
NV,2020-08-31,intra-ucx,10,2,1,0,0,2,0,1,0,16,5,37,15,17,TRUE,0.405405405405405,2020,2020-2021
NV,2020-08-31,intra-ui,5294,372,244,217,156,162,129,126,157,13996,2274,23127,7568,7940,TRUE,0.327236563324253,2020,2020-2021
NV,2020-09-30,inter-total,77,8,3,5,4,3,0,4,3,119,75,301,152,160,TRUE,0.504983388704319,2020,2020-2021
NV,2020-09-30,inter-ucfe,0,0,0,0,1,0,0,0,0,0,0,1,0,0,TRUE,0,2020,2020-2021
NV,2020-09-30,inter-ucx,0,0,0,0,0,0,0,0,0,0,0,0,0,0,TRUE,0,2020,2020-2021
NV,2020-09-30,inter-ui,77,8,3,5,3,3,0,4,3,119,75,300,152,160,TRUE,0.506666666666667,2020,2020-2021
NV,2020-09-30,intra-total,3840,312,281,299,302,146,154,126,142,5070,2935,13607,6775,7087,TRUE,0.497905489821416,2020,2020-2021
NV,2020-09-30,intra-ucfe,4,3,0,1,3,0,0,0,0,8,3,22,7,10,TRUE,0.318181818181818,2020,2020-2021
NV,2020-09-30,intra-ucx,7,3,0,1,0,2,1,1,1,13,6,35,13,16,TRUE,0.371428571428571,2020,2020-2021
NV,2020-09-30,intra-ui,3829,306,281,297,299,144,153,125,141,5049,2926,13550,6755,7061,TRUE,0.498523985239852,2020,2020-2021
NV,2020-10-31,inter-total,113,4,3,4,2,2,4,1,7,169,160,469,273,277,TRUE,0.582089552238806,2020,2020-2021
NV,2020-10-31,inter-ucfe,0,0,0,0,0,0,0,0,0,0,0,0,0,0,TRUE,0,2020,2020-2021
NV,2020-10-31,inter-ucx,0,0,0,0,0,0,0,0,0,0,0,0,0,0,TRUE,0,2020,2020-2021
NV,2020-10-31,inter-ui,113,4,3,4,2,2,4,1,7,169,160,469,273,277,TRUE,0.582089552238806,2020,2020-2021
NV,2020-10-31,intra-total,4866,228,179,115,136,101,115,171,251,9106,3364,18632,8230,8458,TRUE,0.441713181623014,2020,2020-2021
NV,2020-10-31,intra-ucfe,3,0,0,1,1,0,0,0,0,16,2,23,5,5,TRUE,0.217391304347826,2020,2020-2021
NV,2020-10-31,intra-ucx,4,0,2,1,1,0,0,0,2,11,7,28,11,11,TRUE,0.392857142857143,2020,2020-2021
NV,2020-10-31,intra-ui,4859,228,177,113,134,101,115,171,249,9079,3355,18581,8214,8442,TRUE,0.442064474463161,2020,2020-2021
NV,2020-11-30,inter-total,13,4,5,2,4,1,0,2,1,95,33,160,46,50,TRUE,0.2875,2020,2020-2021
NV,2020-11-30,inter-ucfe,0,0,0,0,0,0,0,0,0,1,0,1,0,0,TRUE,0,2020,2020-2021
NV,2020-11-30,inter-ucx,0,0,0,0,0,0,0,0,0,0,0,0,0,0,TRUE,0,2020,2020-2021
NV,2020-11-30,inter-ui,13,4,5,2,4,1,0,2,1,94,33,159,46,50,TRUE,0.289308176100629,2020,2020-2021
NV,2020-11-30,intra-total,1961,204,155,109,73,61,98,50,41,4448,2018,9218,3979,4183,TRUE,0.431655456715123,2020,2020-2021
NV,2020-11-30,intra-ucfe,1,3,2,1,0,1,0,1,0,9,2,20,3,6,TRUE,0.15,2020,2020-2021
NV,2020-11-30,intra-ucx,4,0,1,2,3,1,1,0,0,3,6,21,10,10,TRUE,0.476190476190476,2020,2020-2021
NV,2020-11-30,intra-ui,1956,201,152,106,70,59,97,49,41,4436,2010,9177,3966,4167,TRUE,0.432167374959137,2020,2020-2021
NV,2020-12-31,inter-total,32,3,5,6,3,2,0,1,3,136,24,215,56,59,TRUE,0.26046511627907,2020,2020-2021
NV,2020-12-31,inter-ucfe,0,1,0,0,0,1,0,0,0,0,1,3,1,2,TRUE,0.333333333333333,2020,2020-2021
NV,2020-12-31,inter-ucx,0,0,0,0,0,0,0,0,0,0,0,0,0,0,TRUE,0,2020,2020-2021
NV,2020-12-31,inter-ui,32,2,5,6,3,1,0,1,3,136,23,212,55,57,TRUE,0.259433962264151,2020,2020-2021
NV,2020-12-31,intra-total,3687,196,165,126,115,101,64,62,65,5224,1845,11650,5532,5728,TRUE,0.474849785407725,2020,2020-2021
NV,2020-12-31,intra-ucfe,3,2,3,1,5,2,2,3,1,15,3,40,6,8,TRUE,0.15,2020,2020-2021
NV,2020-12-31,intra-ucx,3,0,0,1,0,1,0,1,1,6,5,18,8,8,TRUE,0.444444444444444,2020,2020-2021
NV,2020-12-31,intra-ui,3681,194,162,124,110,98,62,58,63,5203,1837,11592,5518,5712,TRUE,0.476017943409248,2020,2020-2021
NV,2021-01-31,inter-total,26,1,4,3,4,8,1,7,3,128,29,214,55,56,TRUE,0.257009345794393,2020,2020-2021
NV,2021-01-31,inter-ucfe,0,0,0,0,1,0,0,1,0,1,3,6,3,3,TRUE,0.5,2020,2020-2021
NV,2021-01-31,inter-ucx,0,0,0,0,0,0,0,0,0,0,0,0,0,0,TRUE,0,2020,2020-2021
NV,2021-01-31,inter-ui,26,1,4,3,3,8,1,6,3,127,26,208,52,53,TRUE,0.25,2020,2020-2021
NV,2021-01-31,intra-total,3759,307,194,156,131,188,173,154,145,5567,2586,13360,6345,6652,TRUE,0.474925149700599,2020,2020-2021
NV,2021-01-31,intra-ucfe,2,5,5,1,3,0,5,2,3,19,15,60,17,22,TRUE,0.283333333333333,2020,2020-2021
NV,2021-01-31,intra-ucx,0,0,1,0,0,0,0,0,0,17,2,20,2,2,TRUE,0.1,2020,2020-2021
NV,2021-01-31,intra-ui,3757,302,188,155,128,188,168,152,142,5531,2569,13280,6326,6628,TRUE,0.476355421686747,2020,2020-2021
NV,2021-02-28,inter-total,14,2,3,1,2,2,2,1,6,87,15,135,29,31,TRUE,0.214814814814815,2020,2020-2021
NV,2021-02-28,inter-ucfe,1,1,0,0,0,0,0,0,0,1,0,3,1,2,TRUE,0.333333333333333,2020,2020-2021
NV,2021-02-28,inter-ucx,0,0,0,0,0,0,0,0,0,0,0,0,0,0,TRUE,0,2020,2020-2021
NV,2021-02-28,inter-ui,13,1,3,1,2,2,2,1,6,86,15,132,28,29,TRUE,0.212121212121212,2020,2020-2021
NV,2021-02-28,intra-total,3130,190,162,99,109,123,111,70,58,3087,3107,10246,6237,6427,TRUE,0.60872535623658,2020,2020-2021
NV,2021-02-28,intra-ucfe,3,2,1,2,0,0,2,2,3,16,5,36,8,10,TRUE,0.222222222222222,2020,2020-2021
NV,2021-02-28,intra-ucx,6,1,0,1,0,0,1,0,0,6,0,15,6,7,TRUE,0.4,2020,2020-2021
NV,2021-02-28,intra-ui,3121,187,161,96,109,123,108,68,55,3065,3102,10195,6223,6410,TRUE,0.610397253555665,2020,2020-2021
NV,2021-03-31,inter-total,56,3,6,6,4,5,6,6,1,109,17,219,73,76,TRUE,0.333333333333333,2020,2020-2021
NV,2021-03-31,inter-ucfe,1,1,0,1,0,0,0,1,0,3,0,7,1,2,TRUE,0.142857142857143,2020,2020-2021
NV,2021-03-31,inter-ucx,0,0,1,0,0,0,0,0,0,0,0,1,0,0,TRUE,0,2020,2020-2021
NV,2021-03-31,inter-ui,55,2,5,5,4,5,6,5,1,106,17,211,72,74,TRUE,0.341232227488152,2020,2020-2021
NV,2021-03-31,intra-total,13080,172,133,101,113,154,259,144,80,3189,6029,23454,19109,19281,TRUE,0.814743753730707,2020,2020-2021
NV,2021-03-31,intra-ucfe,1,0,0,0,1,0,1,2,0,27,2,34,3,3,TRUE,0.0882352941176471,2020,2020-2021
NV,2021-03-31,intra-ucx,8,2,1,0,0,0,2,0,2,6,3,24,11,13,TRUE,0.458333333333333,2020,2020-2021
NV,2021-03-31,intra-ui,13071,170,132,101,112,154,256,142,78,3156,6024,23396,19095,19265,TRUE,0.816165156436998,2020,2020-2021
NV,2021-04-30,inter-total,128,8,5,4,4,2,3,4,2,72,58,290,186,194,TRUE,0.641379310344828,2020,2020-2021
NV,2021-04-30,inter-ucfe,0,0,0,0,0,0,0,0,0,1,1,2,1,1,TRUE,0.5,2020,2020-2021
NV,2021-04-30,inter-ucx,0,0,0,0,0,0,0,0,0,0,0,0,0,0,TRUE,0,2020,2020-2021
NV,2021-04-30,inter-ui,128,8,5,4,4,2,3,4,2,71,57,288,185,193,TRUE,0.642361111111111,2020,2020-2021
NV,2021-04-30,intra-total,19060,552,287,182,115,169,127,74,66,3084,10699,34415,29759,30311,TRUE,0.86471015545547,2020,2020-2021
NV,2021-04-30,intra-ucfe,4,1,1,3,0,1,0,0,0,21,5,36,9,10,TRUE,0.25,2020,2020-2021
NV,2021-04-30,intra-ucx,3,2,1,1,1,0,1,2,0,7,7,25,10,12,TRUE,0.4,2020,2020-2021
NV,2021-04-30,intra-ui,19053,549,285,178,114,168,126,72,66,3056,10687,34354,29740,30289,TRUE,0.86569249577924,2020,2020-2021
NV,2021-05-31,inter-total,32,3,2,3,1,4,3,2,2,68,27,147,59,62,TRUE,0.401360544217687,2020,2020-2021
NV,2021-05-31,inter-ucfe,0,0,0,0,0,0,0,0,0,2,1,3,1,1,TRUE,0.333333333333333,2020,2020-2021
NV,2021-05-31,inter-ucx,0,0,0,0,0,0,0,0,0,0,0,0,0,0,TRUE,0,2020,2020-2021
NV,2021-05-31,inter-ui,32,3,2,3,1,4,3,2,2,66,26,144,58,61,TRUE,0.402777777777778,2020,2020-2021
NV,2021-05-31,intra-total,3945,288,226,153,152,180,156,121,76,2650,2363,10310,6308,6596,TRUE,0.611833171677983,2020,2020-2021
NV,2021-05-31,intra-ucfe,1,0,1,1,0,0,1,0,0,18,1,23,2,2,TRUE,0.0869565217391304,2020,2020-2021
NV,2021-05-31,intra-ucx,0,1,1,1,0,0,0,0,0,10,2,15,2,3,TRUE,0.133333333333333,2020,2020-2021
NV,2021-05-31,intra-ui,3944,287,224,151,152,180,155,121,76,2622,2360,10272,6304,6591,TRUE,0.613707165109034,2020,2020-2021
NV,2021-06-30,inter-total,26,3,4,1,3,0,0,2,2,65,19,125,45,48,TRUE,0.36,2020,2020-2021
NV,2021-06-30,inter-ucfe,0,0,0,0,0,0,0,0,0,3,1,4,1,1,TRUE,0.25,2020,2020-2021
NV,2021-06-30,inter-ucx,0,0,0,0,0,0,0,0,0,0,0,0,0,0,TRUE,0,2020,2020-2021
NV,2021-06-30,inter-ui,26,3,4,1,3,0,0,2,2,62,18,121,44,47,TRUE,0.363636363636364,2020,2020-2021
NV,2021-06-30,intra-total,2246,173,105,91,117,89,128,184,287,2980,1345,7745,3591,3764,TRUE,0.463653970303422,2020,2020-2021
NV,2021-06-30,intra-ucfe,2,1,0,1,0,0,1,0,0,12,1,18,3,4,TRUE,0.166666666666667,2020,2020-2021
NV,2021-06-30,intra-ucx,3,2,1,0,1,0,0,0,0,8,3,18,6,8,TRUE,0.333333333333333,2020,2020-2021
NV,2021-06-30,intra-ui,2241,170,104,90,116,89,127,184,287,2960,1341,7709,3582,3752,TRUE,0.464651705798417,2020,2020-2021
NV,2021-07-31,inter-total,16,5,3,2,2,0,1,6,3,52,14,104,30,35,TRUE,0.288461538461538,2021,2021-2022
NV,2021-07-31,inter-ucfe,0,0,0,0,0,0,0,1,0,1,0,2,0,0,TRUE,0,2021,2021-2022
NV,2021-07-31,inter-ucx,0,0,0,0,0,0,0,0,0,0,0,0,0,0,TRUE,0,2021,2021-2022
NV,2021-07-31,inter-ui,16,5,3,2,2,0,1,5,3,51,14,102,30,35,TRUE,0.294117647058824,2021,2021-2022
NV,2021-07-31,intra-total,1754,125,87,75,45,57,86,166,158,2491,1259,6303,3013,3138,TRUE,0.47802633666508,2021,2021-2022
NV,2021-07-31,intra-ucfe,0,0,0,0,0,0,1,0,0,12,3,16,3,3,TRUE,0.1875,2021,2021-2022
NV,2021-07-31,intra-ucx,2,0,0,0,0,0,1,0,0,4,5,12,7,7,TRUE,0.583333333333333,2021,2021-2022
NV,2021-07-31,intra-ui,1752,125,87,75,45,57,84,166,158,2475,1251,6275,3003,3128,TRUE,0.478565737051793,2021,2021-2022
NV,2021-08-31,inter-total,12,4,4,4,2,0,1,1,1,85,15,129,27,31,TRUE,0.209302325581395,2021,2021-2022
NV,2021-08-31,inter-ucfe,0,0,0,0,0,0,0,0,0,0,0,0,0,0,TRUE,0,2021,2021-2022
NV,2021-08-31,inter-ucx,0,0,0,0,0,0,0,0,0,0,0,0,0,0,TRUE,0,2021,2021-2022
NV,2021-08-31,inter-ui,12,4,4,4,2,0,1,1,1,85,15,129,27,31,TRUE,0.209302325581395,2021,2021-2022
NV,2021-08-31,intra-total,1199,137,91,72,67,72,158,85,124,2411,860,5276,2059,2196,TRUE,0.390257771038666,2021,2021-2022
NV,2021-08-31,intra-ucfe,2,0,0,0,0,0,2,1,0,15,3,23,5,5,TRUE,0.217391304347826,2021,2021-2022
NV,2021-08-31,intra-ucx,3,0,0,2,1,0,0,0,0,5,4,15,7,7,TRUE,0.466666666666667,2021,2021-2022
NV,2021-08-31,intra-ui,1194,137,91,70,66,72,156,84,124,2391,853,5238,2047,2184,TRUE,0.390798014509355,2021,2021-2022
NV,2021-09-30,inter-total,77,8,3,5,4,3,0,4,3,119,75,301,152,160,TRUE,0.504983388704319,2021,2021-2022
NV,2021-09-30,inter-ucfe,0,0,0,0,1,0,0,0,0,0,0,1,0,0,TRUE,0,2021,2021-2022
NV,2021-09-30,inter-ucx,0,0,0,0,0,0,0,0,0,0,0,0,0,0,TRUE,0,2021,2021-2022
NV,2021-09-30,inter-ui,77,8,3,5,3,3,0,4,3,119,75,300,152,160,TRUE,0.506666666666667,2021,2021-2022
NV,2021-09-30,intra-total,3840,312,281,299,302,146,154,126,142,5070,2935,13607,6775,7087,TRUE,0.497905489821416,2021,2021-2022
NV,2021-09-30,intra-ucfe,4,3,0,1,3,0,0,0,0,8,3,22,7,10,TRUE,0.318181818181818,2021,2021-2022
NV,2021-09-30,intra-ucx,7,3,0,1,0,2,1,1,1,13,6,35,13,16,TRUE,0.371428571428571,2021,2021-2022
NV,2021-09-30,intra-ui,3829,306,281,297,299,144,153,125,141,5049,2926,13550,6755,7061,TRUE,0.498523985239852,2021,2021-2022
NV,2021-10-31,inter-total,35,2,0,0,0,0,1,1,0,36,14,89,49,51,TRUE,0.550561797752809,2021,2021-2022
NV,2021-10-31,inter-ucfe,0,0,0,0,0,0,0,0,0,1,1,2,1,1,TRUE,0.5,2021,2021-2022
NV,2021-10-31,inter-ucx,0,0,0,0,0,0,0,0,0,0,0,0,0,0,TRUE,0,2021,2021-2022
NV,2021-10-31,inter-ui,35,2,0,0,0,0,1,1,0,35,13,87,48,50,TRUE,0.551724137931035,2021,2021-2022
NV,2021-10-31,intra-total,3473,113,56,34,27,21,34,19,19,1184,961,5941,4434,4547,TRUE,0.746339000168322,2021,2021-2022
NV,2021-10-31,intra-ucfe,2,1,0,0,0,0,0,0,0,3,4,10,6,7,TRUE,0.6,2021,2021-2022
NV,2021-10-31,intra-ucx,0,2,1,0,1,0,0,0,0,1,5,10,5,7,TRUE,0.5,2021,2021-2022
NV,2021-10-31,intra-ui,3471,110,55,34,26,21,34,19,19,1180,952,5921,4423,4533,TRUE,0.747002195575072,2021,2021-2022
NV,2021-11-30,inter-total,8,2,2,1,1,1,0,1,0,20,17,53,25,27,TRUE,0.471698113207547,2021,2021-2022
NV,2021-11-30,inter-ucfe,2,0,0,0,0,0,0,1,0,0,0,3,2,2,TRUE,0.666666666666667,2021,2021-2022
NV,2021-11-30,inter-ucx,0,0,0,0,0,0,0,0,0,0,0,0,0,0,TRUE,0,2021,2021-2022
NV,2021-11-30,inter-ui,6,2,2,1,1,1,0,0,0,20,17,50,23,25,TRUE,0.46,2021,2021-2022
NV,2021-11-30,intra-total,812,119,89,51,35,36,31,23,24,997,896,3113,1708,1827,TRUE,0.548666880822358,2021,2021-2022
NV,2021-11-30,intra-ucfe,2,2,2,0,0,0,0,0,0,3,12,21,14,16,TRUE,0.666666666666667,2021,2021-2022
NV,2021-11-30,intra-ucx,2,2,0,1,0,1,0,0,0,2,0,8,2,4,TRUE,0.25,2021,2021-2022
NV,2021-11-30,intra-ui,808,115,87,50,35,35,31,23,24,992,884,3084,1692,1807,TRUE,0.54863813229572,2021,2021-2022
NV,2021-12-31,inter-total,12,5,3,1,3,1,1,1,2,21,16,66,28,33,TRUE,0.424242424242424,2021,2021-2022
NV,2021-12-31,inter-ucfe,0,2,0,0,2,1,0,0,0,0,2,7,2,4,TRUE,0.285714285714286,2021,2021-2022
NV,2021-12-31,inter-ucx,0,0,0,0,0,0,0,0,1,0,0,1,0,0,TRUE,0,2021,2021-2022
NV,2021-12-31,inter-ui,12,3,3,1,1,0,1,1,1,21,14,58,26,29,TRUE,0.448275862068966,2021,2021-2022
NV,2021-12-31,intra-total,1160,108,96,61,42,37,28,37,33,1047,849,3498,2009,2117,TRUE,0.574328187535735,2021,2021-2022
NV,2021-12-31,intra-ucfe,6,1,4,3,0,1,1,0,0,5,7,28,13,14,TRUE,0.464285714285714,2021,2021-2022
NV,2021-12-31,intra-ucx,0,0,0,0,2,0,0,0,0,8,1,11,1,1,TRUE,0.0909090909090909,2021,2021-2022
NV,2021-12-31,intra-ui,1154,107,92,58,40,36,27,37,33,1034,841,3459,1995,2102,TRUE,0.576756287944493,2021,2021-2022
NV,2022-01-31,inter-total,25,3,1,0,1,3,0,2,2,35,24,96,49,52,TRUE,0.510416666666667,2021,2021-2022
NV,2022-01-31,inter-ucfe,0,1,0,0,0,0,0,0,1,0,2,4,2,3,TRUE,0.5,2021,2021-2022
NV,2022-01-31,inter-ucx,0,0,0,0,0,0,0,0,0,0,0,0,0,0,TRUE,0,2021,2021-2022
NV,2022-01-31,inter-ui,25,2,1,0,1,3,0,2,1,35,22,92,47,49,TRUE,0.510869565217391,2021,2021-2022
NV,2022-01-31,intra-total,1547,178,86,59,42,31,32,25,18,1293,1296,4607,2843,3021,TRUE,0.617104406338181,2021,2021-2022
NV,2022-01-31,intra-ucfe,3,4,3,2,1,0,1,0,0,3,17,34,20,24,TRUE,0.588235294117647,2021,2021-2022
NV,2022-01-31,intra-ucx,0,0,0,0,0,0,1,0,0,4,3,8,3,3,TRUE,0.375,2021,2021-2022
NV,2022-01-31,intra-ui,1544,174,83,57,41,31,30,25,18,1286,1276,4565,2820,2994,TRUE,0.617743702081051,2021,2021-2022
NV,2022-02-28,inter-total,5,1,1,0,0,0,2,2,2,22,11,46,16,17,TRUE,0.347826086956522,2021,2021-2022
NV,2022-02-28,inter-ucfe,0,0,0,0,0,0,0,0,0,2,1,3,1,1,TRUE,0.333333333333333,2021,2021-2022
NV,2022-02-28,inter-ucx,0,0,0,0,0,0,0,0,0,0,0,0,0,0,TRUE,0,2021,2021-2022
NV,2022-02-28,inter-ui,5,1,1,0,0,0,2,2,2,20,10,43,15,16,TRUE,0.348837209302326,2021,2021-2022
NV,2022-02-28,intra-total,864,112,86,63,50,52,48,38,28,928,700,2969,1564,1676,TRUE,0.526776692489054,2021,2021-2022
NV,2022-02-28,intra-ucfe,4,0,0,1,1,1,0,0,0,7,6,20,10,10,TRUE,0.5,2021,2021-2022
NV,2022-02-28,intra-ucx,1,0,2,1,0,0,0,0,0,4,1,9,2,2,TRUE,0.222222222222222,2021,2021-2022
NV,2022-02-28,intra-ui,859,112,84,61,49,51,48,38,28,917,693,2940,1552,1664,TRUE,0.527891156462585,2021,2021-2022
NV,2022-03-31,inter-total,14,4,3,1,1,0,3,0,1,38,11,76,25,29,TRUE,0.328947368421053,2021,2021-2022
NV,2022-03-31,inter-ucfe,0,0,0,0,0,0,0,0,0,4,0,4,0,0,TRUE,0,2021,2021-2022
NV,2022-03-31,inter-ucx,0,0,0,0,0,0,0,0,0,0,0,0,0,0,TRUE,0,2021,2021-2022
NV,2022-03-31,inter-ui,14,4,3,1,1,0,3,0,1,34,11,72,25,29,TRUE,0.347222222222222,2021,2021-2022
NV,2022-03-31,intra-total,840,167,112,94,76,74,77,63,58,1307,669,3537,1509,1676,TRUE,0.426632739609839,2021,2021-2022
NV,2022-03-31,intra-ucfe,3,0,0,0,2,0,0,0,0,8,2,15,5,5,TRUE,0.333333333333333,2021,2021-2022
NV,2022-03-31,intra-ucx,2,3,1,0,2,3,0,0,0,11,7,29,9,12,TRUE,0.310344827586207,2021,2021-2022
NV,2022-03-31,intra-ui,835,164,111,94,72,71,77,63,58,1288,660,3493,1495,1659,TRUE,0.427998854852562,2021,2021-2022
NV,2022-04-30,inter-total,20,1,1,0,1,0,1,1,0,14,16,55,36,37,TRUE,0.654545454545455,2021,2021-2022
NV,2022-04-30,inter-ucfe,0,0,0,0,0,0,0,0,0,0,0,0,0,0,TRUE,0,2021,2021-2022
NV,2022-04-30,inter-ucx,0,0,0,0,0,0,0,0,0,0,0,0,0,0,TRUE,0,2021,2021-2022
NV,2022-04-30,inter-ui,20,1,1,0,1,0,1,1,0,14,16,55,36,37,TRUE,0.654545454545455,2021,2021-2022
NV,2022-04-30,intra-total,1153,77,39,43,26,31,22,23,27,843,809,3093,1962,2039,TRUE,0.634335596508245,2021,2021-2022
NV,2022-04-30,intra-ucfe,5,1,0,0,0,2,0,0,2,9,2,21,7,8,TRUE,0.333333333333333,2021,2021-2022
NV,2022-04-30,intra-ucx,4,0,0,0,0,0,0,0,0,3,6,13,10,10,TRUE,0.769230769230769,2021,2021-2022
NV,2022-04-30,intra-ui,1144,76,39,43,26,29,22,23,25,831,801,3059,1945,2021,TRUE,0.635828702190258,2021,2021-2022
NV,2022-05-31,inter-total,17,3,1,1,0,0,0,1,0,19,10,52,27,30,TRUE,0.519230769230769,2021,2021-2022
NV,2022-05-31,inter-ucfe,0,0,0,0,0,0,0,1,0,1,0,2,0,0,TRUE,0,2021,2021-2022
NV,2022-05-31,inter-ucx,0,0,0,0,0,0,0,0,0,0,0,0,0,0,TRUE,0,2021,2021-2022
NV,2022-05-31,inter-ui,17,3,1,1,0,0,0,0,0,18,10,50,27,30,TRUE,0.54,2021,2021-2022
NV,2022-05-31,intra-total,851,104,80,59,32,27,20,18,17,986,825,3019,1676,1780,TRUE,0.555150712156343,2021,2021-2022
NV,2022-05-31,intra-ucfe,1,0,0,0,1,0,1,0,1,6,0,10,1,1,TRUE,0.1,2021,2021-2022
NV,2022-05-31,intra-ucx,0,0,1,0,0,1,0,0,0,1,1,4,1,1,TRUE,0.25,2021,2021-2022
NV,2022-05-31,intra-ui,850,104,79,59,31,26,19,18,16,979,824,3005,1674,1778,TRUE,0.557071547420965,2021,2021-2022
NV,2022-06-30,inter-total,14,1,2,2,0,1,0,1,0,22,9,52,23,24,TRUE,0.442307692307692,2021,2021-2022
NV,2022-06-30,inter-ucfe,0,0,0,1,0,0,0,0,0,0,0,1,0,0,TRUE,0,2021,2021-2022
NV,2022-06-30,inter-ucx,0,0,0,0,0,0,0,0,0,0,0,0,0,0,TRUE,0,2021,2021-2022
NV,2022-06-30,inter-ui,14,1,2,1,0,1,0,1,0,22,9,51,23,24,TRUE,0.450980392156863,2021,2021-2022
NV,2022-06-30,intra-total,953,109,69,50,41,39,30,29,26,980,759,3085,1712,1821,TRUE,0.554943273905997,2021,2021-2022
NV,2022-06-30,intra-ucfe,1,0,0,0,0,0,0,0,0,4,4,9,5,5,TRUE,0.555555555555556,2021,2021-2022
NV,2022-06-30,intra-ucx,2,0,0,0,1,1,1,0,0,3,0,8,2,2,TRUE,0.25,2021,2021-2022
NV,2022-06-30,intra-ui,950,109,69,50,40,38,29,29,26,973,755,3068,1705,1814,TRUE,0.555736636245111,2021,2021-2022
NV,2022-07-31,inter-total,18,1,4,1,0,0,0,1,1,36,14,76,32,33,TRUE,0.421052631578947,2022,2022-2023
NV,2022-07-31,inter-ucfe,0,0,0,0,0,0,0,0,0,0,0,0,0,0,TRUE,0,2022,2022-2023
NV,2022-07-31,inter-ucx,0,0,0,0,0,0,0,0,0,0,0,0,0,0,TRUE,0,2022,2022-2023
NV,2022-07-31,inter-ui,18,1,4,1,0,0,0,1,1,36,14,76,32,33,TRUE,0.421052631578947,2022,2022-2023
NV,2022-07-31,intra-total,1322,167,70,65,51,29,29,44,15,1252,1091,4135,2413,2580,TRUE,0.583555018137848,2022,2022-2023
NV,2022-07-31,intra-ucfe,0,0,0,0,1,0,0,0,0,8,2,11,2,2,TRUE,0.181818181818182,2022,2022-2023
NV,2022-07-31,intra-ucx,2,1,0,0,0,0,0,0,1,0,0,4,2,3,TRUE,0.5,2022,2022-2023
NV,2022-07-31,intra-ui,1320,166,70,65,50,29,29,44,14,1244,1089,4120,2409,2575,TRUE,0.584708737864078,2022,2022-2023
NV,2022-08-31,inter-total,15,3,10,4,2,2,1,3,2,40,62,144,77,80,TRUE,0.534722222222222,2022,2022-2023
NV,2022-08-31,inter-ucfe,0,0,0,0,0,0,0,0,2,0,0,2,0,0,TRUE,0,2022,2022-2023
NV,2022-08-31,inter-ucx,0,0,0,0,0,0,0,0,0,0,0,0,0,0,TRUE,0,2022,2022-2023
NV,2022-08-31,inter-ui,15,3,10,4,2,2,1,3,0,40,62,142,77,80,TRUE,0.542253521126761,2022,2022-2023
NV,2022-08-31,intra-total,1144,165,126,74,57,48,36,37,31,1543,1142,4403,2286,2451,TRUE,0.519191460367931,2022,2022-2023
NV,2022-08-31,intra-ucfe,0,0,2,0,1,0,0,0,0,6,1,10,1,1,TRUE,0.1,2022,2022-2023
NV,2022-08-31,intra-ucx,4,0,2,0,0,0,0,0,0,5,5,16,9,9,TRUE,0.5625,2022,2022-2023
NV,2022-08-31,intra-ui,1140,165,122,74,56,48,36,37,31,1532,1136,4377,2276,2441,TRUE,0.519990861320539,2022,2022-2023
NV,2022-09-30,inter-total,18,5,2,2,2,2,1,1,1,36,17,87,35,40,TRUE,0.402298850574713,2022,2022-2023
NV,2022-09-30,inter-ucfe,0,0,0,0,0,0,0,0,0,1,0,1,0,0,TRUE,0,2022,2022-2023
NV,2022-09-30,inter-ucx,0,0,0,0,0,0,0,0,0,0,0,0,0,0,TRUE,0,2022,2022-2023
NV,2022-09-30,inter-ui,18,5,2,2,2,2,1,1,1,35,17,86,35,40,TRUE,0.406976744186047,2022,2022-2023
NV,2022-09-30,intra-total,953,113,64,45,46,36,29,26,24,1816,770,3922,1723,1836,TRUE,0.439316675165732,2022,2022-2023
NV,2022-09-30,intra-ucfe,0,0,0,0,0,0,0,0,1,8,1,10,1,1,TRUE,0.1,2022,2022-2023
NV,2022-09-30,intra-ucx,1,0,1,0,0,0,1,2,0,2,7,14,8,8,TRUE,0.571428571428571,2022,2022-2023
NV,2022-09-30,intra-ui,952,113,63,45,46,36,28,24,23,1806,762,3898,1714,1827,TRUE,0.439712673165726,2022,2022-2023
NV,2022-10-31,inter-total,15,2,1,2,1,0,0,1,2,37,23,84,38,40,TRUE,0.452380952380952,2022,2022-2023
NV,2022-10-31,inter-ucfe,0,0,0,0,0,0,0,0,0,0,1,1,1,1,TRUE,1,2022,2022-2023
NV,2022-10-31,inter-ucx,0,0,0,0,0,0,0,0,0,0,0,0,0,0,TRUE,0,2022,2022-2023
NV,2022-10-31,inter-ui,15,2,1,2,1,0,0,1,2,37,22,83,37,39,TRUE,0.445783132530121,2022,2022-2023
NV,2022-10-31,intra-total,914,101,66,30,26,25,24,22,15,1761,828,3812,1742,1843,TRUE,0.45697796432319,2022,2022-2023
NV,2022-10-31,intra-ucfe,1,0,0,0,0,0,0,0,0,11,2,14,3,3,TRUE,0.214285714285714,2022,2022-2023
NV,2022-10-31,intra-ucx,2,0,0,1,0,0,0,0,0,1,5,9,7,7,TRUE,0.777777777777778,2022,2022-2023
NV,2022-10-31,intra-ui,911,101,66,29,26,25,24,22,15,1749,821,3789,1732,1833,TRUE,0.457112694642386,2022,2022-2023
NV,2022-11-30,inter-total,16,4,0,0,1,1,1,0,2,30,37,92,53,57,TRUE,0.576086956521739,2022,2022-2023
NV,2022-11-30,inter-ucfe,0,0,0,0,0,0,0,0,0,0,0,0,0,0,TRUE,0,2022,2022-2023
NV,2022-11-30,inter-ucx,0,0,0,0,0,0,0,0,0,0,0,0,0,0,TRUE,0,2022,2022-2023
NV,2022-11-30,inter-ui,16,4,0,0,1,1,1,0,2,30,37,92,53,57,TRUE,0.576086956521739,2022,2022-2023
NV,2022-11-30,intra-total,1033,150,74,44,43,24,24,24,16,1173,1393,3998,2426,2576,TRUE,0.606803401700851,2022,2022-2023
NV,2022-11-30,intra-ucfe,2,2,3,1,0,0,0,0,0,8,6,22,8,10,TRUE,0.363636363636364,2022,2022-2023
NV,2022-11-30,intra-ucx,4,0,0,0,0,0,0,0,0,3,2,9,6,6,TRUE,0.666666666666667,2022,2022-2023
NV,2022-11-30,intra-ui,1027,148,71,43,43,24,24,24,16,1162,1385,3967,2412,2560,TRUE,0.608016133098059,2022,2022-2023
NV,2022-12-31,inter-total,37,5,3,1,0,1,2,3,1,38,37,128,74,79,TRUE,0.578125,2022,2022-2023
NV,2022-12-31,inter-ucfe,0,1,0,0,0,0,0,0,0,1,3,5,3,4,TRUE,0.6,2022,2022-2023
NV,2022-12-31,inter-ucx,0,0,0,0,0,0,0,0,0,0,0,0,0,0,TRUE,0,2022,2022-2023
NV,2022-12-31,inter-ui,37,4,3,1,0,1,2,3,1,37,34,123,71,75,TRUE,0.577235772357724,2022,2022-2023
NV,2022-12-31,intra-total,1753,170,112,80,64,39,47,50,35,1956,1286,5592,3039,3209,TRUE,0.543454935622318,2022,2022-2023
NV,2022-12-31,intra-ucfe,4,0,0,0,2,0,0,0,0,9,11,26,15,15,TRUE,0.576923076923077,2022,2022-2023
NV,2022-12-31,intra-ucx,0,0,0,1,1,0,1,0,0,2,1,6,1,1,TRUE,0.166666666666667,2022,2022-2023
NV,2022-12-31,intra-ui,1749,170,112,79,61,39,46,50,35,1945,1274,5560,3023,3193,TRUE,0.543705035971223,2022,2022-2023
NV,2023-01-31,inter-total,23,3,3,1,1,2,4,1,3,46,44,131,67,70,TRUE,0.511450381679389,2022,2022-2023
NV,2023-01-31,inter-ucfe,0,0,0,0,0,0,1,0,0,2,1,4,1,1,TRUE,0.25,2022,2022-2023
NV,2023-01-31,inter-ucx,0,0,0,0,0,0,0,0,0,0,0,0,0,0,TRUE,0,2022,2022-2023
NV,2023-01-31,inter-ui,23,3,3,1,1,2,3,1,3,44,43,127,66,69,TRUE,0.519685039370079,2022,2022-2023
NV,2023-01-31,intra-total,1950,311,187,91,67,36,46,34,36,1763,2141,6662,4091,4402,TRUE,0.614079855899129,2022,2022-2023
NV,2023-01-31,intra-ucfe,5,3,2,1,1,0,0,1,1,6,19,39,24,27,TRUE,0.615384615384615,2022,2022-2023
NV,2023-01-31,intra-ucx,0,0,0,0,1,0,0,0,0,4,3,8,3,3,TRUE,0.375,2022,2022-2023
NV,2023-01-31,intra-ui,1945,308,185,90,65,36,46,33,35,1753,2119,6615,4064,4372,TRUE,0.614361300075586,2022,2022-2023
NV,2023-02-28,inter-total,11,4,6,3,1,1,1,1,0,29,24,81,35,39,TRUE,0.432098765432099,2022,2022-2023
NV,2023-02-28,inter-ucfe,0,0,1,0,0,0,0,0,0,0,1,2,1,1,TRUE,0.5,2022,2022-2023
NV,2023-02-28,inter-ucx,0,0,0,0,0,0,0,0,0,0,0,0,0,0,TRUE,0,2022,2022-2023
NV,2023-02-28,inter-ui,11,4,5,3,1,1,1,1,0,29,23,79,34,38,TRUE,0.430379746835443,2022,2022-2023
NV,2023-02-28,intra-total,1215,256,167,116,93,85,74,74,73,1736,1230,5119,2445,2701,TRUE,0.477632350068373,2022,2022-2023
NV,2023-02-28,intra-ucfe,1,1,3,0,1,1,0,1,1,6,11,26,12,13,TRUE,0.461538461538462,2022,2022-2023
NV,2023-02-28,intra-ucx,2,0,0,0,0,0,0,0,0,8,3,13,5,5,TRUE,0.384615384615385,2022,2022-2023
NV,2023-02-28,intra-ui,1212,255,164,116,92,84,74,73,72,1722,1216,5080,2428,2683,TRUE,0.477952755905512,2022,2022-2023
NV,2023-03-31,inter-total,18,3,3,2,2,1,1,2,3,40,16,91,34,37,TRUE,0.373626373626374,2022,2022-2023
NV,2023-03-31,inter-ucfe,0,0,0,0,0,0,0,0,0,0,0,0,0,0,TRUE,0,2022,2022-2023
NV,2023-03-31,inter-ucx,0,0,0,0,0,0,0,0,1,0,0,1,0,0,TRUE,0,2022,2022-2023
NV,2023-03-31,inter-ui,18,3,3,2,2,1,1,2,2,40,16,90,34,37,TRUE,0.377777777777778,2022,2022-2023
NV,2023-03-31,intra-total,1314,173,113,82,50,51,66,59,87,1795,1192,4982,2506,2679,TRUE,0.503010839020474,2022,2022-2023
NV,2023-03-31,intra-ucfe,0,3,0,2,0,1,1,0,0,9,2,18,2,5,TRUE,0.111111111111111,2022,2022-2023
NV,2023-03-31,intra-ucx,4,0,0,0,1,0,0,0,0,3,5,13,9,9,TRUE,0.692307692307692,2022,2022-2023
NV,2023-03-31,intra-ui,1310,170,113,80,49,50,65,59,87,1783,1185,4951,2495,2665,TRUE,0.503938598262977,2022,2022-2023
NV,2023-04-30,inter-total,18,1,5,4,1,4,2,2,1,21,22,81,40,41,TRUE,0.493827160493827,2022,2022-2023
NV,2023-04-30,inter-ucfe,1,0,0,1,0,0,0,0,0,1,0,3,1,1,TRUE,0.333333333333333,2022,2022-2023
NV,2023-04-30,inter-ucx,0,0,0,0,0,0,0,0,0,0,0,0,0,0,TRUE,0,2022,2022-2023
NV,2023-04-30,inter-ui,17,1,5,3,1,4,2,2,1,20,22,78,39,40,TRUE,0.5,2022,2022-2023
NV,2023-04-30,intra-total,1240,191,103,85,78,101,91,129,136,1201,1091,4446,2331,2522,TRUE,0.524291497975709,2022,2022-2023
NV,2023-04-30,intra-ucfe,1,0,0,1,0,0,0,0,0,4,3,9,4,4,TRUE,0.444444444444444,2022,2022-2023
NV,2023-04-30,intra-ucx,2,1,0,1,1,0,0,0,0,5,3,13,5,6,TRUE,0.384615384615385,2022,2022-2023
NV,2023-04-30,intra-ui,1237,190,103,83,77,101,91,129,136,1192,1085,4424,2322,2512,TRUE,0.524864376130199,2022,2022-2023
NV,2023-05-31,inter-total,12,5,5,4,2,0,8,5,6,26,33,106,45,50,TRUE,0.424528301886792,2022,2022-2023
NV,2023-05-31,inter-ucfe,0,0,0,0,0,0,0,0,0,1,1,2,1,1,TRUE,0.5,2022,2022-2023
NV,2023-05-31,inter-ucx,0,0,0,0,0,0,0,0,0,0,0,0,0,0,TRUE,0,2022,2022-2023
NV,2023-05-31,inter-ui,12,5,5,4,2,0,8,5,6,25,32,104,44,49,TRUE,0.423076923076923,2022,2022-2023
NV,2023-05-31,intra-total,1313,211,169,142,136,209,274,356,348,933,1226,5317,2539,2750,TRUE,0.477524920067707,2022,2022-2023
NV,2023-05-31,intra-ucfe,1,1,1,0,0,0,2,2,0,8,1,16,2,3,TRUE,0.125,2022,2022-2023
NV,2023-05-31,intra-ucx,2,0,1,2,0,0,3,0,0,3,1,12,3,3,TRUE,0.25,2022,2022-2023
NV,2023-05-31,intra-ui,1310,210,167,140,136,209,269,354,348,922,1224,5289,2534,2744,TRUE,0.479107581773492,2022,2022-2023
NV,2023-06-30,inter-total,30,7,5,2,9,3,7,1,4,11,20,99,50,57,TRUE,0.505050505050505,2022,2022-2023
NV,2023-06-30,inter-ucfe,0,0,0,0,0,0,0,0,0,0,0,0,0,0,TRUE,0,2022,2022-2023
NV,2023-06-30,inter-ucx,0,0,0,0,0,0,0,0,0,0,0,0,0,0,TRUE,0,2022,2022-2023
NV,2023-06-30,inter-ui,30,7,5,2,9,3,7,1,4,11,20,99,50,57,TRUE,0.505050505050505,2022,2022-2023
NV,2023-06-30,intra-total,1466,256,218,216,422,482,347,159,88,527,1161,5342,2627,2883,TRUE,0.491763384500187,2022,2022-2023
NV,2023-06-30,intra-ucfe,0,0,0,0,0,0,0,0,1,3,1,5,1,1,TRUE,0.2,2022,2022-2023
NV,2023-06-30,intra-ucx,5,1,0,1,1,3,2,0,0,3,5,21,10,11,TRUE,0.476190476190476,2022,2022-2023
NV,2023-06-30,intra-ui,1461,255,218,215,421,479,345,159,87,521,1155,5316,2616,2871,TRUE,0.492099322799097,2022,2022-2023
NV,2023-07-31,inter-total,22,7,5,13,17,11,4,2,1,7,27,116,49,56,TRUE,0.422413793103448,2023,2023-2024
NV,2023-07-31,inter-ucfe,0,0,0,0,0,0,0,0,0,0,0,0,0,0,TRUE,0,2023,2023-2024
NV,2023-07-31,inter-ucx,0,0,0,0,0,0,0,0,0,0,0,0,0,0,TRUE,0,2023,2023-2024
NV,2023-07-31,inter-ui,22,7,5,13,17,11,4,2,1,7,27,116,49,56,TRUE,0.422413793103448,2023,2023-2024
NV,2023-07-31,intra-total,2032,362,408,536,443,281,107,56,31,360,1795,6411,3827,4189,TRUE,0.596942754640462,2023,2023-2024
NV,2023-07-31,intra-ucfe,1,1,0,2,0,0,0,0,0,3,5,12,6,7,TRUE,0.5,2023,2023-2024
NV,2023-07-31,intra-ucx,2,0,2,1,0,0,0,0,0,1,5,11,7,7,TRUE,0.636363636363636,2023,2023-2024
NV,2023-07-31,intra-ui,2029,361,406,533,443,281,107,56,31,356,1785,6388,3814,4175,TRUE,0.597056981840952,2023,2023-2024
NV,2023-08-31,inter-total,39,21,8,9,3,1,1,0,2,10,28,122,67,88,TRUE,0.549180327868853,2023,2023-2024
NV,2023-08-31,inter-ucfe,0,0,0,0,0,0,0,0,0,0,0,0,0,0,TRUE,0,2023,2023-2024
NV,2023-08-31,inter-ucx,0,0,0,0,0,0,0,0,0,0,0,0,0,0,TRUE,0,2023,2023-2024
NV,2023-08-31,inter-ui,39,21,8,9,3,1,1,0,2,10,28,122,67,88,TRUE,0.549180327868853,2023,2023-2024
NV,2023-08-31,intra-total,1943,915,565,205,100,58,45,29,28,340,1690,5918,3633,4548,TRUE,0.613889827644475,2023,2023-2024
NV,2023-08-31,intra-ucfe,0,1,1,1,1,0,0,1,1,1,0,7,0,1,TRUE,0,2023,2023-2024
NV,2023-08-31,intra-ucx,1,3,3,0,0,0,0,0,0,0,6,13,7,10,TRUE,0.538461538461538,2023,2023-2024
NV,2023-08-31,intra-ui,1942,911,561,204,99,58,45,28,27,339,1684,5898,3626,4537,TRUE,0.614784672770431,2023,2023-2024
NV,2023-09-30,inter-total,33,15,4,4,1,0,0,0,1,12,29,99,62,77,TRUE,0.626262626262626,2023,2023-2024
NV,2023-09-30,inter-ucfe,0,0,0,0,0,0,0,0,0,0,1,1,1,1,TRUE,1,2023,2023-2024
NV,2023-09-30,inter-ucx,0,0,0,0,0,0,0,0,0,0,0,0,0,0,TRUE,0,2023,2023-2024
NV,2023-09-30,inter-ui,33,15,4,4,1,0,0,0,1,12,28,98,61,76,TRUE,0.622448979591837,2023,2023-2024
NV,2023-09-30,intra-total,1392,514,188,117,66,46,28,24,17,385,1549,4326,2941,3455,TRUE,0.679842810910772,2023,2023-2024
NV,2023-09-30,intra-ucfe,0,0,0,0,1,0,0,0,0,2,1,4,1,1,TRUE,0.25,2023,2023-2024
NV,2023-09-30,intra-ucx,1,0,0,0,0,0,0,0,0,2,4,7,5,5,TRUE,0.714285714285714,2023,2023-2024
NV,2023-09-30,intra-ui,1391,514,188,117,65,46,28,24,17,381,1544,4315,2935,3449,TRUE,0.68018539976825,2023,2023-2024
NV,2023-10-31,inter-total,22,13,7,3,1,0,1,1,1,7,39,95,61,74,TRUE,0.642105263157895,2023,2023-2024
NV,2023-10-31,inter-ucfe,0,0,0,0,0,0,0,0,0,0,0,0,0,0,TRUE,0,2023,2023-2024
NV,2023-10-31,inter-ucx,0,0,0,0,0,0,0,0,0,0,0,0,0,0,TRUE,0,2023,2023-2024
NV,2023-10-31,inter-ui,22,13,7,3,1,0,1,1,1,7,39,95,61,74,TRUE,0.642105263157895,2023,2023-2024
NV,2023-10-31,intra-total,1686,537,180,117,61,36,26,14,22,330,1977,4986,3663,4200,TRUE,0.734657039711191,2023,2023-2024
NV,2023-10-31,intra-ucfe,1,2,2,0,0,0,0,0,0,2,5,12,6,8,TRUE,0.5,2023,2023-2024
NV,2023-10-31,intra-ucx,4,2,1,0,0,0,0,0,0,0,4,11,8,10,TRUE,0.727272727272727,2023,2023-2024
NV,2023-10-31,intra-ui,1681,533,177,117,61,36,26,14,22,328,1968,4963,3649,4182,TRUE,0.735240781785211,2023,2023-2024
NV,2023-11-30,inter-total,46,12,5,4,0,0,0,1,1,5,41,115,87,99,TRUE,0.756521739130435,2023,2023-2024
NV,2023-11-30,inter-ucfe,0,1,0,0,0,0,0,0,0,1,0,2,0,1,TRUE,0,2023,2023-2024
NV,2023-11-30,inter-ucx,0,0,0,0,0,0,0,0,0,0,0,0,0,0,TRUE,0,2023,2023-2024
NV,2023-11-30,inter-ui,46,11,5,4,0,0,0,1,1,4,41,113,87,98,TRUE,0.769911504424779,2023,2023-2024
NV,2023-11-30,intra-total,1789,595,212,87,51,17,15,11,15,223,2042,5057,3831,4426,TRUE,0.757563772987938,2023,2023-2024
NV,2023-11-30,intra-ucfe,2,2,3,1,0,0,0,0,0,0,11,19,13,15,TRUE,0.68421052631579,2023,2023-2024
NV,2023-11-30,intra-ucx,4,1,0,0,0,0,0,0,0,0,1,6,5,6,TRUE,0.833333333333333,2023,2023-2024
NV,2023-11-30,intra-ui,1783,592,209,86,51,17,15,11,15,223,2030,5032,3813,4405,TRUE,0.75775039745628,2023,2023-2024
NV,2023-12-31,inter-total,34,13,5,1,1,4,1,0,0,6,49,114,83,96,TRUE,0.728070175438597,2023,2023-2024
NV,2023-12-31,inter-ucfe,1,1,0,0,0,0,0,0,0,0,2,4,3,4,TRUE,0.75,2023,2023-2024
NV,2023-12-31,inter-ucx,0,0,0,0,0,0,0,0,0,0,0,0,0,0,TRUE,0,2023,2023-2024
NV,2023-12-31,inter-ui,33,12,5,1,1,4,1,0,0,6,47,110,80,92,TRUE,0.727272727272727,2023,2023-2024
NV,2023-12-31,intra-total,2731,569,203,97,40,44,30,24,15,216,2089,6058,4820,5389,TRUE,0.795642126114229,2023,2023-2024
NV,2023-12-31,intra-ucfe,4,6,1,2,1,0,1,1,0,0,14,30,18,24,TRUE,0.6,2023,2023-2024
NV,2023-12-31,intra-ucx,2,2,1,1,1,1,1,0,0,0,2,11,4,6,TRUE,0.363636363636364,2023,2023-2024
NV,2023-12-31,intra-ui,2725,561,201,94,38,43,28,23,15,216,2073,6017,4798,5359,TRUE,0.797407345853415,2023,2023-2024
NV,2024-01-31,inter-total,42,16,12,7,1,2,1,1,1,3,37,123,79,95,TRUE,0.642276422764228,2023,2023-2024
NV,2024-01-31,inter-ucfe,0,0,1,0,0,0,0,0,0,0,0,1,0,0,TRUE,0,2023,2023-2024
NV,2024-01-31,inter-ucx,0,0,0,0,0,0,0,0,0,0,0,0,0,0,TRUE,0,2023,2023-2024
NV,2024-01-31,inter-ui,42,16,11,7,1,2,1,1,1,3,37,122,79,95,TRUE,0.647540983606557,2023,2023-2024
NV,2024-01-31,intra-total,2822,841,294,113,71,43,26,11,21,238,3096,7576,5918,6759,TRUE,0.781151003167899,2023,2023-2024
NV,2024-01-31,intra-ucfe,1,2,2,1,0,1,0,0,0,2,10,19,11,13,TRUE,0.578947368421053,2023,2023-2024
NV,2024-01-31,intra-ucx,5,5,3,0,2,0,0,0,3,0,3,21,8,13,TRUE,0.380952380952381,2023,2023-2024
NV,2024-01-31,intra-ui,2816,834,289,112,69,42,26,11,18,236,3083,7536,5899,6733,TRUE,0.782776008492569,2023,2023-2024
NV,2024-02-29,inter-total,24,15,9,4,1,1,1,1,1,4,36,97,60,75,TRUE,0.618556701030928,2023,2023-2024
NV,2024-02-29,inter-ucfe,0,0,0,0,0,0,0,0,0,0,1,1,1,1,TRUE,1,2023,2023-2024
NV,2024-02-29,inter-ucx,0,0,0,0,0,0,0,0,0,0,0,0,0,0,TRUE,0,2023,2023-2024
NV,2024-02-29,inter-ui,24,15,9,4,1,1,1,1,1,4,35,96,59,74,TRUE,0.614583333333333,2023,2023-2024
NV,2024-02-29,intra-total,2102,748,218,115,70,43,24,18,13,198,2107,5656,4209,4957,TRUE,0.744165487977369,2023,2023-2024
NV,2024-02-29,intra-ucfe,0,5,3,0,1,3,0,0,0,1,9,22,9,14,TRUE,0.409090909090909,2023,2023-2024
NV,2024-02-29,intra-ucx,3,3,0,0,0,0,0,0,0,0,1,7,4,7,TRUE,0.571428571428571,2023,2023-2024
NV,2024-02-29,intra-ui,2099,740,215,115,69,40,24,18,13,197,2097,5627,4196,4936,TRUE,0.745690421183579,2023,2023-2024
NV,2024-03-31,inter-total,24,12,9,6,5,0,2,1,0,6,35,100,59,71,TRUE,0.59,2023,2023-2024
NV,2024-03-31,inter-ucfe,0,1,0,0,1,0,0,0,0,0,0,2,0,1,TRUE,0,2023,2023-2024
NV,2024-03-31,inter-ucx,0,0,0,0,0,0,0,0,0,0,0,0,0,0,TRUE,0,2023,2023-2024
NV,2024-03-31,inter-ui,24,11,9,6,4,0,2,1,0,6,35,98,59,70,TRUE,0.602040816326531,2023,2023-2024
NV,2024-03-31,intra-total,1788,817,293,127,52,44,22,19,14,218,1684,5078,3472,4289,TRUE,0.683733753446239,2023,2023-2024
NV,2024-03-31,intra-ucfe,2,0,0,2,2,0,1,0,1,1,3,12,5,5,TRUE,0.416666666666667,2023,2023-2024
NV,2024-03-31,intra-ucx,3,4,1,0,0,0,0,0,0,0,6,14,9,13,TRUE,0.642857142857143,2023,2023-2024
NV,2024-03-31,intra-ui,1783,813,292,125,50,44,21,19,13,217,1675,5052,3458,4271,TRUE,0.684481393507522,2023,2023-2024
NV,2024-04-30,inter-total,14,20,7,6,3,2,0,1,0,6,24,83,38,58,TRUE,0.457831325301205,2023,2023-2024
NV,2024-04-30,inter-ucfe,1,0,1,0,0,0,0,0,0,2,0,4,1,1,TRUE,0.25,2023,2023-2024
NV,2024-04-30,inter-ucx,0,0,0,0,0,0,0,0,0,0,0,0,0,0,TRUE,0,2023,2023-2024
NV,2024-04-30,inter-ui,13,20,6,6,3,2,0,1,0,4,24,79,37,57,TRUE,0.468354430379747,2023,2023-2024
NV,2024-04-30,intra-total,1457,823,281,111,49,24,25,23,14,176,1424,4407,2881,3704,TRUE,0.653732697980486,2023,2023-2024
NV,2024-04-30,intra-ucfe,1,2,0,0,1,0,0,0,0,2,2,8,3,5,TRUE,0.375,2023,2023-2024
NV,2024-04-30,intra-ucx,1,1,3,1,0,1,0,0,0,0,3,10,4,5,TRUE,0.4,2023,2023-2024
NV,2024-04-30,intra-ui,1455,820,278,110,48,23,25,23,14,174,1419,4389,2874,3694,TRUE,0.654818865345181,2023,2023-2024
NV,2024-05-31,inter-total,21,25,9,4,3,0,1,0,0,8,34,105,55,80,TRUE,0.523809523809524,2023,2023-2024
NV,2024-05-31,inter-ucfe,0,0,0,0,1,0,0,0,0,0,0,1,0,0,TRUE,0,2023,2023-2024
NV,2024-05-31,inter-ucx,0,0,0,0,0,0,0,0,0,0,0,0,0,0,TRUE,0,2023,2023-2024
NV,2024-05-31,inter-ui,21,25,9,4,2,0,1,0,0,8,34,104,55,80,TRUE,0.528846153846154,2023,2023-2024
NV,2024-05-31,intra-total,1619,758,345,124,87,45,15,23,16,214,1484,4730,3103,3861,TRUE,0.656025369978858,2023,2023-2024
NV,2024-05-31,intra-ucfe,1,1,2,0,0,0,0,0,0,1,2,7,3,4,TRUE,0.428571428571429,2023,2023-2024
NV,2024-05-31,intra-ucx,1,1,2,0,0,1,0,0,0,0,6,11,7,8,TRUE,0.636363636363636,2023,2023-2024
NV,2024-05-31,intra-ui,1617,756,341,124,87,44,15,23,16,213,1476,4712,3093,3849,TRUE,0.656409168081494,2023,2023-2024
NV,2024-06-30,inter-total,17,3,11,6,3,2,0,0,0,5,28,75,45,48,TRUE,0.6,2023,2023-2024
NV,2024-06-30,inter-ucfe,0,0,0,0,0,0,0,0,0,0,0,0,0,0,TRUE,0,2023,2023-2024
NV,2024-06-30,inter-ucx,0,0,0,0,0,0,0,0,0,0,0,0,0,0,TRUE,0,2023,2023-2024
NV,2024-06-30,inter-ui,17,3,11,6,3,2,0,0,0,5,28,75,45,48,TRUE,0.6,2023,2023-2024
NV,2024-06-30,intra-total,1694,434,641,180,76,44,38,18,19,287,1342,4773,3036,3470,TRUE,0.63607793840352,2023,2023-2024
NV,2024-06-30,intra-ucfe,1,1,0,0,1,0,0,0,0,0,1,4,2,3,TRUE,0.5,2023,2023-2024
NV,2024-06-30,intra-ucx,5,2,0,2,0,0,1,0,0,1,4,15,9,11,TRUE,0.6,2023,2023-2024
NV,2024-06-30,intra-ui,1688,431,641,178,75,44,37,18,19,286,1337,4754,3025,3456,TRUE,0.636306268405553,2023,2023-2024
NV,2024-07-31,inter-total,31,6,12,14,2,3,4,2,0,8,26,108,57,63,TRUE,0.527777777777778,2024,2024-2025
NV,2024-07-31,inter-ucfe,0,0,0,0,0,0,0,0,0,0,0,0,0,0,TRUE,0,2024,2024-2025
NV,2024-07-31,inter-ucx,0,0,0,0,0,0,0,0,0,0,0,0,0,0,TRUE,0,2024,2024-2025
NV,2024-07-31,inter-ui,31,6,12,14,2,3,4,2,0,8,26,108,57,63,TRUE,0.527777777777778,2024,2024-2025
NV,2024-07-31,intra-total,2553,346,532,605,173,80,41,27,20,349,1840,6566,4393,4739,TRUE,0.669052695705148,2024,2024-2025
NV,2024-07-31,intra-ucfe,2,0,0,0,0,0,0,0,0,5,2,9,4,4,TRUE,0.444444444444444,2024,2024-2025
NV,2024-07-31,intra-ucx,2,0,0,3,2,0,1,0,0,0,5,13,7,7,TRUE,0.538461538461538,2024,2024-2025
NV,2024-07-31,intra-ui,2549,346,532,602,171,80,40,27,20,344,1833,6544,4382,4728,TRUE,0.669621026894866,2024,2024-2025
NV,2024-08-31,inter-total,16,10,13,9,4,5,0,1,1,8,26,93,42,52,TRUE,0.451612903225806,2024,2024-2025
NV,2024-08-31,inter-ucfe,0,0,0,0,0,0,0,0,0,1,0,1,0,0,TRUE,0,2024,2024-2025
NV,2024-08-31,inter-ucx,0,0,0,0,0,0,0,0,0,0,0,0,0,0,TRUE,0,2024,2024-2025
NV,2024-08-31,inter-ui,16,10,13,9,4,5,0,1,1,7,26,92,42,52,TRUE,0.456521739130435,2024,2024-2025
NV,2024-08-31,intra-total,2089,365,795,611,252,99,45,42,24,452,1393,6167,3482,3847,TRUE,0.564618128749797,2024,2024-2025
NV,2024-08-31,intra-ucfe,0,0,0,0,1,3,0,0,0,1,0,5,0,0,TRUE,0,2024,2024-2025
NV,2024-08-31,intra-ucx,1,0,2,1,3,1,0,0,0,3,8,19,9,9,TRUE,0.473684210526316,2024,2024-2025
NV,2024-08-31,intra-ui,2088,365,793,610,248,95,45,42,24,448,1385,6143,3473,3838,TRUE,0.565358945140811,2024,2024-2025
NV,2024-09-30,inter-total,13,3,8,14,10,5,2,2,2,12,20,91,33,36,TRUE,0.362637362637363,2024,2024-2025
NV,2024-09-30,inter-ucfe,0,0,0,0,0,0,0,0,0,0,0,0,0,0,TRUE,0,2024,2024-2025
NV,2024-09-30,inter-ucx,0,0,0,0,0,0,0,0,0,0,0,0,0,0,TRUE,0,2024,2024-2025
NV,2024-09-30,inter-ui,13,3,8,14,10,5,2,2,2,12,20,91,33,36,TRUE,0.362637362637363,2024,2024-2025
NV,2024-09-30,intra-total,1714,323,413,741,403,156,64,34,27,486,1446,5807,3160,3483,TRUE,0.54417082831066,2024,2024-2025
NV,2024-09-30,intra-ucfe,2,1,0,0,0,0,0,0,0,2,0,5,2,3,TRUE,0.4,2024,2024-2025
NV,2024-09-30,intra-ucx,0,0,0,2,0,0,2,0,0,3,6,13,6,6,TRUE,0.461538461538462,2024,2024-2025
NV,2024-09-30,intra-ui,1712,322,413,739,403,156,62,34,27,481,1440,5789,3152,3474,TRUE,0.544480912074624,2024,2024-2025
NV,2024-10-31,inter-total,33,3,11,18,6,5,1,1,0,5,22,105,55,58,TRUE,0.523809523809524,2024,2024-2025
NV,2024-10-31,inter-ucfe,2,0,0,0,0,0,0,0,0,0,0,2,2,2,TRUE,1,2024,2024-2025
NV,2024-10-31,inter-ucx,0,0,0,0,1,0,0,0,0,0,0,1,0,0,TRUE,0,2024,2024-2025
NV,2024-10-31,inter-ui,31,3,11,18,5,5,1,1,0,5,22,102,53,56,TRUE,0.519607843137255,2024,2024-2025
NV,2024-10-31,intra-total,1514,299,479,640,324,154,89,50,29,444,1087,5109,2601,2900,TRUE,0.509101585437463,2024,2024-2025
NV,2024-10-31,intra-ucfe,2,0,0,0,0,0,0,0,0,0,3,5,5,5,TRUE,1,2024,2024-2025
NV,2024-10-31,intra-ucx,3,1,0,1,2,1,0,0,0,1,0,9,3,4,TRUE,0.333333333333333,2024,2024-2025
NV,2024-10-31,intra-ui,1509,298,479,639,322,153,89,50,29,443,1084,5095,2593,2891,TRUE,0.508930323846909,2024,2024-2025
NV,2024-11-30,inter-total,22,7,16,7,5,5,4,2,3,17,27,115,49,56,TRUE,0.426086956521739,2024,2024-2025
NV,2024-11-30,inter-ucfe,0,0,0,0,0,0,0,0,0,0,0,0,0,0,TRUE,0,2024,2024-2025
NV,2024-11-30,inter-ucx,0,0,0,0,0,0,0,0,0,0,0,0,0,0,TRUE,0,2024,2024-2025
NV,2024-11-30,inter-ui,22,7,16,7,5,5,4,2,3,17,27,115,49,56,TRUE,0.426086956521739,2024,2024-2025
NV,2024-11-30,intra-total,1717,314,598,402,248,149,79,47,29,345,1098,5026,2815,3129,TRUE,0.56008754476721,2024,2024-2025
NV,2024-11-30,intra-ucfe,5,2,0,0,1,0,0,0,0,1,10,19,15,17,TRUE,0.789473684210526,2024,2024-2025
NV,2024-11-30,intra-ucx,1,2,0,0,0,0,1,0,0,1,3,8,4,6,TRUE,0.5,2024,2024-2025
NV,2024-11-30,intra-ui,1711,310,598,402,247,149,78,47,29,343,1085,4999,2796,3106,TRUE,0.559311862372475,2024,2024-2025
NV,2024-12-31,inter-total,25,12,13,10,6,3,2,3,0,8,37,119,62,74,TRUE,0.521008403361345,2024,2024-2025
NV,2024-12-31,inter-ucfe,0,0,0,0,0,0,0,0,0,0,2,2,2,2,TRUE,1,2024,2024-2025
NV,2024-12-31,inter-ucx,0,0,0,0,1,0,0,0,0,0,0,1,0,0,TRUE,0,2024,2024-2025
NV,2024-12-31,inter-ui,25,12,13,10,5,3,2,3,0,8,35,116,60,72,TRUE,0.517241379310345,2024,2024-2025
NV,2024-12-31,intra-total,2348,512,696,477,286,184,117,69,42,384,2002,7117,4350,4862,TRUE,0.611212589574259,2024,2024-2025
NV,2024-12-31,intra-ucfe,6,10,0,0,1,1,0,2,1,0,20,41,26,36,TRUE,0.634146341463415,2024,2024-2025
NV,2024-12-31,intra-ucx,1,2,1,1,2,0,2,0,0,0,4,13,5,7,TRUE,0.384615384615385,2024,2024-2025
NV,2024-12-31,intra-ui,2341,500,695,476,283,183,115,67,41,384,1978,7063,4319,4819,TRUE,0.611496531219029,2024,2024-2025
NY,2019-01-31,inter-total,640,30,23,8,9,4,6,2,7,11,125,865,765,795,FALSE,0.919075144508671,2018,2018-2019
NY,2019-01-31,inter-ucfe,13,2,0,0,0,0,0,0,1,0,6,22,19,21,FALSE,0.954545454545455,2018,2018-2019
NY,2019-01-31,inter-ucx,1,0,0,0,0,0,0,0,0,1,0,2,1,1,FALSE,0.5,2018,2018-2019
NY,2019-01-31,inter-ui,626,28,23,8,9,4,6,2,6,10,119,841,745,773,FALSE,0.919143876337693,2018,2018-2019
NY,2019-01-31,intra-total,38437,1617,679,354,188,158,122,73,58,260,6475,48421,44912,46529,FALSE,0.960926044484831,2018,2018-2019
NY,2019-01-31,intra-ucfe,1379,236,87,5,2,3,2,0,0,2,881,2597,2260,2496,FALSE,0.961108971890643,2018,2018-2019
NY,2019-01-31,intra-ucx,45,3,3,0,1,0,0,0,0,0,7,59,52,55,FALSE,0.932203389830508,2018,2018-2019
NY,2019-01-31,intra-ui,37013,1378,589,349,185,155,120,73,58,258,5587,45765,42600,43978,FALSE,0.960952693106085,2018,2018-2019
NY,2019-02-28,inter-total,603,76,53,22,13,8,3,2,4,7,127,918,730,806,FALSE,0.877995642701525,2018,2018-2019
NY,2019-02-28,inter-ucfe,0,3,1,1,0,1,0,1,0,0,0,7,0,3,FALSE,0.428571428571429,2018,2018-2019
NY,2019-02-28,inter-ucx,0,0,0,0,0,0,0,0,0,0,1,1,1,1,FALSE,1,2018,2018-2019
NY,2019-02-28,inter-ui,603,73,52,21,13,7,3,1,4,7,126,910,729,802,FALSE,0.881318681318681,2018,2018-2019
NY,2019-02-28,intra-total,28578,1788,831,430,282,170,115,101,78,276,5022,37671,33600,35388,FALSE,0.939396352631998,2018,2018-2019
NY,2019-02-28,intra-ucfe,34,14,25,7,4,1,1,1,1,3,23,114,57,71,FALSE,0.62280701754386,2018,2018-2019
NY,2019-02-28,intra-ucx,31,6,2,0,1,1,1,0,0,4,8,54,39,45,FALSE,0.833333333333333,2018,2018-2019
NY,2019-02-28,intra-ui,28513,1768,804,423,277,168,113,100,77,269,4991,37503,33504,35272,FALSE,0.940511425752607,2018,2018-2019
NY,2019-03-31,inter-total,454,43,21,13,12,12,6,5,4,13,73,656,527,570,FALSE,0.86890243902439,2018,2018-2019
NY,2019-03-31,inter-ucfe,1,0,0,1,1,0,0,0,0,1,0,4,1,1,FALSE,0.25,2018,2018-2019
NY,2019-03-31,inter-ucx,2,0,0,0,0,0,0,0,0,0,1,3,3,3,FALSE,1,2018,2018-2019
NY,2019-03-31,inter-ui,451,43,21,12,11,12,6,5,4,12,72,649,523,566,FALSE,0.87211093990755,2018,2018-2019
NY,2019-03-31,intra-total,20371,1331,686,449,320,236,172,123,95,279,4367,28429,24738,26069,FALSE,0.916986176087798,2018,2018-2019
NY,2019-03-31,intra-ucfe,18,5,5,2,4,2,1,1,0,0,15,53,33,38,FALSE,0.716981132075472,2018,2018-2019
NY,2019-03-31,intra-ucx,35,5,4,3,3,0,0,0,0,1,8,59,43,48,FALSE,0.813559322033898,2018,2018-2019
NY,2019-03-31,intra-ui,20318,1321,677,444,313,234,171,122,95,278,4344,28317,24662,25983,FALSE,0.917576014408306,2018,2018-2019
NY,2019-04-30,inter-total,417,24,13,5,5,1,3,4,3,13,104,592,521,545,FALSE,0.920608108108108,2018,2018-2019
NY,2019-04-30,inter-ucfe,1,2,0,0,0,0,1,0,0,0,1,5,2,4,FALSE,0.8,2018,2018-2019
NY,2019-04-30,inter-ucx,1,0,0,0,1,0,0,0,0,0,1,3,2,2,FALSE,0.666666666666667,2018,2018-2019
NY,2019-04-30,inter-ui,415,22,13,5,4,1,2,4,3,13,102,584,517,539,FALSE,0.922945205479452,2018,2018-2019
NY,2019-04-30,intra-total,19188,1178,513,268,175,157,115,96,84,314,4609,26697,23797,24975,FALSE,0.935498370603439,2018,2018-2019
NY,2019-04-30,intra-ucfe,20,12,3,2,0,1,0,0,0,2,6,46,26,38,FALSE,0.826086956521739,2018,2018-2019
NY,2019-04-30,intra-ucx,46,5,2,1,1,1,0,0,0,0,10,66,56,61,FALSE,0.924242424242424,2018,2018-2019
NY,2019-04-30,intra-ui,19122,1161,508,265,174,155,115,96,84,312,4593,26585,23715,24876,FALSE,0.935715629114162,2018,2018-2019
NY,2019-05-31,inter-total,380,48,12,9,4,4,3,3,1,20,88,572,468,516,FALSE,0.902097902097902,2018,2018-2019
NY,2019-05-31,inter-ucfe,0,1,0,0,0,0,0,0,0,1,0,2,0,1,FALSE,0.5,2018,2018-2019
NY,2019-05-31,inter-ucx,0,0,0,0,0,0,0,0,0,0,0,0,0,0,FALSE,0,2018,2018-2019
NY,2019-05-31,inter-ui,380,47,12,9,4,4,3,3,1,19,88,570,468,515,FALSE,0.903508771929825,2018,2018-2019
NY,2019-05-31,intra-total,15728,1232,659,318,220,153,90,95,62,349,4184,23090,19912,21144,FALSE,0.91572109138155,2018,2018-2019
NY,2019-05-31,intra-ucfe,27,8,2,2,1,1,0,0,0,1,15,57,42,50,FALSE,0.87719298245614,2018,2018-2019
NY,2019-05-31,intra-ucx,47,2,3,0,3,1,0,0,0,3,10,69,57,59,FALSE,0.855072463768116,2018,2018-2019
NY,2019-05-31,intra-ui,15654,1222,654,316,216,151,90,95,62,345,4159,22964,19813,21035,FALSE,0.915998954885908,2018,2018-2019
NY,2019-06-30,inter-total,339,23,20,6,8,8,5,6,0,7,78,500,417,440,FALSE,0.88,2018,2018-2019
NY,2019-06-30,inter-ucfe,1,0,0,0,0,0,0,0,0,0,0,1,1,1,FALSE,1,2018,2018-2019
NY,2019-06-30,inter-ucx,0,0,0,0,0,0,0,0,0,0,0,0,0,0,FALSE,0,2018,2018-2019
NY,2019-06-30,inter-ui,338,23,20,6,8,8,5,6,0,7,78,499,416,439,FALSE,0.879759519038076,2018,2018-2019
NY,2019-06-30,intra-total,15739,1174,523,270,183,116,121,116,73,284,3873,22472,19612,20786,FALSE,0.9249733001068,2018,2018-2019
NY,2019-06-30,intra-ucfe,29,3,4,0,1,3,1,0,0,0,14,55,43,46,FALSE,0.836363636363636,2018,2018-2019
NY,2019-06-30,intra-ucx,33,4,0,1,1,0,0,0,0,1,11,51,44,48,FALSE,0.941176470588235,2018,2018-2019
NY,2019-06-30,intra-ui,15677,1167,519,269,181,113,120,116,73,283,3848,22366,19525,20692,FALSE,0.925154251989627,2018,2018-2019
NY,2019-07-31,inter-total,433,33,19,8,6,10,5,4,1,14,118,651,551,584,FALSE,0.897081413210445,2019,2019-2020
NY,2019-07-31,inter-ucfe,1,0,0,0,1,0,0,0,0,0,0,2,1,1,FALSE,0.5,2019,2019-2020
NY,2019-07-31,inter-ucx,1,0,0,0,0,0,0,0,0,0,0,1,1,1,FALSE,1,2019,2019-2020
NY,2019-07-31,inter-ui,431,33,19,8,5,10,5,4,1,14,118,648,549,582,FALSE,0.898148148148148,2019,2019-2020
NY,2019-07-31,intra-total,28801,1507,521,303,173,120,107,92,76,357,5463,37520,34264,35771,FALSE,0.953384861407249,2019,2019-2020
NY,2019-07-31,intra-ucfe,20,9,6,5,1,0,1,1,0,0,8,51,28,37,FALSE,0.725490196078431,2019,2019-2020
NY,2019-07-31,intra-ucx,52,5,1,1,0,0,0,1,0,0,12,72,64,69,FALSE,0.958333333333333,2019,2019-2020
NY,2019-07-31,intra-ui,28729,1493,514,297,172,120,106,90,76,357,5443,37397,34172,35665,FALSE,0.953686124555446,2019,2019-2020
NY,2019-08-31,inter-total,330,38,16,11,10,7,5,3,0,16,107,543,437,475,FALSE,0.874769797421731,2019,2019-2020
NY,2019-08-31,inter-ucfe,2,0,2,1,0,0,0,0,0,0,1,6,3,3,FALSE,0.5,2019,2019-2020
NY,2019-08-31,inter-ucx,1,0,0,0,0,0,0,0,0,0,0,1,1,1,FALSE,1,2019,2019-2020
NY,2019-08-31,inter-ui,327,38,14,10,10,7,5,3,0,16,106,536,433,471,FALSE,0.878731343283582,2019,2019-2020
NY,2019-08-31,intra-total,21461,1413,732,396,238,188,110,85,75,305,4378,29381,25839,27252,FALSE,0.927538204962391,2019,2019-2020
NY,2019-08-31,intra-ucfe,14,9,7,3,2,0,2,0,1,2,8,48,22,31,FALSE,0.645833333333333,2019,2019-2020
NY,2019-08-31,intra-ucx,32,5,1,2,0,1,0,0,0,1,10,52,42,47,FALSE,0.903846153846154,2019,2019-2020
NY,2019-08-31,intra-ui,21415,1399,724,391,236,187,108,85,74,302,4360,29281,25775,27174,FALSE,0.928042075065742,2019,2019-2020
NY,2019-09-30,inter-total,324,46,22,11,8,13,6,1,6,17,115,569,439,485,FALSE,0.852372583479789,2019,2019-2020
NY,2019-09-30,inter-ucfe,1,1,0,0,0,1,0,0,1,0,2,6,3,4,FALSE,0.666666666666667,2019,2019-2020
NY,2019-09-30,inter-ucx,1,0,0,0,0,0,0,0,0,0,1,2,2,2,FALSE,1,2019,2019-2020
NY,2019-09-30,inter-ui,322,45,22,11,8,12,6,1,5,17,112,561,434,479,FALSE,0.853832442067736,2019,2019-2020
NY,2019-09-30,intra-total,16998,1399,681,380,231,159,141,118,98,279,3956,24440,20954,22353,FALSE,0.914607201309329,2019,2019-2020
NY,2019-09-30,intra-ucfe,18,8,4,1,3,2,1,0,2,3,11,53,29,37,FALSE,0.69811320754717,2019,2019-2020
NY,2019-09-30,intra-ucx,38,4,1,1,0,0,0,0,0,0,11,55,49,53,FALSE,0.963636363636364,2019,2019-2020
NY,2019-09-30,intra-ui,16942,1387,676,378,228,157,140,118,96,276,3934,24332,20876,22263,FALSE,0.914967943448956,2019,2019-2020
NY,2019-10-31,inter-total,374,39,20,9,9,9,1,6,0,14,94,575,468,507,FALSE,0.881739130434783,2019,2019-2020
NY,2019-10-31,inter-ucfe,0,1,0,0,0,0,0,0,0,0,0,1,0,1,FALSE,1,2019,2019-2020
NY,2019-10-31,inter-ucx,1,0,0,0,0,0,0,0,0,0,0,1,1,1,FALSE,1,2019,2019-2020
NY,2019-10-31,inter-ui,373,38,20,9,9,9,1,6,0,14,94,573,467,505,FALSE,0.881326352530541,2019,2019-2020
NY,2019-10-31,intra-total,16074,1285,664,362,270,178,119,107,75,330,3902,23366,19976,21261,FALSE,0.909911837712916,2019,2019-2020
NY,2019-10-31,intra-ucfe,22,11,4,5,0,2,1,1,0,3,6,55,28,39,FALSE,0.709090909090909,2019,2019-2020
NY,2019-10-31,intra-ucx,29,8,4,0,1,0,0,1,0,1,8,52,37,45,FALSE,0.865384615384615,2019,2019-2020
NY,2019-10-31,intra-ui,16023,1266,656,357,269,176,118,105,75,326,3888,23259,19911,21177,FALSE,0.910486263381917,2019,2019-2020
NY,2019-11-30,inter-total,495,41,18,10,5,7,8,3,1,16,112,716,607,648,FALSE,0.905027932960894,2019,2019-2020
NY,2019-11-30,inter-ucfe,0,1,1,0,0,0,0,0,0,0,0,2,0,1,FALSE,0.5,2019,2019-2020
NY,2019-11-30,inter-ucx,2,0,0,0,0,0,0,0,1,0,1,4,3,3,FALSE,0.75,2019,2019-2020
NY,2019-11-30,inter-ui,493,40,17,10,5,7,8,3,0,16,111,710,604,644,FALSE,0.907042253521127,2019,2019-2020
NY,2019-11-30,intra-total,18990,1284,682,358,239,141,104,73,68,295,4161,26395,23151,24435,FALSE,0.925743512028793,2019,2019-2020
NY,2019-11-30,intra-ucfe,20,8,6,3,1,4,0,2,1,5,16,66,36,44,FALSE,0.666666666666667,2019,2019-2020
NY,2019-11-30,intra-ucx,46,7,4,1,3,0,0,0,0,2,4,67,50,57,FALSE,0.850746268656716,2019,2019-2020
NY,2019-11-30,intra-ui,18924,1269,672,354,235,137,104,71,67,288,4141,26262,23065,24334,FALSE,0.926585941664763,2019,2019-2020
NY,2019-12-31,inter-total,640,42,15,7,8,1,3,4,1,12,99,832,739,781,FALSE,0.938701923076923,2019,2019-2020
NY,2019-12-31,inter-ucfe,0,2,0,1,1,0,0,1,0,2,0,7,0,2,FALSE,0.285714285714286,2019,2019-2020
NY,2019-12-31,inter-ucx,1,1,0,0,0,0,0,0,0,0,0,2,1,2,FALSE,1,2019,2019-2020
NY,2019-12-31,inter-ui,639,39,15,6,7,1,3,3,1,10,99,823,738,777,FALSE,0.944106925880923,2019,2019-2020
NY,2019-12-31,intra-total,29681,1367,666,360,214,176,136,102,79,286,4761,37828,34442,35809,FALSE,0.946626837263403,2019,2019-2020
NY,2019-12-31,intra-ucfe,16,6,4,2,1,0,0,1,0,1,12,43,28,34,FALSE,0.790697674418605,2019,2019-2020
NY,2019-12-31,intra-ucx,41,10,1,2,0,1,0,1,0,0,11,67,52,62,FALSE,0.925373134328358,2019,2019-2020
NY,2019-12-31,intra-ui,29624,1351,661,356,213,175,136,100,79,285,4738,37718,34362,35713,FALSE,0.946842356434594,2019,2019-2020
NY,2020-01-31,inter-total,676,34,20,11,6,9,8,1,1,11,149,926,825,859,FALSE,0.927645788336933,2019,2019-2020
NY,2020-01-31,inter-ucfe,3,1,0,0,1,0,0,0,0,0,0,5,3,4,FALSE,0.8,2019,2019-2020
NY,2020-01-31,inter-ucx,1,0,1,0,0,0,0,0,0,0,0,2,1,1,FALSE,0.5,2019,2019-2020
NY,2020-01-31,inter-ui,672,33,19,11,5,9,8,1,1,11,149,919,821,854,FALSE,0.929270946681175,2019,2019-2020
NY,2020-01-31,intra-total,36910,1394,673,347,193,163,133,83,69,368,5568,45901,42478,43872,FALSE,0.955796170018082,2019,2019-2020
NY,2020-01-31,intra-ucfe,18,4,4,3,0,2,0,0,0,0,14,45,32,36,FALSE,0.8,2019,2019-2020
NY,2020-01-31,intra-ucx,35,7,1,3,2,0,0,0,0,1,8,57,43,50,FALSE,0.87719298245614,2019,2019-2020
NY,2020-01-31,intra-ui,36857,1383,668,341,191,161,133,83,69,367,5546,45799,42403,43786,FALSE,0.956047075263652,2019,2019-2020
NY,2020-02-29,inter-total,640,73,25,13,13,8,3,4,1,9,123,912,763,836,FALSE,0.916666666666667,2019,2019-2020
NY,2020-02-29,inter-ucfe,0,0,0,0,1,0,1,1,0,0,0,3,0,0,FALSE,0,2019,2019-2020
NY,2020-02-29,inter-ucx,4,1,0,0,0,0,0,0,0,0,1,6,5,6,FALSE,1,2019,2019-2020
NY,2020-02-29,inter-ui,636,72,25,13,12,8,2,3,1,9,122,903,758,830,FALSE,0.919158361018826,2019,2019-2020
NY,2020-02-29,intra-total,29352,1716,811,396,226,143,131,98,62,292,5031,38258,34383,36099,FALSE,0.943567358460976,2019,2019-2020
NY,2020-02-29,intra-ucfe,11,12,7,4,2,2,2,1,1,0,12,54,23,35,FALSE,0.648148148148148,2019,2019-2020
NY,2020-02-29,intra-ucx,38,7,1,1,0,0,0,0,0,2,12,61,50,57,FALSE,0.934426229508197,2019,2019-2020
NY,2020-02-29,intra-ui,29303,1697,803,391,224,141,129,97,61,290,5007,38143,34310,36007,FALSE,0.944000209737042,2019,2019-2020
NY,2020-03-31,inter-total,1233,30,12,14,9,4,6,2,1,13,288,1612,1521,1551,FALSE,0.962158808933003,2019,2019-2020
NY,2020-03-31,inter-ucfe,0,0,0,0,0,0,0,0,0,1,0,1,0,0,FALSE,0,2019,2019-2020
NY,2020-03-31,inter-ucx,0,0,0,0,0,0,0,0,0,0,0,0,0,0,FALSE,0,2019,2019-2020
NY,2020-03-31,inter-ui,1233,30,12,14,9,4,6,2,1,12,288,1611,1521,1551,FALSE,0.962756052141527,2019,2019-2020
NY,2020-03-31,intra-total,181212,1303,547,327,221,192,128,89,59,244,34473,218795,215685,216988,FALSE,0.991741127539478,2019,2019-2020
NY,2020-03-31,intra-ucfe,13,7,3,6,3,6,0,2,1,0,13,54,26,33,FALSE,0.611111111111111,2019,2019-2020
NY,2020-03-31,intra-ucx,38,10,1,1,1,2,0,2,1,1,6,63,44,54,FALSE,0.857142857142857,2019,2019-2020
NY,2020-03-31,intra-ui,181161,1286,543,320,217,184,128,85,57,243,34454,218678,215615,216901,FALSE,0.99187389677974,2019,2019-2020
NY,2020-04-30,inter-total,3026,541,355,236,86,1,1,3,1,9,2079,6338,5105,5646,FALSE,0.8908172925213,2019,2019-2020
NY,2020-04-30,inter-ucfe,0,0,0,0,0,0,0,0,0,0,1,1,1,1,FALSE,1,2019,2019-2020
NY,2020-04-30,inter-ucx,0,0,1,0,1,0,0,0,0,0,0,2,0,0,FALSE,0,2019,2019-2020
NY,2020-04-30,inter-ui,3026,541,354,236,85,1,1,3,1,9,2078,6335,5104,5645,FALSE,0.891081294396212,2019,2019-2020
NY,2020-04-30,intra-total,364045,41148,25781,15684,5100,141,48,36,26,122,243326,695457,607371,648519,FALSE,0.932507689188548,2019,2019-2020
NY,2020-04-30,intra-ucfe,6,8,12,4,2,1,0,0,0,0,8,41,14,22,FALSE,0.536585365853659,2019,2019-2020
NY,2020-04-30,intra-ucx,9,11,5,3,2,2,0,0,0,0,6,38,15,26,FALSE,0.68421052631579,2019,2019-2020
NY,2020-04-30,intra-ui,364030,41129,25764,15677,5096,138,48,36,26,122,243312,695378,607342,648471,FALSE,0.932544601641122,2019,2019-2020
NY,2020-05-31,inter-total,1396,226,300,407,599,1239,1108,379,198,9,385,6246,1781,2007,FALSE,0.321325648414986,2019,2019-2020
NY,2020-05-31,inter-ucfe,0,0,0,0,0,0,0,1,0,0,0,1,0,0,FALSE,0,2019,2019-2020
NY,2020-05-31,inter-ucx,0,0,0,1,0,1,0,0,0,0,0,2,0,0,FALSE,0,2019,2019-2020
NY,2020-05-31,inter-ui,1396,226,300,406,599,1238,1108,378,198,9,385,6243,1781,2007,FALSE,0.321480057664584,2019,2019-2020
NY,2020-05-31,intra-total,90387,10984,14269,21528,48409,104941,81862,24593,9810,662,22483,429928,112870,123854,FALSE,0.288080794923801,2019,2019-2020
NY,2020-05-31,intra-ucfe,4,7,3,3,12,19,21,6,13,2,4,94,8,15,FALSE,0.159574468085106,2019,2019-2020
NY,2020-05-31,intra-ucx,5,5,3,9,9,13,13,13,8,0,3,81,8,13,FALSE,0.160493827160494,2019,2019-2020
NY,2020-05-31,intra-ui,90378,10972,14263,21516,48388,104909,81828,24574,9789,660,22476,429753,112854,123826,FALSE,0.288132950788011,2019,2019-2020
NY,2020-06-30,inter-total,752,148,263,305,286,312,353,419,493,2325,220,5876,972,1120,FALSE,0.190605854322669,2019,2019-2020
NY,2020-06-30,inter-ucfe,0,0,0,0,0,0,0,0,1,2,0,3,0,0,FALSE,0,2019,2019-2020
NY,2020-06-30,inter-ucx,0,0,1,0,0,0,0,0,0,0,0,1,0,0,FALSE,0,2019,2019-2020
NY,2020-06-30,inter-ui,752,148,262,305,286,312,353,419,492,2323,220,5872,972,1120,FALSE,0.190735694822888,2019,2019-2020
NY,2020-06-30,intra-total,63363,4778,8504,11104,13706,13556,18444,22775,32428,115111,12401,316170,75764,80542,FALSE,0.254742701711105,2019,2019-2020
NY,2020-06-30,intra-ucfe,5,4,3,7,4,6,5,7,6,53,5,105,10,14,FALSE,0.133333333333333,2019,2019-2020
NY,2020-06-30,intra-ucx,1,9,4,7,8,12,8,8,4,60,4,125,5,14,FALSE,0.112,2019,2019-2020
NY,2020-06-30,intra-ui,63357,4765,8497,11090,13694,13538,18431,22760,32418,114998,12392,315940,75749,80514,FALSE,0.254839526492372,2019,2019-2020
NY,2020-07-31,inter-total,758,116,122,92,124,73,91,76,65,1765,143,3425,901,1017,FALSE,0.296934306569343,2020,2020-2021
NY,2020-07-31,inter-ucfe,0,1,0,0,0,0,2,1,0,2,1,7,1,2,FALSE,0.285714285714286,2020,2020-2021
NY,2020-07-31,inter-ucx,0,1,0,1,0,0,1,0,1,3,0,7,0,1,FALSE,0.142857142857143,2020,2020-2021
NY,2020-07-31,inter-ui,758,114,122,91,124,73,88,75,64,1760,142,3411,900,1014,FALSE,0.297273526824978,2020,2020-2021
NY,2020-07-31,intra-total,51125,5555,5028,3581,3011,2649,2647,2671,2405,74568,8856,162096,59981,65536,FALSE,0.404303622544665,2020,2020-2021
NY,2020-07-31,intra-ucfe,4,3,10,5,3,2,1,5,4,32,1,70,5,8,FALSE,0.114285714285714,2020,2020-2021
NY,2020-07-31,intra-ucx,7,9,15,7,5,4,14,10,8,52,4,135,11,20,FALSE,0.148148148148148,2020,2020-2021
NY,2020-07-31,intra-ui,51114,5543,5003,3569,3003,2643,2632,2656,2393,74484,8851,161891,59965,65508,FALSE,0.404642629917661,2020,2020-2021
NY,2020-08-31,inter-total,495,34,65,47,46,43,33,29,25,941,192,1950,687,721,FALSE,0.36974358974359,2020,2020-2021
NY,2020-08-31,inter-ucfe,0,0,1,0,0,0,1,0,0,2,0,4,0,0,FALSE,0,2020,2020-2021
NY,2020-08-31,inter-ucx,0,0,0,0,0,0,0,1,0,1,0,2,0,0,FALSE,0,2020,2020-2021
NY,2020-08-31,inter-ui,495,34,64,47,46,43,32,28,25,938,192,1944,687,721,FALSE,0.370884773662552,2020,2020-2021
NY,2020-08-31,intra-total,22655,2924,3163,3206,2904,2291,1993,1746,1468,38382,5959,86691,28614,31538,FALSE,0.363797856755603,2020,2020-2021
NY,2020-08-31,intra-ucfe,4,5,2,1,2,0,2,1,4,34,4,59,8,13,FALSE,0.220338983050847,2020,2020-2021
NY,2020-08-31,intra-ucx,5,4,3,4,5,5,3,7,6,44,4,90,9,13,FALSE,0.144444444444444,2020,2020-2021
NY,2020-08-31,intra-ui,22646,2915,3158,3201,2897,2286,1988,1738,1458,38304,5951,86542,28597,31512,FALSE,0.364123778049964,2020,2020-2021
NY,2020-09-30,inter-total,840,34,48,55,42,43,28,33,31,1005,259,2418,1099,1133,FALSE,0.468569065343259,2020,2020-2021
NY,2020-09-30,inter-ucfe,0,0,0,0,0,0,0,0,0,0,0,0,0,0,FALSE,0,2020,2020-2021
NY,2020-09-30,inter-ucx,0,0,0,1,0,0,0,0,0,2,0,3,0,0,FALSE,0,2020,2020-2021
NY,2020-09-30,inter-ui,840,34,48,54,42,43,28,33,31,1003,259,2415,1099,1133,FALSE,0.469151138716356,2020,2020-2021
NY,2020-09-30,intra-total,23979,2447,2558,2318,2026,1892,1851,1486,1230,23724,6296,69807,30275,32722,FALSE,0.468749552337158,2020,2020-2021
NY,2020-09-30,intra-ucfe,4,2,2,2,3,1,7,2,4,24,4,55,8,10,FALSE,0.181818181818182,2020,2020-2021
NY,2020-09-30,intra-ucx,10,0,6,13,6,4,4,7,1,42,3,96,13,13,FALSE,0.135416666666667,2020,2020-2021
NY,2020-09-30,intra-ui,23965,2445,2550,2303,2017,1887,1840,1477,1225,23658,6289,69656,30254,32699,FALSE,0.469435511657287,2020,2020-2021
NY,2020-10-31,inter-total,511,36,60,43,33,37,37,39,29,1079,98,2002,609,645,FALSE,0.322177822177822,2020,2020-2021
NY,2020-10-31,inter-ucfe,0,0,0,0,0,0,0,0,2,2,0,4,0,0,FALSE,0,2020,2020-2021
NY,2020-10-31,inter-ucx,1,0,1,0,0,0,0,0,0,4,0,6,1,1,FALSE,0.166666666666667,2020,2020-2021
NY,2020-10-31,inter-ui,510,36,59,43,33,37,37,39,27,1073,98,1992,608,644,FALSE,0.323293172690763,2020,2020-2021
NY,2020-10-31,intra-total,18660,1671,2109,1879,1707,1609,1473,1153,969,21966,3499,56695,22159,23830,FALSE,0.420319252138637,2020,2020-2021
NY,2020-10-31,intra-ucfe,11,1,3,1,5,0,2,4,0,26,1,54,12,13,FALSE,0.240740740740741,2020,2020-2021
NY,2020-10-31,intra-ucx,20,2,3,6,4,9,7,3,4,43,2,103,22,24,FALSE,0.233009708737864,2020,2020-2021
NY,2020-10-31,intra-ui,18629,1668,2103,1872,1698,1600,1464,1146,965,21897,3496,56538,22125,23793,FALSE,0.420832006791892,2020,2020-2021
NY,2020-11-30,inter-total,663,35,31,39,22,32,16,19,20,512,296,1685,959,994,FALSE,0.589910979228487,2020,2020-2021
NY,2020-11-30,inter-ucfe,1,0,0,1,0,0,0,0,0,0,0,2,1,1,FALSE,0.5,2020,2020-2021
NY,2020-11-30,inter-ucx,0,0,0,0,0,0,0,0,0,0,0,0,0,0,FALSE,0,2020,2020-2021
NY,2020-11-30,inter-ui,662,35,31,38,22,32,16,19,20,512,296,1683,958,993,FALSE,0.590017825311943,2020,2020-2021
NY,2020-11-30,intra-total,18787,1307,1531,1243,1056,882,732,798,757,17050,3951,48094,22738,24045,FALSE,0.499958414771073,2020,2020-2021
NY,2020-11-30,intra-ucfe,38,1,1,1,2,0,2,1,1,26,5,78,43,44,FALSE,0.564102564102564,2020,2020-2021
NY,2020-11-30,intra-ucx,38,1,2,4,3,3,3,8,6,52,5,125,43,44,FALSE,0.352,2020,2020-2021
NY,2020-11-30,intra-ui,18711,1305,1528,1238,1051,879,727,789,750,16972,3941,47891,22652,23957,FALSE,0.50024012862542,2020,2020-2021
NY,2020-12-31,inter-total,920,25,21,16,19,21,21,12,14,340,230,1639,1150,1175,FALSE,0.716900549115314,2020,2020-2021
NY,2020-12-31,inter-ucfe,0,0,0,0,0,0,0,0,0,0,0,0,0,0,FALSE,0,2020,2020-2021
NY,2020-12-31,inter-ucx,3,0,0,0,0,0,0,0,1,1,0,5,3,3,FALSE,0.6,2020,2020-2021
NY,2020-12-31,inter-ui,917,25,21,16,19,21,21,12,13,339,230,1634,1147,1172,FALSE,0.717258261933905,2020,2020-2021
NY,2020-12-31,intra-total,30136,1342,1116,947,787,827,698,573,490,9582,5148,51646,35284,36626,FALSE,0.709173992177516,2020,2020-2021
NY,2020-12-31,intra-ucfe,61,5,3,3,3,2,3,3,3,20,3,109,64,69,FALSE,0.63302752293578,2020,2020-2021
NY,2020-12-31,intra-ucx,42,0,1,2,0,3,2,1,1,37,3,92,45,45,FALSE,0.489130434782609,2020,2020-2021
NY,2020-12-31,intra-ui,30033,1337,1112,942,784,822,693,569,486,9525,5142,51445,35175,36512,FALSE,0.709728836621635,2020,2020-2021
NY,2021-01-31,inter-total,1799,17,17,23,19,26,33,25,17,484,432,2892,2231,2248,FALSE,0.77731673582296,2020,2020-2021
NY,2021-01-31,inter-ucfe,1,0,0,0,1,0,0,0,0,1,0,3,1,1,FALSE,0.333333333333333,2020,2020-2021
NY,2021-01-31,inter-ucx,2,0,0,0,0,0,0,0,0,0,0,2,2,2,FALSE,1,2020,2020-2021
NY,2021-01-31,inter-ui,1796,17,17,23,18,26,33,25,17,483,432,2887,2228,2245,FALSE,0.777623830966401,2020,2020-2021
NY,2021-01-31,intra-total,50378,1576,1142,1093,1092,1474,1126,854,664,9991,8478,77868,58856,60432,FALSE,0.77608260132532,2020,2020-2021
NY,2021-01-31,intra-ucfe,60,2,2,3,1,2,6,5,2,24,7,114,67,69,FALSE,0.605263157894737,2020,2020-2021
NY,2021-01-31,intra-ucx,79,2,1,0,1,1,1,1,2,30,12,130,91,93,FALSE,0.715384615384615,2020,2020-2021
NY,2021-01-31,intra-ui,50239,1572,1139,1090,1090,1471,1119,848,660,9937,8459,77624,58698,60270,FALSE,0.776435123157786,2020,2020-2021
NY,2021-02-28,inter-total,2086,20,21,15,34,45,55,118,172,340,434,3340,2520,2540,FALSE,0.760479041916168,2020,2020-2021
NY,2021-02-28,inter-ucfe,3,1,0,0,0,0,0,0,0,1,0,5,3,4,FALSE,0.8,2020,2020-2021
NY,2021-02-28,inter-ucx,0,0,0,0,0,0,0,0,0,3,0,3,0,0,FALSE,0,2020,2020-2021
NY,2021-02-28,inter-ui,2083,19,21,15,34,45,55,118,172,336,434,3332,2517,2536,FALSE,0.761104441776711,2020,2020-2021
NY,2021-02-28,intra-total,46485,1447,1512,1536,1617,2133,1882,2807,3117,9977,8065,80578,54550,55997,FALSE,0.694941547320609,2020,2020-2021
NY,2021-02-28,intra-ucfe,70,2,2,1,6,2,2,4,4,22,5,120,75,77,FALSE,0.641666666666667,2020,2020-2021
NY,2021-02-28,intra-ucx,42,1,0,3,0,3,3,7,6,45,10,120,52,53,FALSE,0.441666666666667,2020,2020-2021
NY,2021-02-28,intra-ui,46373,1444,1510,1532,1611,2128,1877,2796,3107,9910,8050,80338,54423,55867,FALSE,0.695399437377082,2020,2020-2021
NY,2021-03-31,inter-total,1835,21,15,20,22,45,34,27,32,709,359,3119,2194,2215,FALSE,0.710163513946778,2020,2020-2021
NY,2021-03-31,inter-ucfe,0,0,0,0,1,0,0,0,1,2,0,4,0,0,FALSE,0,2020,2020-2021
NY,2021-03-31,inter-ucx,1,0,0,0,0,0,0,0,0,0,0,1,1,1,FALSE,1,2020,2020-2021
NY,2021-03-31,inter-ui,1834,21,15,20,21,45,34,27,31,707,359,3114,2193,2214,FALSE,0.710982658959538,2020,2020-2021
NY,2021-03-31,intra-total,71642,2255,2218,2267,2118,2090,2119,1889,1638,16828,14116,119180,85758,88013,FALSE,0.738488001342507,2020,2020-2021
NY,2021-03-31,intra-ucfe,65,1,0,4,2,2,1,5,0,37,8,125,73,74,FALSE,0.592,2020,2020-2021
NY,2021-03-31,intra-ucx,54,1,0,2,1,2,5,5,5,29,7,111,61,62,FALSE,0.558558558558559,2020,2020-2021
NY,2021-03-31,intra-ui,71523,2253,2218,2261,2115,2086,2113,1879,1633,16762,14101,118944,85624,87877,FALSE,0.738809860102233,2020,2020-2021
NY,2021-04-30,inter-total,2439,34,19,11,16,21,25,18,16,432,581,3612,3020,3054,FALSE,0.845514950166113,2020,2020-2021
NY,2021-04-30,inter-ucfe,3,0,0,0,0,0,0,0,0,1,1,5,4,4,FALSE,0.8,2020,2020-2021
NY,2021-04-30,inter-ucx,0,0,0,0,0,0,0,0,0,0,0,0,0,0,FALSE,0,2020,2020-2021
NY,2021-04-30,inter-ui,2436,34,19,11,16,21,25,18,16,431,580,3607,3016,3050,FALSE,0.84557804269476,2020,2020-2021
NY,2021-04-30,intra-total,149833,7344,4103,2008,1224,1021,992,841,762,11193,33420,212741,183253,190597,FALSE,0.895910990359169,2020,2020-2021
NY,2021-04-30,intra-ucfe,46,1,1,0,0,0,2,2,3,27,4,86,50,51,FALSE,0.593023255813954,2020,2020-2021
NY,2021-04-30,intra-ucx,41,1,0,2,3,4,2,3,1,24,8,89,49,50,FALSE,0.561797752808989,2020,2020-2021
NY,2021-04-30,intra-ui,149746,7342,4102,2006,1221,1017,988,836,758,11142,33408,212566,183154,190496,FALSE,0.896173423783672,2020,2020-2021
NY,2021-05-31,inter-total,370,9,13,14,19,23,19,19,11,258,47,802,417,426,FALSE,0.531172069825436,2020,2020-2021
NY,2021-05-31,inter-ucfe,2,0,0,0,0,0,0,0,0,3,0,5,2,2,FALSE,0.4,2020,2020-2021
NY,2021-05-31,inter-ucx,2,0,0,0,0,0,0,0,0,0,0,2,2,2,FALSE,1,2020,2020-2021
NY,2021-05-31,inter-ui,366,9,13,14,19,23,19,19,11,255,47,795,413,422,FALSE,0.530817610062893,2020,2020-2021
NY,2021-05-31,intra-total,26676,1528,1461,1925,2237,2493,1845,1248,766,8149,3658,51986,30334,31862,FALSE,0.612895779632978,2020,2020-2021
NY,2021-05-31,intra-ucfe,44,1,1,4,1,0,1,1,0,29,3,85,47,48,FALSE,0.564705882352941,2020,2020-2021
NY,2021-05-31,intra-ucx,31,2,0,1,1,2,5,7,3,18,6,76,37,39,FALSE,0.513157894736842,2020,2020-2021
NY,2021-05-31,intra-ui,26601,1525,1460,1920,2235,2491,1839,1240,763,8102,3649,51825,30250,31775,FALSE,0.613121080559576,2020,2020-2021
NY,2021-06-30,inter-total,308,41,22,15,17,11,20,25,19,107,99,684,407,448,FALSE,0.654970760233918,2020,2020-2021
NY,2021-06-30,inter-ucfe,0,0,0,0,0,0,0,0,0,1,0,1,0,0,FALSE,0,2020,2020-2021
NY,2021-06-30,inter-ucx,1,1,0,1,0,0,0,0,1,0,0,4,1,2,FALSE,0.5,2020,2020-2021
NY,2021-06-30,inter-ui,307,40,22,14,17,11,20,25,18,106,99,679,406,446,FALSE,0.656848306332842,2020,2020-2021
NY,2021-06-30,intra-total,24337,1400,1099,997,984,1007,1202,1161,1128,4818,4622,42755,28959,30359,FALSE,0.710068997778038,2020,2020-2021
NY,2021-06-30,intra-ucfe,21,2,5,2,0,2,2,2,0,16,9,61,30,32,FALSE,0.524590163934426,2020,2020-2021
NY,2021-06-30,intra-ucx,25,1,4,2,1,0,3,1,1,7,13,58,38,39,FALSE,0.672413793103448,2020,2020-2021
NY,2021-06-30,intra-ui,24291,1397,1090,993,983,1005,1197,1158,1127,4795,4600,42636,28891,30288,FALSE,0.710385589642556,2020,2020-2021
NY,2021-07-31,inter-total,411,8,5,5,4,5,9,6,5,151,38,647,449,457,FALSE,0.706336939721793,2021,2021-2022
NY,2021-07-31,inter-ucfe,1,1,0,0,0,0,0,0,0,1,0,3,1,2,FALSE,0.666666666666667,2021,2021-2022
NY,2021-07-31,inter-ucx,1,0,0,0,0,0,0,0,0,0,0,1,1,1,FALSE,1,2021,2021-2022
NY,2021-07-31,inter-ui,409,7,5,5,4,5,9,6,5,150,38,643,447,454,FALSE,0.706065318818041,2021,2021-2022
NY,2021-07-31,intra-total,28063,802,604,539,489,480,493,471,425,7393,2123,41882,30186,30988,FALSE,0.739888257485316,2021,2021-2022
NY,2021-07-31,intra-ucfe,25,0,0,0,0,0,3,0,1,23,0,52,25,25,FALSE,0.480769230769231,2021,2021-2022
NY,2021-07-31,intra-ucx,41,4,1,0,3,1,3,4,5,20,4,86,45,49,FALSE,0.569767441860465,2021,2021-2022
NY,2021-07-31,intra-ui,27997,798,603,539,486,479,487,467,419,7350,2119,41744,30116,30914,FALSE,0.740561517822921,2021,2021-2022
NY,2021-08-31,inter-total,366,14,10,6,14,8,8,2,8,114,35,585,401,415,FALSE,0.70940170940171,2021,2021-2022
NY,2021-08-31,inter-ucfe,3,0,0,1,0,0,0,0,0,0,0,4,3,3,FALSE,0.75,2021,2021-2022
NY,2021-08-31,inter-ucx,2,0,0,0,0,0,0,0,0,0,0,2,2,2,FALSE,1,2021,2021-2022
NY,2021-08-31,inter-ui,361,14,10,5,14,8,8,2,8,114,35,579,396,410,FALSE,0.708117443868739,2021,2021-2022
NY,2021-08-31,intra-total,23360,696,599,587,518,444,399,321,273,4769,1846,33812,25206,25902,FALSE,0.766059387199811,2021,2021-2022
NY,2021-08-31,intra-ucfe,27,1,0,1,0,0,0,1,0,19,1,50,28,29,FALSE,0.58,2021,2021-2022
NY,2021-08-31,intra-ucx,47,0,1,5,1,3,2,1,1,20,10,91,57,57,FALSE,0.626373626373626,2021,2021-2022
NY,2021-08-31,intra-ui,23286,695,598,581,517,441,397,319,272,4730,1835,33671,25121,25816,FALSE,0.766713195331294,2021,2021-2022
NY,2021-09-30,inter-total,419,10,11,11,2,6,8,6,4,97,35,609,454,464,FALSE,0.761904761904762,2021,2021-2022
NY,2021-09-30,inter-ucfe,2,0,0,0,0,0,0,0,0,2,0,4,2,2,FALSE,0.5,2021,2021-2022
NY,2021-09-30,inter-ucx,1,0,0,0,0,0,0,0,0,0,0,1,1,1,FALSE,1,2021,2021-2022
NY,2021-09-30,inter-ui,416,10,11,11,2,6,8,6,4,95,35,604,451,461,FALSE,0.763245033112583,2021,2021-2022
NY,2021-09-30,intra-total,25641,627,520,498,412,417,321,302,276,3704,1925,34643,27566,28193,FALSE,0.813815200762059,2021,2021-2022
NY,2021-09-30,intra-ucfe,32,0,0,0,0,0,2,2,0,22,1,59,33,33,FALSE,0.559322033898305,2021,2021-2022
NY,2021-09-30,intra-ucx,39,0,2,2,3,1,2,1,1,15,3,69,42,42,FALSE,0.608695652173913,2021,2021-2022
NY,2021-09-30,intra-ui,25570,627,518,496,409,416,317,299,275,3667,1921,34515,27491,28118,FALSE,0.814660292626394,2021,2021-2022
NY,2021-10-31,inter-total,303,23,18,12,12,16,9,8,12,137,44,594,347,370,FALSE,0.622895622895623,2021,2021-2022
NY,2021-10-31,inter-ucfe,0,0,0,0,0,0,1,0,0,2,0,3,0,0,FALSE,0,2021,2021-2022
NY,2021-10-31,inter-ucx,0,0,0,0,0,0,0,0,0,2,0,2,0,0,FALSE,0,2021,2021-2022
NY,2021-10-31,inter-ui,303,23,18,12,12,16,8,8,12,133,44,589,347,370,FALSE,0.628183361629881,2021,2021-2022
NY,2021-10-31,intra-total,15022,954,747,632,594,595,481,445,434,5659,1859,27422,16881,17835,FALSE,0.650390197651521,2021,2021-2022
NY,2021-10-31,intra-ucfe,35,11,13,7,1,1,3,0,3,23,14,111,49,60,FALSE,0.540540540540541,2021,2021-2022
NY,2021-10-31,intra-ucx,34,2,5,2,2,1,3,0,3,7,7,66,41,43,FALSE,0.651515151515152,2021,2021-2022
NY,2021-10-31,intra-ui,14953,941,729,623,591,593,475,445,428,5629,1838,27245,16791,17732,FALSE,0.650835015599193,2021,2021-2022
NY,2021-11-30,inter-total,405,24,17,20,12,6,12,6,10,118,49,679,454,478,FALSE,0.703976435935199,2021,2021-2022
NY,2021-11-30,inter-ucfe,1,1,0,0,0,0,0,0,0,0,1,3,2,3,FALSE,1,2021,2021-2022
NY,2021-11-30,inter-ucx,0,0,0,0,0,0,0,0,0,1,0,1,0,0,FALSE,0,2021,2021-2022
NY,2021-11-30,inter-ui,404,23,17,20,12,6,12,6,10,117,48,675,452,475,FALSE,0.703703703703704,2021,2021-2022
NY,2021-11-30,intra-total,17644,686,552,553,535,453,448,379,378,4903,1554,28085,19198,19884,FALSE,0.707993590884814,2021,2021-2022
NY,2021-11-30,intra-ucfe,21,5,2,1,7,8,7,0,1,33,6,91,27,32,FALSE,0.351648351648352,2021,2021-2022
NY,2021-11-30,intra-ucx,21,4,1,2,5,2,1,0,2,9,7,54,28,32,FALSE,0.592592592592593,2021,2021-2022
NY,2021-11-30,intra-ui,17602,677,549,550,523,443,440,379,375,4861,1541,27940,19143,19820,FALSE,0.709377236936292,2021,2021-2022
NY,2021-12-31,inter-total,351,9,10,12,14,15,10,11,8,120,33,593,384,393,FALSE,0.662731871838111,2021,2021-2022
NY,2021-12-31,inter-ucfe,0,0,0,0,1,0,0,0,0,2,0,3,0,0,FALSE,0,2021,2021-2022
NY,2021-12-31,inter-ucx,2,0,0,0,0,0,0,0,0,0,0,2,2,2,FALSE,1,2021,2021-2022
NY,2021-12-31,inter-ui,349,9,10,12,13,15,10,11,8,118,33,588,382,391,FALSE,0.664965986394558,2021,2021-2022
NY,2021-12-31,intra-total,15558,569,398,384,380,348,424,389,362,4636,1303,24751,16861,17430,FALSE,0.704213971152681,2021,2021-2022
NY,2021-12-31,intra-ucfe,6,4,3,4,3,1,3,2,5,31,5,67,11,15,FALSE,0.223880597014925,2021,2021-2022
NY,2021-12-31,intra-ucx,12,3,3,1,1,3,1,1,1,7,5,38,17,20,FALSE,0.526315789473684,2021,2021-2022
NY,2021-12-31,intra-ui,15540,562,392,379,376,344,420,386,356,4598,1293,24646,16833,17395,FALSE,0.7057940436582,2021,2021-2022
NY,2022-01-31,inter-total,308,21,18,19,7,8,10,9,13,107,50,570,358,379,FALSE,0.664912280701754,2021,2021-2022
NY,2022-01-31,inter-ucfe,0,0,0,0,0,1,0,0,0,0,0,1,0,0,FALSE,0,2021,2021-2022
NY,2022-01-31,inter-ucx,0,0,0,0,0,0,0,0,0,1,0,1,0,0,FALSE,0,2021,2021-2022
NY,2022-01-31,inter-ui,308,21,18,19,7,7,10,9,13,106,50,568,358,379,FALSE,0.667253521126761,2021,2021-2022
NY,2022-01-31,intra-total,23012,866,636,472,405,355,424,512,402,4103,1963,33150,24975,25841,FALSE,0.779517345399698,2021,2021-2022
NY,2022-01-31,intra-ucfe,11,3,1,2,2,0,2,3,1,27,5,57,16,19,FALSE,0.333333333333333,2021,2021-2022
NY,2022-01-31,intra-ucx,19,4,2,0,3,0,2,1,0,3,5,39,24,28,FALSE,0.717948717948718,2021,2021-2022
NY,2022-01-31,intra-ui,22982,859,633,470,400,355,420,508,401,4073,1953,33054,24935,25794,FALSE,0.780359411871483,2021,2021-2022
NY,2022-02-28,inter-total,296,41,26,27,24,6,8,7,7,88,50,580,346,387,FALSE,0.667241379310345,2021,2021-2022
NY,2022-02-28,inter-ucfe,2,0,0,0,0,0,0,0,0,0,0,2,2,2,FALSE,1,2021,2021-2022
NY,2022-02-28,inter-ucx,1,0,0,0,0,0,0,0,0,0,1,2,2,2,FALSE,1,2021,2021-2022
NY,2022-02-28,inter-ui,293,41,26,27,24,6,8,7,7,88,49,576,342,383,FALSE,0.664930555555556,2021,2021-2022
NY,2022-02-28,intra-total,13566,1460,1217,889,666,409,280,220,183,3399,1815,24104,15381,16841,FALSE,0.698680716893462,2021,2021-2022
NY,2022-02-28,intra-ucfe,7,5,1,1,3,0,0,0,0,23,5,45,12,17,FALSE,0.377777777777778,2021,2021-2022
NY,2022-02-28,intra-ucx,13,2,0,3,1,1,1,1,1,8,2,33,15,17,FALSE,0.515151515151515,2021,2021-2022
NY,2022-02-28,intra-ui,13546,1453,1216,885,662,408,279,219,182,3368,1808,24026,15354,16807,FALSE,0.699533838341796,2021,2021-2022
NY,2022-03-31,inter-total,225,45,29,18,19,15,17,12,10,114,58,562,283,328,FALSE,0.583629893238434,2021,2021-2022
NY,2022-03-31,inter-ucfe,0,0,1,0,1,0,0,0,0,1,0,3,0,0,FALSE,0,2021,2021-2022
NY,2022-03-31,inter-ucx,1,0,0,0,1,0,0,0,0,1,0,3,1,1,FALSE,0.333333333333333,2021,2021-2022
NY,2022-03-31,inter-ui,224,45,28,18,17,15,17,12,10,112,58,556,282,327,FALSE,0.588129496402878,2021,2021-2022
NY,2022-03-31,intra-total,11482,1449,1018,721,640,686,558,540,380,4003,1960,23437,13442,14891,FALSE,0.635362887741605,2021,2021-2022
NY,2022-03-31,intra-ucfe,10,4,3,1,3,1,0,2,2,30,2,58,12,16,FALSE,0.275862068965517,2021,2021-2022
NY,2022-03-31,intra-ucx,16,3,2,2,3,0,1,0,2,3,3,35,19,22,FALSE,0.628571428571429,2021,2021-2022
NY,2022-03-31,intra-ui,11456,1442,1013,718,634,685,557,538,376,3970,1955,23344,13411,14853,FALSE,0.63626627827279,2021,2021-2022
NY,2022-04-30,inter-total,173,25,23,13,18,13,6,8,5,91,35,410,208,233,FALSE,0.568292682926829,2021,2021-2022
NY,2022-04-30,inter-ucfe,1,0,1,0,1,0,0,0,0,0,0,3,1,1,FALSE,0.333333333333333,2021,2021-2022
NY,2022-04-30,inter-ucx,2,0,0,0,0,0,0,0,0,0,0,2,2,2,FALSE,1,2021,2021-2022
NY,2022-04-30,inter-ui,170,25,22,13,17,13,6,8,5,91,35,405,205,230,FALSE,0.567901234567901,2021,2021-2022
NY,2022-04-30,intra-total,8989,992,806,500,411,310,349,325,345,3430,1528,17985,10517,11509,FALSE,0.63992215735335,2021,2021-2022
NY,2022-04-30,intra-ucfe,23,3,2,0,1,1,2,3,1,8,5,49,28,31,FALSE,0.63265306122449,2021,2021-2022
NY,2022-04-30,intra-ucx,15,2,3,0,2,2,1,0,1,9,5,40,20,22,FALSE,0.55,2021,2021-2022
NY,2022-04-30,intra-ui,8951,987,801,500,408,307,346,322,343,3413,1518,17896,10469,11456,FALSE,0.640143048725972,2021,2021-2022
NY,2022-05-31,inter-total,243,30,27,23,8,12,3,6,7,83,43,485,286,316,FALSE,0.651546391752577,2021,2021-2022
NY,2022-05-31,inter-ucfe,1,1,0,0,0,1,0,0,0,0,0,3,1,2,FALSE,0.666666666666667,2021,2021-2022
NY,2022-05-31,inter-ucx,0,0,0,0,0,0,0,0,0,0,0,0,0,0,FALSE,0,2021,2021-2022
NY,2022-05-31,inter-ui,242,29,27,23,8,11,3,6,7,83,43,482,285,314,FALSE,0.651452282157676,2021,2021-2022
NY,2022-05-31,intra-total,9996,1042,1043,699,518,366,300,263,294,3073,1736,19330,11732,12774,FALSE,0.660838075530264,2021,2021-2022
NY,2022-05-31,intra-ucfe,22,5,3,3,2,3,2,0,2,19,10,71,32,37,FALSE,0.52112676056338,2021,2021-2022
NY,2022-05-31,intra-ucx,22,3,0,4,3,1,0,0,0,9,5,47,27,30,FALSE,0.638297872340426,2021,2021-2022
NY,2022-05-31,intra-ui,9952,1034,1040,692,513,362,298,263,292,3045,1721,19212,11673,12707,FALSE,0.66140953570685,2021,2021-2022
NY,2022-06-30,inter-total,218,29,32,12,25,8,15,11,5,74,49,478,267,296,FALSE,0.619246861924686,2021,2021-2022
NY,2022-06-30,inter-ucfe,1,0,0,0,1,0,1,0,0,0,0,3,1,1,FALSE,0.333333333333333,2021,2021-2022
NY,2022-06-30,inter-ucx,1,1,0,0,0,0,0,0,0,0,0,2,1,2,FALSE,1,2021,2021-2022
NY,2022-06-30,inter-ui,216,28,32,12,24,8,14,11,5,74,49,473,265,293,FALSE,0.619450317124736,2021,2021-2022
NY,2022-06-30,intra-total,9855,1041,930,685,542,490,438,369,279,2599,1701,18929,11556,12597,FALSE,0.665486819166359,2021,2021-2022
NY,2022-06-30,intra-ucfe,45,10,5,2,4,7,0,5,0,15,12,105,57,67,FALSE,0.638095238095238,2021,2021-2022
NY,2022-06-30,intra-ucx,13,2,3,1,1,1,3,0,0,6,3,33,16,18,FALSE,0.545454545454545,2021,2021-2022
NY,2022-06-30,intra-ui,9797,1029,922,682,537,482,435,364,279,2578,1686,18791,11483,12512,FALSE,0.665850673194615,2021,2021-2022
NY,2022-07-31,inter-total,237,25,23,18,11,4,5,13,7,51,50,444,287,312,FALSE,0.702702702702703,2022,2022-2023
NY,2022-07-31,inter-ucfe,1,0,0,0,0,0,0,0,1,0,0,2,1,1,FALSE,0.5,2022,2022-2023
NY,2022-07-31,inter-ucx,3,0,0,0,0,0,0,0,0,0,0,3,3,3,FALSE,1,2022,2022-2023
NY,2022-07-31,inter-ui,233,25,23,18,11,4,5,13,6,51,50,439,283,308,FALSE,0.701594533029613,2022,2022-2023
NY,2022-07-31,intra-total,15372,943,636,470,480,382,298,245,209,2093,2133,23261,17505,18448,FALSE,0.793087141567431,2022,2022-2023
NY,2022-07-31,intra-ucfe,14,3,5,7,7,2,1,2,2,16,6,65,20,23,FALSE,0.353846153846154,2022,2022-2023
NY,2022-07-31,intra-ucx,13,3,3,0,0,1,0,1,0,2,8,31,21,24,FALSE,0.774193548387097,2022,2022-2023
NY,2022-07-31,intra-ui,15345,937,628,463,473,379,297,242,207,2075,2119,23165,17464,18401,FALSE,0.794344916900497,2022,2022-2023
NY,2022-08-31,inter-total,212,43,27,27,17,12,6,12,8,89,87,540,299,342,FALSE,0.633333333333333,2022,2022-2023
NY,2022-08-31,inter-ucfe,0,0,0,0,1,0,0,2,0,1,0,4,0,0,FALSE,0,2022,2022-2023
NY,2022-08-31,inter-ucx,1,0,0,0,0,0,0,0,0,0,0,1,1,1,FALSE,1,2022,2022-2023
NY,2022-08-31,inter-ui,211,43,27,27,16,12,6,10,8,88,87,535,298,341,FALSE,0.637383177570094,2022,2022-2023
NY,2022-08-31,intra-total,12440,1546,1331,998,812,598,432,319,292,2591,2452,23811,14892,16438,FALSE,0.690353198101718,2022,2022-2023
NY,2022-08-31,intra-ucfe,7,9,7,3,4,2,4,1,4,15,9,65,16,25,FALSE,0.384615384615385,2022,2022-2023
NY,2022-08-31,intra-ucx,16,9,5,5,3,0,3,1,1,8,4,55,20,29,FALSE,0.527272727272727,2022,2022-2023
NY,2022-08-31,intra-ui,12417,1528,1319,990,805,596,425,317,287,2568,2439,23691,14856,16384,FALSE,0.691570638639146,2022,2022-2023
NY,2022-09-30,inter-total,191,31,33,20,12,16,13,13,12,66,83,490,274,305,FALSE,0.622448979591837,2022,2022-2023
NY,2022-09-30,inter-ucfe,0,0,0,0,0,0,0,1,1,1,0,3,0,0,FALSE,0,2022,2022-2023
NY,2022-09-30,inter-ucx,0,1,0,0,0,0,0,0,0,1,1,3,1,2,FALSE,0.666666666666667,2022,2022-2023
NY,2022-09-30,inter-ui,191,30,33,20,12,16,13,12,11,64,82,484,273,303,FALSE,0.62603305785124,2022,2022-2023
NY,2022-09-30,intra-total,9316,1433,981,688,597,530,537,460,416,2097,2536,19591,11852,13285,FALSE,0.678117502935021,2022,2022-2023
NY,2022-09-30,intra-ucfe,3,6,1,1,3,4,0,4,0,18,6,46,9,15,FALSE,0.326086956521739,2022,2022-2023
NY,2022-09-30,intra-ucx,7,4,3,2,1,4,1,1,1,4,7,35,14,18,FALSE,0.514285714285714,2022,2022-2023
NY,2022-09-30,intra-ui,9306,1423,977,685,593,522,536,455,415,2075,2523,19510,11829,13252,FALSE,0.679241414659149,2022,2022-2023
NY,2022-10-31,inter-total,219,27,19,19,14,8,5,9,16,69,75,480,294,321,FALSE,0.66875,2022,2022-2023
NY,2022-10-31,inter-ucfe,0,0,0,1,0,0,0,0,0,1,1,3,1,1,FALSE,0.333333333333333,2022,2022-2023
NY,2022-10-31,inter-ucx,0,0,0,1,0,0,0,0,0,1,0,2,0,0,FALSE,0,2022,2022-2023
NY,2022-10-31,inter-ui,219,27,19,17,14,8,5,9,16,67,74,475,293,320,FALSE,0.673684210526316,2022,2022-2023
NY,2022-10-31,intra-total,9098,1219,819,631,496,465,455,429,433,2474,2384,18903,11482,12701,FALSE,0.671903930593028,2022,2022-2023
NY,2022-10-31,intra-ucfe,5,3,5,5,2,1,2,1,0,8,10,42,15,18,FALSE,0.428571428571429,2022,2022-2023
NY,2022-10-31,intra-ucx,9,6,4,2,2,3,1,1,0,4,2,34,11,17,FALSE,0.5,2022,2022-2023
NY,2022-10-31,intra-ui,9084,1210,810,624,492,461,452,427,433,2462,2372,18827,11456,12666,FALSE,0.672757210389334,2022,2022-2023
NY,2022-11-30,inter-total,330,53,35,17,12,13,11,9,8,76,93,657,423,476,FALSE,0.724505327245053,2022,2022-2023
NY,2022-11-30,inter-ucfe,0,0,0,0,0,1,0,1,0,2,0,4,0,0,FALSE,0,2022,2022-2023
NY,2022-11-30,inter-ucx,1,0,0,0,0,0,0,0,0,0,0,1,1,1,FALSE,1,2022,2022-2023
NY,2022-11-30,inter-ui,329,53,35,17,12,12,11,8,8,74,93,652,422,475,FALSE,0.728527607361963,2022,2022-2023
NY,2022-11-30,intra-total,11714,1384,928,686,506,381,359,276,321,2328,2782,21665,14496,15880,FALSE,0.732979459958458,2022,2022-2023
NY,2022-11-30,intra-ucfe,9,3,1,3,3,2,0,0,0,12,7,40,16,19,FALSE,0.475,2022,2022-2023
NY,2022-11-30,intra-ucx,17,2,2,1,1,2,1,1,0,10,9,46,26,28,FALSE,0.608695652173913,2022,2022-2023
NY,2022-11-30,intra-ui,11688,1379,925,682,502,377,358,275,321,2306,2766,21579,14454,15833,FALSE,0.733722600676584,2022,2022-2023
NY,2022-12-31,inter-total,369,46,35,21,11,21,7,10,6,74,81,681,450,496,FALSE,0.728340675477239,2022,2022-2023
NY,2022-12-31,inter-ucfe,0,0,0,0,0,0,0,0,0,1,1,2,1,1,FALSE,0.5,2022,2022-2023
NY,2022-12-31,inter-ucx,1,0,0,0,0,0,0,0,0,1,0,2,1,1,FALSE,0.5,2022,2022-2023
NY,2022-12-31,inter-ui,368,46,35,21,11,21,7,10,6,72,80,677,448,494,FALSE,0.729689807976366,2022,2022-2023
NY,2022-12-31,intra-total,15118,1426,1069,723,580,429,349,309,281,2284,2946,25514,18064,19490,FALSE,0.763894332523321,2022,2022-2023
NY,2022-12-31,intra-ucfe,3,4,4,5,4,0,4,1,5,6,6,42,9,13,FALSE,0.30952380952381,2022,2022-2023
NY,2022-12-31,intra-ucx,15,0,2,1,2,2,2,0,0,2,3,29,18,18,FALSE,0.620689655172414,2022,2022-2023
NY,2022-12-31,intra-ui,15100,1422,1063,717,574,427,343,308,276,2276,2937,25443,18037,19459,FALSE,0.764807609165586,2022,2022-2023
NY,2023-01-31,inter-total,431,45,20,23,9,13,13,9,13,46,105,727,536,581,FALSE,0.799174690508941,2022,2022-2023
NY,2023-01-31,inter-ucfe,0,1,0,0,0,1,0,0,0,1,0,3,0,1,FALSE,0.333333333333333,2022,2022-2023
NY,2023-01-31,inter-ucx,0,0,0,0,0,0,0,0,0,1,0,1,0,0,FALSE,0,2022,2022-2023
NY,2023-01-31,inter-ui,431,44,20,23,9,12,13,9,13,44,105,723,536,580,FALSE,0.802213001383126,2022,2022-2023
NY,2023-01-31,intra-total,23136,1779,1110,775,610,490,360,308,243,1988,4000,34799,27136,28915,FALSE,0.830914681456364,2022,2022-2023
NY,2023-01-31,intra-ucfe,7,1,4,2,0,3,0,1,2,9,4,33,11,12,FALSE,0.363636363636364,2022,2022-2023
NY,2023-01-31,intra-ucx,13,3,5,0,2,0,3,1,0,5,5,37,18,21,FALSE,0.567567567567568,2022,2022-2023
NY,2023-01-31,intra-ui,23116,1775,1101,773,608,487,357,306,241,1974,3991,34729,27107,28882,FALSE,0.831639264015664,2022,2022-2023
NY,2023-02-28,inter-total,388,50,36,23,21,12,14,8,5,40,121,718,509,559,FALSE,0.778551532033426,2022,2022-2023
NY,2023-02-28,inter-ucfe,0,0,0,0,0,0,0,0,0,0,1,1,1,1,FALSE,1,2022,2022-2023
NY,2023-02-28,inter-ucx,0,0,0,0,0,0,0,0,0,1,0,1,0,0,FALSE,0,2022,2022-2023
NY,2023-02-28,inter-ui,388,50,36,23,21,12,14,8,5,39,120,716,508,558,FALSE,0.779329608938548,2022,2022-2023
NY,2023-02-28,intra-total,15169,1762,1289,940,701,534,422,326,260,1882,3792,27077,18961,20723,FALSE,0.76533589393212,2022,2022-2023
NY,2023-02-28,intra-ucfe,2,2,4,3,2,1,1,1,3,10,3,32,5,7,FALSE,0.21875,2022,2022-2023
NY,2023-02-28,intra-ucx,10,4,2,2,1,2,0,0,0,7,2,30,12,16,FALSE,0.533333333333333,2022,2022-2023
NY,2023-02-28,intra-ui,15157,1756,1283,935,698,531,421,325,257,1865,3787,27015,18944,20700,FALSE,0.76624097723487,2022,2022-2023
NY,2023-03-31,inter-total,314,59,35,24,24,18,21,16,12,77,123,723,437,496,FALSE,0.686030428769018,2022,2022-2023
NY,2023-03-31,inter-ucfe,0,0,0,0,0,0,0,0,0,0,0,0,0,0,FALSE,0,2022,2022-2023
NY,2023-03-31,inter-ucx,0,0,0,1,0,0,0,0,0,1,2,4,2,2,FALSE,0.5,2022,2022-2023
NY,2023-03-31,inter-ui,314,59,35,23,24,18,21,16,12,76,121,719,435,494,FALSE,0.687065368567455,2022,2022-2023
NY,2023-03-31,intra-total,12585,2085,1347,1068,888,803,715,545,502,2974,4433,27945,17018,19103,FALSE,0.683592771515477,2022,2022-2023
NY,2023-03-31,intra-ucfe,3,7,4,5,2,2,3,3,3,7,3,42,6,13,FALSE,0.30952380952381,2022,2022-2023
NY,2023-03-31,intra-ucx,18,6,1,1,3,2,1,2,0,6,8,48,26,32,FALSE,0.666666666666667,2022,2022-2023
NY,2023-03-31,intra-ui,12564,2072,1342,1062,883,799,711,540,499,2961,4422,27855,16986,19058,FALSE,0.684185963022797,2022,2022-2023
NY,2023-04-30,inter-total,239,41,19,14,14,11,10,4,7,54,99,512,338,379,FALSE,0.740234375,2022,2022-2023
NY,2023-04-30,inter-ucfe,0,0,0,0,0,0,0,0,0,1,0,1,0,0,FALSE,0,2022,2022-2023
NY,2023-04-30,inter-ucx,0,0,0,0,0,0,0,0,0,1,1,2,1,1,FALSE,0.5,2022,2022-2023
NY,2023-04-30,inter-ui,239,41,19,14,14,11,10,4,7,52,98,509,337,378,FALSE,0.742632612966601,2022,2022-2023
NY,2023-04-30,intra-total,10315,1678,910,588,455,375,386,371,334,2418,3748,21578,14063,15741,FALSE,0.729493002131801,2022,2022-2023
NY,2023-04-30,intra-ucfe,11,1,2,1,2,1,2,0,0,7,4,31,15,16,FALSE,0.516129032258065,2022,2022-2023
NY,2023-04-30,intra-ucx,13,6,4,2,2,0,2,2,1,5,5,42,18,24,FALSE,0.571428571428571,2022,2022-2023
NY,2023-04-30,intra-ui,10291,1671,904,585,451,374,382,369,333,2406,3739,21505,14030,15701,FALSE,0.730109276912346,2022,2022-2023
NY,2023-05-31,inter-total,268,40,24,18,19,6,15,11,12,81,89,583,357,397,FALSE,0.680960548885077,2022,2022-2023
NY,2023-05-31,inter-ucfe,0,1,0,0,0,0,0,0,0,1,1,3,1,2,FALSE,0.666666666666667,2022,2022-2023
NY,2023-05-31,inter-ucx,0,0,0,0,0,0,0,0,0,0,0,0,0,0,FALSE,0,2022,2022-2023
NY,2023-05-31,inter-ui,268,39,24,18,19,6,15,11,12,80,88,580,356,395,FALSE,0.681034482758621,2022,2022-2023
NY,2023-05-31,intra-total,11305,1849,1219,933,736,557,514,515,447,2746,3751,24572,15056,16905,FALSE,0.687978186553801,2022,2022-2023
NY,2023-05-31,intra-ucfe,20,7,3,3,5,2,0,0,1,9,9,59,29,36,FALSE,0.610169491525424,2022,2022-2023
NY,2023-05-31,intra-ucx,12,5,5,0,2,1,0,1,1,5,8,40,20,25,FALSE,0.625,2022,2022-2023
NY,2023-05-31,intra-ui,11273,1837,1211,930,729,554,514,514,445,2732,3734,24473,15007,16844,FALSE,0.688268704286356,2022,2022-2023
NY,2023-06-30,inter-total,230,46,38,19,18,13,5,12,7,59,80,527,310,356,FALSE,0.675521821631879,2022,2022-2023
NY,2023-06-30,inter-ucfe,0,0,0,0,0,1,0,0,0,1,0,2,0,0,FALSE,0,2022,2022-2023
NY,2023-06-30,inter-ucx,0,0,0,1,0,0,0,0,0,0,1,2,1,1,FALSE,0.5,2022,2022-2023
NY,2023-06-30,inter-ui,230,46,38,18,18,12,5,12,7,58,79,523,309,355,FALSE,0.678776290630975,2022,2022-2023
NY,2023-06-30,intra-total,10388,2002,1408,940,680,512,434,329,308,2208,3530,22739,13918,15920,FALSE,0.700118738730815,2022,2022-2023
NY,2023-06-30,intra-ucfe,14,11,5,4,4,2,4,0,0,13,3,60,17,28,FALSE,0.466666666666667,2022,2022-2023
NY,2023-06-30,intra-ucx,16,1,1,2,1,1,0,0,0,2,5,29,21,22,FALSE,0.758620689655172,2022,2022-2023
NY,2023-06-30,intra-ui,10358,1990,1402,934,675,509,430,329,308,2193,3522,22650,13880,15870,FALSE,0.700662251655629,2022,2022-2023
NY,2023-07-31,inter-total,299,32,27,21,25,14,10,12,4,58,95,597,394,426,FALSE,0.71356783919598,2023,2023-2024
NY,2023-07-31,inter-ucfe,1,1,0,0,0,0,0,0,0,1,0,3,1,2,FALSE,0.666666666666667,2023,2023-2024
NY,2023-07-31,inter-ucx,2,0,0,0,0,0,0,0,0,0,1,3,3,3,FALSE,1,2023,2023-2024
NY,2023-07-31,inter-ui,296,31,27,21,25,14,10,12,4,57,94,591,390,421,FALSE,0.712351945854484,2023,2023-2024
NY,2023-07-31,intra-total,19723,1851,1143,928,725,509,437,332,302,2215,4367,32532,24090,25941,FALSE,0.797399483585393,2023,2023-2024
NY,2023-07-31,intra-ucfe,11,0,3,4,3,1,0,3,2,9,4,40,15,15,FALSE,0.375,2023,2023-2024
NY,2023-07-31,intra-ucx,14,9,7,2,1,2,0,0,1,8,6,50,20,29,FALSE,0.58,2023,2023-2024
NY,2023-07-31,intra-ui,19698,1842,1133,922,721,506,437,329,299,2198,4357,32442,24055,25897,FALSE,0.798255348005672,2023,2023-2024
NY,2023-08-31,inter-total,314,55,40,38,28,21,11,13,12,83,89,704,403,458,FALSE,0.650568181818182,2023,2023-2024
NY,2023-08-31,inter-ucfe,0,0,0,0,0,0,0,0,0,1,0,1,0,0,FALSE,0,2023,2023-2024
NY,2023-08-31,inter-ucx,1,0,0,0,0,0,0,0,0,0,0,1,1,1,FALSE,1,2023,2023-2024
NY,2023-08-31,inter-ui,313,55,40,38,28,21,11,13,12,82,89,702,402,457,FALSE,0.650997150997151,2023,2023-2024
NY,2023-08-31,intra-total,16681,2467,1716,1321,1018,759,561,472,350,2594,4048,31987,20729,23196,FALSE,0.725169600150061,2023,2023-2024
NY,2023-08-31,intra-ucfe,5,7,7,3,1,2,1,1,6,10,8,51,13,20,FALSE,0.392156862745098,2023,2023-2024
NY,2023-08-31,intra-ucx,22,5,8,3,1,0,1,0,0,7,6,53,28,33,FALSE,0.622641509433962,2023,2023-2024
NY,2023-08-31,intra-ui,16654,2455,1701,1315,1016,757,559,471,344,2577,4034,31883,20688,23143,FALSE,0.725872722140326,2023,2023-2024
NY,2023-09-30,inter-total,207,43,30,21,13,15,8,7,14,80,118,556,325,368,FALSE,0.661870503597122,2023,2023-2024
NY,2023-09-30,inter-ucfe,0,0,0,0,1,0,0,0,0,2,2,5,2,2,FALSE,0.4,2023,2023-2024
NY,2023-09-30,inter-ucx,0,0,0,0,0,0,0,0,0,0,0,0,0,0,FALSE,0,2023,2023-2024
NY,2023-09-30,inter-ui,207,43,30,21,12,15,8,7,14,78,116,551,323,366,FALSE,0.664246823956443,2023,2023-2024
NY,2023-09-30,intra-total,12378,1755,1149,951,735,595,492,429,346,2987,3640,25457,16018,17773,FALSE,0.698157677652512,2023,2023-2024
NY,2023-09-30,intra-ucfe,9,2,5,5,3,1,1,1,3,11,5,46,14,16,FALSE,0.347826086956522,2023,2023-2024
NY,2023-09-30,intra-ucx,10,3,3,1,0,0,0,0,0,3,4,24,14,17,FALSE,0.708333333333333,2023,2023-2024
NY,2023-09-30,intra-ui,12359,1750,1141,945,732,594,491,428,343,2973,3631,25387,15990,17740,FALSE,0.698782841611849,2023,2023-2024
NY,2023-10-31,inter-total,297,37,25,17,15,7,17,6,5,86,117,629,414,451,FALSE,0.717011128775835,2023,2023-2024
NY,2023-10-31,inter-ucfe,1,1,0,0,0,0,0,0,0,0,0,2,1,2,FALSE,1,2023,2023-2024
NY,2023-10-31,inter-ucx,0,0,0,0,0,0,0,0,0,0,0,0,0,0,FALSE,0,2023,2023-2024
NY,2023-10-31,inter-ui,296,36,25,17,15,7,17,6,5,86,117,627,413,449,FALSE,0.716108452950558,2023,2023-2024
NY,2023-10-31,intra-total,12765,1431,966,726,611,457,410,319,289,2577,3601,24152,16366,17797,FALSE,0.736874792977807,2023,2023-2024
NY,2023-10-31,intra-ucfe,11,6,7,3,3,3,1,5,1,8,7,55,18,24,FALSE,0.436363636363636,2023,2023-2024
NY,2023-10-31,intra-ucx,15,4,2,2,3,0,1,2,3,2,8,42,23,27,FALSE,0.642857142857143,2023,2023-2024
NY,2023-10-31,intra-ui,12739,1421,957,721,605,454,408,312,285,2567,3586,24055,16325,17746,FALSE,0.737726044481397,2023,2023-2024
NY,2023-11-30,inter-total,357,52,33,28,11,14,8,4,9,81,121,718,478,530,FALSE,0.738161559888579,2023,2023-2024
NY,2023-11-30,inter-ucfe,1,0,0,0,0,1,0,0,0,0,2,4,3,3,FALSE,0.75,2023,2023-2024
NY,2023-11-30,inter-ucx,0,0,0,0,0,0,0,0,0,1,0,1,0,0,FALSE,0,2023,2023-2024
NY,2023-11-30,inter-ui,356,52,33,28,11,13,8,4,9,80,119,713,475,527,FALSE,0.739130434782609,2023,2023-2024
NY,2023-11-30,intra-total,14548,1387,964,688,504,397,280,267,212,2348,3573,25168,18121,19508,FALSE,0.77511125238398,2023,2023-2024
NY,2023-11-30,intra-ucfe,8,8,1,2,4,3,3,0,1,9,11,50,19,27,FALSE,0.54,2023,2023-2024
NY,2023-11-30,intra-ucx,17,1,2,5,0,0,2,0,1,4,3,35,20,21,FALSE,0.6,2023,2023-2024
NY,2023-11-30,intra-ui,14523,1378,961,681,500,394,275,267,210,2335,3559,25083,18082,19460,FALSE,0.775824263445361,2023,2023-2024
NY,2023-12-31,inter-total,336,36,26,23,18,17,9,8,6,39,116,634,452,488,FALSE,0.769716088328076,2023,2023-2024
NY,2023-12-31,inter-ucfe,0,0,0,0,0,0,0,0,0,0,0,0,0,0,FALSE,0,2023,2023-2024
NY,2023-12-31,inter-ucx,0,0,0,0,0,0,0,0,0,0,0,0,0,0,FALSE,0,2023,2023-2024
NY,2023-12-31,inter-ui,336,36,26,23,18,17,9,8,6,39,116,634,452,488,FALSE,0.769716088328076,2023,2023-2024
NY,2023-12-31,intra-total,17026,1229,942,661,507,359,326,246,256,2317,3245,27114,20271,21500,FALSE,0.792948292395073,2023,2023-2024
NY,2023-12-31,intra-ucfe,5,5,1,8,4,0,0,2,5,4,5,39,10,15,FALSE,0.384615384615385,2023,2023-2024
NY,2023-12-31,intra-ucx,14,2,1,1,1,1,2,2,0,4,3,31,17,19,FALSE,0.612903225806452,2023,2023-2024
NY,2023-12-31,intra-ui,17007,1222,940,652,502,358,324,242,251,2309,3237,27044,20244,21466,FALSE,0.793743529063748,2023,2023-2024
NY,2024-01-31,inter-total,398,47,31,30,23,25,10,12,11,62,115,764,513,560,FALSE,0.732984293193717,2023,2023-2024
NY,2024-01-31,inter-ucfe,0,0,1,1,0,0,0,1,0,0,0,3,0,0,FALSE,0,2023,2023-2024
NY,2024-01-31,inter-ucx,0,0,0,0,0,0,0,1,0,0,0,1,0,0,FALSE,0,2023,2023-2024
NY,2024-01-31,inter-ui,398,47,30,29,23,25,10,10,11,62,115,760,513,560,FALSE,0.736842105263158,2023,2023-2024
NY,2024-01-31,intra-total,26815,1938,1282,864,578,458,351,266,187,2230,4825,39794,31640,33578,FALSE,0.843795547067397,2023,2023-2024
NY,2024-01-31,intra-ucfe,10,2,3,1,1,1,1,1,1,7,8,36,18,20,FALSE,0.555555555555556,2023,2023-2024
NY,2024-01-31,intra-ucx,8,1,4,2,1,2,3,1,1,7,5,35,13,14,FALSE,0.4,2023,2023-2024
NY,2024-01-31,intra-ui,26797,1935,1275,861,576,455,347,264,185,2216,4812,39723,31609,33544,FALSE,0.844447801022078,2023,2023-2024
NY,2024-02-29,inter-total,390,47,39,25,23,10,11,11,6,58,93,713,483,530,FALSE,0.743338008415147,2023,2023-2024
NY,2024-02-29,inter-ucfe,0,0,0,0,0,0,0,0,0,0,0,0,0,0,FALSE,0,2023,2023-2024
NY,2024-02-29,inter-ucx,0,0,0,0,1,0,0,0,0,0,0,1,0,0,FALSE,0,2023,2023-2024
NY,2024-02-29,inter-ui,390,47,39,25,22,10,11,11,6,58,93,712,483,530,FALSE,0.74438202247191,2023,2023-2024
NY,2024-02-29,intra-total,19405,1669,1243,936,669,619,445,349,287,2002,4179,31803,23584,25253,FALSE,0.794044586988649,2023,2023-2024
NY,2024-02-29,intra-ucfe,7,8,0,4,2,4,1,2,1,5,6,40,13,21,FALSE,0.525,2023,2023-2024
NY,2024-02-29,intra-ucx,19,2,3,3,0,2,1,0,1,9,5,45,24,26,FALSE,0.577777777777778,2023,2023-2024
NY,2024-02-29,intra-ui,19379,1659,1240,929,667,613,443,347,285,1988,4168,31718,23547,25206,FALSE,0.794690711898607,2023,2023-2024
NY,2024-03-31,inter-total,276,23,25,18,21,14,13,11,11,54,81,547,357,380,FALSE,0.694698354661792,2023,2023-2024
NY,2024-03-31,inter-ucfe,0,0,1,0,0,0,0,0,0,0,1,2,1,1,FALSE,0.5,2023,2023-2024
NY,2024-03-31,inter-ucx,0,1,0,0,0,0,0,0,0,0,2,3,2,3,FALSE,1,2023,2023-2024
NY,2024-03-31,inter-ui,276,22,24,18,21,14,13,11,11,54,78,542,354,376,FALSE,0.693726937269373,2023,2023-2024
NY,2024-03-31,intra-total,14936,1132,854,739,647,625,568,463,376,2129,3222,25691,18158,19290,FALSE,0.750846599976646,2023,2023-2024
NY,2024-03-31,intra-ucfe,5,4,3,5,4,4,2,4,2,10,7,50,12,16,FALSE,0.32,2023,2023-2024
NY,2024-03-31,intra-ucx,11,3,1,3,1,2,3,1,1,5,2,33,13,16,FALSE,0.484848484848485,2023,2023-2024
NY,2024-03-31,intra-ui,14920,1125,850,731,642,619,563,458,373,2114,3213,25608,18133,19258,FALSE,0.752030615432677,2023,2023-2024
NY,2024-04-30,inter-total,286,30,20,17,13,12,15,6,12,68,65,544,351,381,FALSE,0.700367647058824,2023,2023-2024
NY,2024-04-30,inter-ucfe,0,0,0,1,0,0,0,0,0,0,0,1,0,0,FALSE,0,2023,2023-2024
NY,2024-04-30,inter-ucx,1,0,0,0,0,0,0,0,0,0,0,1,1,1,FALSE,1,2023,2023-2024
NY,2024-04-30,inter-ui,285,30,20,16,13,12,15,6,12,68,65,542,350,380,FALSE,0.701107011070111,2023,2023-2024
NY,2024-04-30,intra-total,13656,1308,885,653,543,432,414,325,307,2197,3419,24139,17075,18383,FALSE,0.761547702887444,2023,2023-2024
NY,2024-04-30,intra-ucfe,7,3,5,4,1,2,1,4,2,1,2,32,9,12,FALSE,0.375,2023,2023-2024
NY,2024-04-30,intra-ucx,9,3,4,2,0,2,1,1,0,10,2,34,11,14,FALSE,0.411764705882353,2023,2023-2024
NY,2024-04-30,intra-ui,13640,1302,876,647,542,428,412,320,305,2186,3415,24073,17055,18357,FALSE,0.762555560171146,2023,2023-2024
NY,2024-05-31,inter-total,217,43,22,15,8,14,10,6,10,64,82,491,299,342,FALSE,0.696537678207739,2023,2023-2024
NY,2024-05-31,inter-ucfe,1,0,1,0,0,0,0,0,0,0,0,2,1,1,FALSE,0.5,2023,2023-2024
NY,2024-05-31,inter-ucx,0,0,0,0,0,0,0,0,0,0,0,0,0,0,FALSE,0,2023,2023-2024
NY,2024-05-31,inter-ui,216,43,21,15,8,14,10,6,10,64,82,489,298,341,FALSE,0.697341513292434,2023,2023-2024
NY,2024-05-31,intra-total,12536,1208,855,646,515,423,346,275,241,1866,3270,22181,15806,17014,FALSE,0.767052883098147,2023,2023-2024
NY,2024-05-31,intra-ucfe,23,4,1,5,1,3,3,1,0,8,5,54,28,32,FALSE,0.592592592592593,2023,2023-2024
NY,2024-05-31,intra-ucx,13,0,5,0,2,1,1,0,2,2,4,30,17,17,FALSE,0.566666666666667,2023,2023-2024
NY,2024-05-31,intra-ui,12500,1204,849,641,512,419,342,274,239,1856,3261,22097,15761,16965,FALSE,0.767751278454089,2023,2023-2024
NY,2024-06-30,inter-total,186,40,22,13,11,3,8,8,8,46,80,425,266,306,FALSE,0.72,2023,2023-2024
NY,2024-06-30,inter-ucfe,0,0,0,0,0,0,0,0,0,0,0,0,0,0,FALSE,0,2023,2023-2024
NY,2024-06-30,inter-ucx,0,0,1,0,0,0,0,0,0,1,0,2,0,0,FALSE,0,2023,2023-2024
NY,2024-06-30,inter-ui,186,40,21,13,11,3,8,8,8,45,80,423,266,306,FALSE,0.723404255319149,2023,2023-2024
NY,2024-06-30,intra-total,10749,1406,853,570,432,401,337,265,234,1464,3199,19910,13948,15354,FALSE,0.771170266197891,2023,2023-2024
NY,2024-06-30,intra-ucfe,0,4,5,3,2,2,1,1,0,4,4,26,4,8,FALSE,0.307692307692308,2023,2023-2024
NY,2024-06-30,intra-ucx,10,4,1,3,0,1,1,0,1,2,7,30,17,21,FALSE,0.7,2023,2023-2024
NY,2024-06-30,intra-ui,10739,1398,847,564,430,398,335,264,233,1458,3188,19854,13927,15325,FALSE,0.771884758738793,2023,2023-2024
NY,2024-07-31,inter-total,246,39,24,20,12,8,13,12,4,35,96,509,342,381,FALSE,0.74852652259332,2024,2024-2025
NY,2024-07-31,inter-ucfe,0,0,0,0,0,0,0,0,0,0,0,0,0,0,FALSE,0,2024,2024-2025
NY,2024-07-31,inter-ucx,0,0,0,0,0,0,0,0,0,0,0,0,0,0,FALSE,0,2024,2024-2025
NY,2024-07-31,inter-ui,246,39,24,20,12,8,13,12,4,35,96,509,342,381,FALSE,0.74852652259332,2024,2024-2025
NY,2024-07-31,intra-total,20642,1795,969,688,545,449,333,266,221,1545,4161,31614,24803,26598,FALSE,0.84133611691023,2024,2024-2025
NY,2024-07-31,intra-ucfe,1,1,2,3,4,6,5,1,2,6,1,32,2,3,FALSE,0.09375,2024,2024-2025
NY,2024-07-31,intra-ucx,6,6,2,1,3,1,0,2,1,2,8,32,14,20,FALSE,0.625,2024,2024-2025
NY,2024-07-31,intra-ui,20635,1788,965,684,538,442,328,263,218,1537,4152,31550,24787,26575,FALSE,0.842313787638669,2024,2024-2025
NY,2024-08-31,inter-total,197,33,30,33,17,20,11,10,8,66,93,518,290,323,FALSE,0.623552123552124,2024,2024-2025
NY,2024-08-31,inter-ucfe,0,0,0,0,1,1,0,0,0,0,0,2,0,0,FALSE,0,2024,2024-2025
NY,2024-08-31,inter-ucx,0,0,1,0,0,0,0,0,0,1,0,2,0,0,FALSE,0,2024,2024-2025
NY,2024-08-31,inter-ui,197,33,29,33,16,19,11,10,8,65,93,514,290,323,FALSE,0.6284046692607,2024,2024-2025
NY,2024-08-31,intra-total,15403,1650,1404,1135,870,636,412,320,296,1775,3745,27646,19148,20798,FALSE,0.752296896476886,2024,2024-2025
NY,2024-08-31,intra-ucfe,0,3,3,3,7,2,4,3,2,8,0,35,0,3,FALSE,0.0857142857142857,2024,2024-2025
NY,2024-08-31,intra-ucx,9,4,1,3,1,0,1,0,0,9,4,32,13,17,FALSE,0.53125,2024,2024-2025
NY,2024-08-31,intra-ui,15394,1643,1400,1129,862,634,407,317,294,1758,3741,27579,19135,20778,FALSE,0.753399325573806,2024,2024-2025
NY,2024-09-30,inter-total,217,33,32,18,18,13,8,13,7,66,79,504,296,329,FALSE,0.652777777777778,2024,2024-2025
NY,2024-09-30,inter-ucfe,0,0,0,0,0,0,0,0,0,2,0,2,0,0,FALSE,0,2024,2024-2025
NY,2024-09-30,inter-ucx,0,0,0,1,0,0,0,0,0,0,0,1,0,0,FALSE,0,2024,2024-2025
NY,2024-09-30,inter-ui,217,33,32,17,18,13,8,13,7,64,79,501,296,329,FALSE,0.656686626746507,2024,2024-2025
NY,2024-09-30,intra-total,14014,1524,1007,664,484,442,481,420,358,1768,3636,24798,17650,19174,FALSE,0.773207516735221,2024,2024-2025
NY,2024-09-30,intra-ucfe,0,2,4,1,0,3,1,2,1,16,1,31,1,3,FALSE,0.0967741935483871,2024,2024-2025
NY,2024-09-30,intra-ucx,4,2,2,2,1,0,0,0,0,7,3,21,7,9,FALSE,0.428571428571429,2024,2024-2025
NY,2024-09-30,intra-ui,14010,1520,1001,661,483,439,480,418,357,1745,3632,24746,17642,19162,FALSE,0.774347369271801,2024,2024-2025
NY,2024-10-31,inter-total,241,36,36,13,15,14,4,8,12,55,79,513,320,356,FALSE,0.693957115009747,2024,2024-2025
NY,2024-10-31,inter-ucfe,0,0,0,0,0,0,0,0,0,0,1,1,1,1,FALSE,1,2024,2024-2025
NY,2024-10-31,inter-ucx,1,0,0,0,0,0,0,0,0,0,0,1,1,1,FALSE,1,2024,2024-2025
NY,2024-10-31,inter-ui,240,36,36,13,15,14,4,8,12,55,78,511,318,354,FALSE,0.692759295499022,2024,2024-2025
NY,2024-10-31,intra-total,11761,1395,873,638,459,379,340,303,282,2062,3158,21650,14919,16314,FALSE,0.753533487297922,2024,2024-2025
NY,2024-10-31,intra-ucfe,5,3,5,5,1,1,1,1,0,16,6,44,11,14,FALSE,0.318181818181818,2024,2024-2025
NY,2024-10-31,intra-ucx,13,6,1,0,0,1,0,1,0,6,3,31,16,22,FALSE,0.709677419354839,2024,2024-2025
NY,2024-10-31,intra-ui,11743,1386,867,633,458,377,339,301,282,2040,3149,21575,14892,16278,FALSE,0.754484356894554,2024,2024-2025
NY,2024-11-30,inter-total,294,47,25,11,13,12,9,5,4,51,95,566,389,436,FALSE,0.770318021201414,2024,2024-2025
NY,2024-11-30,inter-ucfe,0,0,0,0,0,0,0,0,0,1,1,2,1,1,FALSE,0.5,2024,2024-2025
NY,2024-11-30,inter-ucx,0,0,0,0,0,0,0,0,0,1,0,1,0,0,FALSE,0,2024,2024-2025
NY,2024-11-30,inter-ui,294,47,25,11,13,12,9,5,4,49,94,563,388,435,FALSE,0.772646536412078,2024,2024-2025
NY,2024-11-30,intra-total,13435,1403,849,662,460,368,337,293,274,1785,3226,23092,16661,18064,FALSE,0.78226225532652,2024,2024-2025
NY,2024-11-30,intra-ucfe,7,3,1,4,3,3,1,2,5,9,2,40,9,12,FALSE,0.3,2024,2024-2025
NY,2024-11-30,intra-ucx,9,0,2,2,1,1,1,1,1,7,2,27,11,11,FALSE,0.407407407407407,2024,2024-2025
NY,2024-11-30,intra-ui,13419,1400,846,656,456,364,335,290,268,1769,3222,23025,16641,18041,FALSE,0.783539630836048,2024,2024-2025
NY,2024-12-31,inter-total,366,43,23,19,24,15,5,11,9,50,87,652,453,496,FALSE,0.760736196319019,2024,2024-2025
NY,2024-12-31,inter-ucfe,0,0,0,1,0,0,0,0,0,0,0,1,0,0,FALSE,0,2024,2024-2025
NY,2024-12-31,inter-ucx,0,0,0,0,0,0,0,0,0,0,0,0,0,0,FALSE,0,2024,2024-2025
NY,2024-12-31,inter-ui,366,43,23,18,24,15,5,11,9,50,87,651,453,496,FALSE,0.761904761904762,2024,2024-2025
NY,2024-12-31,intra-total,20196,1487,908,777,600,497,435,339,245,1747,4254,31485,24450,25937,FALSE,0.823789105923456,2024,2024-2025
NY,2024-12-31,intra-ucfe,8,4,4,1,3,5,2,1,1,5,5,39,13,17,FALSE,0.435897435897436,2024,2024-2025
NY,2024-12-31,intra-ucx,12,2,1,0,4,1,0,0,0,1,2,23,14,16,FALSE,0.695652173913044,2024,2024-2025
NY,2024-12-31,intra-ui,20176,1481,903,776,593,491,433,338,244,1741,4247,31423,24423,25904,FALSE,0.8243643191293,2024,2024-2025
OH,2019-01-31,inter-total,222,81,42,20,9,7,4,2,0,1,239,627,461,542,FALSE,0.864433811802233,2018,2018-2019
OH,2019-01-31,inter-ucfe,0,0,0,0,0,0,0,0,0,0,0,0,0,0,FALSE,0,2018,2018-2019
OH,2019-01-31,inter-ucx,0,0,0,0,0,0,0,0,0,0,0,0,0,0,FALSE,0,2018,2018-2019
OH,2019-01-31,inter-ui,222,81,42,20,9,7,4,2,0,1,239,627,461,542,FALSE,0.864433811802233,2018,2018-2019
OH,2019-01-31,intra-total,14979,1510,476,193,81,41,25,21,10,44,7875,25255,22854,24364,FALSE,0.96471985745397,2018,2018-2019
OH,2019-01-31,intra-ucfe,40,5,0,0,2,0,1,0,0,1,15,64,55,60,FALSE,0.9375,2018,2018-2019
OH,2019-01-31,intra-ucx,10,3,0,0,0,0,1,0,0,0,5,19,15,18,FALSE,0.947368421052632,2018,2018-2019
OH,2019-01-31,intra-ui,14929,1502,476,193,79,41,23,21,10,43,7855,25172,22784,24286,FALSE,0.964802161131416,2018,2018-2019
OH,2019-02-28,inter-total,159,56,43,22,17,7,8,0,4,9,139,464,298,354,FALSE,0.762931034482759,2018,2018-2019
OH,2019-02-28,inter-ucfe,0,0,1,0,0,0,0,0,0,0,0,1,0,0,FALSE,0,2018,2018-2019
OH,2019-02-28,inter-ucx,0,0,0,0,0,0,0,0,0,0,0,0,0,0,FALSE,0,2018,2018-2019
OH,2019-02-28,inter-ui,159,56,42,22,17,7,8,0,4,9,139,463,298,354,FALSE,0.764578833693305,2018,2018-2019
OH,2019-02-28,intra-total,7908,1235,538,234,138,66,40,21,23,50,4631,14884,12539,13774,FALSE,0.925423273313625,2018,2018-2019
OH,2019-02-28,intra-ucfe,0,3,1,0,4,0,0,0,0,1,0,9,0,3,FALSE,0.333333333333333,2018,2018-2019
OH,2019-02-28,intra-ucx,6,4,2,1,0,0,0,0,1,1,9,24,15,19,FALSE,0.791666666666667,2018,2018-2019
OH,2019-02-28,intra-ui,7902,1228,535,233,134,66,40,21,22,48,4622,14851,12524,13752,FALSE,0.925998249276143,2018,2018-2019
OH,2019-03-31,inter-total,120,27,13,7,5,9,3,0,1,3,70,258,190,217,FALSE,0.84108527131783,2018,2018-2019
OH,2019-03-31,inter-ucfe,0,0,0,0,0,0,0,0,0,0,0,0,0,0,FALSE,0,2018,2018-2019
OH,2019-03-31,inter-ucx,1,0,0,0,0,0,0,0,0,0,0,1,1,1,FALSE,1,2018,2018-2019
OH,2019-03-31,inter-ui,119,27,13,7,5,9,3,0,1,3,70,257,189,216,FALSE,0.840466926070039,2018,2018-2019
OH,2019-03-31,intra-total,5668,636,278,142,89,82,40,22,19,42,2794,9812,8462,9098,FALSE,0.927231960864248,2018,2018-2019
OH,2019-03-31,intra-ucfe,3,1,0,1,1,2,0,0,0,0,4,12,7,8,FALSE,0.666666666666667,2018,2018-2019
OH,2019-03-31,intra-ucx,11,2,1,2,0,1,0,0,0,0,2,19,13,15,FALSE,0.789473684210526,2018,2018-2019
OH,2019-03-31,intra-ui,5654,633,277,139,88,79,40,22,19,42,2788,9781,8442,9075,FALSE,0.927819241386361,2018,2018-2019
OH,2019-04-30,inter-total,101,14,7,3,2,0,1,1,1,5,62,197,163,177,FALSE,0.898477157360406,2018,2018-2019
OH,2019-04-30,inter-ucfe,0,0,0,0,0,0,0,0,0,0,1,1,1,1,FALSE,1,2018,2018-2019
OH,2019-04-30,inter-ucx,0,0,0,0,0,0,0,0,0,0,0,0,0,0,FALSE,0,2018,2018-2019
OH,2019-04-30,inter-ui,101,14,7,3,2,0,1,1,1,5,61,196,162,176,FALSE,0.897959183673469,2018,2018-2019
OH,2019-04-30,intra-total,4868,442,163,45,41,12,18,17,17,58,2322,8003,7190,7632,FALSE,0.95364238410596,2018,2018-2019
OH,2019-04-30,intra-ucfe,0,1,0,0,0,0,0,1,0,1,3,6,3,4,FALSE,0.666666666666667,2018,2018-2019
OH,2019-04-30,intra-ucx,20,1,0,0,0,0,0,0,0,0,3,24,23,24,FALSE,1,2018,2018-2019
OH,2019-04-30,intra-ui,4848,440,163,45,41,12,18,16,17,57,2316,7973,7164,7604,FALSE,0.953718800953217,2018,2018-2019
OH,2019-05-31,inter-total,101,15,6,1,1,1,2,2,1,7,60,197,161,176,FALSE,0.893401015228426,2018,2018-2019
OH,2019-05-31,inter-ucfe,1,0,0,0,0,0,0,0,0,0,0,1,1,1,FALSE,1,2018,2018-2019
OH,2019-05-31,inter-ucx,0,0,0,0,0,0,0,0,0,0,0,0,0,0,FALSE,0,2018,2018-2019
OH,2019-05-31,inter-ui,100,15,6,1,1,1,2,2,1,7,60,196,160,175,FALSE,0.892857142857143,2018,2018-2019
OH,2019-05-31,intra-total,7367,448,154,73,38,15,18,11,6,35,2776,10941,10143,10591,FALSE,0.968010236724248,2018,2018-2019
OH,2019-05-31,intra-ucfe,5,1,1,2,0,1,1,0,0,3,4,18,9,10,FALSE,0.555555555555556,2018,2018-2019
OH,2019-05-31,intra-ucx,13,0,0,0,0,0,0,0,0,0,4,17,17,17,FALSE,1,2018,2018-2019
OH,2019-05-31,intra-ui,7349,447,153,71,38,14,17,11,6,32,2768,10906,10117,10564,FALSE,0.968641114982578,2018,2018-2019
OH,2019-06-30,inter-total,56,17,5,1,4,2,4,1,0,3,51,144,107,124,FALSE,0.861111111111111,2018,2018-2019
OH,2019-06-30,inter-ucfe,0,0,0,0,1,0,0,0,0,0,0,1,0,0,FALSE,0,2018,2018-2019
OH,2019-06-30,inter-ucx,1,0,0,0,0,0,0,0,0,0,0,1,1,1,FALSE,1,2018,2018-2019
OH,2019-06-30,inter-ui,55,17,5,1,3,2,4,1,0,3,51,142,106,123,FALSE,0.866197183098592,2018,2018-2019
OH,2019-06-30,intra-total,5752,585,170,70,38,22,23,11,14,27,2739,9451,8491,9076,FALSE,0.960321659083695,2018,2018-2019
OH,2019-06-30,intra-ucfe,0,1,1,1,1,0,0,0,1,0,1,6,1,2,FALSE,0.333333333333333,2018,2018-2019
OH,2019-06-30,intra-ucx,12,1,1,0,0,0,0,0,0,0,6,20,18,19,FALSE,0.95,2018,2018-2019
OH,2019-06-30,intra-ui,5740,583,168,69,37,22,23,11,13,27,2732,9425,8472,9055,FALSE,0.960742705570292,2018,2018-2019
OH,2019-07-31,inter-total,52,13,10,9,2,2,0,2,0,5,55,150,107,120,FALSE,0.8,2019,2019-2020
OH,2019-07-31,inter-ucfe,0,0,0,0,0,0,0,0,0,0,0,0,0,0,FALSE,0,2019,2019-2020
OH,2019-07-31,inter-ucx,0,0,0,0,0,0,0,0,0,0,1,1,1,1,FALSE,1,2019,2019-2020
OH,2019-07-31,inter-ui,52,13,10,9,2,2,0,2,0,5,54,149,106,119,FALSE,0.798657718120805,2019,2019-2020
OH,2019-07-31,intra-total,5236,678,227,89,49,26,28,14,14,34,3185,9580,8421,9099,FALSE,0.949791231732777,2019,2019-2020
OH,2019-07-31,intra-ucfe,5,4,1,0,1,0,0,1,0,1,4,17,9,13,FALSE,0.764705882352941,2019,2019-2020
OH,2019-07-31,intra-ucx,15,2,1,0,1,0,0,0,0,0,9,28,24,26,FALSE,0.928571428571429,2019,2019-2020
OH,2019-07-31,intra-ui,5216,672,225,89,47,26,28,13,14,33,3172,9535,8388,9060,FALSE,0.950183534347142,2019,2019-2020
OH,2019-08-31,inter-total,69,10,2,4,2,0,0,2,2,1,57,149,126,136,FALSE,0.912751677852349,2019,2019-2020
OH,2019-08-31,inter-ucfe,0,0,0,0,0,0,0,0,0,0,0,0,0,0,FALSE,0,2019,2019-2020
OH,2019-08-31,inter-ucx,0,0,0,0,0,0,0,0,0,0,0,0,0,0,FALSE,0,2019,2019-2020
OH,2019-08-31,inter-ui,69,10,2,4,2,0,0,2,2,1,57,149,126,136,FALSE,0.912751677852349,2019,2019-2020
OH,2019-08-31,intra-total,3691,499,245,100,52,35,25,18,9,34,2098,6806,5789,6288,FALSE,0.923890684689979,2019,2019-2020
OH,2019-08-31,intra-ucfe,3,1,1,1,0,0,0,0,1,0,4,11,7,8,FALSE,0.727272727272727,2019,2019-2020
OH,2019-08-31,intra-ucx,14,1,0,1,1,0,0,0,0,0,2,19,16,17,FALSE,0.894736842105263,2019,2019-2020
OH,2019-08-31,intra-ui,3674,497,244,98,51,35,25,18,8,34,2092,6776,5766,6263,FALSE,0.924291617473436,2019,2019-2020
OH,2019-09-30,inter-total,72,10,6,1,0,4,2,1,1,1,62,160,134,144,FALSE,0.9,2019,2019-2020
OH,2019-09-30,inter-ucfe,0,1,0,0,0,0,0,0,0,0,0,1,0,1,FALSE,1,2019,2019-2020
OH,2019-09-30,inter-ucx,0,0,0,0,0,0,0,0,0,0,0,0,0,0,FALSE,0,2019,2019-2020
OH,2019-09-30,inter-ui,72,9,6,1,0,4,2,1,1,1,62,159,134,143,FALSE,0.89937106918239,2019,2019-2020
OH,2019-09-30,intra-total,3216,413,143,47,27,19,24,15,12,43,2233,6192,5449,5862,FALSE,0.946705426356589,2019,2019-2020
OH,2019-09-30,intra-ucfe,3,1,1,3,0,0,0,0,0,0,4,12,7,8,FALSE,0.666666666666667,2019,2019-2020
OH,2019-09-30,intra-ucx,13,1,1,0,0,0,0,0,0,0,4,19,17,18,FALSE,0.947368421052632,2019,2019-2020
OH,2019-09-30,intra-ui,3200,411,141,44,27,19,24,15,12,43,2225,6161,5425,5836,FALSE,0.94724882324298,2019,2019-2020
OH,2019-10-31,inter-total,92,15,5,6,1,2,1,0,1,4,59,186,151,166,FALSE,0.89247311827957,2019,2019-2020
OH,2019-10-31,inter-ucfe,1,0,1,0,0,0,0,0,0,0,0,2,1,1,FALSE,0.5,2019,2019-2020
OH,2019-10-31,inter-ucx,2,0,0,0,0,0,0,0,0,0,0,2,2,2,FALSE,1,2019,2019-2020
OH,2019-10-31,inter-ui,89,15,4,6,1,2,1,0,1,4,59,182,148,163,FALSE,0.895604395604396,2019,2019-2020
OH,2019-10-31,intra-total,6361,509,135,56,25,21,11,10,16,36,2799,9979,9160,9669,FALSE,0.968934763002305,2019,2019-2020
OH,2019-10-31,intra-ucfe,5,0,1,0,1,0,0,1,0,1,4,13,9,9,FALSE,0.692307692307692,2019,2019-2020
OH,2019-10-31,intra-ucx,16,0,0,1,0,0,0,0,0,0,3,20,19,19,FALSE,0.95,2019,2019-2020
OH,2019-10-31,intra-ui,6340,509,134,55,24,21,11,9,16,35,2792,9946,9132,9641,FALSE,0.969334405791273,2019,2019-2020
OH,2019-11-30,inter-total,153,22,6,9,3,1,0,1,0,2,72,269,225,247,FALSE,0.9182156133829,2019,2019-2020
OH,2019-11-30,inter-ucfe,3,0,0,0,0,0,0,0,0,0,3,6,6,6,FALSE,1,2019,2019-2020
OH,2019-11-30,inter-ucx,0,0,0,0,0,0,0,0,0,0,0,0,0,0,FALSE,0,2019,2019-2020
OH,2019-11-30,inter-ui,150,22,6,9,3,1,0,1,0,2,69,263,219,241,FALSE,0.916349809885931,2019,2019-2020
OH,2019-11-30,intra-total,5525,540,187,57,38,19,13,8,8,36,2728,9159,8253,8793,FALSE,0.960039305601048,2019,2019-2020
OH,2019-11-30,intra-ucfe,7,2,2,1,0,0,0,0,1,0,5,18,12,14,FALSE,0.777777777777778,2019,2019-2020
OH,2019-11-30,intra-ucx,14,2,1,0,0,0,0,0,0,0,7,24,21,23,FALSE,0.958333333333333,2019,2019-2020
OH,2019-11-30,intra-ui,5504,536,184,56,38,19,13,8,7,36,2716,9117,8220,8756,FALSE,0.960403641548755,2019,2019-2020
OH,2019-12-31,inter-total,174,32,18,5,2,1,0,2,1,1,111,347,285,317,FALSE,0.913544668587896,2019,2019-2020
OH,2019-12-31,inter-ucfe,1,1,0,0,0,0,0,0,0,0,0,2,1,2,FALSE,1,2019,2019-2020
OH,2019-12-31,inter-ucx,1,0,0,0,0,0,0,0,0,0,0,1,1,1,FALSE,1,2019,2019-2020
OH,2019-12-31,inter-ui,172,31,18,5,2,1,0,2,1,1,111,344,283,314,FALSE,0.912790697674419,2019,2019-2020
OH,2019-12-31,intra-total,9659,819,290,99,50,31,23,15,17,39,4389,15431,14048,14867,FALSE,0.963450197654073,2019,2019-2020
OH,2019-12-31,intra-ucfe,6,3,0,0,0,1,0,0,0,1,4,15,10,13,FALSE,0.866666666666667,2019,2019-2020
OH,2019-12-31,intra-ucx,16,1,0,0,0,0,1,1,0,0,7,26,23,24,FALSE,0.923076923076923,2019,2019-2020
OH,2019-12-31,intra-ui,9637,815,290,99,50,30,22,14,17,38,4378,15390,14015,14830,FALSE,0.96361273554256,2019,2019-2020
OH,2020-01-31,inter-total,151,46,24,5,7,3,4,1,1,2,151,395,302,348,FALSE,0.881012658227848,2019,2019-2020
OH,2020-01-31,inter-ucfe,2,1,0,0,0,0,0,0,0,0,0,3,2,3,FALSE,1,2019,2019-2020
OH,2020-01-31,inter-ucx,0,0,0,0,0,0,0,0,0,0,0,0,0,0,FALSE,0,2019,2019-2020
OH,2020-01-31,inter-ui,149,45,24,5,7,3,4,1,1,2,151,392,300,345,FALSE,0.880102040816326,2019,2019-2020
OH,2020-01-31,intra-total,13875,1620,551,210,85,33,29,21,12,35,8373,24844,22248,23868,FALSE,0.960714860730961,2019,2019-2020
OH,2020-01-31,intra-ucfe,5,2,1,0,2,0,1,0,0,1,5,17,10,12,FALSE,0.705882352941177,2019,2019-2020
OH,2020-01-31,intra-ucx,15,3,2,1,0,0,0,0,0,0,5,26,20,23,FALSE,0.884615384615385,2019,2019-2020
OH,2020-01-31,intra-ui,13855,1615,548,209,83,33,28,21,12,34,8363,24801,22218,23833,FALSE,0.960969315753397,2019,2019-2020
OH,2020-02-29,inter-total,146,42,29,16,3,7,3,5,1,8,107,367,253,295,FALSE,0.803814713896458,2019,2019-2020
OH,2020-02-29,inter-ucfe,0,0,0,0,0,0,0,0,0,0,0,0,0,0,FALSE,0,2019,2019-2020
OH,2020-02-29,inter-ucx,0,0,0,0,0,0,0,0,0,0,0,0,0,0,FALSE,0,2019,2019-2020
OH,2020-02-29,inter-ui,146,42,29,16,3,7,3,5,1,8,107,367,253,295,FALSE,0.803814713896458,2019,2019-2020
OH,2020-02-29,intra-total,7496,1058,479,235,139,66,35,17,14,42,4108,13689,11604,12662,FALSE,0.924976258309592,2019,2019-2020
OH,2020-02-29,intra-ucfe,6,1,2,2,0,3,1,0,0,2,1,18,7,8,FALSE,0.444444444444444,2019,2019-2020
OH,2020-02-29,intra-ucx,11,1,0,1,0,0,0,0,0,1,2,16,13,14,FALSE,0.875,2019,2019-2020
OH,2020-02-29,intra-ui,7479,1056,477,232,139,63,34,17,14,39,4105,13655,11584,12640,FALSE,0.925668253387038,2019,2019-2020
OH,2020-03-31,inter-total,324,26,11,6,4,3,2,2,1,4,92,475,416,442,FALSE,0.930526315789474,2019,2019-2020
OH,2020-03-31,inter-ucfe,1,0,0,0,0,0,0,0,0,0,0,1,1,1,FALSE,1,2019,2019-2020
OH,2020-03-31,inter-ucx,0,0,0,0,0,0,0,0,0,0,0,0,0,0,FALSE,0,2019,2019-2020
OH,2020-03-31,inter-ui,323,26,11,6,4,3,2,2,1,4,92,474,415,441,FALSE,0.930379746835443,2019,2019-2020
OH,2020-03-31,intra-total,89590,819,240,117,63,51,28,19,24,39,15902,106892,105492,106311,FALSE,0.994564607267148,2019,2019-2020
OH,2020-03-31,intra-ucfe,1,2,0,2,0,0,0,1,0,0,1,7,2,4,FALSE,0.571428571428571,2019,2019-2020
OH,2020-03-31,intra-ucx,13,1,0,0,0,0,0,0,0,0,4,18,17,18,FALSE,1,2019,2019-2020
OH,2020-03-31,intra-ui,89576,816,240,115,63,51,28,18,24,39,15897,106867,105473,106289,FALSE,0.994591408011828,2019,2019-2020
OH,2020-04-30,inter-total,296,254,190,114,22,5,2,1,0,5,211,1100,507,761,FALSE,0.691818181818182,2019,2019-2020
OH,2020-04-30,inter-ucfe,0,0,0,0,0,0,0,0,0,0,0,0,0,0,FALSE,0,2019,2019-2020
OH,2020-04-30,inter-ucx,1,0,0,0,0,0,0,0,0,0,0,1,1,1,FALSE,1,2019,2019-2020
OH,2020-04-30,inter-ui,295,254,190,114,22,5,2,1,0,5,211,1099,506,760,FALSE,0.691537761601456,2019,2019-2020
OH,2020-04-30,intra-total,122239,80818,56711,30293,3444,96,32,31,16,71,89139,382890,211378,292196,FALSE,0.763133014703962,2019,2019-2020
OH,2020-04-30,intra-ucfe,0,3,2,5,1,1,0,0,0,0,2,14,2,5,FALSE,0.357142857142857,2019,2019-2020
OH,2020-04-30,intra-ucx,8,21,28,19,6,0,0,0,0,0,29,111,37,58,FALSE,0.522522522522523,2019,2019-2020
OH,2020-04-30,intra-ui,122231,80794,56681,30269,3437,95,32,31,16,71,89108,382765,211339,292133,FALSE,0.763217640066359,2019,2019-2020
OH,2020-05-31,inter-total,78,147,143,211,148,109,48,22,8,4,97,1015,175,322,FALSE,0.317241379310345,2019,2019-2020
OH,2020-05-31,inter-ucfe,0,0,0,0,0,0,0,0,0,0,0,0,0,0,FALSE,0,2019,2019-2020
OH,2020-05-31,inter-ucx,0,0,0,0,1,1,0,0,0,0,0,2,0,0,FALSE,0,2019,2019-2020
OH,2020-05-31,inter-ui,78,147,143,211,147,108,48,22,8,4,97,1013,175,322,FALSE,0.31786771964462,2019,2019-2020
OH,2020-05-31,intra-total,30708,24146,22263,22514,15619,8314,3891,1991,550,143,22939,153078,53647,77793,FALSE,0.508191902167522,2019,2019-2020
OH,2020-05-31,intra-ucfe,0,0,4,1,4,7,3,0,0,2,0,21,0,0,FALSE,0,2019,2019-2020
OH,2020-05-31,intra-ucx,8,10,11,18,18,12,3,1,0,1,12,94,20,30,FALSE,0.319148936170213,2019,2019-2020
OH,2020-05-31,intra-ui,30700,24136,22248,22495,15597,8295,3885,1990,550,140,22927,152963,53627,77763,FALSE,0.508377843007786,2019,2019-2020
OH,2020-06-30,inter-total,48,64,54,55,39,54,45,44,33,63,50,549,98,162,FALSE,0.295081967213115,2019,2019-2020
OH,2020-06-30,inter-ucfe,0,0,0,0,0,0,0,0,0,0,0,0,0,0,FALSE,0,2019,2019-2020
OH,2020-06-30,inter-ucx,0,0,2,0,0,1,1,0,0,0,0,4,0,0,FALSE,0,2019,2019-2020
OH,2020-06-30,inter-ui,48,64,52,55,39,53,44,44,33,63,50,545,98,162,FALSE,0.297247706422018,2019,2019-2020
OH,2020-06-30,intra-total,13857,8643,6045,4049,3229,2520,2668,2333,2248,5444,9720,60756,23577,32220,FALSE,0.530317993284614,2019,2019-2020
OH,2020-06-30,intra-ucfe,1,2,0,2,2,6,2,2,5,7,0,29,1,3,FALSE,0.103448275862069,2019,2019-2020
OH,2020-06-30,intra-ucx,8,13,10,3,7,10,6,6,4,7,10,84,18,31,FALSE,0.369047619047619,2019,2019-2020
OH,2020-06-30,intra-ui,13848,8628,6035,4044,3220,2504,2660,2325,2239,5430,9710,60643,23558,32186,FALSE,0.530745510611282,2019,2019-2020
OH,2020-07-31,inter-total,18,37,22,16,16,19,10,13,12,100,61,324,79,116,FALSE,0.358024691358025,2020,2020-2021
OH,2020-07-31,inter-ucfe,0,0,0,0,0,0,0,0,0,1,0,1,0,0,FALSE,0,2020,2020-2021
OH,2020-07-31,inter-ucx,1,0,0,1,0,0,0,0,0,0,0,2,1,1,FALSE,0.5,2020,2020-2021
OH,2020-07-31,inter-ui,17,37,22,15,16,19,10,13,12,99,61,321,78,115,FALSE,0.358255451713396,2020,2020-2021
OH,2020-07-31,intra-total,3700,6307,2493,2146,1677,1357,997,676,584,7171,7746,34854,11446,17753,FALSE,0.509353302346933,2020,2020-2021
OH,2020-07-31,intra-ucfe,0,3,1,1,0,0,0,0,0,6,0,11,0,3,FALSE,0.272727272727273,2020,2020-2021
OH,2020-07-31,intra-ucx,7,13,2,3,2,10,4,0,3,6,10,60,17,30,FALSE,0.5,2020,2020-2021
OH,2020-07-31,intra-ui,3693,6291,2490,2142,1675,1347,993,676,581,7159,7736,34783,11429,17720,FALSE,0.509444268751977,2020,2020-2021
OH,2020-08-31,inter-total,6,41,14,19,27,16,10,10,13,119,37,312,43,84,FALSE,0.269230769230769,2020,2020-2021
OH,2020-08-31,inter-ucfe,0,0,1,0,0,1,0,0,0,1,0,3,0,0,FALSE,0,2020,2020-2021
OH,2020-08-31,inter-ucx,1,0,0,0,0,0,0,0,0,0,0,1,1,1,FALSE,1,2020,2020-2021
OH,2020-08-31,inter-ui,5,41,13,19,27,15,10,10,13,118,37,308,42,83,FALSE,0.26948051948052,2020,2020-2021
OH,2020-08-31,intra-total,1456,3270,1656,1702,1711,1498,1140,1013,809,6593,3940,24788,5396,8666,FALSE,0.349604647410037,2020,2020-2021
OH,2020-08-31,intra-ucfe,0,0,0,1,0,0,0,0,0,6,2,9,2,2,FALSE,0.222222222222222,2020,2020-2021
OH,2020-08-31,intra-ucx,7,6,8,4,5,5,2,2,4,12,10,65,17,23,FALSE,0.353846153846154,2020,2020-2021
OH,2020-08-31,intra-ui,1449,3264,1648,1697,1706,1493,1138,1011,805,6575,3928,24714,5377,8641,FALSE,0.349639880229829,2020,2020-2021
OH,2020-09-30,inter-total,6,39,16,15,16,9,7,12,8,104,38,270,44,83,FALSE,0.307407407407407,2020,2020-2021
OH,2020-09-30,inter-ucfe,0,0,0,0,0,0,0,0,0,0,0,0,0,0,FALSE,0,2020,2020-2021
OH,2020-09-30,inter-ucx,0,1,0,0,0,0,0,0,0,0,0,1,0,1,FALSE,1,2020,2020-2021
OH,2020-09-30,inter-ui,6,38,16,15,16,9,7,12,8,104,38,269,44,82,FALSE,0.304832713754647,2020,2020-2021
OH,2020-09-30,intra-total,1054,2624,1037,913,843,808,847,855,807,6901,2696,19385,3750,6374,FALSE,0.328810936290947,2020,2020-2021
OH,2020-09-30,intra-ucfe,0,2,0,1,0,0,3,0,0,14,2,22,2,4,FALSE,0.181818181818182,2020,2020-2021
OH,2020-09-30,intra-ucx,11,14,7,5,5,0,1,1,0,8,21,73,32,46,FALSE,0.63013698630137,2020,2020-2021
OH,2020-09-30,intra-ui,1043,2608,1030,907,838,808,843,854,807,6879,2673,19290,3716,6324,FALSE,0.327838258164852,2020,2020-2021
OH,2020-10-31,inter-total,23,36,6,12,7,10,9,5,5,124,63,300,86,122,FALSE,0.406666666666667,2020,2020-2021
OH,2020-10-31,inter-ucfe,0,0,0,0,1,0,0,0,0,0,0,1,0,0,FALSE,0,2020,2020-2021
OH,2020-10-31,inter-ucx,0,0,0,1,0,0,0,0,0,0,1,2,1,1,FALSE,0.5,2020,2020-2021
OH,2020-10-31,inter-ui,23,36,6,11,6,10,9,5,5,124,62,297,85,121,FALSE,0.407407407407407,2020,2020-2021
OH,2020-10-31,intra-total,1088,2028,778,704,672,605,602,539,445,6787,2556,16804,3644,5672,FALSE,0.337538681266365,2020,2020-2021
OH,2020-10-31,intra-ucfe,1,0,0,1,1,0,1,1,1,7,0,13,1,1,FALSE,0.0769230769230769,2020,2020-2021
OH,2020-10-31,intra-ucx,8,8,5,2,2,4,1,0,1,6,8,45,16,24,FALSE,0.533333333333333,2020,2020-2021
OH,2020-10-31,intra-ui,1079,2020,773,701,669,601,600,538,443,6774,2548,16746,3627,5647,FALSE,0.33721485727935,2020,2020-2021
OH,2020-11-30,inter-total,19,92,24,11,10,13,7,4,5,83,53,321,72,164,FALSE,0.510903426791277,2020,2020-2021
OH,2020-11-30,inter-ucfe,0,0,0,0,0,0,0,0,0,0,0,0,0,0,FALSE,0,2020,2020-2021
OH,2020-11-30,inter-ucx,0,0,0,0,0,0,0,0,0,0,0,0,0,0,FALSE,0,2020,2020-2021
OH,2020-11-30,inter-ui,19,92,24,11,10,13,7,4,5,83,53,321,72,164,FALSE,0.510903426791277,2020,2020-2021
OH,2020-11-30,intra-total,1669,3112,875,686,614,531,462,400,349,5718,2972,17388,4641,7753,FALSE,0.445882217621348,2020,2020-2021
OH,2020-11-30,intra-ucfe,1,6,4,6,4,0,0,1,0,8,3,33,4,10,FALSE,0.303030303030303,2020,2020-2021
OH,2020-11-30,intra-ucx,3,9,5,2,0,1,1,2,0,2,4,29,7,16,FALSE,0.551724137931035,2020,2020-2021
OH,2020-11-30,intra-ui,1665,3097,866,678,610,530,461,397,349,5708,2965,17326,4630,7727,FALSE,0.445977144176382,2020,2020-2021
OH,2020-12-31,inter-total,23,210,22,13,14,9,4,6,10,96,68,475,91,301,FALSE,0.633684210526316,2020,2020-2021
OH,2020-12-31,inter-ucfe,0,1,0,0,0,0,0,0,0,0,0,1,0,1,FALSE,1,2020,2020-2021
OH,2020-12-31,inter-ucx,0,0,0,0,0,0,0,0,0,0,0,0,0,0,FALSE,0,2020,2020-2021
OH,2020-12-31,inter-ui,23,209,22,13,14,9,4,6,10,96,68,474,91,300,FALSE,0.632911392405063,2020,2020-2021
OH,2020-12-31,intra-total,2811,7795,1657,949,712,523,412,379,324,5262,7861,28685,10672,18467,FALSE,0.64378595084539,2020,2020-2021
OH,2020-12-31,intra-ucfe,1,4,3,5,13,11,4,3,2,12,2,60,3,7,FALSE,0.116666666666667,2020,2020-2021
OH,2020-12-31,intra-ucx,3,12,4,4,1,4,1,1,0,2,11,43,14,26,FALSE,0.604651162790698,2020,2020-2021
OH,2020-12-31,intra-ui,2807,7779,1650,940,698,508,407,375,322,5248,7848,28582,10655,18434,FALSE,0.644951367993842,2020,2020-2021
OH,2021-01-31,inter-total,21,157,20,16,15,14,12,7,10,77,91,440,112,269,FALSE,0.611363636363636,2020,2020-2021
OH,2021-01-31,inter-ucfe,0,0,0,0,0,0,0,0,0,0,0,0,0,0,FALSE,0,2020,2020-2021
OH,2021-01-31,inter-ucx,0,1,0,0,0,0,0,0,0,0,0,1,0,1,FALSE,1,2020,2020-2021
OH,2021-01-31,inter-ui,21,156,20,16,15,14,12,7,10,77,91,439,112,268,FALSE,0.610478359908884,2020,2020-2021
OH,2021-01-31,intra-total,2331,7678,2040,1349,915,749,580,466,357,3851,7963,28279,10294,17972,FALSE,0.635524594221861,2020,2020-2021
OH,2021-01-31,intra-ucfe,0,4,0,2,4,0,0,4,4,17,2,37,2,6,FALSE,0.162162162162162,2020,2020-2021
OH,2021-01-31,intra-ucx,8,5,2,2,1,1,0,1,0,3,7,30,15,20,FALSE,0.666666666666667,2020,2020-2021
OH,2021-01-31,intra-ui,2323,7669,2038,1345,910,748,580,461,353,3831,7954,28212,10277,17946,FALSE,0.636112292641429,2020,2020-2021
OH,2021-02-28,inter-total,16,174,17,19,9,5,5,6,5,69,108,433,124,298,FALSE,0.688221709006928,2020,2020-2021
OH,2021-02-28,inter-ucfe,0,0,0,0,0,0,0,0,0,1,0,1,0,0,FALSE,0,2020,2020-2021
OH,2021-02-28,inter-ucx,0,0,0,0,0,0,0,0,0,0,0,0,0,0,FALSE,0,2020,2020-2021
OH,2021-02-28,inter-ui,16,174,17,19,9,5,5,6,5,68,108,432,124,298,FALSE,0.689814814814815,2020,2020-2021
OH,2021-02-28,intra-total,1938,10789,1462,1091,918,764,558,429,371,3170,7288,28778,9226,20015,FALSE,0.695496559872125,2020,2020-2021
OH,2021-02-28,intra-ucfe,2,2,3,3,4,1,2,1,1,16,2,37,4,6,FALSE,0.162162162162162,2020,2020-2021
OH,2021-02-28,intra-ucx,6,9,4,2,0,1,0,1,0,2,10,35,16,25,FALSE,0.714285714285714,2020,2020-2021
OH,2021-02-28,intra-ui,1930,10778,1455,1086,914,762,556,427,370,3152,7276,28706,9206,19984,FALSE,0.696161081307044,2020,2020-2021
OH,2021-03-31,inter-total,6,121,16,11,9,12,11,8,14,57,65,330,71,192,FALSE,0.581818181818182,2020,2020-2021
OH,2021-03-31,inter-ucfe,0,0,0,0,0,0,0,0,0,0,0,0,0,0,FALSE,0,2020,2020-2021
OH,2021-03-31,inter-ucx,0,0,0,0,0,0,0,0,0,0,0,0,0,0,FALSE,0,2020,2020-2021
OH,2021-03-31,inter-ui,6,121,16,11,9,12,11,8,14,57,65,330,71,192,FALSE,0.581818181818182,2020,2020-2021
OH,2021-03-31,intra-total,1718,7842,982,684,675,885,818,765,727,3988,5878,24962,7596,15438,FALSE,0.618460059290121,2020,2020-2021
OH,2021-03-31,intra-ucfe,0,1,2,1,0,0,2,1,0,16,1,24,1,2,FALSE,0.0833333333333333,2020,2020-2021
OH,2021-03-31,intra-ucx,1,8,1,4,0,0,0,0,0,3,5,22,6,14,FALSE,0.636363636363636,2020,2020-2021
OH,2021-03-31,intra-ui,1717,7833,979,679,675,885,816,764,727,3969,5872,24916,7589,15422,FALSE,0.618959704607481,2020,2020-2021
OH,2021-04-30,inter-total,3,35,31,17,12,11,11,10,7,40,12,189,15,50,FALSE,0.264550264550265,2020,2020-2021
OH,2021-04-30,inter-ucfe,0,1,0,0,0,0,0,0,0,0,0,1,0,1,FALSE,1,2020,2020-2021
OH,2021-04-30,inter-ucx,0,0,0,0,0,0,0,0,0,0,0,0,0,0,FALSE,0,2020,2020-2021
OH,2021-04-30,inter-ui,3,34,31,17,12,11,11,10,7,40,12,188,15,49,FALSE,0.26063829787234,2020,2020-2021
OH,2021-04-30,intra-total,603,2343,3166,1696,981,905,927,710,392,1703,1016,14442,1619,3962,FALSE,0.274338734247334,2020,2020-2021
OH,2021-04-30,intra-ucfe,0,0,0,0,3,3,1,1,0,8,0,16,0,0,FALSE,0,2020,2020-2021
OH,2021-04-30,intra-ucx,2,4,1,0,3,3,1,0,0,3,0,17,2,6,FALSE,0.352941176470588,2020,2020-2021
OH,2021-04-30,intra-ui,601,2339,3165,1696,975,899,925,709,392,1692,1016,14409,1617,3956,FALSE,0.274550628079672,2020,2020-2021
OH,2021-05-31,inter-total,5,25,24,26,15,6,12,9,6,31,6,165,11,36,FALSE,0.218181818181818,2020,2020-2021
OH,2021-05-31,inter-ucfe,0,0,0,0,0,0,0,0,0,0,0,0,0,0,FALSE,0,2020,2020-2021
OH,2021-05-31,inter-ucx,0,0,0,0,0,0,0,0,0,0,0,0,0,0,FALSE,0,2020,2020-2021
OH,2021-05-31,inter-ui,5,25,24,26,15,6,12,9,6,31,6,165,11,36,FALSE,0.218181818181818,2020,2020-2021
OH,2021-05-31,intra-total,2528,2998,2377,2539,2319,1960,1277,826,518,1890,1425,20657,3953,6951,FALSE,0.336496103015927,2020,2020-2021
OH,2021-05-31,intra-ucfe,0,0,1,1,0,1,1,0,2,10,1,17,1,1,FALSE,0.0588235294117647,2020,2020-2021
OH,2021-05-31,intra-ucx,5,0,1,3,2,4,0,0,0,1,3,19,8,8,FALSE,0.421052631578947,2020,2020-2021
OH,2021-05-31,intra-ui,2523,2998,2375,2535,2317,1955,1276,826,516,1879,1421,20621,3944,6942,FALSE,0.336647107317783,2020,2020-2021
OH,2021-06-30,inter-total,1,26,15,14,16,15,6,7,6,37,11,154,12,38,FALSE,0.246753246753247,2020,2020-2021
OH,2021-06-30,inter-ucfe,0,0,0,0,0,0,0,0,0,0,0,0,0,0,FALSE,0,2020,2020-2021
OH,2021-06-30,inter-ucx,0,0,0,0,0,0,0,0,0,0,0,0,0,0,FALSE,0,2020,2020-2021
OH,2021-06-30,inter-ui,1,26,15,14,16,15,6,7,6,37,11,154,12,38,FALSE,0.246753246753247,2020,2020-2021
OH,2021-06-30,intra-total,1482,2649,1905,1478,1227,851,689,508,468,2266,2108,15631,3590,6239,FALSE,0.39914272919199,2020,2020-2021
OH,2021-06-30,intra-ucfe,1,0,0,0,0,0,0,0,1,10,0,12,1,1,FALSE,0.0833333333333333,2020,2020-2021
OH,2021-06-30,intra-ucx,3,1,1,3,1,0,0,1,0,0,1,11,4,5,FALSE,0.454545454545455,2020,2020-2021
OH,2021-06-30,intra-ui,1478,2648,1904,1475,1226,851,689,507,467,2256,2107,15608,3585,6233,FALSE,0.39934648898001,2020,2020-2021
OH,2021-07-31,inter-total,18,12,12,5,10,3,4,4,8,33,15,124,33,45,FALSE,0.362903225806452,2021,2021-2022
OH,2021-07-31,inter-ucfe,0,0,0,0,0,0,0,0,0,1,0,1,0,0,FALSE,0,2021,2021-2022
OH,2021-07-31,inter-ucx,0,0,0,1,0,0,0,0,0,0,0,1,0,0,FALSE,0,2021,2021-2022
OH,2021-07-31,inter-ui,18,12,12,4,10,3,4,4,8,32,15,122,33,45,FALSE,0.368852459016393,2021,2021-2022
OH,2021-07-31,intra-total,1711,776,541,366,300,275,248,200,199,2306,1408,8330,3119,3895,FALSE,0.467587034813926,2021,2021-2022
OH,2021-07-31,intra-ucfe,1,1,0,0,0,1,0,0,1,9,0,13,1,2,FALSE,0.153846153846154,2021,2021-2022
OH,2021-07-31,intra-ucx,4,1,4,3,1,0,2,0,1,2,0,18,4,5,FALSE,0.277777777777778,2021,2021-2022
OH,2021-07-31,intra-ui,1706,774,537,363,299,274,246,200,197,2295,1408,8299,3114,3888,FALSE,0.468490179539704,2021,2021-2022
OH,2021-08-31,inter-total,18,5,6,7,5,2,4,4,4,55,19,129,37,42,FALSE,0.325581395348837,2021,2021-2022
OH,2021-08-31,inter-ucfe,0,0,0,0,0,0,0,0,0,0,0,0,0,0,FALSE,0,2021,2021-2022
OH,2021-08-31,inter-ucx,0,0,0,0,0,0,0,0,0,0,0,0,0,0,FALSE,0,2021,2021-2022
OH,2021-08-31,inter-ui,18,5,6,7,5,2,4,4,4,55,19,129,37,42,FALSE,0.325581395348837,2021,2021-2022
OH,2021-08-31,intra-total,1681,774,429,263,183,217,169,185,183,2814,1447,8345,3128,3902,FALSE,0.467585380467346,2021,2021-2022
OH,2021-08-31,intra-ucfe,1,0,1,1,0,0,0,0,1,6,2,12,3,3,FALSE,0.25,2021,2021-2022
OH,2021-08-31,intra-ucx,6,3,4,1,1,0,2,0,0,5,1,23,7,10,FALSE,0.434782608695652,2021,2021-2022
OH,2021-08-31,intra-ui,1674,771,424,261,182,217,167,185,182,2803,1444,8310,3118,3889,FALSE,0.467990373044525,2021,2021-2022
OH,2021-09-30,inter-total,6,9,9,6,2,5,3,6,2,42,7,97,13,22,FALSE,0.22680412371134,2021,2021-2022
OH,2021-09-30,inter-ucfe,0,0,0,0,0,0,0,0,0,0,0,0,0,0,FALSE,0,2021,2021-2022
OH,2021-09-30,inter-ucx,0,0,0,0,0,0,0,0,0,0,0,0,0,0,FALSE,0,2021,2021-2022
OH,2021-09-30,inter-ui,6,9,9,6,2,5,3,6,2,42,7,97,13,22,FALSE,0.22680412371134,2021,2021-2022
OH,2021-09-30,intra-total,672,628,474,356,212,180,148,130,107,2082,783,5772,1455,2083,FALSE,0.360880110880111,2021,2021-2022
OH,2021-09-30,intra-ucfe,0,0,1,0,0,0,0,0,0,13,1,15,1,1,FALSE,0.0666666666666667,2021,2021-2022
OH,2021-09-30,intra-ucx,6,1,0,0,0,0,0,0,0,4,2,13,8,9,FALSE,0.692307692307692,2021,2021-2022
OH,2021-09-30,intra-ui,666,627,473,356,212,180,148,130,107,2065,780,5744,1446,2073,FALSE,0.360898328690808,2021,2021-2022
OH,2021-10-31,inter-total,16,6,4,4,3,3,5,2,2,43,25,113,41,47,FALSE,0.415929203539823,2021,2021-2022
OH,2021-10-31,inter-ucfe,0,0,0,1,0,0,0,0,0,0,0,1,0,0,FALSE,0,2021,2021-2022
OH,2021-10-31,inter-ucx,1,0,0,0,0,0,0,0,0,0,0,1,1,1,FALSE,1,2021,2021-2022
OH,2021-10-31,inter-ui,15,6,4,3,3,3,5,2,2,43,25,111,40,46,FALSE,0.414414414414414,2021,2021-2022
OH,2021-10-31,intra-total,964,465,347,335,216,152,126,111,93,1599,912,5320,1876,2341,FALSE,0.440037593984962,2021,2021-2022
OH,2021-10-31,intra-ucfe,0,1,1,0,1,0,1,0,0,8,2,14,2,3,FALSE,0.214285714285714,2021,2021-2022
OH,2021-10-31,intra-ucx,4,1,0,0,1,1,0,0,0,2,3,12,7,8,FALSE,0.666666666666667,2021,2021-2022
OH,2021-10-31,intra-ui,960,463,346,335,214,151,125,111,93,1589,907,5294,1867,2330,FALSE,0.440120891575368,2021,2021-2022
OH,2021-11-30,inter-total,24,9,4,2,7,4,2,2,2,23,22,101,46,55,FALSE,0.544554455445545,2021,2021-2022
OH,2021-11-30,inter-ucfe,0,0,0,0,0,0,0,0,0,0,0,0,0,0,FALSE,0,2021,2021-2022
OH,2021-11-30,inter-ucx,0,0,0,0,0,0,0,0,0,0,0,0,0,0,FALSE,0,2021,2021-2022
OH,2021-11-30,inter-ui,24,9,4,2,7,4,2,2,2,23,22,101,46,55,FALSE,0.544554455445545,2021,2021-2022
OH,2021-11-30,intra-total,1626,485,235,185,180,201,184,146,112,1106,1583,6043,3209,3694,FALSE,0.611285785206024,2021,2021-2022
OH,2021-11-30,intra-ucfe,5,3,1,1,0,1,1,0,0,4,1,17,6,9,FALSE,0.529411764705882,2021,2021-2022
OH,2021-11-30,intra-ucx,6,0,0,0,1,0,1,0,0,2,3,13,9,9,FALSE,0.692307692307692,2021,2021-2022
OH,2021-11-30,intra-ui,1615,482,234,184,179,200,182,146,112,1100,1579,6013,3194,3676,FALSE,0.61134209213371,2021,2021-2022
OH,2021-12-31,inter-total,37,17,9,8,6,2,1,5,1,24,41,151,78,95,FALSE,0.629139072847682,2021,2021-2022
OH,2021-12-31,inter-ucfe,0,0,0,0,0,0,0,0,0,0,0,0,0,0,FALSE,0,2021,2021-2022
OH,2021-12-31,inter-ucx,0,0,0,0,0,0,0,0,0,0,1,1,1,1,FALSE,1,2021,2021-2022
OH,2021-12-31,inter-ui,37,17,9,8,6,2,1,5,1,24,40,150,77,94,FALSE,0.626666666666667,2021,2021-2022
OH,2021-12-31,intra-total,3407,788,396,299,223,174,114,110,126,1246,2772,9655,6179,6967,FALSE,0.721595028482652,2021,2021-2022
OH,2021-12-31,intra-ucfe,0,1,1,1,1,1,0,0,1,12,4,22,4,5,FALSE,0.227272727272727,2021,2021-2022
OH,2021-12-31,intra-ucx,7,2,1,1,0,0,1,2,2,3,5,24,12,14,FALSE,0.583333333333333,2021,2021-2022
OH,2021-12-31,intra-ui,3400,785,394,297,222,173,113,108,123,1231,2763,9609,6163,6948,FALSE,0.723072119887605,2021,2021-2022
OH,2022-01-31,inter-total,66,14,7,7,13,4,3,3,1,11,55,184,121,135,FALSE,0.733695652173913,2021,2021-2022
OH,2022-01-31,inter-ucfe,0,0,0,0,0,0,0,0,0,0,0,0,0,0,FALSE,0,2021,2021-2022
OH,2022-01-31,inter-ucx,0,0,0,0,0,0,0,0,0,0,0,0,0,0,FALSE,0,2021,2021-2022
OH,2022-01-31,inter-ui,66,14,7,7,13,4,3,3,1,11,55,184,121,135,FALSE,0.733695652173913,2021,2021-2022
OH,2022-01-31,intra-total,7316,1369,749,529,375,234,139,102,83,812,4474,16182,11790,13159,FALSE,0.813187492275368,2021,2021-2022
OH,2022-01-31,intra-ucfe,3,2,0,0,0,1,0,0,0,5,2,13,5,7,FALSE,0.538461538461538,2021,2021-2022
OH,2022-01-31,intra-ucx,4,3,2,2,2,0,0,0,0,6,5,24,9,12,FALSE,0.5,2021,2021-2022
OH,2022-01-31,intra-ui,7309,1364,747,527,373,233,139,102,83,801,4467,16145,11776,13140,FALSE,0.813874264478167,2021,2021-2022
OH,2022-02-28,inter-total,49,13,12,8,9,4,4,1,3,17,34,154,83,96,FALSE,0.623376623376623,2021,2021-2022
OH,2022-02-28,inter-ucfe,1,1,0,0,0,0,0,0,0,0,0,2,1,2,FALSE,1,2021,2021-2022
OH,2022-02-28,inter-ucx,0,0,0,0,0,0,0,0,0,0,0,0,0,0,FALSE,0,2021,2021-2022
OH,2022-02-28,inter-ui,48,12,12,8,9,4,4,1,3,17,34,152,82,94,FALSE,0.618421052631579,2021,2021-2022
OH,2022-02-28,intra-total,4807,1126,783,629,457,307,167,104,70,617,2526,11593,7333,8459,FALSE,0.729664452686966,2021,2021-2022
OH,2022-02-28,intra-ucfe,2,1,1,1,1,0,0,0,0,5,2,13,4,5,FALSE,0.384615384615385,2021,2021-2022
OH,2022-02-28,intra-ucx,1,0,0,1,0,0,0,1,0,1,1,5,2,2,FALSE,0.4,2021,2021-2022
OH,2022-02-28,intra-ui,4804,1125,782,627,456,307,167,103,70,611,2523,11575,7327,8452,FALSE,0.730194384449244,2021,2021-2022
OH,2022-03-31,inter-total,32,11,4,4,5,5,2,4,8,21,24,120,56,67,FALSE,0.558333333333333,2021,2021-2022
OH,2022-03-31,inter-ucfe,0,0,0,0,0,0,0,0,0,0,0,0,0,0,FALSE,0,2021,2021-2022
OH,2022-03-31,inter-ucx,0,0,0,0,0,0,0,0,0,0,0,0,0,0,FALSE,0,2021,2021-2022
OH,2022-03-31,inter-ui,32,11,4,4,5,5,2,4,8,21,24,120,56,67,FALSE,0.558333333333333,2021,2021-2022
OH,2022-03-31,intra-total,2851,878,472,353,286,310,208,150,124,644,2184,8460,5035,5913,FALSE,0.698936170212766,2021,2021-2022
OH,2022-03-31,intra-ucfe,0,1,1,0,0,0,1,0,0,3,1,7,1,2,FALSE,0.285714285714286,2021,2021-2022
OH,2022-03-31,intra-ucx,11,1,1,1,0,0,1,0,0,1,1,17,12,13,FALSE,0.764705882352941,2021,2021-2022
OH,2022-03-31,intra-ui,2840,876,470,352,286,310,206,150,124,640,2182,8436,5022,5898,FALSE,0.699146514935989,2021,2021-2022
OH,2022-04-30,inter-total,29,10,2,0,2,1,0,2,1,17,24,88,53,63,FALSE,0.715909090909091,2021,2021-2022
OH,2022-04-30,inter-ucfe,0,0,0,0,0,0,0,0,0,0,0,0,0,0,FALSE,0,2021,2021-2022
OH,2022-04-30,inter-ucx,0,0,1,0,0,0,0,0,0,0,0,1,0,0,FALSE,0,2021,2021-2022
OH,2022-04-30,inter-ui,29,10,1,0,2,1,0,2,1,17,24,87,53,63,FALSE,0.724137931034483,2021,2021-2022
OH,2022-04-30,intra-total,2230,460,246,157,145,97,94,59,70,571,1812,5941,4042,4502,FALSE,0.757784884699546,2021,2021-2022
OH,2022-04-30,intra-ucfe,1,3,0,0,0,0,1,0,0,2,2,9,3,6,FALSE,0.666666666666667,2021,2021-2022
OH,2022-04-30,intra-ucx,8,3,1,1,0,0,0,0,0,1,5,19,13,16,FALSE,0.842105263157895,2021,2021-2022
OH,2022-04-30,intra-ui,2221,454,245,156,145,97,93,59,70,568,1805,5913,4026,4480,FALSE,0.757652629798749,2021,2021-2022
OH,2022-05-31,inter-total,30,9,5,4,3,4,1,2,2,12,18,90,48,57,FALSE,0.633333333333333,2021,2021-2022
OH,2022-05-31,inter-ucfe,0,0,0,0,0,0,0,0,0,1,0,1,0,0,FALSE,0,2021,2021-2022
OH,2022-05-31,inter-ucx,1,0,0,0,0,0,0,0,0,0,0,1,1,1,FALSE,1,2021,2021-2022
OH,2022-05-31,inter-ui,29,9,5,4,3,4,1,2,2,11,18,88,47,56,FALSE,0.636363636363636,2021,2021-2022
OH,2022-05-31,intra-total,2611,454,221,129,104,75,35,37,23,410,1557,5656,4168,4622,FALSE,0.817185289957567,2021,2021-2022
OH,2022-05-31,intra-ucfe,4,2,0,0,1,0,0,0,0,2,0,9,4,6,FALSE,0.666666666666667,2021,2021-2022
OH,2022-05-31,intra-ucx,4,0,1,1,0,0,0,0,0,1,2,9,6,6,FALSE,0.666666666666667,2021,2021-2022
OH,2022-05-31,intra-ui,2603,452,220,128,103,75,35,37,23,407,1555,5638,4158,4610,FALSE,0.817665838949982,2021,2021-2022
OH,2022-06-30,inter-total,42,11,4,4,3,2,1,2,1,13,27,110,69,80,FALSE,0.727272727272727,2021,2021-2022
OH,2022-06-30,inter-ucfe,0,0,0,0,0,0,0,0,0,0,0,0,0,0,FALSE,0,2021,2021-2022
OH,2022-06-30,inter-ucx,0,0,0,0,0,0,0,0,0,0,0,0,0,0,FALSE,0,2021,2021-2022
OH,2022-06-30,inter-ui,42,11,4,4,3,2,1,2,1,13,27,110,69,80,FALSE,0.727272727272727,2021,2021-2022
OH,2022-06-30,intra-total,4120,531,265,154,94,60,35,43,25,398,2452,8177,6572,7103,FALSE,0.868655986303045,2021,2021-2022
OH,2022-06-30,intra-ucfe,9,4,1,0,0,1,0,0,0,4,3,22,12,16,FALSE,0.727272727272727,2021,2021-2022
OH,2022-06-30,intra-ucx,5,0,0,2,0,1,0,0,0,3,5,16,10,10,FALSE,0.625,2021,2021-2022
OH,2022-06-30,intra-ui,4106,527,264,152,94,58,35,43,25,391,2444,8139,6550,7077,FALSE,0.869517139697752,2021,2021-2022
OH,2022-07-31,inter-total,15,16,9,5,1,1,0,0,1,8,24,80,39,55,FALSE,0.6875,2022,2022-2023
OH,2022-07-31,inter-ucfe,0,0,0,0,0,0,0,0,0,0,0,0,0,0,FALSE,0,2022,2022-2023
OH,2022-07-31,inter-ucx,0,0,0,0,0,0,0,0,0,0,0,0,0,0,FALSE,0,2022,2022-2023
OH,2022-07-31,inter-ui,15,16,9,5,1,1,0,0,1,8,24,80,39,55,FALSE,0.6875,2022,2022-2023
OH,2022-07-31,intra-total,3051,825,379,222,130,87,44,35,37,329,2274,7413,5325,6150,FALSE,0.829623634156212,2022,2022-2023
OH,2022-07-31,intra-ucfe,2,4,2,0,2,3,1,0,0,1,1,16,3,7,FALSE,0.4375,2022,2022-2023
OH,2022-07-31,intra-ucx,5,0,0,0,0,0,0,0,0,1,4,10,9,9,FALSE,0.9,2022,2022-2023
OH,2022-07-31,intra-ui,3044,821,377,222,128,84,43,35,37,327,2269,7387,5313,6134,FALSE,0.830377690537431,2022,2022-2023
OH,2022-08-31,inter-total,27,10,11,5,3,7,5,1,1,9,21,100,48,58,FALSE,0.58,2022,2022-2023
OH,2022-08-31,inter-ucfe,0,1,0,0,0,0,0,0,0,0,0,1,0,1,FALSE,1,2022,2022-2023
OH,2022-08-31,inter-ucx,0,0,0,0,0,0,0,0,0,0,0,0,0,0,FALSE,0,2022,2022-2023
OH,2022-08-31,inter-ui,27,9,11,5,3,7,5,1,1,9,21,99,48,57,FALSE,0.575757575757576,2022,2022-2023
OH,2022-08-31,intra-total,2315,741,499,284,192,142,97,66,68,320,1691,6415,4006,4747,FALSE,0.739984411535464,2022,2022-2023
OH,2022-08-31,intra-ucfe,3,0,2,0,2,0,1,0,1,1,2,12,5,5,FALSE,0.416666666666667,2022,2022-2023
OH,2022-08-31,intra-ucx,4,1,1,0,0,0,2,0,0,0,4,12,8,9,FALSE,0.75,2022,2022-2023
OH,2022-08-31,intra-ui,2308,740,496,284,190,142,94,66,67,319,1685,6391,3993,4733,FALSE,0.740572680331717,2022,2022-2023
OH,2022-09-30,inter-total,16,14,7,6,6,5,0,1,0,5,26,86,42,56,FALSE,0.651162790697675,2022,2022-2023
OH,2022-09-30,inter-ucfe,0,0,0,0,0,0,0,0,0,0,0,0,0,0,FALSE,0,2022,2022-2023
OH,2022-09-30,inter-ucx,0,0,0,0,0,0,0,0,0,0,1,1,1,1,FALSE,1,2022,2022-2023
OH,2022-09-30,inter-ui,16,14,7,6,6,5,0,1,0,5,25,85,41,55,FALSE,0.647058823529412,2022,2022-2023
OH,2022-09-30,intra-total,1788,638,348,197,174,115,90,68,47,300,1659,5424,3447,4085,FALSE,0.753134218289086,2022,2022-2023
OH,2022-09-30,intra-ucfe,1,1,0,0,0,1,0,0,0,3,2,8,3,4,FALSE,0.5,2022,2022-2023
OH,2022-09-30,intra-ucx,4,2,1,0,1,1,0,0,0,1,6,16,10,12,FALSE,0.75,2022,2022-2023
OH,2022-09-30,intra-ui,1783,635,347,197,173,113,90,68,47,296,1651,5400,3434,4069,FALSE,0.753518518518519,2022,2022-2023
OH,2022-10-31,inter-total,22,6,7,2,3,3,1,1,1,9,27,82,49,55,FALSE,0.670731707317073,2022,2022-2023
OH,2022-10-31,inter-ucfe,0,0,0,0,0,0,0,0,0,0,0,0,0,0,FALSE,0,2022,2022-2023
OH,2022-10-31,inter-ucx,0,0,1,0,0,0,0,0,0,0,0,1,0,0,FALSE,0,2022,2022-2023
OH,2022-10-31,inter-ui,22,6,6,2,3,3,1,1,1,9,27,81,49,55,FALSE,0.679012345679012,2022,2022-2023
OH,2022-10-31,intra-total,1736,612,324,199,130,97,66,48,41,297,1776,5326,3512,4124,FALSE,0.774314682688697,2022,2022-2023
OH,2022-10-31,intra-ucfe,2,0,1,0,0,0,0,0,0,1,2,6,4,4,FALSE,0.666666666666667,2022,2022-2023
OH,2022-10-31,intra-ucx,5,2,0,1,0,0,0,0,0,0,5,13,10,12,FALSE,0.923076923076923,2022,2022-2023
OH,2022-10-31,intra-ui,1729,610,323,198,130,97,66,48,41,296,1769,5307,3498,4108,FALSE,0.774071980403241,2022,2022-2023
OH,2022-11-30,inter-total,45,11,9,7,1,1,2,0,0,13,44,133,89,100,FALSE,0.75187969924812,2022,2022-2023
OH,2022-11-30,inter-ucfe,0,0,0,0,0,0,0,0,0,0,0,0,0,0,FALSE,0,2022,2022-2023
OH,2022-11-30,inter-ucx,0,0,0,0,0,0,0,0,0,0,1,1,1,1,FALSE,1,2022,2022-2023
OH,2022-11-30,inter-ui,45,11,9,7,1,1,2,0,0,13,43,132,88,99,FALSE,0.75,2022,2022-2023
OH,2022-11-30,intra-total,2578,785,434,237,137,91,65,52,41,274,2576,7270,5154,5939,FALSE,0.816918844566713,2022,2022-2023
OH,2022-11-30,intra-ucfe,4,0,0,1,1,0,0,0,0,4,3,13,7,7,FALSE,0.538461538461538,2022,2022-2023
OH,2022-11-30,intra-ucx,4,6,2,0,0,0,0,0,0,0,7,19,11,17,FALSE,0.894736842105263,2022,2022-2023
OH,2022-11-30,intra-ui,2570,779,432,236,136,91,65,52,41,270,2566,7238,5136,5915,FALSE,0.817214700193424,2022,2022-2023
OH,2022-12-31,inter-total,53,20,8,3,4,4,2,0,4,16,40,154,93,113,FALSE,0.733766233766234,2022,2022-2023
OH,2022-12-31,inter-ucfe,0,0,0,0,0,0,0,0,0,0,0,0,0,0,FALSE,0,2022,2022-2023
OH,2022-12-31,inter-ucx,0,0,0,0,0,0,0,0,0,0,0,0,0,0,FALSE,0,2022,2022-2023
OH,2022-12-31,inter-ui,53,20,8,3,4,4,2,0,4,16,40,154,93,113,FALSE,0.733766233766234,2022,2022-2023
OH,2022-12-31,intra-total,6139,1030,587,304,187,135,97,56,36,248,4110,12929,10249,11279,FALSE,0.872379921107588,2022,2022-2023
OH,2022-12-31,intra-ucfe,2,0,1,0,1,1,0,1,0,1,1,8,3,3,FALSE,0.375,2022,2022-2023
OH,2022-12-31,intra-ucx,8,4,1,0,0,0,2,0,0,0,6,21,14,18,FALSE,0.857142857142857,2022,2022-2023
OH,2022-12-31,intra-ui,6129,1026,585,304,186,134,95,55,36,247,4103,12900,10232,11258,FALSE,0.872713178294574,2022,2022-2023
OH,2023-01-31,inter-total,44,25,21,10,2,5,5,1,0,10,55,178,99,124,FALSE,0.696629213483146,2022,2022-2023
OH,2023-01-31,inter-ucfe,0,0,0,0,0,0,0,0,0,0,0,0,0,0,FALSE,0,2022,2022-2023
OH,2023-01-31,inter-ucx,0,0,0,0,0,0,0,0,0,0,0,0,0,0,FALSE,0,2022,2022-2023
OH,2023-01-31,inter-ui,44,25,21,10,2,5,5,1,0,10,55,178,99,124,FALSE,0.696629213483146,2022,2022-2023
OH,2023-01-31,intra-total,7215,2331,1197,584,338,212,132,85,50,221,6726,19091,13941,16272,FALSE,0.852338798386674,2022,2022-2023
OH,2023-01-31,intra-ucfe,1,1,1,1,0,0,0,1,0,2,0,7,1,2,FALSE,0.285714285714286,2022,2022-2023
OH,2023-01-31,intra-ucx,0,3,3,4,1,0,0,1,0,0,1,13,1,4,FALSE,0.307692307692308,2022,2022-2023
OH,2023-01-31,intra-ui,7214,2327,1193,579,337,212,132,83,50,219,6725,19071,13939,16266,FALSE,0.852918043102092,2022,2022-2023
OH,2023-02-28,inter-total,48,19,15,12,9,3,5,4,4,9,35,163,83,102,FALSE,0.625766871165644,2022,2022-2023
OH,2023-02-28,inter-ucfe,0,0,0,0,0,0,0,0,0,0,0,0,0,0,FALSE,0,2022,2022-2023
OH,2023-02-28,inter-ucx,0,0,0,0,0,0,0,0,0,0,0,0,0,0,FALSE,0,2022,2022-2023
OH,2023-02-28,inter-ui,48,19,15,12,9,3,5,4,4,9,35,163,83,102,FALSE,0.625766871165644,2022,2022-2023
OH,2023-02-28,intra-total,4414,1548,1066,712,456,291,182,135,87,330,3709,12930,8123,9671,FALSE,0.747950502706883,2022,2022-2023
OH,2023-02-28,intra-ucfe,1,1,0,2,0,0,0,0,0,3,3,10,4,5,FALSE,0.5,2022,2022-2023
OH,2023-02-28,intra-ucx,2,3,1,6,1,0,0,0,0,0,3,16,5,8,FALSE,0.5,2022,2022-2023
OH,2023-02-28,intra-ui,4411,1544,1065,704,455,291,182,135,87,327,3703,12904,8114,9658,FALSE,0.74845009299442,2022,2022-2023
OH,2023-03-31,inter-total,27,16,10,5,5,5,6,7,4,22,37,144,64,80,FALSE,0.555555555555556,2022,2022-2023
OH,2023-03-31,inter-ucfe,0,0,0,0,0,0,0,0,0,0,0,0,0,0,FALSE,0,2022,2022-2023
OH,2023-03-31,inter-ucx,0,0,0,0,0,0,0,0,0,0,0,0,0,0,FALSE,0,2022,2022-2023
OH,2023-03-31,inter-ui,27,16,10,5,5,5,6,7,4,22,37,144,64,80,FALSE,0.555555555555556,2022,2022-2023
OH,2023-03-31,intra-total,2421,1176,775,528,362,369,277,253,212,751,2839,9963,5260,6436,FALSE,0.64599016360534,2022,2022-2023
OH,2023-03-31,intra-ucfe,1,0,0,0,1,1,0,0,1,2,1,7,2,2,FALSE,0.285714285714286,2022,2022-2023
OH,2023-03-31,intra-ucx,3,3,0,0,0,2,0,0,0,0,3,11,6,9,FALSE,0.818181818181818,2022,2022-2023
OH,2023-03-31,intra-ui,2417,1173,775,528,361,366,277,253,211,749,2835,9945,5252,6425,FALSE,0.646053293112117,2022,2022-2023
OH,2023-04-30,inter-total,12,14,10,5,4,5,3,5,3,20,22,103,34,48,FALSE,0.466019417475728,2022,2022-2023
OH,2023-04-30,inter-ucfe,0,0,0,0,0,0,0,0,0,0,0,0,0,0,FALSE,0,2022,2022-2023
OH,2023-04-30,inter-ucx,0,0,0,0,0,0,0,0,0,0,0,0,0,0,FALSE,0,2022,2022-2023
OH,2023-04-30,inter-ui,12,14,10,5,4,5,3,5,3,20,22,103,34,48,FALSE,0.466019417475728,2022,2022-2023
OH,2023-04-30,intra-total,1024,1127,693,439,307,253,217,204,178,781,1522,6745,2546,3673,FALSE,0.544551519644181,2022,2022-2023
OH,2023-04-30,intra-ucfe,3,1,0,1,0,1,0,0,0,5,1,12,4,5,FALSE,0.416666666666667,2022,2022-2023
OH,2023-04-30,intra-ucx,1,2,1,0,1,1,0,0,0,1,2,9,3,5,FALSE,0.555555555555556,2022,2022-2023
OH,2023-04-30,intra-ui,1020,1124,692,438,306,251,217,204,178,775,1519,6724,2539,3663,FALSE,0.54476502082094,2022,2022-2023
OH,2023-05-31,inter-total,41,17,20,15,9,4,5,1,1,21,32,166,73,90,FALSE,0.542168674698795,2022,2022-2023
OH,2023-05-31,inter-ucfe,0,0,0,0,0,0,0,0,0,0,0,0,0,0,FALSE,0,2022,2022-2023
OH,2023-05-31,inter-ucx,0,0,0,0,0,0,0,0,0,0,1,1,1,1,FALSE,1,2022,2022-2023
OH,2023-05-31,inter-ui,41,17,20,15,9,4,5,1,1,21,31,165,72,89,FALSE,0.539393939393939,2022,2022-2023
OH,2023-05-31,intra-total,2081,1211,867,575,344,223,146,89,74,508,1898,8016,3979,5190,FALSE,0.647455089820359,2022,2022-2023
OH,2023-05-31,intra-ucfe,3,2,0,0,0,0,0,0,0,3,1,9,4,6,FALSE,0.666666666666667,2022,2022-2023
OH,2023-05-31,intra-ucx,6,1,1,0,0,1,0,0,1,2,1,13,7,8,FALSE,0.615384615384615,2022,2022-2023
OH,2023-05-31,intra-ui,2072,1208,866,575,344,222,146,89,73,503,1896,7994,3968,5176,FALSE,0.647485614210658,2022,2022-2023
OH,2023-06-30,inter-total,30,13,9,13,5,4,8,0,5,9,40,136,70,83,FALSE,0.610294117647059,2022,2022-2023
OH,2023-06-30,inter-ucfe,0,0,0,0,0,0,0,0,0,0,0,0,0,0,FALSE,0,2022,2022-2023
OH,2023-06-30,inter-ucx,0,0,0,0,0,0,0,0,0,0,0,0,0,0,FALSE,0,2022,2022-2023
OH,2023-06-30,inter-ui,30,13,9,13,5,4,8,0,5,9,40,136,70,83,FALSE,0.610294117647059,2022,2022-2023
OH,2023-06-30,intra-total,3239,1167,720,447,260,171,126,77,61,354,3195,9817,6434,7601,FALSE,0.774269124987267,2022,2022-2023
OH,2023-06-30,intra-ucfe,2,1,2,0,0,0,0,0,1,3,0,9,2,3,FALSE,0.333333333333333,2022,2022-2023
OH,2023-06-30,intra-ucx,0,0,3,2,2,0,0,0,1,1,0,9,0,0,FALSE,0,2022,2022-2023
OH,2023-06-30,intra-ui,3237,1166,715,445,258,171,126,77,59,350,3195,9799,6432,7598,FALSE,0.775385243392183,2022,2022-2023
OH,2023-07-31,inter-total,8,5,25,8,4,4,4,2,2,12,18,92,26,31,FALSE,0.33695652173913,2023,2023-2024
OH,2023-07-31,inter-ucfe,0,0,0,0,0,0,0,0,0,0,0,0,0,0,FALSE,0,2023,2023-2024
OH,2023-07-31,inter-ucx,0,0,0,1,0,0,0,0,0,1,0,2,0,0,FALSE,0,2023,2023-2024
OH,2023-07-31,inter-ui,8,5,25,7,4,4,4,2,2,11,18,90,26,31,FALSE,0.344444444444444,2023,2023-2024
OH,2023-07-31,intra-total,1670,1064,796,455,303,181,121,60,44,266,2214,7174,3884,4948,FALSE,0.689712851965431,2023,2023-2024
OH,2023-07-31,intra-ucfe,1,1,0,0,2,0,0,0,0,0,0,4,1,2,FALSE,0.5,2023,2023-2024
OH,2023-07-31,intra-ucx,0,0,0,4,3,0,0,1,0,0,0,8,0,0,FALSE,0,2023,2023-2024
OH,2023-07-31,intra-ui,1669,1063,796,451,298,181,121,59,44,266,2214,7162,3883,4946,FALSE,0.69058922088802,2023,2023-2024
OH,2023-08-31,inter-total,11,13,13,10,11,4,2,6,1,11,24,106,35,48,FALSE,0.452830188679245,2023,2023-2024
OH,2023-08-31,inter-ucfe,0,0,0,0,0,0,0,0,0,0,0,0,0,0,FALSE,0,2023,2023-2024
OH,2023-08-31,inter-ucx,1,0,0,0,0,0,0,0,0,0,0,1,1,1,FALSE,1,2023,2023-2024
OH,2023-08-31,inter-ui,10,13,13,10,11,4,2,6,1,11,24,105,34,47,FALSE,0.447619047619048,2023,2023-2024
OH,2023-08-31,intra-total,1233,1128,718,500,350,265,174,128,80,425,1910,6911,3143,4271,FALSE,0.61800028939372,2023,2023-2024
OH,2023-08-31,intra-ucfe,1,0,0,0,1,0,1,1,0,2,1,7,2,2,FALSE,0.285714285714286,2023,2023-2024
OH,2023-08-31,intra-ucx,2,1,2,0,0,1,0,0,0,0,2,8,4,5,FALSE,0.625,2023,2023-2024
OH,2023-08-31,intra-ui,1230,1127,716,500,349,264,173,127,80,423,1907,6896,3137,4264,FALSE,0.618329466357309,2023,2023-2024
OH,2023-09-30,inter-total,10,11,15,12,6,10,5,3,2,11,22,107,32,43,FALSE,0.401869158878505,2023,2023-2024
OH,2023-09-30,inter-ucfe,0,0,0,0,0,0,0,0,0,0,0,0,0,0,FALSE,0,2023,2023-2024
OH,2023-09-30,inter-ucx,1,0,0,0,0,0,0,0,0,0,0,1,1,1,FALSE,1,2023,2023-2024
OH,2023-09-30,inter-ui,9,11,15,12,6,10,5,3,2,11,22,106,31,42,FALSE,0.39622641509434,2023,2023-2024
OH,2023-09-30,intra-total,851,864,717,490,287,236,160,138,87,541,1327,5698,2178,3042,FALSE,0.533871533871534,2023,2023-2024
OH,2023-09-30,intra-ucfe,1,0,0,0,0,0,0,0,0,1,1,3,2,2,FALSE,0.666666666666667,2023,2023-2024
OH,2023-09-30,intra-ucx,3,1,0,2,1,0,0,0,0,0,1,8,4,5,FALSE,0.625,2023,2023-2024
OH,2023-09-30,intra-ui,847,863,717,488,286,236,160,138,87,540,1325,5687,2172,3035,FALSE,0.533673289959557,2023,2023-2024
OH,2023-10-31,inter-total,23,18,6,10,5,2,6,4,3,16,23,116,46,64,FALSE,0.551724137931035,2023,2023-2024
OH,2023-10-31,inter-ucfe,0,0,0,0,1,0,0,0,0,0,0,1,0,0,FALSE,0,2023,2023-2024
OH,2023-10-31,inter-ucx,0,0,0,0,0,0,0,0,0,0,0,0,0,0,FALSE,0,2023,2023-2024
OH,2023-10-31,inter-ui,23,18,6,10,4,2,6,4,3,16,23,115,46,64,FALSE,0.556521739130435,2023,2023-2024
OH,2023-10-31,intra-total,2346,1225,759,430,267,222,164,111,97,688,2195,8504,4541,5766,FALSE,0.678033866415804,2023,2023-2024
OH,2023-10-31,intra-ucfe,0,0,0,0,0,0,0,0,1,2,1,4,1,1,FALSE,0.25,2023,2023-2024
OH,2023-10-31,intra-ucx,2,1,1,2,0,0,0,1,0,0,3,10,5,6,FALSE,0.6,2023,2023-2024
OH,2023-10-31,intra-ui,2344,1224,758,428,267,222,164,110,96,686,2191,8490,4535,5759,FALSE,0.678327444051826,2023,2023-2024
OH,2023-11-30,inter-total,17,15,13,4,3,7,3,2,1,11,50,126,67,82,FALSE,0.650793650793651,2023,2023-2024
OH,2023-11-30,inter-ucfe,0,0,0,0,0,0,0,0,0,0,0,0,0,0,FALSE,0,2023,2023-2024
OH,2023-11-30,inter-ucx,0,0,0,0,0,0,0,1,0,0,0,1,0,0,FALSE,0,2023,2023-2024
OH,2023-11-30,inter-ui,17,15,13,4,3,7,3,1,1,11,50,125,67,82,FALSE,0.656,2023,2023-2024
OH,2023-11-30,intra-total,1608,1090,758,534,343,221,123,103,75,780,2078,7713,3686,4776,FALSE,0.619214313496694,2023,2023-2024
OH,2023-11-30,intra-ucfe,0,1,2,0,1,0,0,0,0,2,2,8,2,3,FALSE,0.375,2023,2023-2024
OH,2023-11-30,intra-ucx,1,1,0,0,3,4,0,1,0,1,3,14,4,5,FALSE,0.357142857142857,2023,2023-2024
OH,2023-11-30,intra-ui,1607,1088,756,534,339,217,123,102,75,777,2073,7691,3680,4768,FALSE,0.619945390716422,2023,2023-2024
OH,2023-12-31,inter-total,30,22,14,10,6,3,1,1,0,8,40,135,70,92,FALSE,0.681481481481482,2023,2023-2024
OH,2023-12-31,inter-ucfe,0,0,0,0,0,0,0,0,0,0,0,0,0,0,FALSE,0,2023,2023-2024
OH,2023-12-31,inter-ucx,0,0,0,0,0,0,0,0,0,0,0,0,0,0,FALSE,0,2023,2023-2024
OH,2023-12-31,inter-ui,30,22,14,10,6,3,1,1,0,8,40,135,70,92,FALSE,0.681481481481482,2023,2023-2024
OH,2023-12-31,intra-total,4469,1517,870,468,276,192,123,91,66,428,2997,11497,7466,8983,FALSE,0.781334261111594,2023,2023-2024
OH,2023-12-31,intra-ucfe,3,1,3,3,0,0,0,1,1,0,0,12,3,4,FALSE,0.333333333333333,2023,2023-2024
OH,2023-12-31,intra-ucx,3,2,0,2,1,0,0,0,0,0,2,10,5,7,FALSE,0.7,2023,2023-2024
OH,2023-12-31,intra-ui,4463,1514,867,463,275,192,123,90,65,428,2995,11475,7458,8972,FALSE,0.781873638344227,2023,2023-2024
OH,2024-01-31,inter-total,28,19,25,6,4,7,2,5,1,3,36,136,64,83,FALSE,0.610294117647059,2023,2023-2024
OH,2024-01-31,inter-ucfe,0,0,0,0,0,0,0,0,0,1,0,1,0,0,FALSE,0,2023,2023-2024
OH,2024-01-31,inter-ucx,0,0,0,0,0,0,0,0,0,0,0,0,0,0,FALSE,0,2023,2023-2024
OH,2024-01-31,inter-ui,28,19,25,6,4,7,2,5,1,2,36,135,64,83,FALSE,0.614814814814815,2023,2023-2024
OH,2024-01-31,intra-total,5979,2219,1509,743,420,213,157,112,75,275,4526,16228,10505,12724,FALSE,0.784076904116342,2023,2023-2024
OH,2024-01-31,intra-ucfe,0,1,1,1,2,1,0,0,2,1,0,9,0,1,FALSE,0.111111111111111,2023,2023-2024
OH,2024-01-31,intra-ucx,5,0,1,2,1,0,1,0,0,0,4,14,9,9,FALSE,0.642857142857143,2023,2023-2024
OH,2024-01-31,intra-ui,5974,2218,1507,740,417,212,156,112,73,274,4522,16205,10496,12714,FALSE,0.784572662758408,2023,2023-2024
OH,2024-02-29,inter-total,28,32,23,14,4,6,4,5,1,15,35,167,63,95,FALSE,0.568862275449102,2023,2023-2024
OH,2024-02-29,inter-ucfe,0,0,0,0,0,0,0,0,0,0,0,0,0,0,FALSE,0,2023,2023-2024
OH,2024-02-29,inter-ucx,0,0,0,0,0,0,0,0,0,0,0,0,0,0,FALSE,0,2023,2023-2024
OH,2024-02-29,inter-ui,28,32,23,14,4,6,4,5,1,15,35,167,63,95,FALSE,0.568862275449102,2023,2023-2024
OH,2024-02-29,intra-total,3191,2027,1769,1060,612,388,277,163,97,393,3143,13120,6334,8361,FALSE,0.637271341463415,2023,2023-2024
OH,2024-02-29,intra-ucfe,2,2,0,0,0,0,2,1,0,0,2,9,4,6,FALSE,0.666666666666667,2023,2023-2024
OH,2024-02-29,intra-ucx,3,3,4,2,0,1,0,0,0,0,1,14,4,7,FALSE,0.5,2023,2023-2024
OH,2024-02-29,intra-ui,3186,2022,1765,1058,612,387,275,162,97,393,3140,13097,6326,8348,FALSE,0.637397877376499,2023,2023-2024
OH,2024-03-31,inter-total,28,14,12,4,9,10,2,4,2,10,24,119,52,66,FALSE,0.554621848739496,2023,2023-2024
OH,2024-03-31,inter-ucfe,0,0,0,0,0,0,0,0,0,0,0,0,0,0,FALSE,0,2023,2023-2024
OH,2024-03-31,inter-ucx,0,0,0,0,0,0,0,0,0,0,0,0,0,0,FALSE,0,2023,2023-2024
OH,2024-03-31,inter-ui,28,14,12,4,9,10,2,4,2,10,24,119,52,66,FALSE,0.554621848739496,2023,2023-2024
OH,2024-03-31,intra-total,2046,1015,711,479,418,365,272,195,150,479,1951,8081,3997,5012,FALSE,0.620220269768593,2023,2023-2024
OH,2024-03-31,intra-ucfe,0,1,1,1,1,1,0,0,1,3,1,10,1,2,FALSE,0.2,2023,2023-2024
OH,2024-03-31,intra-ucx,1,2,1,3,1,0,0,0,0,2,1,11,2,4,FALSE,0.363636363636364,2023,2023-2024
OH,2024-03-31,intra-ui,2045,1012,709,475,416,364,272,195,149,474,1949,8060,3994,5006,FALSE,0.621091811414392,2023,2023-2024
OH,2024-04-30,inter-total,33,12,10,7,5,4,4,4,2,13,29,123,62,74,FALSE,0.601626016260163,2023,2023-2024
OH,2024-04-30,inter-ucfe,0,0,0,0,0,0,0,0,0,0,1,1,1,1,FALSE,1,2023,2023-2024
OH,2024-04-30,inter-ucx,1,0,0,0,0,0,0,0,0,0,0,1,1,1,FALSE,1,2023,2023-2024
OH,2024-04-30,inter-ui,32,12,10,7,5,4,4,4,2,13,28,121,60,72,FALSE,0.59504132231405,2023,2023-2024
OH,2024-04-30,intra-total,1950,786,494,307,212,158,121,103,118,533,1765,6547,3715,4501,FALSE,0.68749045364289,2023,2023-2024
OH,2024-04-30,intra-ucfe,1,1,2,0,1,0,1,2,1,2,3,14,4,5,FALSE,0.357142857142857,2023,2023-2024
OH,2024-04-30,intra-ucx,4,0,0,2,0,1,0,0,1,1,6,15,10,10,FALSE,0.666666666666667,2023,2023-2024
OH,2024-04-30,intra-ui,1945,785,492,305,211,157,120,101,116,530,1756,6518,3701,4486,FALSE,0.688247928812519,2023,2023-2024
OH,2024-05-31,inter-total,23,12,7,5,6,3,2,2,1,16,21,98,44,56,FALSE,0.571428571428571,2023,2023-2024
OH,2024-05-31,inter-ucfe,0,0,0,0,0,0,0,0,0,0,0,0,0,0,FALSE,0,2023,2023-2024
OH,2024-05-31,inter-ucx,0,0,0,0,0,0,0,0,0,0,0,0,0,0,FALSE,0,2023,2023-2024
OH,2024-05-31,inter-ui,23,12,7,5,6,3,2,2,1,16,21,98,44,56,FALSE,0.571428571428571,2023,2023-2024
OH,2024-05-31,intra-total,2504,724,446,280,177,111,81,64,58,387,1905,6737,4409,5133,FALSE,0.76191183019148,2023,2023-2024
OH,2024-05-31,intra-ucfe,0,3,1,2,0,0,0,0,1,3,2,12,2,5,FALSE,0.416666666666667,2023,2023-2024
OH,2024-05-31,intra-ucx,4,0,0,0,1,0,0,0,0,1,3,9,7,7,FALSE,0.777777777777778,2023,2023-2024
OH,2024-05-31,intra-ui,2500,721,445,278,176,111,81,64,57,383,1900,6716,4400,5121,FALSE,0.762507444907683,2023,2023-2024
OH,2024-06-30,inter-total,25,13,6,5,3,3,1,2,0,7,25,90,50,63,FALSE,0.7,2023,2023-2024
OH,2024-06-30,inter-ucfe,0,0,0,0,0,0,0,0,0,0,0,0,0,0,FALSE,0,2023,2023-2024
OH,2024-06-30,inter-ucx,0,0,0,0,0,0,0,0,0,0,0,0,0,0,FALSE,0,2023,2023-2024
OH,2024-06-30,inter-ui,25,13,6,5,3,3,1,2,0,7,25,90,50,63,FALSE,0.7,2023,2023-2024
OH,2024-06-30,intra-total,3652,835,446,200,170,105,79,61,45,296,2501,8390,6153,6988,FALSE,0.832896305125149,2023,2023-2024
OH,2024-06-30,intra-ucfe,0,0,1,2,1,1,1,0,0,1,3,10,3,3,FALSE,0.3,2023,2023-2024
OH,2024-06-30,intra-ucx,3,2,1,1,1,1,0,0,1,0,3,13,6,8,FALSE,0.615384615384615,2023,2023-2024
OH,2024-06-30,intra-ui,3649,833,444,197,168,103,78,61,44,295,2495,8367,6144,6977,FALSE,0.833871160511533,2023,2023-2024
OH,2024-07-31,inter-total,24,13,5,4,4,0,0,1,0,11,26,88,50,63,FALSE,0.715909090909091,2024,2024-2025
OH,2024-07-31,inter-ucfe,0,0,0,0,0,0,0,0,0,0,0,0,0,0,FALSE,0,2024,2024-2025
OH,2024-07-31,inter-ucx,0,0,0,0,0,0,0,0,0,0,0,0,0,0,FALSE,0,2024,2024-2025
OH,2024-07-31,inter-ui,24,13,5,4,4,0,0,1,0,11,26,88,50,63,FALSE,0.715909090909091,2024,2024-2025
OH,2024-07-31,intra-total,4033,1125,638,290,186,112,81,61,51,275,3234,10086,7267,8392,FALSE,0.832044418005156,2024,2024-2025
OH,2024-07-31,intra-ucfe,0,1,3,1,0,0,0,0,1,1,3,10,3,4,FALSE,0.4,2024,2024-2025
OH,2024-07-31,intra-ucx,5,3,1,0,0,0,0,1,0,0,1,11,6,9,FALSE,0.818181818181818,2024,2024-2025
OH,2024-07-31,intra-ui,4028,1121,634,289,186,112,81,60,50,274,3230,10065,7258,8379,FALSE,0.832488822652757,2024,2024-2025
OH,2024-08-31,inter-total,23,10,9,8,3,5,1,2,1,7,31,100,54,64,FALSE,0.64,2024,2024-2025
OH,2024-08-31,inter-ucfe,0,0,0,0,0,0,0,0,0,0,0,0,0,0,FALSE,0,2024,2024-2025
OH,2024-08-31,inter-ucx,0,0,0,0,0,0,0,0,0,0,0,0,0,0,FALSE,0,2024,2024-2025
OH,2024-08-31,inter-ui,23,10,9,8,3,5,1,2,1,7,31,100,54,64,FALSE,0.64,2024,2024-2025
OH,2024-08-31,intra-total,2727,902,549,290,183,120,78,52,73,327,2201,7502,4928,5830,FALSE,0.777126099706745,2024,2024-2025
OH,2024-08-31,intra-ucfe,1,0,1,0,0,0,0,1,0,0,1,4,2,2,FALSE,0.5,2024,2024-2025
OH,2024-08-31,intra-ucx,5,0,0,0,2,1,0,0,0,0,4,12,9,9,FALSE,0.75,2024,2024-2025
OH,2024-08-31,intra-ui,2721,902,548,290,181,119,78,51,73,327,2196,7486,4917,5819,FALSE,0.777317659631312,2024,2024-2025
OH,2024-09-30,inter-total,29,12,7,5,1,2,5,2,1,9,29,102,58,70,FALSE,0.686274509803922,2024,2024-2025
OH,2024-09-30,inter-ucfe,0,0,0,1,0,0,0,0,0,0,0,1,0,0,FALSE,0,2024,2024-2025
OH,2024-09-30,inter-ucx,1,0,0,0,0,0,0,0,0,0,1,2,2,2,FALSE,1,2024,2024-2025
OH,2024-09-30,inter-ui,28,12,7,4,1,2,5,2,1,9,28,99,56,68,FALSE,0.686868686868687,2024,2024-2025
OH,2024-09-30,intra-total,2232,763,397,216,120,104,53,53,37,349,2077,6401,4309,5072,FALSE,0.792376191220122,2024,2024-2025
OH,2024-09-30,intra-ucfe,0,1,1,1,0,0,0,0,0,3,1,7,1,2,FALSE,0.285714285714286,2024,2024-2025
OH,2024-09-30,intra-ucx,4,1,1,1,1,0,0,1,0,1,3,13,7,8,FALSE,0.615384615384615,2024,2024-2025
OH,2024-09-30,intra-ui,2228,761,395,214,119,104,53,52,37,345,2073,6381,4301,5062,FALSE,0.793292587368751,2024,2024-2025
OH,2024-10-31,inter-total,39,10,5,3,1,4,0,1,0,2,27,92,66,76,FALSE,0.826086956521739,2024,2024-2025
OH,2024-10-31,inter-ucfe,0,0,0,0,0,0,0,0,0,0,0,0,0,0,FALSE,0,2024,2024-2025
OH,2024-10-31,inter-ucx,0,0,0,0,0,0,0,0,0,0,0,0,0,0,FALSE,0,2024,2024-2025
OH,2024-10-31,inter-ui,39,10,5,3,1,4,0,1,0,2,27,92,66,76,FALSE,0.826086956521739,2024,2024-2025
OH,2024-10-31,intra-total,5509,908,380,220,101,74,49,39,36,224,2833,10373,8342,9250,FALSE,0.891738166393522,2024,2024-2025
OH,2024-10-31,intra-ucfe,2,0,0,0,0,1,0,0,0,2,0,5,2,2,FALSE,0.4,2024,2024-2025
OH,2024-10-31,intra-ucx,6,2,0,1,0,0,0,0,0,1,8,18,14,16,FALSE,0.888888888888889,2024,2024-2025
OH,2024-10-31,intra-ui,5501,906,380,219,101,73,49,39,36,221,2825,10350,8326,9232,FALSE,0.891980676328502,2024,2024-2025
OH,2024-11-30,inter-total,48,12,9,7,1,1,0,1,2,8,38,127,86,98,FALSE,0.771653543307087,2024,2024-2025
OH,2024-11-30,inter-ucfe,0,0,0,0,0,0,0,0,0,0,0,0,0,0,FALSE,0,2024,2024-2025
OH,2024-11-30,inter-ucx,1,0,0,0,0,0,0,0,0,0,0,1,1,1,FALSE,1,2024,2024-2025
OH,2024-11-30,inter-ui,47,12,9,7,1,1,0,1,2,8,38,126,85,97,FALSE,0.76984126984127,2024,2024-2025
OH,2024-11-30,intra-total,3575,878,433,197,112,76,63,33,36,191,2495,8089,6070,6948,FALSE,0.858944245271356,2024,2024-2025
OH,2024-11-30,intra-ucfe,0,0,0,1,1,1,0,1,0,3,0,7,0,0,FALSE,0,2024,2024-2025
OH,2024-11-30,intra-ucx,5,3,1,1,0,0,0,0,0,0,3,13,8,11,FALSE,0.846153846153846,2024,2024-2025
OH,2024-11-30,intra-ui,3570,875,432,195,111,75,63,32,36,188,2492,8069,6062,6937,FALSE,0.859710001239311,2024,2024-2025
OK,2019-01-31,inter-total,195,6,0,3,1,1,4,0,0,3,18,231,213,219,FALSE,0.948051948051948,2018,2018-2019
OK,2019-01-31,inter-ucfe,4,0,0,0,0,0,1,0,0,0,1,6,5,5,FALSE,0.833333333333333,2018,2018-2019
OK,2019-01-31,inter-ucx,0,0,0,0,0,0,0,0,0,0,0,0,0,0,FALSE,0,2018,2018-2019
OK,2019-01-31,inter-ui,191,6,0,3,1,1,3,0,0,3,17,225,208,214,FALSE,0.951111111111111,2018,2018-2019
OK,2019-01-31,intra-total,2974,136,50,23,12,28,37,20,13,24,518,3835,3492,3628,FALSE,0.946023468057366,2018,2018-2019
OK,2019-01-31,intra-ucfe,217,1,1,1,0,0,1,1,0,1,20,243,237,238,FALSE,0.979423868312757,2018,2018-2019
OK,2019-01-31,intra-ucx,10,1,0,0,0,1,0,0,0,0,1,13,11,12,FALSE,0.923076923076923,2018,2018-2019
OK,2019-01-31,intra-ui,2747,134,49,22,12,27,36,19,13,23,497,3579,3244,3378,FALSE,0.943839061190277,2018,2018-2019
OK,2019-02-28,inter-total,109,8,4,3,0,0,0,0,0,0,18,142,127,135,FALSE,0.950704225352113,2018,2018-2019
OK,2019-02-28,inter-ucfe,0,1,0,1,0,0,0,0,0,0,0,2,0,1,FALSE,0.5,2018,2018-2019
OK,2019-02-28,inter-ucx,1,0,0,0,0,0,0,0,0,0,0,1,1,1,FALSE,1,2018,2018-2019
OK,2019-02-28,inter-ui,108,7,4,2,0,0,0,0,0,0,18,139,126,133,FALSE,0.956834532374101,2018,2018-2019
OK,2019-02-28,intra-total,1762,130,46,11,23,29,23,16,5,15,468,2528,2230,2360,FALSE,0.933544303797468,2018,2018-2019
OK,2019-02-28,intra-ucfe,7,0,2,0,1,0,0,0,1,5,4,20,11,11,FALSE,0.55,2018,2018-2019
OK,2019-02-28,intra-ucx,5,0,0,0,0,0,0,0,0,0,1,6,6,6,FALSE,1,2018,2018-2019
OK,2019-02-28,intra-ui,1750,130,44,11,22,29,23,16,4,10,463,2502,2213,2343,FALSE,0.936450839328537,2018,2018-2019
OK,2019-03-31,inter-total,117,2,0,8,0,1,0,2,0,1,17,148,134,136,FALSE,0.918918918918919,2018,2018-2019
OK,2019-03-31,inter-ucfe,0,0,0,1,0,0,0,0,0,0,0,1,0,0,FALSE,0,2018,2018-2019
OK,2019-03-31,inter-ucx,0,0,0,0,0,0,0,0,0,0,0,0,0,0,FALSE,0,2018,2018-2019
OK,2019-03-31,inter-ui,117,2,0,7,0,1,0,2,0,1,17,147,134,136,FALSE,0.925170068027211,2018,2018-2019
OK,2019-03-31,intra-total,2041,110,27,19,36,40,20,12,5,17,470,2797,2511,2621,FALSE,0.937075437969253,2018,2018-2019
OK,2019-03-31,intra-ucfe,1,1,0,0,1,0,0,0,0,1,1,5,2,3,FALSE,0.6,2018,2018-2019
OK,2019-03-31,intra-ucx,9,0,0,0,0,0,0,0,0,0,1,10,10,10,FALSE,1,2018,2018-2019
OK,2019-03-31,intra-ui,2031,109,27,19,35,40,20,12,5,16,468,2782,2499,2608,FALSE,0.93745506829619,2018,2018-2019
OK,2019-04-30,inter-total,129,1,1,0,0,0,0,2,1,2,22,158,151,152,FALSE,0.962025316455696,2018,2018-2019
OK,2019-04-30,inter-ucfe,1,0,0,0,0,0,0,0,0,0,0,1,1,1,FALSE,1,2018,2018-2019
OK,2019-04-30,inter-ucx,2,0,0,0,0,0,0,0,0,0,0,2,2,2,FALSE,1,2018,2018-2019
OK,2019-04-30,inter-ui,126,1,1,0,0,0,0,2,1,2,22,155,148,149,FALSE,0.961290322580645,2018,2018-2019
OK,2019-04-30,intra-total,1899,119,26,12,23,36,15,5,4,11,535,2685,2434,2553,FALSE,0.950837988826816,2018,2018-2019
OK,2019-04-30,intra-ucfe,3,0,1,0,0,0,0,0,0,0,1,5,4,4,FALSE,0.8,2018,2018-2019
OK,2019-04-30,intra-ucx,6,1,0,0,0,1,0,0,0,0,1,9,7,8,FALSE,0.888888888888889,2018,2018-2019
OK,2019-04-30,intra-ui,1890,118,25,12,23,35,15,5,4,11,533,2671,2423,2541,FALSE,0.951329090228379,2018,2018-2019
OK,2019-05-31,inter-total,124,3,3,0,0,0,1,1,0,1,20,153,144,147,FALSE,0.96078431372549,2018,2018-2019
OK,2019-05-31,inter-ucfe,0,1,0,0,0,0,0,0,0,0,1,2,1,2,FALSE,1,2018,2018-2019
OK,2019-05-31,inter-ucx,0,0,0,0,0,0,0,0,0,0,0,0,0,0,FALSE,0,2018,2018-2019
OK,2019-05-31,inter-ui,124,2,3,0,0,0,1,1,0,1,19,151,143,145,FALSE,0.960264900662252,2018,2018-2019
OK,2019-05-31,intra-total,1724,132,25,8,12,19,26,17,9,15,515,2502,2239,2371,FALSE,0.947641886490807,2018,2018-2019
OK,2019-05-31,intra-ucfe,3,0,0,0,0,0,0,0,0,0,1,4,4,4,FALSE,1,2018,2018-2019
OK,2019-05-31,intra-ucx,9,0,1,0,0,0,0,0,0,0,1,11,10,10,FALSE,0.909090909090909,2018,2018-2019
OK,2019-05-31,intra-ui,1712,132,24,8,12,19,26,17,9,15,513,2487,2225,2357,FALSE,0.947728186570165,2018,2018-2019
OK,2019-06-30,inter-total,146,6,2,3,0,0,2,1,2,1,21,184,167,173,FALSE,0.940217391304348,2018,2018-2019
OK,2019-06-30,inter-ucfe,0,0,0,0,0,0,0,0,0,0,0,0,0,0,FALSE,0,2018,2018-2019
OK,2019-06-30,inter-ucx,1,0,0,0,0,0,0,0,0,0,0,1,1,1,FALSE,1,2018,2018-2019
OK,2019-06-30,inter-ui,145,6,2,3,0,0,2,1,2,1,21,183,166,172,FALSE,0.939890710382514,2018,2018-2019
OK,2019-06-30,intra-total,2305,127,35,14,8,6,11,16,27,24,547,3120,2852,2979,FALSE,0.954807692307692,2018,2018-2019
OK,2019-06-30,intra-ucfe,3,1,0,1,0,0,0,0,0,2,2,9,5,6,FALSE,0.666666666666667,2018,2018-2019
OK,2019-06-30,intra-ucx,8,0,0,0,0,0,0,0,1,0,1,10,9,9,FALSE,0.9,2018,2018-2019
OK,2019-06-30,intra-ui,2294,126,35,13,8,6,11,16,26,22,544,3101,2838,2964,FALSE,0.955820702999033,2018,2018-2019
OK,2019-07-31,inter-total,151,4,0,1,1,0,0,1,1,6,22,187,173,177,FALSE,0.946524064171123,2019,2019-2020
OK,2019-07-31,inter-ucfe,0,0,0,0,0,0,0,0,0,1,0,1,0,0,FALSE,0,2019,2019-2020
OK,2019-07-31,inter-ucx,0,0,0,0,0,0,0,0,0,0,0,0,0,0,FALSE,0,2019,2019-2020
OK,2019-07-31,inter-ui,151,4,0,1,1,0,0,1,1,5,22,186,173,177,FALSE,0.951612903225806,2019,2019-2020
OK,2019-07-31,intra-total,2018,132,35,19,13,5,7,10,37,37,496,2809,2514,2646,FALSE,0.941972232111072,2019,2019-2020
OK,2019-07-31,intra-ucfe,3,0,0,0,0,0,0,0,0,0,3,6,6,6,FALSE,1,2019,2019-2020
OK,2019-07-31,intra-ucx,3,1,0,0,0,0,0,0,0,0,0,4,3,4,FALSE,1,2019,2019-2020
OK,2019-07-31,intra-ui,2012,131,35,19,13,5,7,10,37,37,493,2799,2505,2636,FALSE,0.941764916041443,2019,2019-2020
OK,2019-08-31,inter-total,64,13,3,1,0,1,0,1,1,3,26,113,90,103,FALSE,0.911504424778761,2019,2019-2020
OK,2019-08-31,inter-ucfe,0,0,0,0,0,0,0,0,0,0,1,1,1,1,FALSE,1,2019,2019-2020
OK,2019-08-31,inter-ucx,0,0,0,0,0,0,0,0,0,0,0,0,0,0,FALSE,0,2019,2019-2020
OK,2019-08-31,inter-ui,64,13,3,1,0,1,0,1,1,3,25,112,89,102,FALSE,0.910714285714286,2019,2019-2020
OK,2019-08-31,intra-total,1162,166,58,7,5,7,15,25,22,62,479,2008,1641,1807,FALSE,0.899900398406374,2019,2019-2020
OK,2019-08-31,intra-ucfe,2,1,0,0,1,0,0,0,0,2,1,7,3,4,FALSE,0.571428571428571,2019,2019-2020
OK,2019-08-31,intra-ucx,9,0,0,0,0,0,0,0,0,0,1,10,10,10,FALSE,1,2019,2019-2020
OK,2019-08-31,intra-ui,1151,165,58,7,4,7,15,25,22,60,477,1991,1628,1793,FALSE,0.900552486187845,2019,2019-2020
OK,2019-09-30,inter-total,110,9,6,2,3,2,1,1,0,3,27,164,137,146,FALSE,0.890243902439024,2019,2019-2020
OK,2019-09-30,inter-ucfe,0,0,0,0,0,0,0,0,0,0,2,2,2,2,FALSE,1,2019,2019-2020
OK,2019-09-30,inter-ucx,0,0,0,0,0,0,0,0,0,0,0,0,0,0,FALSE,0,2019,2019-2020
OK,2019-09-30,inter-ui,110,9,6,2,3,2,1,1,0,3,25,162,135,144,FALSE,0.888888888888889,2019,2019-2020
OK,2019-09-30,intra-total,1508,218,44,23,8,9,12,15,14,63,528,2442,2036,2254,FALSE,0.923013923013923,2019,2019-2020
OK,2019-09-30,intra-ucfe,1,4,0,0,0,0,0,0,0,2,1,8,2,6,FALSE,0.75,2019,2019-2020
OK,2019-09-30,intra-ucx,5,2,0,1,0,0,0,0,0,0,2,10,7,9,FALSE,0.9,2019,2019-2020
OK,2019-09-30,intra-ui,1502,212,44,22,8,9,12,15,14,61,525,2424,2027,2239,FALSE,0.923679867986799,2019,2019-2020
OK,2019-10-31,inter-total,86,11,3,2,1,2,0,0,0,4,22,131,108,119,FALSE,0.908396946564885,2019,2019-2020
OK,2019-10-31,inter-ucfe,0,0,0,0,0,0,0,0,0,1,0,1,0,0,FALSE,0,2019,2019-2020
OK,2019-10-31,inter-ucx,0,0,0,0,0,0,0,0,0,0,0,0,0,0,FALSE,0,2019,2019-2020
OK,2019-10-31,inter-ui,86,11,3,2,1,2,0,0,0,3,22,130,108,119,FALSE,0.915384615384615,2019,2019-2020
OK,2019-10-31,intra-total,1682,172,52,17,12,5,11,20,25,62,549,2607,2231,2403,FALSE,0.92174913693901,2019,2019-2020
OK,2019-10-31,intra-ucfe,0,1,1,0,0,0,0,1,0,1,2,6,2,3,FALSE,0.5,2019,2019-2020
OK,2019-10-31,intra-ucx,3,1,0,0,0,0,1,0,0,0,2,7,5,6,FALSE,0.857142857142857,2019,2019-2020
OK,2019-10-31,intra-ui,1679,170,51,17,12,5,10,19,25,61,545,2594,2224,2394,FALSE,0.92289899768697,2019,2019-2020
OK,2019-11-30,inter-total,100,10,2,3,2,0,0,0,1,4,31,153,131,141,FALSE,0.92156862745098,2019,2019-2020
OK,2019-11-30,inter-ucfe,0,0,0,0,0,0,0,0,0,0,2,2,2,2,FALSE,1,2019,2019-2020
OK,2019-11-30,inter-ucx,0,0,0,0,0,0,0,0,0,0,0,0,0,0,FALSE,0,2019,2019-2020
OK,2019-11-30,inter-ui,100,10,2,3,2,0,0,0,1,4,29,151,129,139,FALSE,0.920529801324503,2019,2019-2020
OK,2019-11-30,intra-total,1740,143,43,17,9,8,4,32,35,45,429,2505,2169,2312,FALSE,0.922954091816367,2019,2019-2020
OK,2019-11-30,intra-ucfe,3,1,0,0,0,0,0,0,1,0,0,5,3,4,FALSE,0.8,2019,2019-2020
OK,2019-11-30,intra-ucx,4,0,0,0,0,0,0,0,0,0,0,4,4,4,FALSE,1,2019,2019-2020
OK,2019-11-30,intra-ui,1733,142,43,17,9,8,4,32,34,45,429,2496,2162,2304,FALSE,0.923076923076923,2019,2019-2020
OK,2019-12-31,inter-total,159,17,8,3,1,1,3,0,0,1,43,236,202,219,FALSE,0.927966101694915,2019,2019-2020
OK,2019-12-31,inter-ucfe,0,0,0,0,0,0,0,0,0,0,1,1,1,1,FALSE,1,2019,2019-2020
OK,2019-12-31,inter-ucx,0,0,0,0,0,0,0,0,0,0,0,0,0,0,FALSE,0,2019,2019-2020
OK,2019-12-31,inter-ui,159,17,8,3,1,1,3,0,0,1,42,235,201,218,FALSE,0.927659574468085,2019,2019-2020
OK,2019-12-31,intra-total,2398,225,50,35,12,10,4,11,30,61,579,3415,2977,3202,FALSE,0.937628111273792,2019,2019-2020
OK,2019-12-31,intra-ucfe,5,1,0,0,0,0,0,0,1,2,6,15,11,12,FALSE,0.8,2019,2019-2020
OK,2019-12-31,intra-ucx,8,0,0,0,0,0,0,0,0,0,0,8,8,8,FALSE,1,2019,2019-2020
OK,2019-12-31,intra-ui,2385,224,50,35,12,10,4,11,29,59,573,3392,2958,3182,FALSE,0.938089622641509,2019,2019-2020
OK,2020-01-31,inter-total,138,15,19,5,10,1,2,1,0,2,38,231,176,191,FALSE,0.826839826839827,2019,2019-2020
OK,2020-01-31,inter-ucfe,0,0,0,0,0,0,0,0,0,1,0,1,0,0,FALSE,0,2019,2019-2020
OK,2020-01-31,inter-ucx,0,0,0,0,0,0,0,0,0,0,0,0,0,0,FALSE,0,2019,2019-2020
OK,2020-01-31,inter-ui,138,15,19,5,10,1,2,1,0,1,38,230,176,191,FALSE,0.830434782608696,2019,2019-2020
OK,2020-01-31,intra-total,2066,287,142,44,26,15,5,17,35,80,528,3245,2594,2881,FALSE,0.887827426810478,2019,2019-2020
OK,2020-01-31,intra-ucfe,4,1,1,1,0,0,0,1,1,0,0,9,4,5,FALSE,0.555555555555556,2019,2019-2020
OK,2020-01-31,intra-ucx,7,1,0,0,0,0,0,0,0,0,1,9,8,9,FALSE,1,2019,2019-2020
OK,2020-01-31,intra-ui,2055,285,141,43,26,15,5,16,34,80,527,3227,2582,2867,FALSE,0.888441276727611,2019,2019-2020
OK,2020-02-29,inter-total,111,10,2,7,4,1,0,1,0,5,23,164,134,144,FALSE,0.878048780487805,2019,2019-2020
OK,2020-02-29,inter-ucfe,0,0,0,0,0,0,0,0,0,0,0,0,0,0,FALSE,0,2019,2019-2020
OK,2020-02-29,inter-ucx,0,0,0,0,0,0,0,0,0,0,1,1,1,1,FALSE,1,2019,2019-2020
OK,2020-02-29,inter-ui,111,10,2,7,4,1,0,1,0,5,22,163,133,143,FALSE,0.877300613496933,2019,2019-2020
OK,2020-02-29,intra-total,1470,279,139,48,33,9,14,23,18,55,424,2512,1894,2173,FALSE,0.865047770700637,2019,2019-2020
OK,2020-02-29,intra-ucfe,2,2,1,0,0,0,0,0,0,0,3,8,5,7,FALSE,0.875,2019,2019-2020
OK,2020-02-29,intra-ucx,13,0,0,1,0,0,0,0,0,0,1,15,14,14,FALSE,0.933333333333333,2019,2019-2020
OK,2020-02-29,intra-ui,1455,277,138,47,33,9,14,23,18,55,420,2489,1875,2152,FALSE,0.864604258738449,2019,2019-2020
OK,2020-03-31,inter-total,272,8,5,4,1,2,0,0,1,3,16,312,288,296,FALSE,0.948717948717949,2019,2019-2020
OK,2020-03-31,inter-ucfe,0,0,0,0,0,0,0,0,0,0,0,0,0,0,FALSE,0,2019,2019-2020
OK,2020-03-31,inter-ucx,0,0,0,0,0,0,0,0,0,0,0,0,0,0,FALSE,0,2019,2019-2020
OK,2020-03-31,inter-ui,272,8,5,4,1,2,0,0,1,3,16,312,288,296,FALSE,0.948717948717949,2019,2019-2020
OK,2020-03-31,intra-total,8788,220,136,67,44,50,27,27,23,49,413,9844,9201,9421,FALSE,0.957029662738724,2019,2019-2020
OK,2020-03-31,intra-ucfe,7,3,0,0,0,0,0,1,0,1,1,13,8,11,FALSE,0.846153846153846,2019,2019-2020
OK,2020-03-31,intra-ucx,7,0,0,0,0,0,0,0,0,0,5,12,12,12,FALSE,1,2019,2019-2020
OK,2020-03-31,intra-ui,8774,217,136,67,44,50,27,26,23,48,407,9819,9181,9398,FALSE,0.957123943375089,2019,2019-2020
OK,2020-04-30,inter-total,1807,50,19,7,1,2,0,2,0,4,194,2086,2001,2051,FALSE,0.983221476510067,2019,2019-2020
OK,2020-04-30,inter-ucfe,1,1,0,0,0,0,0,0,0,0,1,3,2,3,FALSE,1,2019,2019-2020
OK,2020-04-30,inter-ucx,0,0,0,0,0,0,0,0,0,0,0,0,0,0,FALSE,0,2019,2019-2020
OK,2020-04-30,inter-ui,1806,49,19,7,1,2,0,2,0,4,193,2083,1999,2048,FALSE,0.983197311569851,2019,2019-2020
OK,2020-04-30,intra-total,75321,4135,1708,223,39,41,43,32,15,48,11265,92870,86586,90721,FALSE,0.97686012705933,2019,2019-2020
OK,2020-04-30,intra-ucfe,5,2,3,2,0,0,0,0,0,2,9,23,14,16,FALSE,0.695652173913044,2019,2019-2020
OK,2020-04-30,intra-ucx,14,2,1,1,1,0,0,0,0,0,12,31,26,28,FALSE,0.903225806451613,2019,2019-2020
OK,2020-04-30,intra-ui,75302,4131,1704,220,38,41,43,32,15,46,11244,92816,86546,90677,FALSE,0.976954404413032,2019,2019-2020
OK,2020-05-31,inter-total,610,69,82,82,83,42,11,1,1,4,128,1113,738,807,FALSE,0.725067385444744,2019,2019-2020
OK,2020-05-31,inter-ucfe,1,0,0,0,0,0,0,0,0,0,0,1,1,1,FALSE,1,2019,2019-2020
OK,2020-05-31,inter-ucx,0,0,0,0,0,0,0,0,0,0,0,0,0,0,FALSE,0,2019,2019-2020
OK,2020-05-31,inter-ui,609,69,82,82,83,42,11,1,1,4,128,1112,737,806,FALSE,0.724820143884892,2019,2019-2020
OK,2020-05-31,intra-total,44277,3531,3337,3828,2856,1045,405,128,38,67,6154,65666,50431,53962,FALSE,0.821764687966375,2019,2019-2020
OK,2020-05-31,intra-ucfe,4,2,1,1,3,2,1,1,0,2,3,20,7,9,FALSE,0.45,2019,2019-2020
OK,2020-05-31,intra-ucx,7,2,1,1,0,1,0,0,0,0,9,21,16,18,FALSE,0.857142857142857,2019,2019-2020
OK,2020-05-31,intra-ui,44266,3527,3335,3826,2853,1042,404,127,38,65,6142,65625,50408,53935,FALSE,0.821866666666667,2019,2019-2020
OK,2020-06-30,inter-total,363,32,18,37,28,28,34,27,24,37,54,682,417,449,FALSE,0.658357771260997,2019,2019-2020
OK,2020-06-30,inter-ucfe,0,0,0,0,0,1,0,0,0,0,0,1,0,0,FALSE,0,2019,2019-2020
OK,2020-06-30,inter-ucx,0,0,0,0,0,0,0,0,0,0,0,0,0,0,FALSE,0,2019,2019-2020
OK,2020-06-30,inter-ui,363,32,18,37,28,27,34,27,24,37,54,681,417,449,FALSE,0.659324522760646,2019,2019-2020
OK,2020-06-30,intra-total,45540,985,521,614,694,816,958,969,722,970,3493,56282,49033,50018,FALSE,0.888703315447212,2019,2019-2020
OK,2020-06-30,intra-ucfe,6,2,1,2,3,1,2,1,2,4,1,25,7,9,FALSE,0.36,2019,2019-2020
OK,2020-06-30,intra-ucx,10,6,5,2,0,0,2,3,1,5,14,48,24,30,FALSE,0.625,2019,2019-2020
OK,2020-06-30,intra-ui,45524,977,515,610,691,815,954,965,719,961,3478,56209,49002,49979,FALSE,0.889163657065595,2019,2019-2020
OK,2020-07-31,inter-total,158,41,11,18,12,15,13,16,11,129,41,465,199,240,FALSE,0.516129032258065,2020,2020-2021
OK,2020-07-31,inter-ucfe,1,0,0,0,0,0,0,0,0,0,0,1,1,1,FALSE,1,2020,2020-2021
OK,2020-07-31,inter-ucx,0,0,0,0,0,0,0,0,0,0,1,1,1,1,FALSE,1,2020,2020-2021
OK,2020-07-31,inter-ui,157,41,11,18,12,15,13,16,11,129,40,463,197,238,FALSE,0.514038876889849,2020,2020-2021
OK,2020-07-31,intra-total,5936,1087,578,449,295,302,308,315,370,3064,1913,14617,7849,8936,FALSE,0.611342956831087,2020,2020-2021
OK,2020-07-31,intra-ucfe,3,0,0,0,3,2,1,1,0,13,2,25,5,5,FALSE,0.2,2020,2020-2021
OK,2020-07-31,intra-ucx,8,0,2,1,2,0,0,2,2,5,3,25,11,11,FALSE,0.44,2020,2020-2021
OK,2020-07-31,intra-ui,5925,1087,576,448,290,300,307,312,368,3046,1908,14567,7833,8920,FALSE,0.612342966980161,2020,2020-2021
OK,2020-08-31,inter-total,141,11,25,14,8,6,9,8,4,78,14,318,155,166,FALSE,0.522012578616352,2020,2020-2021
OK,2020-08-31,inter-ucfe,0,0,0,0,0,0,0,0,0,1,0,1,0,0,FALSE,0,2020,2020-2021
OK,2020-08-31,inter-ucx,0,0,0,0,0,0,0,0,0,0,0,0,0,0,FALSE,0,2020,2020-2021
OK,2020-08-31,inter-ui,141,11,25,14,8,6,9,8,4,77,14,317,155,166,FALSE,0.523659305993691,2020,2020-2021
OK,2020-08-31,intra-total,4362,352,428,543,422,272,190,153,127,2188,600,9637,4962,5314,FALSE,0.551416415897063,2020,2020-2021
OK,2020-08-31,intra-ucfe,3,2,1,0,0,0,0,1,1,13,0,21,3,5,FALSE,0.238095238095238,2020,2020-2021
OK,2020-08-31,intra-ucx,14,2,1,1,0,1,1,0,2,5,5,32,19,21,FALSE,0.65625,2020,2020-2021
OK,2020-08-31,intra-ui,4345,348,426,542,422,271,189,152,124,2170,595,9584,4940,5288,FALSE,0.551752921535893,2020,2020-2021
OK,2020-09-30,inter-total,53,5,4,7,2,6,9,7,7,91,16,207,69,74,FALSE,0.357487922705314,2020,2020-2021
OK,2020-09-30,inter-ucfe,0,0,0,0,0,0,0,0,0,0,0,0,0,0,FALSE,0,2020,2020-2021
OK,2020-09-30,inter-ucx,0,0,0,0,0,0,0,0,0,1,0,1,0,0,FALSE,0,2020,2020-2021
OK,2020-09-30,inter-ui,53,5,4,7,2,6,9,7,7,90,16,206,69,74,FALSE,0.359223300970874,2020,2020-2021
OK,2020-09-30,intra-total,2569,200,140,124,183,301,369,209,143,1796,379,6413,2948,3148,FALSE,0.490877904256978,2020,2020-2021
OK,2020-09-30,intra-ucfe,4,1,0,1,0,0,1,1,0,8,0,16,4,5,FALSE,0.3125,2020,2020-2021
OK,2020-09-30,intra-ucx,10,1,0,0,1,0,2,0,0,2,2,18,12,13,FALSE,0.722222222222222,2020,2020-2021
OK,2020-09-30,intra-ui,2555,198,140,123,182,301,366,208,143,1786,377,6379,2932,3130,FALSE,0.490672519203637,2020,2020-2021
OK,2020-10-31,inter-total,110,7,7,5,2,0,0,0,0,8,15,154,125,132,FALSE,0.857142857142857,2020,2020-2021
OK,2020-10-31,inter-ucfe,0,0,0,0,0,0,0,0,0,0,0,0,0,0,FALSE,0,2020,2020-2021
OK,2020-10-31,inter-ucx,0,0,0,0,0,0,0,0,0,0,0,0,0,0,FALSE,0,2020,2020-2021
OK,2020-10-31,inter-ui,110,7,7,5,2,0,0,0,0,8,15,154,125,132,FALSE,0.857142857142857,2020,2020-2021
OK,2020-10-31,intra-total,2356,122,106,101,79,86,196,325,290,1511,294,5466,2650,2772,FALSE,0.507135016465423,2020,2020-2021
OK,2020-10-31,intra-ucfe,3,0,0,0,0,1,1,2,0,2,1,10,4,4,FALSE,0.4,2020,2020-2021
OK,2020-10-31,intra-ucx,4,1,0,0,0,0,0,0,0,3,4,12,8,9,FALSE,0.75,2020,2020-2021
OK,2020-10-31,intra-ui,2349,121,106,101,79,85,195,323,290,1506,289,5444,2638,2759,FALSE,0.506796473181484,2020,2020-2021
OK,2020-11-30,inter-total,102,5,8,6,5,5,9,6,5,75,11,237,113,118,FALSE,0.49789029535865,2020,2020-2021
OK,2020-11-30,inter-ucfe,0,0,0,0,0,0,0,0,0,1,0,1,0,0,FALSE,0,2020,2020-2021
OK,2020-11-30,inter-ucx,0,0,0,0,0,0,0,0,0,0,0,0,0,0,FALSE,0,2020,2020-2021
OK,2020-11-30,inter-ui,102,5,8,6,5,5,9,6,5,74,11,236,113,118,FALSE,0.5,2020,2020-2021
OK,2020-11-30,intra-total,2713,133,101,89,61,60,54,39,161,1564,296,5271,3009,3142,FALSE,0.596091823183457,2020,2020-2021
OK,2020-11-30,intra-ucfe,0,0,0,1,1,0,0,0,0,2,1,5,1,1,FALSE,0.2,2020,2020-2021
OK,2020-11-30,intra-ucx,1,1,0,0,0,0,0,0,0,5,0,7,1,2,FALSE,0.285714285714286,2020,2020-2021
OK,2020-11-30,intra-ui,2712,132,101,88,60,60,54,39,161,1557,295,5259,3007,3139,FALSE,0.596881536413767,2020,2020-2021
OK,2020-12-31,inter-total,101,10,4,4,3,3,4,3,6,92,16,246,117,127,FALSE,0.516260162601626,2020,2020-2021
OK,2020-12-31,inter-ucfe,2,0,0,0,0,0,0,0,0,2,0,4,2,2,FALSE,0.5,2020,2020-2021
OK,2020-12-31,inter-ucx,0,0,1,0,0,0,0,0,0,0,0,1,0,0,FALSE,0,2020,2020-2021
OK,2020-12-31,inter-ui,99,10,3,4,3,3,4,3,6,90,16,241,115,125,FALSE,0.518672199170125,2020,2020-2021
OK,2020-12-31,intra-total,2230,133,84,92,54,65,62,55,48,1856,285,4964,2515,2648,FALSE,0.533440773569702,2020,2020-2021
OK,2020-12-31,intra-ucfe,7,1,7,1,1,0,1,1,1,8,5,33,12,13,FALSE,0.393939393939394,2020,2020-2021
OK,2020-12-31,intra-ucx,0,3,1,2,1,0,0,0,1,3,1,12,1,4,FALSE,0.333333333333333,2020,2020-2021
OK,2020-12-31,intra-ui,2223,129,76,89,52,65,61,54,46,1845,279,4919,2502,2631,FALSE,0.534864809920716,2020,2020-2021
OK,2021-01-31,inter-total,121,6,3,6,4,2,3,4,3,99,10,261,131,137,FALSE,0.524904214559387,2020,2020-2021
OK,2021-01-31,inter-ucfe,1,0,0,0,0,0,0,0,0,0,0,1,1,1,FALSE,1,2020,2020-2021
OK,2021-01-31,inter-ucx,0,0,0,0,0,0,0,0,0,1,0,1,0,0,FALSE,0,2020,2020-2021
OK,2021-01-31,inter-ui,120,6,3,6,4,2,3,4,3,98,10,259,130,136,FALSE,0.525096525096525,2020,2020-2021
OK,2021-01-31,intra-total,2997,115,82,65,66,66,64,67,124,2570,299,6515,3296,3411,FALSE,0.523561013046815,2020,2020-2021
OK,2021-01-31,intra-ucfe,7,1,2,0,2,0,2,1,1,10,3,29,10,11,FALSE,0.379310344827586,2020,2020-2021
OK,2021-01-31,intra-ucx,7,0,0,0,0,2,2,0,0,8,1,20,8,8,FALSE,0.4,2020,2020-2021
OK,2021-01-31,intra-ui,2983,114,80,65,64,64,60,66,123,2552,295,6466,3278,3392,FALSE,0.524590163934426,2020,2020-2021
OK,2021-02-28,inter-total,174,6,6,14,17,17,18,8,6,37,25,328,199,205,FALSE,0.625,2020,2020-2021
OK,2021-02-28,inter-ucfe,0,2,0,0,0,0,0,0,0,0,0,2,0,2,FALSE,1,2020,2020-2021
OK,2021-02-28,inter-ucx,0,0,0,0,1,1,0,0,0,0,0,2,0,0,FALSE,0,2020,2020-2021
OK,2021-02-28,inter-ui,174,4,6,14,16,16,18,8,6,37,25,324,199,203,FALSE,0.626543209876543,2020,2020-2021
OK,2021-02-28,intra-total,4797,226,209,611,780,424,318,187,219,1157,502,9430,5299,5525,FALSE,0.585896076352068,2020,2020-2021
OK,2021-02-28,intra-ucfe,6,0,0,5,1,0,2,4,0,21,0,39,6,6,FALSE,0.153846153846154,2020,2020-2021
OK,2021-02-28,intra-ucx,1,1,0,0,2,0,0,0,1,6,1,12,2,3,FALSE,0.25,2020,2020-2021
OK,2021-02-28,intra-ui,4790,225,209,606,777,424,316,183,218,1130,501,9379,5291,5516,FALSE,0.58812240110886,2020,2020-2021
OK,2021-03-31,inter-total,133,10,24,1,10,8,10,10,4,56,32,298,165,175,FALSE,0.587248322147651,2020,2020-2021
OK,2021-03-31,inter-ucfe,0,0,0,0,0,0,0,0,0,1,0,1,0,0,FALSE,0,2020,2020-2021
OK,2021-03-31,inter-ucx,2,0,0,0,0,0,0,0,0,0,0,2,2,2,FALSE,1,2020,2020-2021
OK,2021-03-31,inter-ui,131,10,24,1,10,8,10,10,4,55,32,295,163,173,FALSE,0.586440677966102,2020,2020-2021
OK,2021-03-31,intra-total,9113,796,860,690,481,398,315,187,167,1290,1387,15684,10500,11296,FALSE,0.720224432542719,2020,2020-2021
OK,2021-03-31,intra-ucfe,6,0,2,0,4,0,2,2,1,22,0,39,6,6,FALSE,0.153846153846154,2020,2020-2021
OK,2021-03-31,intra-ucx,5,4,4,2,0,0,1,1,0,4,0,21,5,9,FALSE,0.428571428571429,2020,2020-2021
OK,2021-03-31,intra-ui,9102,792,854,688,477,398,312,184,166,1264,1387,15624,10489,11281,FALSE,0.722030209933436,2020,2020-2021
OK,2021-04-30,inter-total,198,7,4,3,5,4,4,0,6,54,19,304,217,224,FALSE,0.736842105263158,2020,2020-2021
OK,2021-04-30,inter-ucfe,0,0,0,0,0,0,0,0,0,1,0,1,0,0,FALSE,0,2020,2020-2021
OK,2021-04-30,inter-ucx,0,0,0,0,0,0,0,0,0,0,0,0,0,0,FALSE,0,2020,2020-2021
OK,2021-04-30,inter-ui,198,7,4,3,5,4,4,0,6,53,19,303,217,224,FALSE,0.739273927392739,2020,2020-2021
OK,2021-04-30,intra-total,16852,600,278,195,132,111,99,84,78,1155,1777,21361,18629,19229,FALSE,0.900191938579655,2020,2020-2021
OK,2021-04-30,intra-ucfe,18,2,4,0,0,0,2,2,0,12,0,40,18,20,FALSE,0.5,2020,2020-2021
OK,2021-04-30,intra-ucx,15,0,0,0,0,2,0,0,0,0,1,18,16,16,FALSE,0.888888888888889,2020,2020-2021
OK,2021-04-30,intra-ui,16819,598,274,195,132,109,97,82,78,1143,1776,21303,18595,19193,FALSE,0.90095291742947,2020,2020-2021
OK,2021-05-31,inter-total,657,12,10,9,5,3,7,8,2,55,35,803,692,704,FALSE,0.876712328767123,2020,2020-2021
OK,2021-05-31,inter-ucfe,0,1,1,0,0,0,0,0,0,0,0,2,0,1,FALSE,0.5,2020,2020-2021
OK,2021-05-31,inter-ucx,0,0,0,0,0,0,0,0,0,0,0,0,0,0,FALSE,0,2020,2020-2021
OK,2021-05-31,inter-ui,657,11,9,9,5,3,7,8,2,55,35,801,692,703,FALSE,0.877652933832709,2020,2020-2021
OK,2021-05-31,intra-total,13370,786,491,341,264,121,106,92,71,1044,1661,18347,15031,15817,FALSE,0.862102796097455,2020,2020-2021
OK,2021-05-31,intra-ucfe,8,4,8,12,18,0,2,0,2,13,0,67,8,12,FALSE,0.17910447761194,2020,2020-2021
OK,2021-05-31,intra-ucx,7,0,0,3,1,2,0,0,2,8,2,25,9,9,FALSE,0.36,2020,2020-2021
OK,2021-05-31,intra-ui,13355,782,483,326,245,119,104,92,67,1023,1659,18255,15014,15796,FALSE,0.865297178855108,2020,2020-2021
OK,2021-06-30,inter-total,119,16,11,6,2,8,4,1,2,44,48,261,167,183,FALSE,0.701149425287356,2020,2020-2021
OK,2021-06-30,inter-ucfe,2,0,0,0,0,0,0,0,0,4,0,6,2,2,FALSE,0.333333333333333,2020,2020-2021
OK,2021-06-30,inter-ucx,0,0,0,0,0,0,0,0,0,0,0,0,0,0,FALSE,0,2020,2020-2021
OK,2021-06-30,inter-ui,117,16,11,6,2,8,4,1,2,40,48,255,165,181,FALSE,0.709803921568628,2020,2020-2021
OK,2021-06-30,intra-total,9340,661,364,240,227,230,210,195,112,1197,1236,14012,10576,11237,FALSE,0.801955466742792,2020,2020-2021
OK,2021-06-30,intra-ucfe,8,5,3,2,3,3,6,4,0,21,8,63,16,21,FALSE,0.333333333333333,2020,2020-2021
OK,2021-06-30,intra-ucx,10,2,0,2,0,0,0,0,0,2,1,17,11,13,FALSE,0.764705882352941,2020,2020-2021
OK,2021-06-30,intra-ui,9322,654,361,236,224,227,204,191,112,1174,1227,13932,10549,11203,FALSE,0.804120011484353,2020,2020-2021
OK,2021-07-31,inter-total,43,9,12,7,4,4,8,3,3,39,21,153,64,73,FALSE,0.477124183006536,2021,2021-2022
OK,2021-07-31,inter-ucfe,0,0,0,0,0,0,0,0,0,0,0,0,0,0,FALSE,0,2021,2021-2022
OK,2021-07-31,inter-ucx,0,0,0,0,0,0,0,0,0,0,0,0,0,0,FALSE,0,2021,2021-2022
OK,2021-07-31,inter-ui,43,9,12,7,4,4,8,3,3,39,21,153,64,73,FALSE,0.477124183006536,2021,2021-2022
OK,2021-07-31,intra-total,2236,400,252,182,139,82,108,69,74,993,615,5150,2851,3251,FALSE,0.63126213592233,2021,2021-2022
OK,2021-07-31,intra-ucfe,5,1,4,6,5,4,2,0,0,16,3,46,8,9,FALSE,0.195652173913043,2021,2021-2022
OK,2021-07-31,intra-ucx,6,2,0,0,4,0,0,0,0,3,2,17,8,10,FALSE,0.588235294117647,2021,2021-2022
OK,2021-07-31,intra-ui,2225,397,248,176,130,78,106,69,74,974,610,5087,2835,3232,FALSE,0.635344997051307,2021,2021-2022
OK,2021-08-31,inter-total,36,4,7,7,1,2,3,4,2,44,10,120,46,50,FALSE,0.416666666666667,2021,2021-2022
OK,2021-08-31,inter-ucfe,0,0,0,0,0,0,0,0,0,0,0,0,0,0,FALSE,0,2021,2021-2022
OK,2021-08-31,inter-ucx,0,0,0,0,0,0,0,0,0,0,0,0,0,0,FALSE,0,2021,2021-2022
OK,2021-08-31,inter-ui,36,4,7,7,1,2,3,4,2,44,10,120,46,50,FALSE,0.416666666666667,2021,2021-2022
OK,2021-08-31,intra-total,1566,241,201,126,114,121,94,53,87,1004,365,3972,1931,2172,FALSE,0.546827794561934,2021,2021-2022
OK,2021-08-31,intra-ucfe,0,3,0,1,2,2,0,0,6,11,1,26,1,4,FALSE,0.153846153846154,2021,2021-2022
OK,2021-08-31,intra-ucx,5,2,1,1,0,0,3,0,0,2,2,16,7,9,FALSE,0.5625,2021,2021-2022
OK,2021-08-31,intra-ui,1561,236,200,124,112,119,91,53,81,991,362,3930,1923,2159,FALSE,0.549363867684478,2021,2021-2022
OK,2021-09-30,inter-total,12,6,5,3,4,3,3,1,1,32,5,75,17,23,FALSE,0.306666666666667,2021,2021-2022
OK,2021-09-30,inter-ucfe,0,0,0,0,0,0,0,0,0,4,0,4,0,0,FALSE,0,2021,2021-2022
OK,2021-09-30,inter-ucx,0,0,0,0,0,0,0,0,0,0,0,0,0,0,FALSE,0,2021,2021-2022
OK,2021-09-30,inter-ui,12,6,5,3,4,3,3,1,1,28,5,71,17,23,FALSE,0.323943661971831,2021,2021-2022
OK,2021-09-30,intra-total,841,166,96,71,55,40,52,46,61,694,305,2427,1146,1312,FALSE,0.540585084466419,2021,2021-2022
OK,2021-09-30,intra-ucfe,2,0,6,1,0,0,2,0,0,8,2,21,4,4,FALSE,0.19047619047619,2021,2021-2022
OK,2021-09-30,intra-ucx,3,1,1,2,0,2,0,0,2,4,4,19,7,8,FALSE,0.421052631578947,2021,2021-2022
OK,2021-09-30,intra-ui,836,165,89,68,55,38,50,46,59,682,299,2387,1135,1300,FALSE,0.544616673648932,2021,2021-2022
OK,2021-10-31,inter-total,27,6,2,1,3,4,2,3,0,20,12,80,39,45,FALSE,0.5625,2021,2021-2022
OK,2021-10-31,inter-ucfe,0,1,0,0,0,0,0,0,0,0,0,1,0,1,FALSE,1,2021,2021-2022
OK,2021-10-31,inter-ucx,0,0,0,0,0,0,0,0,0,0,0,0,0,0,FALSE,0,2021,2021-2022
OK,2021-10-31,inter-ui,27,5,2,1,3,4,2,3,0,20,12,79,39,44,FALSE,0.556962025316456,2021,2021-2022
OK,2021-10-31,intra-total,880,193,113,79,51,34,31,27,16,602,438,2464,1318,1511,FALSE,0.61323051948052,2021,2021-2022
OK,2021-10-31,intra-ucfe,1,1,2,1,2,0,1,0,0,3,0,11,1,2,FALSE,0.181818181818182,2021,2021-2022
OK,2021-10-31,intra-ucx,6,0,1,0,0,0,0,0,0,5,0,12,6,6,FALSE,0.5,2021,2021-2022
OK,2021-10-31,intra-ui,873,192,110,78,49,34,30,27,16,594,438,2441,1311,1503,FALSE,0.615731257681278,2021,2021-2022
OK,2021-11-30,inter-total,43,10,4,3,3,1,1,2,2,45,11,125,54,64,FALSE,0.512,2021,2021-2022
OK,2021-11-30,inter-ucfe,0,0,0,0,0,0,0,0,0,0,0,0,0,0,FALSE,0,2021,2021-2022
OK,2021-11-30,inter-ucx,0,0,0,0,0,0,0,0,1,0,1,2,1,1,FALSE,0.5,2021,2021-2022
OK,2021-11-30,inter-ui,43,10,4,3,3,1,1,2,1,45,10,123,53,63,FALSE,0.51219512195122,2021,2021-2022
OK,2021-11-30,intra-total,806,257,134,71,39,33,20,23,19,1589,558,3549,1364,1621,FALSE,0.456748379825303,2021,2021-2022
OK,2021-11-30,intra-ucfe,2,4,3,1,0,0,0,0,0,8,2,20,4,8,FALSE,0.4,2021,2021-2022
OK,2021-11-30,intra-ucx,6,1,2,0,0,0,1,0,0,1,1,12,7,8,FALSE,0.666666666666667,2021,2021-2022
OK,2021-11-30,intra-ui,798,252,129,70,39,33,19,23,19,1580,555,3517,1353,1605,FALSE,0.456354847881717,2021,2021-2022
OK,2021-12-31,inter-total,63,6,3,4,1,0,2,1,1,20,13,114,76,82,FALSE,0.719298245614035,2021,2021-2022
OK,2021-12-31,inter-ucfe,0,0,0,0,0,0,0,0,0,1,1,2,1,1,FALSE,0.5,2021,2021-2022
OK,2021-12-31,inter-ucx,1,0,0,0,0,0,0,0,0,0,0,1,1,1,FALSE,1,2021,2021-2022
OK,2021-12-31,inter-ui,62,6,3,4,1,0,2,1,1,19,12,111,74,80,FALSE,0.720720720720721,2021,2021-2022
OK,2021-12-31,intra-total,1440,136,90,65,37,28,19,17,15,386,350,2583,1790,1926,FALSE,0.745644599303136,2021,2021-2022
OK,2021-12-31,intra-ucfe,0,4,3,0,1,0,0,0,0,3,3,14,3,7,FALSE,0.5,2021,2021-2022
OK,2021-12-31,intra-ucx,8,1,0,0,0,0,0,0,0,4,0,13,8,9,FALSE,0.692307692307692,2021,2021-2022
OK,2021-12-31,intra-ui,1432,131,87,65,36,28,19,17,15,379,347,2556,1779,1910,FALSE,0.747261345852895,2021,2021-2022
OK,2022-01-31,inter-total,76,4,1,5,3,1,1,0,2,9,7,109,83,87,FALSE,0.798165137614679,2021,2021-2022
OK,2022-01-31,inter-ucfe,0,0,0,0,0,0,0,0,0,0,0,0,0,0,FALSE,0,2021,2021-2022
OK,2022-01-31,inter-ucx,0,0,0,0,0,0,0,0,0,0,0,0,0,0,FALSE,0,2021,2021-2022
OK,2022-01-31,inter-ui,76,4,1,5,3,1,1,0,2,9,7,109,83,87,FALSE,0.798165137614679,2021,2021-2022
OK,2022-01-31,intra-total,1709,139,68,48,34,28,26,21,11,268,400,2752,2109,2248,FALSE,0.816860465116279,2021,2021-2022
OK,2022-01-31,intra-ucfe,4,4,2,1,0,0,0,1,1,6,1,20,5,9,FALSE,0.45,2021,2021-2022
OK,2022-01-31,intra-ucx,7,2,0,1,1,0,1,0,0,0,2,14,9,11,FALSE,0.785714285714286,2021,2021-2022
OK,2022-01-31,intra-ui,1698,133,66,46,33,28,25,20,10,262,397,2718,2095,2228,FALSE,0.81972038263429,2021,2021-2022
OK,2022-02-28,inter-total,46,10,2,1,1,1,1,1,1,12,10,86,56,66,FALSE,0.767441860465116,2021,2021-2022
OK,2022-02-28,inter-ucfe,1,0,0,0,0,0,0,0,0,3,1,5,2,2,FALSE,0.4,2021,2021-2022
OK,2022-02-28,inter-ucx,0,0,0,0,0,0,0,0,0,0,0,0,0,0,FALSE,0,2021,2021-2022
OK,2022-02-28,inter-ui,45,10,2,1,1,1,1,1,1,9,9,81,54,64,FALSE,0.790123456790123,2021,2021-2022
OK,2022-02-28,intra-total,1230,107,67,26,24,21,16,8,12,213,284,2008,1514,1621,FALSE,0.807270916334661,2021,2021-2022
OK,2022-02-28,intra-ucfe,2,1,0,0,0,1,0,0,0,4,1,9,3,4,FALSE,0.444444444444444,2021,2021-2022
OK,2022-02-28,intra-ucx,4,1,0,0,0,0,0,0,0,1,3,9,7,8,FALSE,0.888888888888889,2021,2021-2022
OK,2022-02-28,intra-ui,1224,105,67,26,24,20,16,8,12,208,280,1990,1504,1609,FALSE,0.808542713567839,2021,2021-2022
OK,2022-03-31,inter-total,30,3,2,1,2,3,2,3,1,11,5,63,35,38,FALSE,0.603174603174603,2021,2021-2022
OK,2022-03-31,inter-ucfe,0,0,0,0,0,0,0,0,0,0,0,0,0,0,FALSE,0,2021,2021-2022
OK,2022-03-31,inter-ucx,0,0,0,0,0,0,0,0,0,0,0,0,0,0,FALSE,0,2021,2021-2022
OK,2022-03-31,inter-ui,30,3,2,1,2,3,2,3,1,11,5,63,35,38,FALSE,0.603174603174603,2021,2021-2022
OK,2022-03-31,intra-total,1171,92,68,34,26,22,13,21,5,238,324,2014,1495,1587,FALSE,0.78798411122145,2021,2021-2022
OK,2022-03-31,intra-ucfe,3,0,1,0,0,0,1,1,0,0,3,9,6,6,FALSE,0.666666666666667,2021,2021-2022
OK,2022-03-31,intra-ucx,9,0,1,0,0,0,0,0,0,0,0,10,9,9,FALSE,0.9,2021,2021-2022
OK,2022-03-31,intra-ui,1159,92,66,34,26,22,12,20,5,238,321,1995,1480,1572,FALSE,0.78796992481203,2021,2021-2022
OK,2022-04-30,inter-total,34,4,1,3,0,1,2,0,0,7,6,58,40,44,FALSE,0.758620689655172,2021,2021-2022
OK,2022-04-30,inter-ucfe,1,0,0,0,0,0,0,0,0,0,0,1,1,1,FALSE,1,2021,2021-2022
OK,2022-04-30,inter-ucx,0,0,0,0,0,0,0,0,0,0,0,0,0,0,FALSE,0,2021,2021-2022
OK,2022-04-30,inter-ui,33,4,1,3,0,1,2,0,0,7,6,57,39,43,FALSE,0.754385964912281,2021,2021-2022
OK,2022-04-30,intra-total,1198,103,61,31,24,21,9,12,5,194,320,1978,1518,1621,FALSE,0.819514661274014,2021,2021-2022
OK,2022-04-30,intra-ucfe,4,0,1,0,0,1,0,0,0,2,1,9,5,5,FALSE,0.555555555555556,2021,2021-2022
OK,2022-04-30,intra-ucx,4,2,0,0,1,0,0,0,1,0,0,8,4,6,FALSE,0.75,2021,2021-2022
OK,2022-04-30,intra-ui,1190,101,60,31,23,20,9,12,4,192,319,1961,1509,1610,FALSE,0.821009688934217,2021,2021-2022
OK,2022-05-31,inter-total,47,2,2,1,1,1,3,0,0,9,9,75,56,58,FALSE,0.773333333333333,2021,2021-2022
OK,2022-05-31,inter-ucfe,0,0,0,0,0,0,0,0,0,0,0,0,0,0,FALSE,0,2021,2021-2022
OK,2022-05-31,inter-ucx,0,0,0,0,0,0,0,0,0,0,0,0,0,0,FALSE,0,2021,2021-2022
OK,2022-05-31,inter-ui,47,2,2,1,1,1,3,0,0,9,9,75,56,58,FALSE,0.773333333333333,2021,2021-2022
OK,2022-05-31,intra-total,1704,131,65,55,40,21,10,9,7,164,345,2551,2049,2180,FALSE,0.854566836534692,2021,2021-2022
OK,2022-05-31,intra-ucfe,3,0,0,0,0,0,0,0,0,3,0,6,3,3,FALSE,0.5,2021,2021-2022
OK,2022-05-31,intra-ucx,6,0,0,0,0,0,0,0,0,2,1,9,7,7,FALSE,0.777777777777778,2021,2021-2022
OK,2022-05-31,intra-ui,1695,131,65,55,40,21,10,9,7,159,344,2536,2039,2170,FALSE,0.855678233438486,2021,2021-2022
OK,2022-06-30,inter-total,60,5,0,2,1,0,2,3,1,12,8,94,68,73,FALSE,0.776595744680851,2021,2021-2022
OK,2022-06-30,inter-ucfe,0,0,0,0,0,0,0,0,0,1,0,1,0,0,FALSE,0,2021,2021-2022
OK,2022-06-30,inter-ucx,0,0,0,0,0,0,0,0,0,0,0,0,0,0,FALSE,0,2021,2021-2022
OK,2022-06-30,inter-ui,60,5,0,2,1,0,2,3,1,11,8,93,68,73,FALSE,0.78494623655914,2021,2021-2022
OK,2022-06-30,intra-total,2019,151,77,52,39,27,21,14,6,162,413,2981,2432,2583,FALSE,0.866487755786649,2021,2021-2022
OK,2022-06-30,intra-ucfe,7,2,0,1,0,0,0,0,0,1,3,14,10,12,FALSE,0.857142857142857,2021,2021-2022
OK,2022-06-30,intra-ucx,3,1,0,0,0,0,0,0,0,1,3,8,6,7,FALSE,0.875,2021,2021-2022
OK,2022-06-30,intra-ui,2009,148,77,51,39,27,21,14,6,160,407,2959,2416,2564,FALSE,0.866508955728287,2021,2021-2022
OK,2022-07-31,inter-total,92,1,2,2,3,0,1,0,1,7,9,118,101,102,FALSE,0.864406779661017,2022,2022-2023
OK,2022-07-31,inter-ucfe,1,0,1,0,0,0,0,0,0,0,0,2,1,1,FALSE,0.5,2022,2022-2023
OK,2022-07-31,inter-ucx,0,0,0,0,0,0,0,0,0,0,1,1,1,1,FALSE,1,2022,2022-2023
OK,2022-07-31,inter-ui,91,1,1,2,3,0,1,0,1,7,8,115,99,100,FALSE,0.869565217391304,2022,2022-2023
OK,2022-07-31,intra-total,2062,112,87,43,38,22,13,7,8,171,369,2932,2431,2543,FALSE,0.867326057298772,2022,2022-2023
OK,2022-07-31,intra-ucfe,1,2,2,2,2,0,3,0,0,1,2,15,3,5,FALSE,0.333333333333333,2022,2022-2023
OK,2022-07-31,intra-ucx,6,0,0,0,0,0,0,0,0,2,1,9,7,7,FALSE,0.777777777777778,2022,2022-2023
OK,2022-07-31,intra-ui,2055,110,85,41,36,22,10,7,8,168,366,2908,2421,2531,FALSE,0.870357634112792,2022,2022-2023
OK,2022-08-31,inter-total,107,4,7,3,1,1,2,1,0,13,12,151,119,123,FALSE,0.814569536423841,2022,2022-2023
OK,2022-08-31,inter-ucfe,0,0,0,0,0,0,0,0,0,0,0,0,0,0,FALSE,0,2022,2022-2023
OK,2022-08-31,inter-ucx,0,0,0,0,0,0,0,0,0,0,0,0,0,0,FALSE,0,2022,2022-2023
OK,2022-08-31,inter-ui,107,4,7,3,1,1,2,1,0,13,12,151,119,123,FALSE,0.814569536423841,2022,2022-2023
OK,2022-08-31,intra-total,2396,141,84,63,40,27,15,13,8,160,401,3348,2797,2938,FALSE,0.877538829151732,2022,2022-2023
OK,2022-08-31,intra-ucfe,7,0,2,0,0,1,0,0,0,1,0,11,7,7,FALSE,0.636363636363636,2022,2022-2023
OK,2022-08-31,intra-ucx,4,0,0,0,1,2,0,2,0,0,1,10,5,5,FALSE,0.5,2022,2022-2023
OK,2022-08-31,intra-ui,2385,141,82,63,39,24,15,11,8,159,400,3327,2785,2926,FALSE,0.879470994890292,2022,2022-2023
OK,2022-09-30,inter-total,99,4,5,2,0,1,1,1,3,4,6,126,105,109,FALSE,0.865079365079365,2022,2022-2023
OK,2022-09-30,inter-ucfe,0,0,0,0,0,0,0,0,0,0,1,1,1,1,FALSE,1,2022,2022-2023
OK,2022-09-30,inter-ucx,0,0,0,0,0,0,0,0,0,0,0,0,0,0,FALSE,0,2022,2022-2023
OK,2022-09-30,inter-ui,99,4,5,2,0,1,1,1,3,4,5,125,104,108,FALSE,0.864,2022,2022-2023
OK,2022-09-30,intra-total,1441,119,70,41,28,30,10,17,14,141,302,2213,1743,1862,FALSE,0.84139177586986,2022,2022-2023
OK,2022-09-30,intra-ucfe,5,1,0,1,1,0,1,0,1,2,1,13,6,7,FALSE,0.538461538461538,2022,2022-2023
OK,2022-09-30,intra-ucx,6,0,0,1,2,0,0,1,1,5,3,19,9,9,FALSE,0.473684210526316,2022,2022-2023
OK,2022-09-30,intra-ui,1430,118,70,39,25,30,9,16,12,134,298,2181,1728,1846,FALSE,0.846400733608436,2022,2022-2023
OK,2022-10-31,inter-total,357,2,2,1,0,1,0,1,0,9,9,382,366,368,FALSE,0.963350785340314,2022,2022-2023
OK,2022-10-31,inter-ucfe,0,0,0,0,0,0,0,0,0,0,0,0,0,0,FALSE,0,2022,2022-2023
OK,2022-10-31,inter-ucx,0,0,0,0,0,0,0,0,0,0,0,0,0,0,FALSE,0,2022,2022-2023
OK,2022-10-31,inter-ui,357,2,2,1,0,1,0,1,0,9,9,382,366,368,FALSE,0.963350785340314,2022,2022-2023
OK,2022-10-31,intra-total,1200,66,51,29,12,14,18,9,10,185,290,1884,1490,1556,FALSE,0.825902335456476,2022,2022-2023
OK,2022-10-31,intra-ucfe,3,2,0,0,0,0,1,0,1,2,2,11,5,7,FALSE,0.636363636363636,2022,2022-2023
OK,2022-10-31,intra-ucx,6,1,1,0,0,0,0,0,0,0,3,11,9,10,FALSE,0.909090909090909,2022,2022-2023
OK,2022-10-31,intra-ui,1191,63,50,29,12,14,17,9,9,183,285,1862,1476,1539,FALSE,0.826530612244898,2022,2022-2023
OK,2022-11-30,inter-total,247,2,1,2,3,2,0,0,0,9,8,274,255,257,FALSE,0.937956204379562,2022,2022-2023
OK,2022-11-30,inter-ucfe,0,0,0,0,0,0,0,0,0,1,0,1,0,0,FALSE,0,2022,2022-2023
OK,2022-11-30,inter-ucx,1,0,0,0,0,0,0,0,0,0,0,1,1,1,FALSE,1,2022,2022-2023
OK,2022-11-30,inter-ui,246,2,1,2,3,2,0,0,0,8,8,272,254,256,FALSE,0.941176470588235,2022,2022-2023
OK,2022-11-30,intra-total,1224,112,50,40,30,14,11,14,8,189,325,2017,1549,1661,FALSE,0.82350024789291,2022,2022-2023
OK,2022-11-30,intra-ucfe,2,0,0,1,0,0,0,0,0,1,1,5,3,3,FALSE,0.6,2022,2022-2023
OK,2022-11-30,intra-ucx,6,1,1,0,0,0,0,0,0,0,1,9,7,8,FALSE,0.888888888888889,2022,2022-2023
OK,2022-11-30,intra-ui,1216,111,49,39,30,14,11,14,8,188,323,2003,1539,1650,FALSE,0.823764353469795,2022,2022-2023
OK,2022-12-31,inter-total,499,5,2,3,2,0,3,1,0,11,10,536,509,514,FALSE,0.958955223880597,2022,2022-2023
OK,2022-12-31,inter-ucfe,0,0,0,0,1,0,0,0,0,0,0,1,0,0,FALSE,0,2022,2022-2023
OK,2022-12-31,inter-ucx,0,0,0,0,0,0,0,0,0,0,0,0,0,0,FALSE,0,2022,2022-2023
OK,2022-12-31,inter-ui,499,5,2,3,1,0,3,1,0,11,10,535,509,514,FALSE,0.960747663551402,2022,2022-2023
OK,2022-12-31,intra-total,1324,89,55,30,21,10,12,9,5,161,335,2051,1659,1748,FALSE,0.852267186738177,2022,2022-2023
OK,2022-12-31,intra-ucfe,2,1,0,0,1,0,0,0,0,1,2,7,4,5,FALSE,0.714285714285714,2022,2022-2023
OK,2022-12-31,intra-ucx,8,0,1,0,1,0,0,0,1,1,0,12,8,8,FALSE,0.666666666666667,2022,2022-2023
OK,2022-12-31,intra-ui,1314,88,54,30,19,10,12,9,4,159,333,2032,1647,1735,FALSE,0.853838582677165,2022,2022-2023
OK,2023-01-31,inter-total,448,5,1,3,2,3,0,1,0,5,19,487,467,472,FALSE,0.969199178644764,2022,2022-2023
OK,2023-01-31,inter-ucfe,0,0,0,0,0,0,0,0,0,0,0,0,0,0,FALSE,0,2022,2022-2023
OK,2023-01-31,inter-ucx,0,0,0,0,0,0,0,0,0,0,0,0,0,0,FALSE,0,2022,2022-2023
OK,2023-01-31,inter-ui,448,5,1,3,2,3,0,1,0,5,19,487,467,472,FALSE,0.969199178644764,2022,2022-2023
OK,2023-01-31,intra-total,1806,111,64,30,34,18,10,8,8,138,377,2604,2183,2294,FALSE,0.880952380952381,2022,2022-2023
OK,2023-01-31,intra-ucfe,7,0,0,1,0,1,0,0,0,1,1,11,8,8,FALSE,0.727272727272727,2022,2022-2023
OK,2023-01-31,intra-ucx,5,0,0,0,0,0,0,0,0,0,2,7,7,7,FALSE,1,2022,2022-2023
OK,2023-01-31,intra-ui,1794,111,64,29,34,17,10,8,8,137,374,2586,2168,2279,FALSE,0.881283836040217,2022,2022-2023
OK,2023-02-28,inter-total,418,1,3,2,1,1,1,0,0,5,12,444,430,431,FALSE,0.970720720720721,2022,2022-2023
OK,2023-02-28,inter-ucfe,1,0,0,0,0,0,0,0,0,0,0,1,1,1,FALSE,1,2022,2022-2023
OK,2023-02-28,inter-ucx,0,0,0,0,0,0,0,0,0,0,0,0,0,0,FALSE,0,2022,2022-2023
OK,2023-02-28,inter-ui,417,1,3,2,1,1,1,0,0,5,12,443,429,430,FALSE,0.970654627539503,2022,2022-2023
OK,2023-02-28,intra-total,1294,100,49,33,24,9,13,5,8,182,315,2032,1609,1709,FALSE,0.841043307086614,2022,2022-2023
OK,2023-02-28,intra-ucfe,0,0,0,0,0,0,1,0,0,1,1,3,1,1,FALSE,0.333333333333333,2022,2022-2023
OK,2023-02-28,intra-ucx,6,1,0,0,0,0,0,0,0,0,0,7,6,7,FALSE,1,2022,2022-2023
OK,2023-02-28,intra-ui,1288,99,49,33,24,9,12,5,8,181,314,2022,1602,1701,FALSE,0.841246290801187,2022,2022-2023
OK,2023-03-31,inter-total,66,2,0,0,4,2,1,2,0,6,2,85,68,70,FALSE,0.823529411764706,2022,2022-2023
OK,2023-03-31,inter-ucfe,0,1,0,0,0,0,0,0,0,0,0,1,0,1,FALSE,1,2022,2022-2023
OK,2023-03-31,inter-ucx,0,0,0,0,0,0,0,0,0,0,0,0,0,0,FALSE,0,2022,2022-2023
OK,2023-03-31,inter-ui,66,1,0,0,4,2,1,2,0,6,2,84,68,69,FALSE,0.821428571428571,2022,2022-2023
OK,2023-03-31,intra-total,825,115,65,51,15,17,12,5,5,171,307,1588,1132,1247,FALSE,0.785264483627204,2022,2022-2023
OK,2023-03-31,intra-ucfe,1,1,0,0,0,0,0,0,0,1,0,3,1,2,FALSE,0.666666666666667,2022,2022-2023
OK,2023-03-31,intra-ucx,5,0,0,1,1,0,0,0,0,0,1,8,6,6,FALSE,0.75,2022,2022-2023
OK,2023-03-31,intra-ui,819,114,65,50,14,17,12,5,5,170,306,1577,1125,1239,FALSE,0.7856689917565,2022,2022-2023
OK,2023-04-30,inter-total,194,1,0,0,1,1,1,1,0,6,4,209,198,199,FALSE,0.952153110047847,2022,2022-2023
OK,2023-04-30,inter-ucfe,0,0,0,0,0,0,0,0,0,0,0,0,0,0,FALSE,0,2022,2022-2023
OK,2023-04-30,inter-ucx,0,0,0,0,0,0,0,0,0,0,1,1,1,1,FALSE,1,2022,2022-2023
OK,2023-04-30,inter-ui,194,1,0,0,1,1,1,1,0,6,3,208,197,198,FALSE,0.951923076923077,2022,2022-2023
OK,2023-04-30,intra-total,956,61,28,19,12,10,14,12,23,187,219,1541,1175,1236,FALSE,0.802076573653472,2022,2022-2023
OK,2023-04-30,intra-ucfe,4,0,0,0,0,0,0,0,1,1,2,8,6,6,FALSE,0.75,2022,2022-2023
OK,2023-04-30,intra-ucx,7,1,0,0,0,0,0,0,0,0,5,13,12,13,FALSE,1,2022,2022-2023
OK,2023-04-30,intra-ui,945,60,28,19,12,10,14,12,22,186,212,1520,1157,1217,FALSE,0.800657894736842,2022,2022-2023
OK,2023-05-31,inter-total,210,1,1,0,1,0,0,0,0,4,4,221,214,215,FALSE,0.972850678733032,2022,2022-2023
OK,2023-05-31,inter-ucfe,0,0,0,0,0,0,0,0,0,0,0,0,0,0,FALSE,0,2022,2022-2023
OK,2023-05-31,inter-ucx,0,0,0,0,0,0,0,0,0,0,0,0,0,0,FALSE,0,2022,2022-2023
OK,2023-05-31,inter-ui,210,1,1,0,1,0,0,0,0,4,4,221,214,215,FALSE,0.972850678733032,2022,2022-2023
OK,2023-05-31,intra-total,1257,98,36,9,22,20,20,23,28,83,291,1887,1548,1646,FALSE,0.872284048754637,2022,2022-2023
OK,2023-05-31,intra-ucfe,0,1,0,0,0,0,1,0,0,1,0,3,0,1,FALSE,0.333333333333333,2022,2022-2023
OK,2023-05-31,intra-ucx,5,0,0,0,0,0,0,0,0,0,0,5,5,5,FALSE,1,2022,2022-2023
OK,2023-05-31,intra-ui,1252,97,36,9,22,20,19,23,28,82,291,1879,1543,1640,FALSE,0.872804683342203,2022,2022-2023
OK,2023-06-30,inter-total,257,2,1,0,0,1,0,1,0,2,6,270,263,265,FALSE,0.981481481481481,2022,2022-2023
OK,2023-06-30,inter-ucfe,1,0,0,0,0,0,0,0,0,0,0,1,1,1,FALSE,1,2022,2022-2023
OK,2023-06-30,inter-ucx,0,0,0,0,0,0,0,0,0,0,0,0,0,0,FALSE,0,2022,2022-2023
OK,2023-06-30,inter-ui,256,2,1,0,0,1,0,1,0,2,6,269,262,264,FALSE,0.981412639405205,2022,2022-2023
OK,2023-06-30,intra-total,1429,96,36,25,16,10,21,27,16,49,312,2037,1741,1837,FALSE,0.901816396661757,2022,2022-2023
OK,2023-06-30,intra-ucfe,2,1,0,0,0,0,0,0,0,0,1,4,3,4,FALSE,1,2022,2022-2023
OK,2023-06-30,intra-ucx,7,0,0,0,0,0,0,0,0,0,0,7,7,7,FALSE,1,2022,2022-2023
OK,2023-06-30,intra-ui,1420,95,36,25,16,10,21,27,16,49,311,2026,1731,1826,FALSE,0.901283316880553,2022,2022-2023
OK,2023-07-31,inter-total,427,3,1,0,0,0,0,0,0,3,6,440,433,436,FALSE,0.990909090909091,2023,2023-2024
OK,2023-07-31,inter-ucfe,1,0,0,0,0,0,0,0,0,0,0,1,1,1,FALSE,1,2023,2023-2024
OK,2023-07-31,inter-ucx,0,0,0,0,0,0,0,0,0,0,0,0,0,0,FALSE,0,2023,2023-2024
OK,2023-07-31,inter-ui,426,3,1,0,0,0,0,0,0,3,6,439,432,435,FALSE,0.990888382687927,2023,2023-2024
OK,2023-07-31,intra-total,1369,75,48,23,16,9,14,11,17,64,284,1930,1653,1728,FALSE,0.895336787564767,2023,2023-2024
OK,2023-07-31,intra-ucfe,1,0,0,0,0,0,0,0,0,0,0,1,1,1,FALSE,1,2023,2023-2024
OK,2023-07-31,intra-ucx,3,0,0,0,0,0,0,0,0,0,0,3,3,3,FALSE,1,2023,2023-2024
OK,2023-07-31,intra-ui,1365,75,48,23,16,9,14,11,17,64,284,1926,1649,1724,FALSE,0.895119418483905,2023,2023-2024
OK,2023-08-31,inter-total,144,2,0,3,0,0,0,1,0,6,6,162,150,152,FALSE,0.938271604938272,2023,2023-2024
OK,2023-08-31,inter-ucfe,1,0,0,0,0,0,0,0,0,0,0,1,1,1,FALSE,1,2023,2023-2024
OK,2023-08-31,inter-ucx,0,0,0,0,0,0,0,0,0,0,0,0,0,0,FALSE,0,2023,2023-2024
OK,2023-08-31,inter-ui,143,2,0,3,0,0,0,1,0,6,6,161,149,151,FALSE,0.937888198757764,2023,2023-2024
OK,2023-08-31,intra-total,1180,119,53,31,18,9,13,19,31,87,287,1847,1467,1586,FALSE,0.858689767190038,2023,2023-2024
OK,2023-08-31,intra-ucfe,1,0,0,0,0,0,0,0,0,0,0,1,1,1,FALSE,1,2023,2023-2024
OK,2023-08-31,intra-ucx,11,0,0,1,0,0,0,0,0,1,1,14,12,12,FALSE,0.857142857142857,2023,2023-2024
OK,2023-08-31,intra-ui,1168,119,53,30,18,9,13,19,31,86,286,1832,1454,1573,FALSE,0.858624454148472,2023,2023-2024
OK,2023-09-30,inter-total,65,4,1,0,1,0,0,0,0,3,2,76,67,71,FALSE,0.93421052631579,2023,2023-2024
OK,2023-09-30,inter-ucfe,0,0,0,0,0,0,0,0,0,0,0,0,0,0,FALSE,0,2023,2023-2024
OK,2023-09-30,inter-ucx,0,0,0,0,0,0,0,0,0,0,0,0,0,0,FALSE,0,2023,2023-2024
OK,2023-09-30,inter-ui,65,4,1,0,1,0,0,0,0,3,2,76,67,71,FALSE,0.93421052631579,2023,2023-2024
OK,2023-09-30,intra-total,895,80,35,20,18,11,16,17,10,37,256,1395,1151,1231,FALSE,0.882437275985663,2023,2023-2024
OK,2023-09-30,intra-ucfe,0,0,1,0,0,0,0,0,0,0,0,1,0,0,FALSE,0,2023,2023-2024
OK,2023-09-30,intra-ucx,4,2,0,0,0,0,0,0,0,0,0,6,4,6,FALSE,1,2023,2023-2024
OK,2023-09-30,intra-ui,891,78,34,20,18,11,16,17,10,37,256,1388,1147,1225,FALSE,0.882564841498559,2023,2023-2024
OK,2023-10-31,inter-total,19,0,0,1,0,1,0,1,2,0,6,30,25,25,FALSE,0.833333333333333,2023,2023-2024
OK,2023-10-31,inter-ucfe,0,0,0,0,0,0,0,0,0,0,0,0,0,0,FALSE,0,2023,2023-2024
OK,2023-10-31,inter-ucx,0,0,0,0,0,0,0,0,0,0,0,0,0,0,FALSE,0,2023,2023-2024
OK,2023-10-31,inter-ui,19,0,0,1,0,1,0,1,2,0,6,30,25,25,FALSE,0.833333333333333,2023,2023-2024
OK,2023-10-31,intra-total,1229,62,28,20,18,15,25,15,14,47,337,1810,1566,1628,FALSE,0.899447513812155,2023,2023-2024
OK,2023-10-31,intra-ucfe,2,0,1,0,0,0,0,1,0,0,3,7,5,5,FALSE,0.714285714285714,2023,2023-2024
OK,2023-10-31,intra-ucx,3,0,0,0,0,0,0,1,0,1,0,5,3,3,FALSE,0.6,2023,2023-2024
OK,2023-10-31,intra-ui,1224,62,27,20,18,15,25,13,14,46,334,1798,1558,1620,FALSE,0.901001112347052,2023,2023-2024
OK,2023-11-30,inter-total,69,3,2,0,0,0,1,0,1,4,4,84,73,76,FALSE,0.904761904761905,2023,2023-2024
OK,2023-11-30,inter-ucfe,0,0,0,0,0,0,0,0,0,0,0,0,0,0,FALSE,0,2023,2023-2024
OK,2023-11-30,inter-ucx,0,0,0,0,0,0,0,0,0,0,0,0,0,0,FALSE,0,2023,2023-2024
OK,2023-11-30,inter-ui,69,3,2,0,0,0,1,0,1,4,4,84,73,76,FALSE,0.904761904761905,2023,2023-2024
OK,2023-11-30,intra-total,1202,102,37,21,12,14,24,15,13,33,363,1836,1565,1667,FALSE,0.907952069716776,2023,2023-2024
OK,2023-11-30,intra-ucfe,2,0,1,0,0,0,0,0,0,2,1,6,3,3,FALSE,0.5,2023,2023-2024
OK,2023-11-30,intra-ucx,4,0,1,0,0,0,0,0,0,0,1,6,5,5,FALSE,0.833333333333333,2023,2023-2024
OK,2023-11-30,intra-ui,1196,102,35,21,12,14,24,15,13,31,361,1824,1557,1659,FALSE,0.90953947368421,2023,2023-2024
OK,2023-12-31,inter-total,33,1,2,1,0,1,1,0,0,3,5,47,38,39,FALSE,0.829787234042553,2023,2023-2024
OK,2023-12-31,inter-ucfe,0,0,0,0,0,0,0,0,0,0,0,0,0,0,FALSE,0,2023,2023-2024
OK,2023-12-31,inter-ucx,0,0,0,0,0,0,0,0,0,0,0,0,0,0,FALSE,0,2023,2023-2024
OK,2023-12-31,inter-ui,33,1,2,1,0,1,1,0,0,3,5,47,38,39,FALSE,0.829787234042553,2023,2023-2024
OK,2023-12-31,intra-total,1292,114,49,31,17,20,28,10,12,36,323,1932,1615,1729,FALSE,0.894927536231884,2023,2023-2024
OK,2023-12-31,intra-ucfe,4,0,0,0,0,0,0,0,1,0,1,6,5,5,FALSE,0.833333333333333,2023,2023-2024
OK,2023-12-31,intra-ucx,7,0,0,0,0,0,0,0,1,0,0,8,7,7,FALSE,0.875,2023,2023-2024
OK,2023-12-31,intra-ui,1281,114,49,31,17,20,28,10,10,36,322,1918,1603,1717,FALSE,0.895203336809176,2023,2023-2024
OK,2024-01-31,inter-total,30,4,1,0,2,1,2,0,1,3,7,51,37,41,FALSE,0.803921568627451,2023,2023-2024
OK,2024-01-31,inter-ucfe,0,0,0,0,0,0,0,0,0,0,0,0,0,0,FALSE,0,2023,2023-2024
OK,2024-01-31,inter-ucx,0,0,0,0,0,0,0,0,0,0,0,0,0,0,FALSE,0,2023,2023-2024
OK,2024-01-31,inter-ui,30,4,1,0,2,1,2,0,1,3,7,51,37,41,FALSE,0.803921568627451,2023,2023-2024
OK,2024-01-31,intra-total,1924,140,49,20,26,19,22,22,18,43,401,2684,2325,2465,FALSE,0.918405365126677,2023,2023-2024
OK,2024-01-31,intra-ucfe,2,1,1,0,0,0,0,0,0,0,0,4,2,3,FALSE,0.75,2023,2023-2024
OK,2024-01-31,intra-ucx,4,0,1,0,0,0,0,0,0,0,1,6,5,5,FALSE,0.833333333333333,2023,2023-2024
OK,2024-01-31,intra-ui,1918,139,47,20,26,19,22,22,18,43,400,2674,2318,2457,FALSE,0.918848167539267,2023,2023-2024
OK,2024-02-29,inter-total,25,2,1,1,0,0,0,0,0,1,6,36,31,33,FALSE,0.916666666666667,2023,2023-2024
OK,2024-02-29,inter-ucfe,1,0,0,0,0,0,0,0,0,0,0,1,1,1,FALSE,1,2023,2023-2024
OK,2024-02-29,inter-ucx,1,0,0,0,0,0,0,0,0,0,0,1,1,1,FALSE,1,2023,2023-2024
OK,2024-02-29,inter-ui,23,2,1,1,0,0,0,0,0,1,6,34,29,31,FALSE,0.911764705882353,2023,2023-2024
OK,2024-02-29,intra-total,1051,103,51,27,19,24,20,20,8,32,325,1680,1376,1479,FALSE,0.880357142857143,2023,2023-2024
OK,2024-02-29,intra-ucfe,2,0,0,0,1,0,0,0,0,0,1,4,3,3,FALSE,0.75,2023,2023-2024
OK,2024-02-29,intra-ucx,3,0,0,2,0,0,0,0,0,0,0,5,3,3,FALSE,0.6,2023,2023-2024
OK,2024-02-29,intra-ui,1046,103,51,25,18,24,20,20,8,32,324,1671,1370,1473,FALSE,0.881508078994614,2023,2023-2024
OK,2024-03-31,inter-total,20,0,0,1,1,2,0,0,0,2,8,34,28,28,FALSE,0.823529411764706,2023,2023-2024
OK,2024-03-31,inter-ucfe,0,0,0,0,0,0,0,0,0,0,1,1,1,1,FALSE,1,2023,2023-2024
OK,2024-03-31,inter-ucx,0,0,0,0,0,0,0,0,0,0,0,0,0,0,FALSE,0,2023,2023-2024
OK,2024-03-31,inter-ui,20,0,0,1,1,2,0,0,0,2,7,33,27,27,FALSE,0.818181818181818,2023,2023-2024
OK,2024-03-31,intra-total,1037,95,38,22,25,29,30,10,8,28,339,1661,1376,1471,FALSE,0.885611077664058,2023,2023-2024
OK,2024-03-31,intra-ucfe,2,1,1,0,1,2,0,0,0,1,1,9,3,4,FALSE,0.444444444444444,2023,2023-2024
OK,2024-03-31,intra-ucx,6,1,0,0,0,0,0,0,0,0,0,7,6,7,FALSE,1,2023,2023-2024
OK,2024-03-31,intra-ui,1029,93,37,22,24,27,30,10,8,27,338,1645,1367,1460,FALSE,0.887537993920973,2023,2023-2024
OK,2024-04-30,inter-total,18,2,0,0,2,0,0,0,0,1,5,28,23,25,FALSE,0.892857142857143,2023,2023-2024
OK,2024-04-30,inter-ucfe,0,0,0,0,0,0,0,0,0,0,0,0,0,0,FALSE,0,2023,2023-2024
OK,2024-04-30,inter-ucx,0,0,0,0,0,0,0,0,0,0,0,0,0,0,FALSE,0,2023,2023-2024
OK,2024-04-30,inter-ui,18,2,0,0,2,0,0,0,0,1,5,28,23,25,FALSE,0.892857142857143,2023,2023-2024
OK,2024-04-30,intra-total,1033,70,37,14,33,31,13,6,3,18,314,1572,1347,1417,FALSE,0.901399491094148,2023,2023-2024
OK,2024-04-30,intra-ucfe,2,1,1,0,0,0,0,0,0,2,0,6,2,3,FALSE,0.5,2023,2023-2024
OK,2024-04-30,intra-ucx,3,0,0,0,0,1,0,0,0,0,1,5,4,4,FALSE,0.8,2023,2023-2024
OK,2024-04-30,intra-ui,1028,69,36,14,33,30,13,6,3,16,313,1561,1341,1410,FALSE,0.903267136450993,2023,2023-2024
OK,2024-05-31,inter-total,26,4,0,1,0,0,0,0,0,2,4,37,30,34,FALSE,0.918918918918919,2023,2023-2024
OK,2024-05-31,inter-ucfe,0,0,0,0,0,0,0,0,0,0,0,0,0,0,FALSE,0,2023,2023-2024
OK,2024-05-31,inter-ucx,0,0,0,0,0,0,0,0,0,0,0,0,0,0,FALSE,0,2023,2023-2024
OK,2024-05-31,inter-ui,26,4,0,1,0,0,0,0,0,2,4,37,30,34,FALSE,0.918918918918919,2023,2023-2024
OK,2024-05-31,intra-total,1203,121,60,37,35,16,19,11,7,18,312,1839,1515,1636,FALSE,0.889613920609027,2023,2023-2024
OK,2024-05-31,intra-ucfe,2,0,0,0,0,0,0,0,0,0,0,2,2,2,FALSE,1,2023,2023-2024
OK,2024-05-31,intra-ucx,5,0,0,1,0,0,0,0,0,0,1,7,6,6,FALSE,0.857142857142857,2023,2023-2024
OK,2024-05-31,intra-ui,1196,121,60,36,35,16,19,11,7,18,311,1830,1507,1628,FALSE,0.889617486338798,2023,2023-2024
OK,2024-06-30,inter-total,24,4,3,0,1,1,0,0,0,3,3,39,27,31,FALSE,0.794871794871795,2023,2023-2024
OK,2024-06-30,inter-ucfe,0,0,1,0,0,0,0,0,0,0,0,1,0,0,FALSE,0,2023,2023-2024
OK,2024-06-30,inter-ucx,0,0,0,0,0,0,0,0,0,0,0,0,0,0,FALSE,0,2023,2023-2024
OK,2024-06-30,inter-ui,24,4,2,0,1,1,0,0,0,3,3,38,27,31,FALSE,0.81578947368421,2023,2023-2024
OK,2024-06-30,intra-total,1865,89,35,21,37,24,17,8,6,25,325,2452,2190,2279,FALSE,0.929445350734095,2023,2023-2024
OK,2024-06-30,intra-ucfe,2,1,1,0,0,0,0,1,0,0,0,5,2,3,FALSE,0.6,2023,2023-2024
OK,2024-06-30,intra-ucx,10,0,1,0,0,0,0,0,0,0,0,11,10,10,FALSE,0.909090909090909,2023,2023-2024
OK,2024-06-30,intra-ui,1853,88,33,21,37,24,17,7,6,25,325,2436,2178,2266,FALSE,0.930213464696223,2023,2023-2024
OK,2024-07-31,inter-total,28,1,2,2,0,0,1,1,1,1,4,41,32,33,FALSE,0.804878048780488,2024,2024-2025
OK,2024-07-31,inter-ucfe,0,0,0,0,0,0,0,0,0,0,0,0,0,0,FALSE,0,2024,2024-2025
OK,2024-07-31,inter-ucx,0,0,0,0,0,0,0,0,0,0,0,0,0,0,FALSE,0,2024,2024-2025
OK,2024-07-31,inter-ui,28,1,2,2,0,0,1,1,1,1,4,41,32,33,FALSE,0.804878048780488,2024,2024-2025
OK,2024-07-31,intra-total,1684,97,32,16,34,26,16,14,6,30,414,2369,2098,2195,FALSE,0.926551287463065,2024,2024-2025
OK,2024-07-31,intra-ucfe,3,1,0,0,0,0,0,1,0,1,1,7,4,5,FALSE,0.714285714285714,2024,2024-2025
OK,2024-07-31,intra-ucx,8,0,0,0,0,0,0,0,0,0,0,8,8,8,FALSE,1,2024,2024-2025
OK,2024-07-31,intra-ui,1673,96,32,16,34,26,16,13,6,29,413,2354,2086,2182,FALSE,0.926932880203908,2024,2024-2025
OK,2024-08-31,inter-total,18,1,1,1,0,0,0,0,0,1,6,28,24,25,FALSE,0.892857142857143,2024,2024-2025
OK,2024-08-31,inter-ucfe,0,0,0,0,0,0,0,0,0,0,0,0,0,0,FALSE,0,2024,2024-2025
OK,2024-08-31,inter-ucx,0,0,0,1,0,0,0,0,0,0,0,1,0,0,FALSE,0,2024,2024-2025
OK,2024-08-31,inter-ui,18,1,1,0,0,0,0,0,0,1,6,27,24,25,FALSE,0.925925925925926,2024,2024-2025
OK,2024-08-31,intra-total,1199,93,37,24,27,35,23,18,5,29,371,1861,1570,1663,FALSE,0.893605588393337,2024,2024-2025
OK,2024-08-31,intra-ucfe,0,1,1,0,0,0,0,0,1,1,1,5,1,2,FALSE,0.4,2024,2024-2025
OK,2024-08-31,intra-ucx,3,0,1,0,0,0,0,0,0,1,1,6,4,4,FALSE,0.666666666666667,2024,2024-2025
OK,2024-08-31,intra-ui,1196,92,35,24,27,35,23,18,4,27,369,1850,1565,1657,FALSE,0.895675675675676,2024,2024-2025
OK,2024-09-30,inter-total,19,0,1,0,0,1,1,0,0,1,7,30,26,26,FALSE,0.866666666666667,2024,2024-2025
OK,2024-09-30,inter-ucfe,0,0,0,0,0,0,0,0,0,0,0,0,0,0,FALSE,0,2024,2024-2025
OK,2024-09-30,inter-ucx,1,0,0,0,0,0,0,0,0,0,0,1,1,1,FALSE,1,2024,2024-2025
OK,2024-09-30,inter-ui,18,0,1,0,0,1,1,0,0,1,7,29,25,25,FALSE,0.862068965517241,2024,2024-2025
OK,2024-09-30,intra-total,1147,64,30,39,32,25,23,19,7,29,306,1721,1453,1517,FALSE,0.881464264962231,2024,2024-2025
OK,2024-09-30,intra-ucfe,0,1,1,0,0,1,0,0,0,1,0,4,0,1,FALSE,0.25,2024,2024-2025
OK,2024-09-30,intra-ucx,7,1,0,1,0,0,1,0,0,0,1,11,8,9,FALSE,0.818181818181818,2024,2024-2025
OK,2024-09-30,intra-ui,1140,62,29,38,32,24,22,19,7,28,305,1706,1445,1507,FALSE,0.883352872215709,2024,2024-2025
OK,2024-10-31,inter-total,15,1,1,1,0,1,1,0,0,0,5,25,20,21,FALSE,0.84,2024,2024-2025
OK,2024-10-31,inter-ucfe,0,0,0,0,0,0,0,0,0,0,1,1,1,1,FALSE,1,2024,2024-2025
OK,2024-10-31,inter-ucx,0,0,0,0,0,0,0,0,0,0,0,0,0,0,FALSE,0,2024,2024-2025
OK,2024-10-31,inter-ui,15,1,1,1,0,1,1,0,0,0,4,24,19,20,FALSE,0.833333333333333,2024,2024-2025
OK,2024-10-31,intra-total,1143,59,23,27,19,23,12,15,5,20,281,1627,1424,1483,FALSE,0.911493546404425,2024,2024-2025
OK,2024-10-31,intra-ucfe,2,0,0,0,0,0,0,0,0,1,1,4,3,3,FALSE,0.75,2024,2024-2025
OK,2024-10-31,intra-ucx,4,0,0,0,0,0,0,0,0,0,0,4,4,4,FALSE,1,2024,2024-2025
OK,2024-10-31,intra-ui,1137,59,23,27,19,23,12,15,5,19,280,1619,1417,1476,FALSE,0.911673872760964,2024,2024-2025
OK,2024-11-30,inter-total,17,1,0,1,0,0,0,1,1,0,8,29,25,26,FALSE,0.896551724137931,2024,2024-2025
OK,2024-11-30,inter-ucfe,1,0,0,0,0,0,0,0,0,0,1,2,2,2,FALSE,1,2024,2024-2025
OK,2024-11-30,inter-ucx,0,0,0,0,0,0,0,0,0,0,0,0,0,0,FALSE,0,2024,2024-2025
OK,2024-11-30,inter-ui,16,1,0,1,0,0,0,1,1,0,7,27,23,24,FALSE,0.888888888888889,2024,2024-2025
OK,2024-11-30,intra-total,1128,58,17,17,22,21,18,6,4,12,294,1597,1422,1480,FALSE,0.926737633061991,2024,2024-2025
OK,2024-11-30,intra-ucfe,1,0,1,0,0,0,0,0,0,1,0,3,1,1,FALSE,0.333333333333333,2024,2024-2025
OK,2024-11-30,intra-ucx,1,0,0,0,0,0,0,0,0,0,2,3,3,3,FALSE,1,2024,2024-2025
OK,2024-11-30,intra-ui,1126,58,16,17,22,21,18,6,4,11,292,1591,1418,1476,FALSE,0.927718416090509,2024,2024-2025
OK,2024-12-31,inter-total,43,2,0,1,0,0,0,0,0,0,7,53,50,52,FALSE,0.981132075471698,2024,2024-2025
OK,2024-12-31,inter-ucfe,0,0,0,0,0,0,0,0,0,0,0,0,0,0,FALSE,0,2024,2024-2025
OK,2024-12-31,inter-ucx,0,0,0,0,0,0,0,0,0,0,0,0,0,0,FALSE,0,2024,2024-2025
OK,2024-12-31,inter-ui,43,2,0,1,0,0,0,0,0,0,7,53,50,52,FALSE,0.981132075471698,2024,2024-2025
OK,2024-12-31,intra-total,1426,108,24,14,26,29,17,18,4,19,377,2062,1803,1911,FALSE,0.926770126091174,2024,2024-2025
OK,2024-12-31,intra-ucfe,4,2,0,0,0,0,0,0,0,0,1,7,5,7,FALSE,1,2024,2024-2025
OK,2024-12-31,intra-ucx,6,0,0,0,0,0,0,0,0,0,0,6,6,6,FALSE,1,2024,2024-2025
OK,2024-12-31,intra-ui,1416,106,24,14,26,29,17,18,4,19,376,2049,1792,1898,FALSE,0.92630551488531,2024,2024-2025
OR,2019-01-31,inter-total,236,34,3,1,5,4,3,0,1,3,58,348,294,328,FALSE,0.942528735632184,2018,2018-2019
OR,2019-01-31,inter-ucfe,31,4,0,0,0,1,0,0,0,1,12,49,43,47,FALSE,0.959183673469388,2018,2018-2019
OR,2019-01-31,inter-ucx,1,0,0,0,0,0,0,0,0,0,0,1,1,1,FALSE,1,2018,2018-2019
OR,2019-01-31,inter-ui,204,30,3,1,5,3,3,0,1,2,46,298,250,280,FALSE,0.939597315436242,2018,2018-2019
OR,2019-01-31,intra-total,8475,467,139,52,43,32,32,22,12,61,1573,10908,10048,10515,FALSE,0.963971397139714,2018,2018-2019
OR,2019-01-31,intra-ucfe,702,65,4,1,1,2,1,1,1,1,276,1055,978,1043,FALSE,0.988625592417062,2018,2018-2019
OR,2019-01-31,intra-ucx,8,1,0,0,0,0,0,0,0,1,5,15,13,14,FALSE,0.933333333333333,2018,2018-2019
OR,2019-01-31,intra-ui,7765,401,135,51,42,30,31,21,11,59,1292,9838,9057,9458,FALSE,0.961374263061598,2018,2018-2019
OR,2019-02-28,inter-total,185,17,3,3,3,3,0,2,0,5,39,260,224,241,FALSE,0.926923076923077,2018,2018-2019
OR,2019-02-28,inter-ucfe,12,4,2,3,2,0,0,0,0,0,5,28,17,21,FALSE,0.75,2018,2018-2019
OR,2019-02-28,inter-ucx,1,0,0,0,0,0,0,0,0,0,0,1,1,1,FALSE,1,2018,2018-2019
OR,2019-02-28,inter-ui,172,13,1,0,1,3,0,2,0,5,34,231,206,219,FALSE,0.948051948051948,2018,2018-2019
OR,2019-02-28,intra-total,5181,458,179,84,51,49,34,25,19,68,1108,7256,6289,6747,FALSE,0.929851157662624,2018,2018-2019
OR,2019-02-28,intra-ucfe,34,19,7,14,5,0,2,0,0,1,35,117,69,88,FALSE,0.752136752136752,2018,2018-2019
OR,2019-02-28,intra-ucx,9,0,0,0,0,0,0,0,0,0,3,12,12,12,FALSE,1,2018,2018-2019
OR,2019-02-28,intra-ui,5138,439,172,70,46,49,32,25,19,67,1070,7127,6208,6647,FALSE,0.932650484074646,2018,2018-2019
OR,2019-03-31,inter-total,124,30,13,3,3,3,1,1,1,1,36,216,160,190,FALSE,0.87962962962963,2018,2018-2019
OR,2019-03-31,inter-ucfe,4,1,0,0,0,1,0,1,1,0,1,9,5,6,FALSE,0.666666666666667,2018,2018-2019
OR,2019-03-31,inter-ucx,1,0,0,0,0,0,0,0,0,0,0,1,1,1,FALSE,1,2018,2018-2019
OR,2019-03-31,inter-ui,119,29,13,3,3,2,1,0,0,1,35,206,154,183,FALSE,0.888349514563107,2018,2018-2019
OR,2019-03-31,intra-total,4648,610,266,112,64,57,43,36,16,34,1037,6923,5685,6295,FALSE,0.909287880976455,2018,2018-2019
OR,2019-03-31,intra-ucfe,14,3,4,1,3,3,2,4,1,1,14,50,28,31,FALSE,0.62,2018,2018-2019
OR,2019-03-31,intra-ucx,11,1,1,0,0,0,0,0,0,0,0,13,11,12,FALSE,0.923076923076923,2018,2018-2019
OR,2019-03-31,intra-ui,4623,606,261,111,61,54,41,32,15,33,1023,6860,5646,6252,FALSE,0.911370262390671,2018,2018-2019
OR,2019-04-30,inter-total,151,18,7,5,1,2,1,1,0,2,59,247,210,228,FALSE,0.923076923076923,2018,2018-2019
OR,2019-04-30,inter-ucfe,3,0,1,0,0,1,0,0,0,1,1,7,4,4,FALSE,0.571428571428571,2018,2018-2019
OR,2019-04-30,inter-ucx,0,0,0,0,0,0,0,0,0,0,0,0,0,0,FALSE,0,2018,2018-2019
OR,2019-04-30,inter-ui,148,18,6,5,1,1,1,1,0,1,58,240,206,224,FALSE,0.933333333333333,2018,2018-2019
OR,2019-04-30,intra-total,4277,433,165,61,47,45,39,21,15,40,1046,6189,5323,5756,FALSE,0.93003716270803,2018,2018-2019
OR,2019-04-30,intra-ucfe,19,1,4,0,0,1,1,0,1,4,4,35,23,24,FALSE,0.685714285714286,2018,2018-2019
OR,2019-04-30,intra-ucx,7,1,0,0,0,0,0,0,0,0,2,10,9,10,FALSE,1,2018,2018-2019
OR,2019-04-30,intra-ui,4251,431,161,61,47,44,38,21,14,36,1040,6144,5291,5722,FALSE,0.931315104166667,2018,2018-2019
OR,2019-05-31,inter-total,127,14,5,0,0,1,0,1,1,1,45,195,172,186,FALSE,0.953846153846154,2018,2018-2019
OR,2019-05-31,inter-ucfe,0,0,0,0,0,0,0,0,0,0,0,0,0,0,FALSE,0,2018,2018-2019
OR,2019-05-31,inter-ucx,1,0,0,0,0,0,0,0,0,0,0,1,1,1,FALSE,1,2018,2018-2019
OR,2019-05-31,inter-ui,126,14,5,0,0,1,0,1,1,1,45,194,171,185,FALSE,0.95360824742268,2018,2018-2019
OR,2019-05-31,intra-total,3256,335,107,49,43,53,23,15,14,32,1000,4927,4256,4591,FALSE,0.931804343413842,2018,2018-2019
OR,2019-05-31,intra-ucfe,9,2,2,0,0,0,1,0,0,0,2,16,11,13,FALSE,0.8125,2018,2018-2019
OR,2019-05-31,intra-ucx,6,0,1,0,0,0,0,0,0,0,1,8,7,7,FALSE,0.875,2018,2018-2019
OR,2019-05-31,intra-ui,3241,333,104,49,43,53,22,15,14,32,997,4903,4238,4571,FALSE,0.932286355292678,2018,2018-2019
OR,2019-06-30,inter-total,124,10,3,0,1,0,4,0,0,4,29,175,153,163,FALSE,0.931428571428571,2018,2018-2019
OR,2019-06-30,inter-ucfe,0,0,0,0,0,0,0,0,0,1,0,1,0,0,FALSE,0,2018,2018-2019
OR,2019-06-30,inter-ucx,2,0,0,0,0,0,0,0,0,0,0,2,2,2,FALSE,1,2018,2018-2019
OR,2019-06-30,inter-ui,122,10,3,0,1,0,4,0,0,3,29,172,151,161,FALSE,0.936046511627907,2018,2018-2019
OR,2019-06-30,intra-total,3376,274,92,47,41,35,35,24,8,26,774,4732,4150,4424,FALSE,0.93491124260355,2018,2018-2019
OR,2019-06-30,intra-ucfe,55,3,1,0,1,0,0,0,0,2,0,62,55,58,FALSE,0.935483870967742,2018,2018-2019
OR,2019-06-30,intra-ucx,9,0,0,0,0,0,0,0,0,0,0,9,9,9,FALSE,1,2018,2018-2019
OR,2019-06-30,intra-ui,3312,271,91,47,40,35,35,24,8,24,774,4661,4086,4357,FALSE,0.934777944647071,2018,2018-2019
OR,2019-07-31,inter-total,140,20,3,5,4,1,1,1,0,2,50,227,190,210,FALSE,0.92511013215859,2019,2019-2020
OR,2019-07-31,inter-ucfe,0,0,0,0,0,0,0,0,0,0,0,0,0,0,FALSE,0,2019,2019-2020
OR,2019-07-31,inter-ucx,2,0,0,0,0,0,0,0,0,0,0,2,2,2,FALSE,1,2019,2019-2020
OR,2019-07-31,inter-ui,138,20,3,5,4,1,1,1,0,2,50,225,188,208,FALSE,0.924444444444444,2019,2019-2020
OR,2019-07-31,intra-total,5420,395,110,53,55,27,22,21,6,28,1141,7278,6561,6956,FALSE,0.955757076119813,2019,2019-2020
OR,2019-07-31,intra-ucfe,14,2,1,1,1,0,0,0,0,1,7,27,21,23,FALSE,0.851851851851852,2019,2019-2020
OR,2019-07-31,intra-ucx,9,0,0,0,0,0,0,0,0,0,2,11,11,11,FALSE,1,2019,2019-2020
OR,2019-07-31,intra-ui,5397,393,109,52,54,27,22,21,6,27,1132,7240,6529,6922,FALSE,0.956077348066298,2019,2019-2020
OR,2019-08-31,inter-total,133,14,5,4,8,3,0,0,0,2,33,202,166,180,FALSE,0.891089108910891,2019,2019-2020
OR,2019-08-31,inter-ucfe,0,0,0,0,0,0,0,0,0,0,0,0,0,0,FALSE,0,2019,2019-2020
OR,2019-08-31,inter-ucx,1,0,0,0,0,0,0,0,0,0,0,1,1,1,FALSE,1,2019,2019-2020
OR,2019-08-31,inter-ui,132,14,5,4,8,3,0,0,0,2,33,201,165,179,FALSE,0.890547263681592,2019,2019-2020
OR,2019-08-31,intra-total,3284,326,132,68,59,27,34,10,6,29,993,4968,4277,4603,FALSE,0.926529790660225,2019,2019-2020
OR,2019-08-31,intra-ucfe,9,2,3,1,1,0,0,0,0,3,2,21,11,13,FALSE,0.619047619047619,2019,2019-2020
OR,2019-08-31,intra-ucx,11,0,0,1,0,0,0,0,0,0,2,14,13,13,FALSE,0.928571428571429,2019,2019-2020
OR,2019-08-31,intra-ui,3264,324,129,66,58,27,34,10,6,26,989,4933,4253,4577,FALSE,0.9278329616866,2019,2019-2020
OR,2019-09-30,inter-total,148,18,2,3,3,2,1,0,1,1,33,212,181,199,FALSE,0.938679245283019,2019,2019-2020
OR,2019-09-30,inter-ucfe,0,0,0,0,0,0,0,0,0,0,0,0,0,0,FALSE,0,2019,2019-2020
OR,2019-09-30,inter-ucx,2,0,0,0,0,0,0,0,0,0,1,3,3,3,FALSE,1,2019,2019-2020
OR,2019-09-30,inter-ui,146,18,2,3,3,2,1,0,1,1,32,209,178,196,FALSE,0.937799043062201,2019,2019-2020
OR,2019-09-30,intra-total,3562,364,108,47,51,28,31,13,5,34,906,5149,4468,4832,FALSE,0.93843464750437,2019,2019-2020
OR,2019-09-30,intra-ucfe,4,3,0,0,0,0,2,0,0,2,6,17,10,13,FALSE,0.764705882352941,2019,2019-2020
OR,2019-09-30,intra-ucx,18,1,0,0,0,0,0,0,0,0,4,23,22,23,FALSE,1,2019,2019-2020
OR,2019-09-30,intra-ui,3540,360,108,47,51,28,29,13,5,32,896,5109,4436,4796,FALSE,0.938735564689763,2019,2019-2020
OR,2019-10-31,inter-total,157,19,9,2,4,1,3,1,0,2,56,254,213,232,FALSE,0.913385826771654,2019,2019-2020
OR,2019-10-31,inter-ucfe,4,0,0,0,0,0,0,0,0,1,2,7,6,6,FALSE,0.857142857142857,2019,2019-2020
OR,2019-10-31,inter-ucx,0,0,0,0,0,0,0,0,0,0,2,2,2,2,FALSE,1,2019,2019-2020
OR,2019-10-31,inter-ui,153,19,9,2,4,1,3,1,0,1,52,245,205,224,FALSE,0.914285714285714,2019,2019-2020
OR,2019-10-31,intra-total,3494,417,152,57,49,43,37,17,3,41,1044,5354,4538,4955,FALSE,0.925476279417258,2019,2019-2020
OR,2019-10-31,intra-ucfe,28,2,2,0,1,1,0,1,0,4,5,44,33,35,FALSE,0.795454545454545,2019,2019-2020
OR,2019-10-31,intra-ucx,14,2,1,0,1,0,0,0,0,0,1,19,15,17,FALSE,0.894736842105263,2019,2019-2020
OR,2019-10-31,intra-ui,3452,413,149,57,47,42,37,16,3,37,1038,5291,4490,4903,FALSE,0.926667926667927,2019,2019-2020
OR,2019-11-30,inter-total,205,13,5,0,0,2,0,0,0,0,43,268,248,261,FALSE,0.973880597014925,2019,2019-2020
OR,2019-11-30,inter-ucfe,23,0,2,0,0,0,0,0,0,0,2,27,25,25,FALSE,0.925925925925926,2019,2019-2020
OR,2019-11-30,inter-ucx,1,0,0,0,0,0,0,0,0,0,0,1,1,1,FALSE,1,2019,2019-2020
OR,2019-11-30,inter-ui,181,13,3,0,0,2,0,0,0,0,41,240,222,235,FALSE,0.979166666666667,2019,2019-2020
OR,2019-11-30,intra-total,3945,301,123,57,38,32,15,11,6,25,898,5451,4843,5144,FALSE,0.943680058704825,2019,2019-2020
OR,2019-11-30,intra-ucfe,63,4,2,0,1,0,1,0,0,1,3,75,66,70,FALSE,0.933333333333333,2019,2019-2020
OR,2019-11-30,intra-ucx,7,0,2,2,0,0,0,0,0,0,1,12,8,8,FALSE,0.666666666666667,2019,2019-2020
OR,2019-11-30,intra-ui,3875,297,119,55,37,32,14,11,6,24,894,5364,4769,5066,FALSE,0.944444444444444,2019,2019-2020
OR,2019-12-31,inter-total,229,19,7,2,4,2,1,2,3,2,55,326,284,303,FALSE,0.929447852760736,2019,2019-2020
OR,2019-12-31,inter-ucfe,15,3,0,0,0,0,0,0,1,0,7,26,22,25,FALSE,0.961538461538461,2019,2019-2020
OR,2019-12-31,inter-ucx,0,0,0,0,0,0,0,0,0,0,0,0,0,0,FALSE,0,2019,2019-2020
OR,2019-12-31,inter-ui,214,16,7,2,4,2,1,2,2,2,48,300,262,278,FALSE,0.926666666666667,2019,2019-2020
OR,2019-12-31,intra-total,7454,375,154,48,48,36,24,25,12,19,1185,9380,8639,9014,FALSE,0.960980810234542,2019,2019-2020
OR,2019-12-31,intra-ucfe,128,2,1,1,2,2,1,0,0,0,21,158,149,151,FALSE,0.955696202531646,2019,2019-2020
OR,2019-12-31,intra-ucx,10,0,0,2,0,0,0,0,0,0,2,14,12,12,FALSE,0.857142857142857,2019,2019-2020
OR,2019-12-31,intra-ui,7316,373,153,45,46,34,23,25,12,19,1162,9208,8478,8851,FALSE,0.961229365768897,2019,2019-2020
OR,2020-01-31,inter-total,266,10,9,1,1,0,4,1,2,2,53,349,319,329,FALSE,0.94269340974212,2019,2019-2020
OR,2020-01-31,inter-ucfe,31,0,0,1,0,0,0,0,1,1,10,44,41,41,FALSE,0.931818181818182,2019,2019-2020
OR,2020-01-31,inter-ucx,0,0,0,0,0,0,0,0,0,0,0,0,0,0,FALSE,0,2019,2019-2020
OR,2020-01-31,inter-ui,235,10,9,0,1,0,4,1,1,1,43,305,278,288,FALSE,0.944262295081967,2019,2019-2020
OR,2020-01-31,intra-total,8266,519,175,68,44,35,28,36,31,44,1379,10625,9645,10164,FALSE,0.956611764705882,2019,2019-2020
OR,2020-01-31,intra-ucfe,174,9,3,1,1,3,1,1,0,3,75,271,249,258,FALSE,0.952029520295203,2019,2019-2020
OR,2020-01-31,intra-ucx,10,0,0,0,1,0,0,0,0,0,2,13,12,12,FALSE,0.923076923076923,2019,2019-2020
OR,2020-01-31,intra-ui,8082,510,172,67,42,32,27,35,31,41,1302,10341,9384,9894,FALSE,0.956774006382361,2019,2019-2020
OR,2020-02-29,inter-total,162,13,12,1,3,0,0,1,2,4,39,237,201,214,FALSE,0.90295358649789,2019,2019-2020
OR,2020-02-29,inter-ucfe,11,2,2,0,1,0,0,0,0,1,5,22,16,18,FALSE,0.818181818181818,2019,2019-2020
OR,2020-02-29,inter-ucx,0,0,0,0,0,0,0,0,0,0,0,0,0,0,FALSE,0,2019,2019-2020
OR,2020-02-29,inter-ui,151,11,10,1,2,0,0,1,2,3,34,215,185,196,FALSE,0.911627906976744,2019,2019-2020
OR,2020-02-29,intra-total,4704,459,165,73,53,39,32,23,15,43,1129,6735,5833,6292,FALSE,0.934224201930215,2019,2019-2020
OR,2020-02-29,intra-ucfe,60,5,6,4,1,0,0,1,0,1,19,97,79,84,FALSE,0.865979381443299,2019,2019-2020
OR,2020-02-29,intra-ucx,10,0,0,0,0,0,0,0,0,0,1,11,11,11,FALSE,1,2019,2019-2020
OR,2020-02-29,intra-ui,4634,454,159,69,52,39,32,22,15,42,1109,6627,5743,6197,FALSE,0.935113927870831,2019,2019-2020
OR,2020-03-31,inter-total,273,30,8,1,4,2,3,2,1,6,37,367,310,340,FALSE,0.926430517711172,2019,2019-2020
OR,2020-03-31,inter-ucfe,8,3,1,0,0,0,1,0,0,0,0,13,8,11,FALSE,0.846153846153846,2019,2019-2020
OR,2020-03-31,inter-ucx,0,0,0,0,0,0,0,0,0,0,0,0,0,0,FALSE,0,2019,2019-2020
OR,2020-03-31,inter-ui,265,27,7,1,4,2,2,2,1,6,37,354,302,329,FALSE,0.929378531073446,2019,2019-2020
OR,2020-03-31,intra-total,18704,508,218,84,39,48,41,31,17,49,1055,20794,19759,20267,FALSE,0.974656150812734,2019,2019-2020
OR,2020-03-31,intra-ucfe,36,1,2,2,0,0,1,1,0,4,2,49,38,39,FALSE,0.795918367346939,2019,2019-2020
OR,2020-03-31,intra-ucx,10,1,0,0,0,0,0,0,0,0,3,14,13,14,FALSE,1,2019,2019-2020
OR,2020-03-31,intra-ui,18658,506,216,82,39,48,40,30,17,45,1050,20731,19708,20214,FALSE,0.975061502098307,2019,2019-2020
OR,2020-04-30,inter-total,962,218,133,25,1,4,1,3,1,3,219,1570,1181,1399,FALSE,0.891082802547771,2019,2019-2020
OR,2020-04-30,inter-ucfe,1,1,0,0,0,0,0,0,0,0,1,3,2,3,FALSE,1,2019,2019-2020
OR,2020-04-30,inter-ucx,0,0,0,0,0,0,0,0,0,0,0,0,0,0,FALSE,0,2019,2019-2020
OR,2020-04-30,inter-ui,961,217,133,25,1,4,1,3,1,3,218,1567,1179,1396,FALSE,0.890874282067645,2019,2019-2020
OR,2020-04-30,intra-total,99100,12293,5818,1145,78,51,39,40,17,50,19095,137726,118195,130488,FALSE,0.947446379042447,2019,2019-2020
OR,2020-04-30,intra-ucfe,13,4,3,2,1,0,0,0,0,1,2,26,15,19,FALSE,0.730769230769231,2019,2019-2020
OR,2020-04-30,intra-ucx,2,2,4,0,0,1,0,0,0,0,2,11,4,6,FALSE,0.545454545454545,2019,2019-2020
OR,2020-04-30,intra-ui,99085,12287,5811,1143,77,50,39,40,17,49,19091,137689,118176,130463,FALSE,0.947519409684143,2019,2019-2020
OR,2020-05-31,inter-total,380,78,147,230,180,91,33,9,1,2,58,1209,438,516,FALSE,0.426799007444169,2019,2019-2020
OR,2020-05-31,inter-ucfe,0,0,0,0,0,0,0,0,0,0,0,0,0,0,FALSE,0,2019,2019-2020
OR,2020-05-31,inter-ucx,0,0,0,0,0,0,0,0,0,0,0,0,0,0,FALSE,0,2019,2019-2020
OR,2020-05-31,inter-ui,380,78,147,230,180,91,33,9,1,2,58,1209,438,516,FALSE,0.426799007444169,2019,2019-2020
OR,2020-05-31,intra-total,25551,4404,6622,8412,6694,3736,1693,425,36,65,3756,61394,29307,33711,FALSE,0.549092745219403,2019,2019-2020
OR,2020-05-31,intra-ucfe,0,0,1,6,13,6,2,0,0,1,1,30,1,1,FALSE,0.0333333333333333,2019,2019-2020
OR,2020-05-31,intra-ucx,0,1,0,7,5,6,0,0,0,1,0,20,0,1,FALSE,0.05,2019,2019-2020
OR,2020-05-31,intra-ui,25551,4403,6621,8399,6676,3724,1691,425,36,63,3755,61344,29306,33709,FALSE,0.549507694314032,2019,2019-2020
OR,2020-06-30,inter-total,291,65,68,97,153,147,89,97,73,132,64,1276,355,420,FALSE,0.329153605015674,2019,2019-2020
OR,2020-06-30,inter-ucfe,0,0,0,0,0,0,0,1,2,1,0,4,0,0,FALSE,0,2019,2019-2020
OR,2020-06-30,inter-ucx,0,0,0,0,0,0,0,0,0,0,0,0,0,0,FALSE,0,2019,2019-2020
OR,2020-06-30,inter-ui,291,65,68,97,153,147,89,96,71,131,64,1272,355,420,FALSE,0.330188679245283,2019,2019-2020
OR,2020-06-30,intra-total,12623,1320,1604,2001,2508,2625,2477,3042,3057,5247,1917,38421,14540,15860,FALSE,0.412795086020666,2019,2019-2020
OR,2020-06-30,intra-ucfe,2,3,19,5,4,9,8,10,6,7,2,75,4,7,FALSE,0.0933333333333333,2019,2019-2020
OR,2020-06-30,intra-ucx,7,2,4,3,5,11,12,6,1,5,3,59,10,12,FALSE,0.203389830508475,2019,2019-2020
OR,2020-06-30,intra-ui,12614,1315,1581,1993,2499,2605,2457,3026,3050,5235,1912,38287,14526,15841,FALSE,0.413743568313004,2019,2019-2020
OR,2020-07-31,inter-total,273,25,30,31,42,23,28,35,42,349,46,924,319,344,FALSE,0.372294372294372,2020,2020-2021
OR,2020-07-31,inter-ucfe,0,0,0,0,0,0,0,0,0,3,0,3,0,0,FALSE,0,2020,2020-2021
OR,2020-07-31,inter-ucx,0,0,0,0,0,0,0,0,0,0,0,0,0,0,FALSE,0,2020,2020-2021
OR,2020-07-31,inter-ui,273,25,30,31,42,23,28,35,42,346,46,921,319,344,FALSE,0.373507057546146,2020,2020-2021
OR,2020-07-31,intra-total,9588,1172,912,886,886,991,1058,1430,1859,15551,1648,35981,11236,12408,FALSE,0.344848670131458,2020,2020-2021
OR,2020-07-31,intra-ucfe,9,6,5,6,1,2,5,5,4,17,15,75,24,30,FALSE,0.4,2020,2020-2021
OR,2020-07-31,intra-ucx,15,4,3,4,3,2,2,2,3,9,5,52,20,24,FALSE,0.461538461538462,2020,2020-2021
OR,2020-07-31,intra-ui,9564,1162,904,876,882,987,1051,1423,1852,15525,1628,35854,11192,12354,FALSE,0.344564065376248,2020,2020-2021
OR,2020-08-31,inter-total,224,10,10,13,11,9,14,8,20,433,21,773,245,255,FALSE,0.329883570504528,2020,2020-2021
OR,2020-08-31,inter-ucfe,0,0,0,0,0,0,0,0,0,1,0,1,0,0,FALSE,0,2020,2020-2021
OR,2020-08-31,inter-ucx,0,0,0,0,0,0,0,0,0,0,0,0,0,0,FALSE,0,2020,2020-2021
OR,2020-08-31,inter-ui,224,10,10,13,11,9,14,8,20,432,21,772,245,255,FALSE,0.330310880829016,2020,2020-2021
OR,2020-08-31,intra-total,6061,229,236,231,267,235,321,257,244,14003,612,22696,6673,6902,FALSE,0.304106450475855,2020,2020-2021
OR,2020-08-31,intra-ucfe,2,0,0,0,1,0,0,0,1,39,4,47,6,6,FALSE,0.127659574468085,2020,2020-2021
OR,2020-08-31,intra-ucx,4,1,0,0,1,0,2,0,0,9,4,21,8,9,FALSE,0.428571428571429,2020,2020-2021
OR,2020-08-31,intra-ui,6055,228,236,231,265,235,319,257,243,13955,604,22628,6659,6887,FALSE,0.304357433268517,2020,2020-2021
OR,2020-09-30,inter-total,172,16,10,17,12,11,9,13,9,341,23,633,195,211,FALSE,0.333333333333333,2020,2020-2021
OR,2020-09-30,inter-ucfe,1,0,0,0,0,0,0,0,0,2,0,3,1,1,FALSE,0.333333333333333,2020,2020-2021
OR,2020-09-30,inter-ucx,0,0,0,0,0,0,0,0,0,0,0,0,0,0,FALSE,0,2020,2020-2021
OR,2020-09-30,inter-ui,171,16,10,17,12,11,9,13,9,339,23,630,194,210,FALSE,0.333333333333333,2020,2020-2021
OR,2020-09-30,intra-total,6198,258,247,203,283,248,260,315,316,12039,730,21097,6928,7186,FALSE,0.340617149357729,2020,2020-2021
OR,2020-09-30,intra-ucfe,2,1,2,0,0,0,1,0,3,25,0,34,2,3,FALSE,0.0882352941176471,2020,2020-2021
OR,2020-09-30,intra-ucx,10,3,0,0,1,1,1,1,0,12,3,32,13,16,FALSE,0.5,2020,2020-2021
OR,2020-09-30,intra-ui,6186,254,245,203,282,247,258,314,313,12002,727,21031,6913,7167,FALSE,0.340782654177167,2020,2020-2021
OR,2020-10-31,inter-total,187,7,12,3,7,4,5,7,8,301,16,557,203,210,FALSE,0.377019748653501,2020,2020-2021
OR,2020-10-31,inter-ucfe,0,0,0,0,0,0,0,0,1,1,0,2,0,0,FALSE,0,2020,2020-2021
OR,2020-10-31,inter-ucx,0,0,0,0,0,0,0,0,0,0,0,0,0,0,FALSE,0,2020,2020-2021
OR,2020-10-31,inter-ui,187,7,12,3,7,4,5,7,7,300,16,555,203,210,FALSE,0.378378378378378,2020,2020-2021
OR,2020-10-31,intra-total,3976,248,205,170,197,147,165,164,204,6767,472,12715,4448,4696,FALSE,0.369327565867086,2020,2020-2021
OR,2020-10-31,intra-ucfe,9,2,1,0,0,0,0,1,0,18,6,37,15,17,FALSE,0.45945945945946,2020,2020-2021
OR,2020-10-31,intra-ucx,13,5,1,1,2,1,0,0,0,8,2,33,15,20,FALSE,0.606060606060606,2020,2020-2021
OR,2020-10-31,intra-ui,3954,241,203,169,195,146,165,163,204,6741,464,12645,4418,4659,FALSE,0.368446026097272,2020,2020-2021
OR,2020-11-30,inter-total,367,16,17,12,12,14,14,19,13,603,77,1164,444,460,FALSE,0.395189003436426,2020,2020-2021
OR,2020-11-30,inter-ucfe,3,2,1,0,1,0,2,0,0,2,6,17,9,11,FALSE,0.647058823529412,2020,2020-2021
OR,2020-11-30,inter-ucx,0,0,0,0,0,0,0,0,0,0,0,0,0,0,FALSE,0,2020,2020-2021
OR,2020-11-30,inter-ui,364,14,16,12,11,14,12,19,13,601,71,1147,435,449,FALSE,0.391455972101133,2020,2020-2021
OR,2020-11-30,intra-total,6427,410,260,245,223,238,258,1048,840,21800,1018,32767,7445,7855,FALSE,0.239722891933958,2020,2020-2021
OR,2020-11-30,intra-ucfe,20,13,12,3,7,6,3,0,1,30,12,107,32,45,FALSE,0.420560747663551,2020,2020-2021
OR,2020-11-30,intra-ucx,5,5,3,0,0,1,1,0,0,19,4,38,9,14,FALSE,0.368421052631579,2020,2020-2021
OR,2020-11-30,intra-ui,6402,392,245,242,216,231,254,1048,839,21751,1002,32622,7404,7796,FALSE,0.238979829562872,2020,2020-2021
OR,2020-12-31,inter-total,361,33,25,15,20,16,15,17,14,312,96,924,457,490,FALSE,0.53030303030303,2020,2020-2021
OR,2020-12-31,inter-ucfe,2,3,7,4,1,1,1,1,0,2,2,24,4,7,FALSE,0.291666666666667,2020,2020-2021
OR,2020-12-31,inter-ucx,0,0,0,0,0,0,0,0,0,0,0,0,0,0,FALSE,0,2020,2020-2021
OR,2020-12-31,inter-ui,359,30,18,11,19,15,14,16,14,310,94,900,453,483,FALSE,0.536666666666667,2020,2020-2021
OR,2020-12-31,intra-total,7299,681,367,339,290,312,321,275,309,7504,1926,19623,9225,9906,FALSE,0.504815777404067,2020,2020-2021
OR,2020-12-31,intra-ucfe,13,83,23,16,3,6,2,4,1,16,23,190,36,119,FALSE,0.626315789473684,2020,2020-2021
OR,2020-12-31,intra-ucx,3,2,2,4,3,1,0,1,1,14,1,32,4,6,FALSE,0.1875,2020,2020-2021
OR,2020-12-31,intra-ui,7283,596,342,319,284,305,319,270,307,7474,1902,19401,9185,9781,FALSE,0.504149270656152,2020,2020-2021
OR,2021-01-31,inter-total,182,74,30,23,23,20,14,13,9,196,108,692,290,364,FALSE,0.526011560693642,2020,2020-2021
OR,2021-01-31,inter-ucfe,1,16,4,0,0,0,0,0,0,3,0,24,1,17,FALSE,0.708333333333333,2020,2020-2021
OR,2021-01-31,inter-ucx,0,0,0,0,0,0,0,0,0,0,0,0,0,0,FALSE,0,2020,2020-2021
OR,2021-01-31,inter-ui,181,58,26,23,23,20,14,13,9,193,108,668,289,347,FALSE,0.519461077844311,2020,2020-2021
OR,2021-01-31,intra-total,6775,841,609,507,444,426,356,286,238,5663,1718,17863,8493,9334,FALSE,0.522532609304148,2020,2020-2021
OR,2021-01-31,intra-ucfe,4,78,26,13,3,10,3,7,2,19,5,170,9,87,FALSE,0.511764705882353,2020,2020-2021
OR,2021-01-31,intra-ucx,4,4,2,1,1,4,2,1,1,7,3,30,7,11,FALSE,0.366666666666667,2020,2020-2021
OR,2021-01-31,intra-ui,6767,759,581,493,440,412,351,278,235,5637,1710,17663,8477,9236,FALSE,0.522900979448565,2020,2020-2021
OR,2021-02-28,inter-total,107,60,50,34,25,22,11,9,9,221,59,607,166,226,FALSE,0.372322899505766,2020,2020-2021
OR,2021-02-28,inter-ucfe,2,5,9,2,3,2,1,2,3,4,0,33,2,7,FALSE,0.212121212121212,2020,2020-2021
OR,2021-02-28,inter-ucx,1,0,1,0,0,0,0,0,0,0,0,2,1,1,FALSE,0.5,2020,2020-2021
OR,2021-02-28,inter-ui,104,55,40,32,22,20,10,7,6,217,59,572,163,218,FALSE,0.381118881118881,2020,2020-2021
OR,2021-02-28,intra-total,4162,633,614,519,409,339,239,239,226,5644,1159,14183,5321,5954,FALSE,0.419798350137489,2020,2020-2021
OR,2021-02-28,intra-ucfe,5,27,80,21,9,8,3,2,4,37,12,208,17,44,FALSE,0.211538461538462,2020,2020-2021
OR,2021-02-28,intra-ucx,5,7,0,2,1,0,1,0,1,12,3,32,8,15,FALSE,0.46875,2020,2020-2021
OR,2021-02-28,intra-ui,4152,599,534,496,399,331,235,237,221,5595,1144,13943,5296,5895,FALSE,0.422792799254106,2020,2020-2021
OR,2021-03-31,inter-total,188,72,35,13,13,15,20,5,17,180,98,656,286,358,FALSE,0.545731707317073,2020,2020-2021
OR,2021-03-31,inter-ucfe,0,2,2,0,1,2,3,0,2,12,2,26,2,4,FALSE,0.153846153846154,2020,2020-2021
OR,2021-03-31,inter-ucx,0,0,0,0,0,0,0,0,0,0,0,0,0,0,FALSE,0,2020,2020-2021
OR,2021-03-31,inter-ui,188,70,33,13,12,13,17,5,15,168,96,630,284,354,FALSE,0.561904761904762,2020,2020-2021
OR,2021-03-31,intra-total,5408,688,547,460,363,317,358,247,240,5376,1323,15327,6731,7419,FALSE,0.484047758856919,2020,2020-2021
OR,2021-03-31,intra-ucfe,10,25,22,22,10,8,23,13,25,71,19,248,29,54,FALSE,0.217741935483871,2020,2020-2021
OR,2021-03-31,intra-ucx,6,3,5,1,1,0,1,0,0,12,1,30,7,10,FALSE,0.333333333333333,2020,2020-2021
OR,2021-03-31,intra-ui,5392,660,520,437,352,309,334,234,215,5293,1303,15049,6695,7355,FALSE,0.488736793142402,2020,2020-2021
OR,2021-04-30,inter-total,80,94,60,27,16,7,7,7,6,56,88,448,168,262,FALSE,0.584821428571429,2020,2020-2021
OR,2021-04-30,inter-ucfe,0,0,0,0,0,0,0,0,0,2,0,2,0,0,FALSE,0,2020,2020-2021
OR,2021-04-30,inter-ucx,0,0,0,0,0,0,0,0,1,0,0,1,0,0,FALSE,0,2020,2020-2021
OR,2021-04-30,inter-ui,80,94,60,27,16,7,7,7,5,54,88,445,168,262,FALSE,0.58876404494382,2020,2020-2021
OR,2021-04-30,intra-total,4898,1846,1034,847,438,178,161,126,84,1471,3184,14267,8082,9928,FALSE,0.695871591785239,2020,2020-2021
OR,2021-04-30,intra-ucfe,1,6,8,4,1,5,0,0,0,22,10,57,11,17,FALSE,0.298245614035088,2020,2020-2021
OR,2021-04-30,intra-ucx,0,4,2,1,1,0,0,0,0,6,2,16,2,6,FALSE,0.375,2020,2020-2021
OR,2021-04-30,intra-ui,4897,1836,1024,842,436,173,161,126,84,1443,3172,14194,8069,9905,FALSE,0.697830069043258,2020,2020-2021
OR,2021-05-31,inter-total,129,107,82,32,15,9,9,3,3,37,98,524,227,334,FALSE,0.637404580152672,2020,2020-2021
OR,2021-05-31,inter-ucfe,0,0,0,0,0,0,0,0,0,3,0,3,0,0,FALSE,0,2020,2020-2021
OR,2021-05-31,inter-ucx,0,0,0,0,0,0,0,0,0,0,0,0,0,0,FALSE,0,2020,2020-2021
OR,2021-05-31,inter-ui,129,107,82,32,15,9,9,3,3,34,98,521,227,334,FALSE,0.641074856046065,2020,2020-2021
OR,2021-05-31,intra-total,5026,1161,1119,795,643,423,213,129,57,758,1552,11876,6578,7739,FALSE,0.651650387335803,2020,2020-2021
OR,2021-05-31,intra-ucfe,1,8,5,1,1,1,1,0,1,20,3,42,4,12,FALSE,0.285714285714286,2020,2020-2021
OR,2021-05-31,intra-ucx,6,3,1,2,0,0,1,0,0,3,2,18,8,11,FALSE,0.611111111111111,2020,2020-2021
OR,2021-05-31,intra-ui,5019,1150,1113,792,642,422,211,129,56,735,1547,11816,6566,7716,FALSE,0.653012863913338,2020,2020-2021
OR,2021-06-30,inter-total,77,54,60,32,12,6,15,7,8,43,52,366,129,183,FALSE,0.5,2020,2020-2021
OR,2021-06-30,inter-ucfe,0,0,0,0,0,0,0,0,0,2,0,2,0,0,FALSE,0,2020,2020-2021
OR,2021-06-30,inter-ucx,0,0,0,0,0,0,0,0,0,0,0,0,0,0,FALSE,0,2020,2020-2021
OR,2021-06-30,inter-ui,77,54,60,32,12,6,15,7,8,41,52,364,129,183,FALSE,0.502747252747253,2020,2020-2021
OR,2021-06-30,intra-total,4408,979,706,538,406,335,285,199,141,897,1460,10354,5868,6847,FALSE,0.661290322580645,2020,2020-2021
OR,2021-06-30,intra-ucfe,7,19,7,3,2,3,1,1,0,21,31,95,38,57,FALSE,0.6,2020,2020-2021
OR,2021-06-30,intra-ucx,11,2,1,0,0,0,1,0,0,4,7,26,18,20,FALSE,0.769230769230769,2020,2020-2021
OR,2021-06-30,intra-ui,4390,958,698,535,404,332,283,198,141,872,1422,10233,5812,6770,FALSE,0.661585067917522,2020,2020-2021
OR,2021-07-31,inter-total,88,67,28,15,8,6,9,7,4,25,60,317,148,215,FALSE,0.678233438485805,2021,2021-2022
OR,2021-07-31,inter-ucfe,0,0,0,0,0,0,0,0,0,1,0,1,0,0,FALSE,0,2021,2021-2022
OR,2021-07-31,inter-ucx,0,0,0,0,0,0,0,0,0,0,0,0,0,0,FALSE,0,2021,2021-2022
OR,2021-07-31,inter-ui,88,67,28,15,8,6,9,7,4,24,60,316,148,215,FALSE,0.680379746835443,2021,2021-2022
OR,2021-07-31,intra-total,4132,1054,483,298,166,123,111,86,62,661,1641,8817,5773,6827,FALSE,0.774299648406488,2021,2021-2022
OR,2021-07-31,intra-ucfe,6,5,3,4,3,1,1,1,0,7,6,37,12,17,FALSE,0.45945945945946,2021,2021-2022
OR,2021-07-31,intra-ucx,2,1,3,0,1,1,0,0,0,4,2,14,4,5,FALSE,0.357142857142857,2021,2021-2022
OR,2021-07-31,intra-ui,4124,1048,477,294,162,121,110,85,62,650,1633,8766,5757,6805,FALSE,0.776294775268081,2021,2021-2022
OR,2021-08-31,inter-total,66,50,41,13,8,2,2,3,4,28,62,279,128,178,FALSE,0.637992831541219,2021,2021-2022
OR,2021-08-31,inter-ucfe,0,0,0,0,0,0,0,0,0,4,0,4,0,0,FALSE,0,2021,2021-2022
OR,2021-08-31,inter-ucx,0,0,0,0,0,0,0,0,0,0,0,0,0,0,FALSE,0,2021,2021-2022
OR,2021-08-31,inter-ui,66,50,41,13,8,2,2,3,4,24,62,275,128,178,FALSE,0.647272727272727,2021,2021-2022
OR,2021-08-31,intra-total,3963,1037,502,205,121,99,47,40,44,605,1712,8375,5675,6712,FALSE,0.801432835820896,2021,2021-2022
OR,2021-08-31,intra-ucfe,1,4,11,3,1,0,0,0,0,10,0,30,1,5,FALSE,0.166666666666667,2021,2021-2022
OR,2021-08-31,intra-ucx,4,2,1,0,1,2,0,0,0,3,4,17,8,10,FALSE,0.588235294117647,2021,2021-2022
OR,2021-08-31,intra-ui,3958,1031,490,202,119,97,47,40,44,592,1708,8328,5666,6697,FALSE,0.804154658981748,2021,2021-2022
OR,2021-09-30,inter-total,183,45,36,10,10,5,7,7,1,25,40,369,223,268,FALSE,0.726287262872629,2021,2021-2022
OR,2021-09-30,inter-ucfe,0,0,1,0,1,0,0,0,0,1,0,3,0,0,FALSE,0,2021,2021-2022
OR,2021-09-30,inter-ucx,0,0,0,0,0,0,0,0,0,0,0,0,0,0,FALSE,0,2021,2021-2022
OR,2021-09-30,inter-ui,183,45,35,10,9,5,7,7,1,24,40,366,223,268,FALSE,0.73224043715847,2021,2021-2022
OR,2021-09-30,intra-total,7782,900,574,223,115,80,69,35,25,546,1443,11792,9225,10125,FALSE,0.858632971506106,2021,2021-2022
OR,2021-09-30,intra-ucfe,12,2,3,0,0,2,2,0,0,7,2,30,14,16,FALSE,0.533333333333333,2021,2021-2022
OR,2021-09-30,intra-ucx,2,4,5,1,1,0,0,0,0,0,2,15,4,8,FALSE,0.533333333333333,2021,2021-2022
OR,2021-09-30,intra-ui,7768,894,566,222,114,78,67,35,25,539,1439,11747,9207,10101,FALSE,0.8598791180727,2021,2021-2022
OR,2021-10-31,inter-total,99,15,9,3,6,0,4,1,3,36,54,230,153,168,FALSE,0.730434782608696,2021,2021-2022
OR,2021-10-31,inter-ucfe,1,1,0,0,0,0,0,0,0,1,0,3,1,2,FALSE,0.666666666666667,2021,2021-2022
OR,2021-10-31,inter-ucx,0,0,0,0,0,0,0,0,0,0,0,0,0,0,FALSE,0,2021,2021-2022
OR,2021-10-31,inter-ui,98,14,9,3,6,0,4,1,3,35,54,227,152,166,FALSE,0.731277533039648,2021,2021-2022
OR,2021-10-31,intra-total,2281,404,144,104,108,64,78,47,40,624,884,4778,3165,3569,FALSE,0.746965257429887,2021,2021-2022
OR,2021-10-31,intra-ucfe,6,6,2,0,0,2,1,0,2,6,4,29,10,16,FALSE,0.551724137931035,2021,2021-2022
OR,2021-10-31,intra-ucx,5,1,1,0,0,1,1,0,1,2,1,13,6,7,FALSE,0.538461538461538,2021,2021-2022
OR,2021-10-31,intra-ui,2270,397,141,104,108,61,76,47,37,616,879,4736,3149,3546,FALSE,0.748733108108108,2021,2021-2022
OR,2021-11-30,inter-total,163,32,15,4,6,3,1,3,0,16,77,320,240,272,FALSE,0.85,2021,2021-2022
OR,2021-11-30,inter-ucfe,11,5,3,0,0,0,0,0,0,1,6,26,17,22,FALSE,0.846153846153846,2021,2021-2022
OR,2021-11-30,inter-ucx,0,0,0,0,0,0,0,0,0,0,0,0,0,0,FALSE,0,2021,2021-2022
OR,2021-11-30,inter-ui,152,27,12,4,6,3,1,3,0,15,71,294,223,250,FALSE,0.850340136054422,2021,2021-2022
OR,2021-11-30,intra-total,3829,565,247,148,65,65,33,34,33,490,1057,6566,4886,5451,FALSE,0.83018580566555,2021,2021-2022
OR,2021-11-30,intra-ucfe,30,16,4,7,1,2,0,2,1,8,19,90,49,65,FALSE,0.722222222222222,2021,2021-2022
OR,2021-11-30,intra-ucx,5,2,2,1,0,0,0,0,1,0,1,12,6,8,FALSE,0.666666666666667,2021,2021-2022
OR,2021-11-30,intra-ui,3794,547,241,140,64,63,33,32,31,482,1037,6464,4831,5378,FALSE,0.831992574257426,2021,2021-2022
OR,2021-12-31,inter-total,166,20,10,11,6,5,3,0,0,17,82,320,248,268,FALSE,0.8375,2021,2021-2022
OR,2021-12-31,inter-ucfe,7,5,3,4,1,0,1,0,0,1,8,30,15,20,FALSE,0.666666666666667,2021,2021-2022
OR,2021-12-31,inter-ucx,0,0,0,0,0,0,0,0,0,0,0,0,0,0,FALSE,0,2021,2021-2022
OR,2021-12-31,inter-ui,159,15,7,7,5,5,2,0,0,16,74,290,233,248,FALSE,0.855172413793104,2021,2021-2022
OR,2021-12-31,intra-total,4728,279,104,100,81,76,53,34,21,421,855,6752,5583,5862,FALSE,0.868187203791469,2021,2021-2022
OR,2021-12-31,intra-ucfe,83,28,5,9,0,2,2,1,1,6,47,184,130,158,FALSE,0.858695652173913,2021,2021-2022
OR,2021-12-31,intra-ucx,6,1,0,1,0,0,0,0,1,0,0,9,6,7,FALSE,0.777777777777778,2021,2021-2022
OR,2021-12-31,intra-ui,4639,250,99,90,81,74,51,33,19,415,808,6559,5447,5697,FALSE,0.868577527062052,2021,2021-2022
OR,2022-01-31,inter-total,210,32,2,6,2,3,2,1,2,14,89,363,299,331,FALSE,0.911845730027548,2021,2021-2022
OR,2022-01-31,inter-ucfe,15,1,2,0,0,1,0,0,0,1,10,30,25,26,FALSE,0.866666666666667,2021,2021-2022
OR,2022-01-31,inter-ucx,0,0,0,0,0,0,0,0,0,0,0,0,0,0,FALSE,0,2021,2021-2022
OR,2022-01-31,inter-ui,195,31,0,6,2,2,2,1,2,13,79,333,274,305,FALSE,0.915915915915916,2021,2021-2022
OR,2022-01-31,intra-total,7418,283,85,42,26,40,25,17,20,247,1175,9378,8593,8876,FALSE,0.946470462785242,2021,2021-2022
OR,2022-01-31,intra-ucfe,128,20,13,5,3,3,1,0,1,3,60,237,188,208,FALSE,0.877637130801688,2021,2021-2022
OR,2022-01-31,intra-ucx,3,2,0,1,0,0,0,0,0,3,4,13,7,9,FALSE,0.692307692307692,2021,2021-2022
OR,2022-01-31,intra-ui,7287,261,72,36,23,37,24,17,19,241,1111,9128,8398,8659,FALSE,0.94861963190184,2021,2021-2022
OR,2022-02-28,inter-total,107,27,14,7,6,2,1,2,1,13,53,233,160,187,FALSE,0.802575107296137,2021,2021-2022
OR,2022-02-28,inter-ucfe,6,3,5,3,3,1,0,1,0,0,4,26,10,13,FALSE,0.5,2021,2021-2022
OR,2022-02-28,inter-ucx,0,0,0,0,0,0,0,0,0,0,0,0,0,0,FALSE,0,2021,2021-2022
OR,2022-02-28,inter-ui,101,24,9,4,3,1,1,1,1,13,49,207,150,174,FALSE,0.840579710144928,2021,2021-2022
OR,2022-02-28,intra-total,2766,290,107,71,55,34,18,18,10,210,838,4417,3604,3894,FALSE,0.881593841974191,2021,2021-2022
OR,2022-02-28,intra-ucfe,35,14,15,15,12,1,3,1,2,4,29,131,64,78,FALSE,0.595419847328244,2021,2021-2022
OR,2022-02-28,intra-ucx,3,0,0,0,2,0,0,0,0,0,3,8,6,6,FALSE,0.75,2021,2021-2022
OR,2022-02-28,intra-ui,2728,276,92,56,41,33,15,17,8,206,806,4278,3534,3810,FALSE,0.890603085553997,2021,2021-2022
OR,2022-03-31,inter-total,97,18,10,4,3,5,2,4,0,8,45,196,142,160,FALSE,0.816326530612245,2021,2021-2022
OR,2022-03-31,inter-ucfe,4,0,0,1,1,1,0,0,0,2,3,12,7,7,FALSE,0.583333333333333,2021,2021-2022
OR,2022-03-31,inter-ucx,0,0,0,0,0,0,0,0,0,0,0,0,0,0,FALSE,0,2021,2021-2022
OR,2022-03-31,inter-ui,93,18,10,3,2,4,2,4,0,6,42,184,135,153,FALSE,0.831521739130435,2021,2021-2022
OR,2022-03-31,intra-total,2748,281,99,60,48,35,34,26,19,194,849,4393,3597,3878,FALSE,0.882768040063738,2021,2021-2022
OR,2022-03-31,intra-ucfe,14,8,1,2,1,1,3,1,1,3,14,49,28,36,FALSE,0.73469387755102,2021,2021-2022
OR,2022-03-31,intra-ucx,4,1,0,0,0,0,0,0,0,1,0,6,4,5,FALSE,0.833333333333333,2021,2021-2022
OR,2022-03-31,intra-ui,2730,272,98,58,47,34,31,25,18,190,835,4338,3565,3837,FALSE,0.884508990318119,2021,2021-2022
OR,2022-04-30,inter-total,88,14,4,2,6,2,2,2,1,5,35,161,123,137,FALSE,0.850931677018634,2021,2021-2022
OR,2022-04-30,inter-ucfe,1,0,0,0,1,0,0,0,0,0,0,2,1,1,FALSE,0.5,2021,2021-2022
OR,2022-04-30,inter-ucx,0,0,0,0,0,0,0,0,0,0,0,0,0,0,FALSE,0,2021,2021-2022
OR,2022-04-30,inter-ui,87,14,4,2,5,2,2,2,1,5,35,159,122,136,FALSE,0.855345911949686,2021,2021-2022
OR,2022-04-30,intra-total,2658,226,102,40,36,39,20,15,16,161,733,4046,3391,3617,FALSE,0.893969352446861,2021,2021-2022
OR,2022-04-30,intra-ucfe,9,3,2,1,0,0,1,0,0,2,4,22,13,16,FALSE,0.727272727272727,2021,2021-2022
OR,2022-04-30,intra-ucx,5,0,0,0,0,0,0,0,0,1,1,7,6,6,FALSE,0.857142857142857,2021,2021-2022
OR,2022-04-30,intra-ui,2644,223,100,39,36,39,19,15,16,158,728,4017,3372,3595,FALSE,0.894946477470749,2021,2021-2022
OR,2022-05-31,inter-total,123,22,8,0,2,3,2,0,1,5,45,211,168,190,FALSE,0.900473933649289,2021,2021-2022
OR,2022-05-31,inter-ucfe,1,0,1,0,0,0,0,0,0,0,0,2,1,1,FALSE,0.5,2021,2021-2022
OR,2022-05-31,inter-ucx,0,0,0,0,0,0,0,0,0,0,0,0,0,0,FALSE,0,2021,2021-2022
OR,2022-05-31,inter-ui,122,22,7,0,2,3,2,0,1,5,45,209,167,189,FALSE,0.904306220095694,2021,2021-2022
OR,2022-05-31,intra-total,3017,298,105,56,41,23,21,14,8,170,841,4594,3858,4156,FALSE,0.904658249891162,2021,2021-2022
OR,2022-05-31,intra-ucfe,4,1,1,2,0,0,0,0,0,7,2,17,6,7,FALSE,0.411764705882353,2021,2021-2022
OR,2022-05-31,intra-ucx,4,1,3,0,2,0,1,0,0,1,2,14,6,7,FALSE,0.5,2021,2021-2022
OR,2022-05-31,intra-ui,3009,296,101,54,39,23,20,14,8,162,837,4563,3846,4142,FALSE,0.907736138505369,2021,2021-2022
OR,2022-06-30,inter-total,82,8,4,3,3,1,1,0,0,2,44,148,126,134,FALSE,0.905405405405405,2021,2021-2022
OR,2022-06-30,inter-ucfe,0,0,0,0,0,0,0,0,0,0,1,1,1,1,FALSE,1,2021,2021-2022
OR,2022-06-30,inter-ucx,0,0,0,0,0,0,0,0,0,0,0,0,0,0,FALSE,0,2021,2021-2022
OR,2022-06-30,inter-ui,82,8,4,3,3,1,1,0,0,2,43,147,125,133,FALSE,0.904761904761905,2021,2021-2022
OR,2022-06-30,intra-total,2732,183,47,27,23,25,25,19,6,130,690,3907,3422,3605,FALSE,0.922702841054518,2021,2021-2022
OR,2022-06-30,intra-ucfe,29,2,3,1,1,0,1,1,0,4,7,49,36,38,FALSE,0.775510204081633,2021,2021-2022
OR,2022-06-30,intra-ucx,4,0,0,0,0,0,0,0,0,0,2,6,6,6,FALSE,1,2021,2021-2022
OR,2022-06-30,intra-ui,2699,181,44,26,22,25,24,18,6,126,681,3852,3380,3561,FALSE,0.924454828660436,2021,2021-2022
OR,2022-07-31,inter-total,95,12,4,2,1,0,3,3,1,5,38,164,133,145,FALSE,0.884146341463415,2022,2022-2023
OR,2022-07-31,inter-ucfe,0,0,0,0,0,0,0,0,0,0,0,0,0,0,FALSE,0,2022,2022-2023
OR,2022-07-31,inter-ucx,0,0,0,0,0,0,0,0,0,0,0,0,0,0,FALSE,0,2022,2022-2023
OR,2022-07-31,inter-ui,95,12,4,2,1,0,3,3,1,5,38,164,133,145,FALSE,0.884146341463415,2022,2022-2023
OR,2022-07-31,intra-total,3703,220,66,46,26,22,16,19,7,87,841,5053,4544,4764,FALSE,0.942806253710667,2022,2022-2023
OR,2022-07-31,intra-ucfe,3,2,2,1,2,1,0,0,2,4,6,23,9,11,FALSE,0.478260869565217,2022,2022-2023
OR,2022-07-31,intra-ucx,7,1,1,0,0,0,0,0,0,0,3,12,10,11,FALSE,0.916666666666667,2022,2022-2023
OR,2022-07-31,intra-ui,3693,217,63,45,24,21,16,19,5,83,832,5018,4525,4742,FALSE,0.944998007174173,2022,2022-2023
OR,2022-08-31,inter-total,119,12,2,9,1,3,3,0,1,7,52,209,171,183,FALSE,0.875598086124402,2022,2022-2023
OR,2022-08-31,inter-ucfe,0,0,0,0,0,0,0,0,0,0,0,0,0,0,FALSE,0,2022,2022-2023
OR,2022-08-31,inter-ucx,0,0,0,0,0,0,0,0,0,0,0,0,0,0,FALSE,0,2022,2022-2023
OR,2022-08-31,inter-ui,119,12,2,9,1,3,3,0,1,7,52,209,171,183,FALSE,0.875598086124402,2022,2022-2023
OR,2022-08-31,intra-total,3558,208,84,38,44,25,16,11,7,119,831,4941,4389,4597,FALSE,0.930378465897592,2022,2022-2023
OR,2022-08-31,intra-ucfe,6,2,1,2,2,1,0,0,0,1,3,18,9,11,FALSE,0.611111111111111,2022,2022-2023
OR,2022-08-31,intra-ucx,4,0,0,0,0,0,0,0,0,0,3,7,7,7,FALSE,1,2022,2022-2023
OR,2022-08-31,intra-ui,3548,206,83,36,42,24,16,11,7,118,825,4916,4373,4579,FALSE,0.931448331977217,2022,2022-2023
OR,2022-09-30,inter-total,88,10,9,3,1,2,1,1,0,5,62,182,150,160,FALSE,0.879120879120879,2022,2022-2023
OR,2022-09-30,inter-ucfe,0,0,0,0,0,0,0,0,0,0,0,0,0,0,FALSE,0,2022,2022-2023
OR,2022-09-30,inter-ucx,1,0,0,0,0,0,0,0,0,0,0,1,1,1,FALSE,1,2022,2022-2023
OR,2022-09-30,inter-ui,87,10,9,3,1,2,1,1,0,5,62,181,149,159,FALSE,0.878453038674033,2022,2022-2023
OR,2022-09-30,intra-total,2654,196,70,24,30,27,24,29,17,128,737,3936,3391,3587,FALSE,0.911331300813008,2022,2022-2023
OR,2022-09-30,intra-ucfe,6,0,1,1,0,2,0,1,1,6,3,21,9,9,FALSE,0.428571428571429,2022,2022-2023
OR,2022-09-30,intra-ucx,2,1,1,0,0,0,0,0,0,1,0,5,2,3,FALSE,0.6,2022,2022-2023
OR,2022-09-30,intra-ui,2646,195,68,23,30,25,24,28,16,121,734,3910,3380,3575,FALSE,0.914322250639386,2022,2022-2023
OR,2022-10-31,inter-total,131,10,1,0,2,1,1,0,3,1,47,197,178,188,FALSE,0.954314720812183,2022,2022-2023
OR,2022-10-31,inter-ucfe,5,0,0,0,0,0,0,0,0,0,0,5,5,5,FALSE,1,2022,2022-2023
OR,2022-10-31,inter-ucx,0,1,0,0,0,0,0,0,0,0,1,2,1,2,FALSE,1,2022,2022-2023
OR,2022-10-31,inter-ui,126,9,1,0,2,1,1,0,3,1,46,190,172,181,FALSE,0.952631578947368,2022,2022-2023
OR,2022-10-31,intra-total,3537,152,61,24,24,30,25,33,25,108,761,4780,4298,4450,FALSE,0.930962343096234,2022,2022-2023
OR,2022-10-31,intra-ucfe,7,1,2,0,0,0,0,0,0,4,1,15,8,9,FALSE,0.6,2022,2022-2023
OR,2022-10-31,intra-ucx,4,0,1,0,0,0,0,0,0,0,0,5,4,4,FALSE,0.8,2022,2022-2023
OR,2022-10-31,intra-ui,3526,151,58,24,24,30,25,33,25,104,760,4760,4286,4437,FALSE,0.932142857142857,2022,2022-2023
OR,2022-11-30,inter-total,154,19,2,7,0,1,3,0,2,3,97,288,251,270,FALSE,0.9375,2022,2022-2023
OR,2022-11-30,inter-ucfe,8,0,1,0,0,0,0,0,0,0,3,12,11,11,FALSE,0.916666666666667,2022,2022-2023
OR,2022-11-30,inter-ucx,0,0,0,0,0,0,0,0,0,0,0,0,0,0,FALSE,0,2022,2022-2023
OR,2022-11-30,inter-ui,146,19,1,7,0,1,3,0,2,3,94,276,240,259,FALSE,0.938405797101449,2022,2022-2023
OR,2022-11-30,intra-total,4064,245,76,34,34,49,24,21,10,73,1024,5654,5088,5333,FALSE,0.943226034665723,2022,2022-2023
OR,2022-11-30,intra-ucfe,26,9,1,0,0,0,0,0,0,0,19,55,45,54,FALSE,0.981818181818182,2022,2022-2023
OR,2022-11-30,intra-ucx,6,0,0,0,0,0,0,0,0,0,0,6,6,6,FALSE,1,2022,2022-2023
OR,2022-11-30,intra-ui,4032,236,75,34,34,49,24,21,10,73,1005,5593,5037,5273,FALSE,0.942785624888253,2022,2022-2023
OR,2022-12-31,inter-total,242,25,8,5,3,2,2,2,1,4,115,409,357,382,FALSE,0.93398533007335,2022,2022-2023
OR,2022-12-31,inter-ucfe,16,1,1,1,2,0,0,0,0,0,12,33,28,29,FALSE,0.878787878787879,2022,2022-2023
OR,2022-12-31,inter-ucx,1,0,0,0,0,0,0,0,0,0,0,1,1,1,FALSE,1,2022,2022-2023
OR,2022-12-31,inter-ui,225,24,7,4,1,2,2,2,1,4,103,375,328,352,FALSE,0.938666666666667,2022,2022-2023
OR,2022-12-31,intra-total,5000,292,103,40,61,52,47,37,24,77,1057,6790,6057,6349,FALSE,0.935051546391753,2022,2022-2023
OR,2022-12-31,intra-ucfe,86,13,6,2,2,0,1,0,1,3,59,173,145,158,FALSE,0.913294797687861,2022,2022-2023
OR,2022-12-31,intra-ucx,7,2,0,0,0,0,1,0,1,0,2,13,9,11,FALSE,0.846153846153846,2022,2022-2023
OR,2022-12-31,intra-ui,4907,277,97,38,59,52,45,37,22,74,996,6604,5903,6180,FALSE,0.935796486977589,2022,2022-2023
OR,2023-01-31,inter-total,214,27,9,4,2,6,2,2,4,7,117,394,331,358,FALSE,0.908629441624365,2022,2022-2023
OR,2023-01-31,inter-ucfe,5,1,1,0,0,0,1,0,0,0,4,12,9,10,FALSE,0.833333333333333,2022,2022-2023
OR,2023-01-31,inter-ucx,0,0,0,0,0,0,0,0,0,0,0,0,0,0,FALSE,0,2022,2022-2023
OR,2023-01-31,inter-ui,209,26,8,4,2,6,1,2,4,7,113,382,322,348,FALSE,0.910994764397906,2022,2022-2023
OR,2023-01-31,intra-total,8319,399,130,69,29,40,51,41,25,116,1701,10920,10020,10419,FALSE,0.954120879120879,2022,2022-2023
OR,2023-01-31,intra-ucfe,24,17,6,3,1,0,0,2,0,1,26,80,50,67,FALSE,0.8375,2022,2022-2023
OR,2023-01-31,intra-ucx,7,2,0,0,0,0,0,0,0,0,0,9,7,9,FALSE,1,2022,2022-2023
OR,2023-01-31,intra-ui,8288,380,124,66,28,40,51,39,25,115,1675,10831,9963,10343,FALSE,0.95494414181516,2022,2022-2023
OR,2023-02-28,inter-total,186,37,15,9,5,2,1,2,0,10,94,361,280,317,FALSE,0.878116343490305,2022,2022-2023
OR,2023-02-28,inter-ucfe,6,13,3,4,0,0,0,0,0,1,7,34,13,26,FALSE,0.764705882352941,2022,2022-2023
OR,2023-02-28,inter-ucx,0,0,0,0,0,0,0,0,0,0,0,0,0,0,FALSE,0,2022,2022-2023
OR,2023-02-28,inter-ui,180,24,12,5,5,2,1,2,0,9,87,327,267,291,FALSE,0.889908256880734,2022,2022-2023
OR,2023-02-28,intra-total,5152,438,219,87,60,32,26,24,11,171,1332,7552,6484,6922,FALSE,0.916578389830508,2022,2022-2023
OR,2023-02-28,intra-ucfe,14,72,36,13,1,6,3,1,0,1,34,181,48,120,FALSE,0.662983425414365,2022,2022-2023
OR,2023-02-28,intra-ucx,3,2,0,1,0,0,0,1,0,0,0,7,3,5,FALSE,0.714285714285714,2022,2022-2023
OR,2023-02-28,intra-ui,5135,364,183,73,59,26,23,22,11,170,1298,7364,6433,6797,FALSE,0.923003802281369,2022,2022-2023
OR,2023-03-31,inter-total,187,17,10,1,1,4,1,3,0,5,86,315,273,290,FALSE,0.920634920634921,2022,2022-2023
OR,2023-03-31,inter-ucfe,4,1,0,0,0,1,0,0,0,0,1,7,5,6,FALSE,0.857142857142857,2022,2022-2023
OR,2023-03-31,inter-ucx,0,0,0,0,0,0,0,0,0,0,0,0,0,0,FALSE,0,2022,2022-2023
OR,2023-03-31,inter-ui,183,16,10,1,1,3,1,3,0,5,85,308,268,284,FALSE,0.922077922077922,2022,2022-2023
OR,2023-03-31,intra-total,4957,341,118,61,47,42,34,16,23,202,1243,7084,6200,6541,FALSE,0.923348390739695,2022,2022-2023
OR,2023-03-31,intra-ucfe,10,9,1,1,2,3,3,0,0,1,10,40,20,29,FALSE,0.725,2022,2022-2023
OR,2023-03-31,intra-ucx,4,1,1,0,0,0,0,0,0,0,2,8,6,7,FALSE,0.875,2022,2022-2023
OR,2023-03-31,intra-ui,4943,331,116,60,45,39,31,16,23,201,1231,7036,6174,6505,FALSE,0.92453098351336,2022,2022-2023
OR,2023-04-30,inter-total,196,9,1,5,1,1,1,2,0,7,73,296,269,278,FALSE,0.939189189189189,2022,2022-2023
OR,2023-04-30,inter-ucfe,0,1,0,0,0,0,0,0,0,0,0,1,0,1,FALSE,1,2022,2022-2023
OR,2023-04-30,inter-ucx,0,0,0,0,0,0,0,0,0,0,0,0,0,0,FALSE,0,2022,2022-2023
OR,2023-04-30,inter-ui,196,8,1,5,1,1,1,2,0,7,73,295,269,277,FALSE,0.938983050847458,2022,2022-2023
OR,2023-04-30,intra-total,4631,203,58,26,15,11,12,16,18,156,993,6139,5624,5827,FALSE,0.949177390454471,2022,2022-2023
OR,2023-04-30,intra-ucfe,5,0,1,1,0,0,0,2,0,1,4,14,9,9,FALSE,0.642857142857143,2022,2022-2023
OR,2023-04-30,intra-ucx,9,2,0,0,0,0,0,0,0,0,2,13,11,13,FALSE,1,2022,2022-2023
OR,2023-04-30,intra-ui,4617,201,57,25,15,11,12,14,18,155,987,6112,5604,5805,FALSE,0.949770942408377,2022,2022-2023
OR,2023-05-31,inter-total,153,11,3,4,0,2,1,1,0,12,66,253,219,230,FALSE,0.909090909090909,2022,2022-2023
OR,2023-05-31,inter-ucfe,0,1,0,0,0,0,1,0,0,0,0,2,0,1,FALSE,0.5,2022,2022-2023
OR,2023-05-31,inter-ucx,0,0,0,0,0,0,0,0,0,0,0,0,0,0,FALSE,0,2022,2022-2023
OR,2023-05-31,inter-ui,153,10,3,4,0,2,0,1,0,12,66,251,219,229,FALSE,0.912350597609562,2022,2022-2023
OR,2023-05-31,intra-total,4626,317,124,49,34,24,14,21,15,193,1130,6547,5756,6073,FALSE,0.927600427676798,2022,2022-2023
OR,2023-05-31,intra-ucfe,5,0,1,0,1,0,0,0,0,0,2,9,7,7,FALSE,0.777777777777778,2022,2022-2023
OR,2023-05-31,intra-ucx,2,1,0,0,0,0,0,0,0,0,2,5,4,5,FALSE,1,2022,2022-2023
OR,2023-05-31,intra-ui,4619,316,123,49,33,24,14,21,15,193,1126,6533,5745,6061,FALSE,0.927751415888566,2022,2022-2023
OR,2023-06-30,inter-total,135,20,14,1,1,0,1,3,1,6,67,249,202,222,FALSE,0.891566265060241,2022,2022-2023
OR,2023-06-30,inter-ucfe,0,0,0,0,0,0,0,0,0,0,0,0,0,0,FALSE,0,2022,2022-2023
OR,2023-06-30,inter-ucx,0,0,0,0,0,0,0,0,0,0,0,0,0,0,FALSE,0,2022,2022-2023
OR,2023-06-30,inter-ui,135,20,14,1,1,0,1,3,1,6,67,249,202,222,FALSE,0.891566265060241,2022,2022-2023
OR,2023-06-30,intra-total,3804,384,160,58,41,37,39,38,49,139,1033,5782,4837,5221,FALSE,0.902974749221723,2022,2022-2023
OR,2023-06-30,intra-ucfe,13,2,0,0,0,0,0,0,0,3,17,35,30,32,FALSE,0.914285714285714,2022,2022-2023
OR,2023-06-30,intra-ucx,6,1,0,0,0,0,0,0,0,2,4,13,10,11,FALSE,0.846153846153846,2022,2022-2023
OR,2023-06-30,intra-ui,3785,381,160,58,41,37,39,38,49,134,1012,5734,4797,5178,FALSE,0.903034530868504,2022,2022-2023
OR,2023-07-31,inter-total,134,16,7,11,3,1,3,3,0,6,48,232,182,198,FALSE,0.853448275862069,2023,2023-2024
OR,2023-07-31,inter-ucfe,0,0,0,0,0,0,0,0,0,1,0,1,0,0,FALSE,0,2023,2023-2024
OR,2023-07-31,inter-ucx,0,0,0,0,0,0,0,0,0,0,0,0,0,0,FALSE,0,2023,2023-2024
OR,2023-07-31,inter-ui,134,16,7,11,3,1,3,3,0,5,48,231,182,198,FALSE,0.857142857142857,2023,2023-2024
OR,2023-07-31,intra-total,5908,363,168,151,108,62,43,41,35,118,1045,8042,6953,7316,FALSE,0.909723949266352,2023,2023-2024
OR,2023-07-31,intra-ucfe,10,3,2,1,0,0,0,0,0,0,3,19,13,16,FALSE,0.842105263157895,2023,2023-2024
OR,2023-07-31,intra-ucx,3,0,0,0,0,0,0,0,0,0,3,6,6,6,FALSE,1,2023,2023-2024
OR,2023-07-31,intra-ui,5895,360,166,150,108,62,43,41,35,118,1039,8017,6934,7294,FALSE,0.909816639640763,2023,2023-2024
OR,2023-08-31,inter-total,146,17,8,9,12,3,7,2,2,5,35,246,181,198,FALSE,0.804878048780488,2023,2023-2024
OR,2023-08-31,inter-ucfe,1,0,0,0,0,0,0,0,0,0,0,1,1,1,FALSE,1,2023,2023-2024
OR,2023-08-31,inter-ucx,0,0,0,0,0,0,0,0,0,0,0,0,0,0,FALSE,0,2023,2023-2024
OR,2023-08-31,inter-ui,145,17,8,9,12,3,7,2,2,5,35,245,180,197,FALSE,0.804081632653061,2023,2023-2024
OR,2023-08-31,intra-total,3767,248,170,250,364,236,101,53,38,96,701,6024,4468,4716,FALSE,0.782868525896414,2023,2023-2024
OR,2023-08-31,intra-ucfe,1,1,3,1,2,1,0,1,0,2,3,15,4,5,FALSE,0.333333333333333,2023,2023-2024
OR,2023-08-31,intra-ucx,5,3,2,0,2,0,0,0,0,0,0,12,5,8,FALSE,0.666666666666667,2023,2023-2024
OR,2023-08-31,intra-ui,3761,244,165,249,360,235,101,52,38,94,698,5997,4459,4703,FALSE,0.784225446056361,2023,2023-2024
OR,2023-09-30,inter-total,90,11,5,2,10,11,10,3,0,3,45,190,135,146,FALSE,0.768421052631579,2023,2023-2024
OR,2023-09-30,inter-ucfe,1,0,0,0,0,0,0,0,0,0,0,1,1,1,FALSE,1,2023,2023-2024
OR,2023-09-30,inter-ucx,0,0,0,0,0,0,0,0,0,0,0,0,0,0,FALSE,0,2023,2023-2024
OR,2023-09-30,inter-ui,89,11,5,2,10,11,10,3,0,3,45,189,134,145,FALSE,0.767195767195767,2023,2023-2024
OR,2023-09-30,intra-total,2886,155,78,66,136,279,296,131,46,95,451,4619,3337,3492,FALSE,0.756007793894782,2023,2023-2024
OR,2023-09-30,intra-ucfe,1,1,1,4,0,0,0,3,0,2,1,13,2,3,FALSE,0.230769230769231,2023,2023-2024
OR,2023-09-30,intra-ucx,5,1,0,0,1,2,1,0,0,0,0,10,5,6,FALSE,0.6,2023,2023-2024
OR,2023-09-30,intra-ui,2880,153,77,62,135,277,295,128,46,93,450,4596,3330,3483,FALSE,0.757832898172324,2023,2023-2024
OR,2023-10-31,inter-total,108,11,8,6,5,8,8,15,10,7,32,218,140,151,FALSE,0.692660550458716,2023,2023-2024
OR,2023-10-31,inter-ucfe,5,0,0,0,0,0,0,0,0,1,0,6,5,5,FALSE,0.833333333333333,2023,2023-2024
OR,2023-10-31,inter-ucx,0,0,0,0,0,0,0,0,0,0,0,0,0,0,FALSE,0,2023,2023-2024
OR,2023-10-31,inter-ui,103,11,8,6,5,8,8,15,10,6,32,212,135,146,FALSE,0.688679245283019,2023,2023-2024
OR,2023-10-31,intra-total,3524,152,94,69,75,93,212,406,301,261,660,5847,4184,4336,FALSE,0.741576877030956,2023,2023-2024
OR,2023-10-31,intra-ucfe,3,2,1,2,0,0,1,1,0,4,3,17,6,8,FALSE,0.470588235294118,2023,2023-2024
OR,2023-10-31,intra-ucx,4,0,0,0,0,0,1,1,0,1,1,8,5,5,FALSE,0.625,2023,2023-2024
OR,2023-10-31,intra-ui,3517,150,93,67,75,93,210,404,301,256,656,5822,4173,4323,FALSE,0.742528340776366,2023,2023-2024
OR,2023-11-30,inter-total,160,13,8,3,5,2,4,11,17,23,71,317,231,244,FALSE,0.769716088328076,2023,2023-2024
OR,2023-11-30,inter-ucfe,10,1,2,0,1,1,0,0,0,0,1,16,11,12,FALSE,0.75,2023,2023-2024
OR,2023-11-30,inter-ucx,1,0,0,0,0,0,0,0,0,0,0,1,1,1,FALSE,1,2023,2023-2024
OR,2023-11-30,inter-ui,149,12,6,3,4,1,4,11,17,23,70,300,219,231,FALSE,0.77,2023,2023-2024
OR,2023-11-30,intra-total,4195,184,93,71,70,74,93,180,426,674,546,6606,4741,4925,FALSE,0.745534362700575,2023,2023-2024
OR,2023-11-30,intra-ucfe,20,4,0,0,0,0,0,1,0,2,24,51,44,48,FALSE,0.941176470588235,2023,2023-2024
OR,2023-11-30,intra-ucx,5,0,0,1,0,0,0,0,0,2,4,12,9,9,FALSE,0.75,2023,2023-2024
OR,2023-11-30,intra-ui,4170,180,93,70,70,74,93,179,426,670,518,6543,4688,4868,FALSE,0.744001222680728,2023,2023-2024
OR,2023-12-31,inter-total,132,20,3,6,4,9,20,14,17,23,59,307,191,211,FALSE,0.687296416938111,2023,2023-2024
OR,2023-12-31,inter-ucfe,10,2,0,2,0,0,0,0,0,0,8,22,18,20,FALSE,0.909090909090909,2023,2023-2024
OR,2023-12-31,inter-ucx,0,0,0,0,0,0,0,0,0,0,0,0,0,0,FALSE,0,2023,2023-2024
OR,2023-12-31,inter-ui,122,18,3,4,4,9,20,14,17,23,51,285,173,191,FALSE,0.670175438596491,2023,2023-2024
OR,2023-12-31,intra-total,4759,178,96,111,128,188,485,557,440,615,573,8130,5332,5510,FALSE,0.677736777367774,2023,2023-2024
OR,2023-12-31,intra-ucfe,75,14,0,4,0,1,2,2,1,1,49,149,124,138,FALSE,0.926174496644295,2023,2023-2024
OR,2023-12-31,intra-ucx,4,2,1,0,0,1,0,1,0,0,1,10,5,7,FALSE,0.7,2023,2023-2024
OR,2023-12-31,intra-ui,4680,162,95,107,128,186,483,554,439,614,523,7971,5203,5365,FALSE,0.673064860117927,2023,2023-2024
OR,2024-01-31,inter-total,179,12,6,7,7,9,16,22,12,14,75,359,254,266,FALSE,0.740947075208914,2023,2023-2024
OR,2024-01-31,inter-ucfe,13,0,0,1,0,0,0,1,2,1,15,33,28,28,FALSE,0.848484848484848,2023,2023-2024
OR,2024-01-31,inter-ucx,0,0,0,0,0,0,0,0,0,0,0,0,0,0,FALSE,0,2023,2023-2024
OR,2024-01-31,inter-ui,166,12,6,6,7,9,16,21,10,13,60,326,226,238,FALSE,0.730061349693252,2023,2023-2024
OR,2024-01-31,intra-total,8489,196,129,98,127,197,475,526,263,423,978,11901,9467,9663,FALSE,0.811948575749937,2023,2023-2024
OR,2024-01-31,intra-ucfe,58,5,4,2,1,0,0,2,2,3,66,143,124,129,FALSE,0.902097902097902,2023,2023-2024
OR,2024-01-31,intra-ucx,1,0,2,0,1,0,0,0,0,3,1,8,2,2,FALSE,0.25,2023,2023-2024
OR,2024-01-31,intra-ui,8430,191,123,96,125,197,475,524,261,417,911,11750,9341,9532,FALSE,0.811234042553192,2023,2023-2024
OR,2024-02-29,inter-total,148,9,8,3,6,28,20,17,7,17,48,311,196,205,FALSE,0.659163987138264,2023,2023-2024
OR,2024-02-29,inter-ucfe,4,0,1,1,0,0,0,2,0,1,3,12,7,7,FALSE,0.583333333333333,2023,2023-2024
OR,2024-02-29,inter-ucx,0,0,0,0,0,0,0,0,0,0,0,0,0,0,FALSE,0,2023,2023-2024
OR,2024-02-29,inter-ui,144,9,7,2,6,28,20,15,7,16,45,299,189,198,FALSE,0.662207357859532,2023,2023-2024
OR,2024-02-29,intra-total,4618,243,176,160,235,487,613,376,200,375,714,8197,5332,5575,FALSE,0.680126875686227,2023,2023-2024
OR,2024-02-29,intra-ucfe,29,8,1,2,4,1,3,4,1,9,39,101,68,76,FALSE,0.752475247524752,2023,2023-2024
OR,2024-02-29,intra-ucx,6,0,0,1,0,2,0,0,0,0,0,9,6,6,FALSE,0.666666666666667,2023,2023-2024
OR,2024-02-29,intra-ui,4583,235,175,157,231,484,610,372,199,366,675,8087,5258,5493,FALSE,0.679238283665142,2023,2023-2024
OR,2024-03-31,inter-total,34,14,5,5,1,2,3,4,1,8,19,96,53,67,FALSE,0.697916666666667,2023,2023-2024
OR,2024-03-31,inter-ucfe,1,0,0,0,1,0,0,0,0,0,1,3,2,2,FALSE,0.666666666666667,2023,2023-2024
OR,2024-03-31,inter-ucx,0,0,0,0,0,0,0,0,0,0,0,0,0,0,FALSE,0,2023,2023-2024
OR,2024-03-31,inter-ui,33,14,5,5,0,2,3,4,1,8,18,93,51,65,FALSE,0.698924731182796,2023,2023-2024
OR,2024-03-31,intra-total,1364,358,156,93,100,101,113,147,81,209,442,3164,1806,2164,FALSE,0.683944374209861,2023,2023-2024
OR,2024-03-31,intra-ucfe,2,1,2,0,0,0,0,0,0,3,2,10,4,5,FALSE,0.5,2023,2023-2024
OR,2024-03-31,intra-ucx,1,0,0,1,0,1,0,0,1,0,1,5,2,2,FALSE,0.4,2023,2023-2024
OR,2024-03-31,intra-ui,1361,357,154,92,100,100,113,147,80,206,439,3149,1800,2157,FALSE,0.684979358526516,2023,2023-2024
OR,2024-04-30,inter-total,39,25,18,23,8,10,10,6,12,26,27,204,66,91,FALSE,0.446078431372549,2023,2023-2024
OR,2024-04-30,inter-ucfe,0,0,1,0,0,0,0,0,0,1,0,2,0,0,FALSE,0,2023,2023-2024
OR,2024-04-30,inter-ucx,0,0,0,0,0,0,0,0,0,0,0,0,0,0,FALSE,0,2023,2023-2024
OR,2024-04-30,inter-ui,39,25,17,23,8,10,10,6,12,25,27,202,66,91,FALSE,0.450495049504951,2023,2023-2024
OR,2024-04-30,intra-total,1776,872,499,486,174,181,272,266,220,688,592,6026,2368,3240,FALSE,0.537670096249585,2023,2023-2024
OR,2024-04-30,intra-ucfe,5,3,1,1,0,2,1,1,0,4,0,18,5,8,FALSE,0.444444444444444,2023,2023-2024
OR,2024-04-30,intra-ucx,1,1,0,0,0,0,0,1,0,1,0,4,1,2,FALSE,0.5,2023,2023-2024
OR,2024-04-30,intra-ui,1770,868,498,485,174,179,271,264,220,683,592,6004,2362,3230,FALSE,0.537974683544304,2023,2023-2024
OR,2024-05-31,inter-total,60,50,36,18,7,7,3,6,3,35,38,263,98,148,FALSE,0.562737642585551,2023,2023-2024
OR,2024-05-31,inter-ucfe,0,0,1,0,1,0,0,0,0,3,0,5,0,0,FALSE,0,2023,2023-2024
OR,2024-05-31,inter-ucx,0,0,0,0,0,0,0,0,0,0,0,0,0,0,FALSE,0,2023,2023-2024
OR,2024-05-31,inter-ui,60,50,35,18,6,7,3,6,3,32,38,258,98,148,FALSE,0.573643410852713,2023,2023-2024
OR,2024-05-31,intra-total,1685,1239,1011,432,233,151,130,128,134,608,1264,7015,2949,4188,FALSE,0.597006414825374,2023,2023-2024
OR,2024-05-31,intra-ucfe,5,3,3,0,1,2,1,0,0,4,1,20,6,9,FALSE,0.45,2023,2023-2024
OR,2024-05-31,intra-ucx,3,2,0,1,0,0,0,0,0,1,1,8,4,6,FALSE,0.75,2023,2023-2024
OR,2024-05-31,intra-ui,1677,1234,1008,431,232,149,129,128,134,603,1262,6987,2939,4173,FALSE,0.597252039501932,2023,2023-2024
OR,2024-06-30,inter-total,68,14,8,6,4,7,2,3,5,34,37,188,105,119,FALSE,0.632978723404255,2023,2023-2024
OR,2024-06-30,inter-ucfe,2,0,0,0,0,0,0,0,0,0,0,2,2,2,FALSE,1,2023,2023-2024
OR,2024-06-30,inter-ucx,0,0,0,0,0,0,0,0,0,0,0,0,0,0,FALSE,0,2023,2023-2024
OR,2024-06-30,inter-ui,66,14,8,6,4,7,2,3,5,34,37,186,103,117,FALSE,0.629032258064516,2023,2023-2024
OR,2024-06-30,intra-total,2554,417,155,119,86,74,70,85,97,613,1167,5437,3721,4138,FALSE,0.761081478756667,2023,2023-2024
OR,2024-06-30,intra-ucfe,22,2,2,0,0,2,0,0,0,2,9,39,31,33,FALSE,0.846153846153846,2023,2023-2024
OR,2024-06-30,intra-ucx,1,0,0,0,0,0,0,0,1,0,0,2,1,1,FALSE,0.5,2023,2023-2024
OR,2024-06-30,intra-ui,2531,415,153,119,86,72,70,85,96,611,1158,5396,3689,4104,FALSE,0.76056338028169,2023,2023-2024
OR,2024-07-31,inter-total,88,27,7,8,6,6,2,1,3,24,35,207,123,150,FALSE,0.72463768115942,2024,2024-2025
OR,2024-07-31,inter-ucfe,0,0,0,1,0,0,0,0,1,0,0,2,0,0,FALSE,0,2024,2024-2025
OR,2024-07-31,inter-ucx,0,0,0,0,0,0,0,0,0,0,0,0,0,0,FALSE,0,2024,2024-2025
OR,2024-07-31,inter-ui,88,27,7,7,6,6,2,1,2,24,35,205,123,150,FALSE,0.731707317073171,2024,2024-2025
OR,2024-07-31,intra-total,4695,1094,475,166,95,81,83,56,49,432,1949,9175,6644,7738,FALSE,0.843378746594006,2024,2024-2025
OR,2024-07-31,intra-ucfe,13,2,1,1,1,0,0,0,1,3,3,25,16,18,FALSE,0.72,2024,2024-2025
OR,2024-07-31,intra-ucx,4,1,0,1,0,0,0,0,0,0,2,8,6,7,FALSE,0.875,2024,2024-2025
OR,2024-07-31,intra-ui,4678,1091,474,164,94,81,83,56,48,429,1944,9142,6622,7713,FALSE,0.843688470794137,2024,2024-2025
OR,2024-08-31,inter-total,82,22,10,9,3,6,3,3,2,13,42,195,124,146,FALSE,0.748717948717949,2024,2024-2025
OR,2024-08-31,inter-ucfe,0,0,0,0,0,0,0,0,0,0,0,0,0,0,FALSE,0,2024,2024-2025
OR,2024-08-31,inter-ucx,0,0,0,0,0,0,0,0,0,0,0,0,0,0,FALSE,0,2024,2024-2025
OR,2024-08-31,inter-ui,82,22,10,9,3,6,3,3,2,13,42,195,124,146,FALSE,0.748717948717949,2024,2024-2025
OR,2024-08-31,intra-total,3480,509,510,223,175,114,81,61,41,333,999,6526,4479,4988,FALSE,0.764327306159975,2024,2024-2025
OR,2024-08-31,intra-ucfe,4,0,2,1,0,0,0,0,0,1,3,11,7,7,FALSE,0.636363636363636,2024,2024-2025
OR,2024-08-31,intra-ucx,8,0,0,1,0,0,0,0,0,0,2,11,10,10,FALSE,0.909090909090909,2024,2024-2025
OR,2024-08-31,intra-ui,3468,509,508,221,175,114,81,61,41,332,994,6504,4462,4971,FALSE,0.76429889298893,2024,2024-2025
OR,2024-09-30,inter-total,100,20,4,4,3,9,3,6,1,17,29,196,129,149,FALSE,0.760204081632653,2024,2024-2025
OR,2024-09-30,inter-ucfe,1,0,0,0,0,0,0,0,0,0,0,1,1,1,FALSE,1,2024,2024-2025
OR,2024-09-30,inter-ucx,0,0,0,0,0,0,0,0,0,0,0,0,0,0,FALSE,0,2024,2024-2025
OR,2024-09-30,inter-ui,99,20,4,4,3,9,3,6,1,17,29,195,128,148,FALSE,0.758974358974359,2024,2024-2025
OR,2024-09-30,intra-total,3562,385,217,153,97,68,70,63,54,309,867,5845,4429,4814,FALSE,0.823609923011121,2024,2024-2025
OR,2024-09-30,intra-ucfe,1,0,1,1,0,0,0,0,1,7,1,12,2,2,FALSE,0.166666666666667,2024,2024-2025
OR,2024-09-30,intra-ucx,4,1,0,0,0,0,0,0,0,0,1,6,5,6,FALSE,1,2024,2024-2025
OR,2024-09-30,intra-ui,3557,384,216,152,97,68,70,63,53,302,865,5827,4422,4806,FALSE,0.82478119100738,2024,2024-2025
OR,2024-10-31,inter-total,107,29,13,6,5,2,2,1,1,18,48,232,155,184,FALSE,0.793103448275862,2024,2024-2025
OR,2024-10-31,inter-ucfe,3,0,0,0,0,0,0,0,0,0,0,3,3,3,FALSE,1,2024,2024-2025
OR,2024-10-31,inter-ucx,0,0,0,0,0,0,0,0,0,0,0,0,0,0,FALSE,0,2024,2024-2025
OR,2024-10-31,inter-ui,104,29,13,6,5,2,2,1,1,18,48,229,152,181,FALSE,0.790393013100437,2024,2024-2025
OR,2024-10-31,intra-total,4079,433,176,95,79,65,51,51,48,372,1143,6592,5222,5655,FALSE,0.857858009708738,2024,2024-2025
OR,2024-10-31,intra-ucfe,12,3,2,0,1,0,0,0,0,3,6,27,18,21,FALSE,0.777777777777778,2024,2024-2025
OR,2024-10-31,intra-ucx,6,0,2,0,0,0,0,0,0,0,4,12,10,10,FALSE,0.833333333333333,2024,2024-2025
OR,2024-10-31,intra-ui,4061,430,172,95,78,65,51,51,48,369,1133,6553,5194,5624,FALSE,0.85823287044102,2024,2024-2025
OR,2024-11-30,inter-total,133,24,10,5,1,5,3,3,2,7,47,240,180,204,FALSE,0.85,2024,2024-2025
OR,2024-11-30,inter-ucfe,14,2,0,0,0,0,0,1,1,0,2,20,16,18,FALSE,0.9,2024,2024-2025
OR,2024-11-30,inter-ucx,0,0,0,0,0,0,0,0,0,0,0,0,0,0,FALSE,0,2024,2024-2025
OR,2024-11-30,inter-ui,119,22,10,5,1,5,3,2,1,7,45,220,164,186,FALSE,0.845454545454546,2024,2024-2025
OR,2024-11-30,intra-total,4642,370,157,99,80,35,26,20,17,234,1087,6767,5729,6099,FALSE,0.901285650953155,2024,2024-2025
OR,2024-11-30,intra-ucfe,74,3,1,2,1,0,0,0,0,3,12,96,86,89,FALSE,0.927083333333333,2024,2024-2025
OR,2024-11-30,intra-ucx,7,0,0,0,0,0,0,0,0,0,1,8,8,8,FALSE,1,2024,2024-2025
OR,2024-11-30,intra-ui,4561,367,156,97,79,35,26,20,17,231,1074,6663,5635,6002,FALSE,0.90079543749062,2024,2024-2025
OR,2024-12-31,inter-total,178,29,14,10,11,0,3,1,1,8,56,311,234,263,FALSE,0.845659163987138,2024,2024-2025
OR,2024-12-31,inter-ucfe,12,0,2,2,0,0,0,0,0,1,7,24,19,19,FALSE,0.791666666666667,2024,2024-2025
OR,2024-12-31,inter-ucx,0,0,0,0,0,0,0,0,0,0,0,0,0,0,FALSE,0,2024,2024-2025
OR,2024-12-31,inter-ui,166,29,12,8,11,0,3,1,1,7,49,287,215,244,FALSE,0.850174216027875,2024,2024-2025
OR,2024-12-31,intra-total,6225,644,225,177,100,67,46,45,29,255,1508,9321,7733,8377,FALSE,0.898723312949254,2024,2024-2025
OR,2024-12-31,intra-ucfe,155,5,2,1,0,3,1,0,0,2,25,194,180,185,FALSE,0.95360824742268,2024,2024-2025
OR,2024-12-31,intra-ucx,5,0,0,0,0,0,0,0,0,0,1,6,6,6,FALSE,1,2024,2024-2025
OR,2024-12-31,intra-ui,6065,639,223,176,100,64,45,45,29,253,1482,9121,7547,8186,FALSE,0.897489310382633,2024,2024-2025
PA,2019-01-31,inter-total,704,44,22,11,0,4,4,6,3,11,142,951,846,890,FALSE,0.935856992639327,2018,2018-2019
PA,2019-01-31,inter-ucfe,11,1,0,0,0,0,0,0,0,0,9,21,20,21,FALSE,1,2018,2018-2019
PA,2019-01-31,inter-ucx,0,0,0,0,0,0,0,0,0,0,0,0,0,0,FALSE,0,2018,2018-2019
PA,2019-01-31,inter-ui,693,43,22,11,0,4,4,6,3,11,133,930,826,869,FALSE,0.934408602150538,2018,2018-2019
PA,2019-01-31,intra-total,35410,1192,440,191,136,108,106,97,84,180,4112,42056,39522,40714,FALSE,0.968090165493628,2018,2018-2019
PA,2019-01-31,intra-ucfe,880,88,12,5,5,3,0,0,0,1,373,1367,1253,1341,FALSE,0.980980248719824,2018,2018-2019
PA,2019-01-31,intra-ucx,30,1,1,1,0,0,1,0,0,0,3,37,33,34,FALSE,0.918918918918919,2018,2018-2019
PA,2019-01-31,intra-ui,34500,1103,427,185,131,105,105,97,84,179,3736,40652,38236,39339,FALSE,0.967701466102529,2018,2018-2019
PA,2019-02-28,inter-total,419,58,32,10,6,5,1,4,2,5,133,675,552,610,FALSE,0.903703703703704,2018,2018-2019
PA,2019-02-28,inter-ucfe,0,1,0,0,0,0,0,0,0,1,0,2,0,1,FALSE,0.5,2018,2018-2019
PA,2019-02-28,inter-ucx,1,0,0,0,0,0,0,0,0,0,0,1,1,1,FALSE,1,2018,2018-2019
PA,2019-02-28,inter-ui,418,57,32,10,6,5,1,4,2,4,133,672,551,608,FALSE,0.904761904761905,2018,2018-2019
PA,2019-02-28,intra-total,18079,1255,507,217,125,106,98,81,52,169,3161,23850,21240,22495,FALSE,0.943186582809224,2018,2018-2019
PA,2019-02-28,intra-ucfe,14,39,9,10,2,3,3,2,2,3,29,116,43,82,FALSE,0.706896551724138,2018,2018-2019
PA,2019-02-28,intra-ucx,28,1,0,0,1,1,0,0,0,0,6,37,34,35,FALSE,0.945945945945946,2018,2018-2019
PA,2019-02-28,intra-ui,18037,1215,498,207,122,102,95,79,50,166,3126,23697,21163,22378,FALSE,0.944338945858125,2018,2018-2019
PA,2019-03-31,inter-total,402,31,16,5,10,5,4,3,5,4,80,565,482,513,FALSE,0.907964601769912,2018,2018-2019
PA,2019-03-31,inter-ucfe,0,0,0,0,0,0,0,0,1,0,0,1,0,0,FALSE,0,2018,2018-2019
PA,2019-03-31,inter-ucx,0,0,0,0,0,0,0,0,0,0,0,0,0,0,FALSE,0,2018,2018-2019
PA,2019-03-31,inter-ui,402,31,16,5,10,5,4,3,4,4,80,564,482,513,FALSE,0.909574468085106,2018,2018-2019
PA,2019-03-31,intra-total,10467,1550,398,209,162,196,163,105,75,205,2487,16017,12954,14504,FALSE,0.905537866017356,2018,2018-2019
PA,2019-03-31,intra-ucfe,15,10,3,5,4,5,4,0,3,3,6,58,21,31,FALSE,0.53448275862069,2018,2018-2019
PA,2019-03-31,intra-ucx,31,1,0,0,0,1,0,0,0,0,4,37,35,36,FALSE,0.972972972972973,2018,2018-2019
PA,2019-03-31,intra-ui,10421,1539,395,204,158,190,159,105,72,202,2477,15922,12898,14437,FALSE,0.906732822509735,2018,2018-2019
PA,2019-04-30,inter-total,341,18,9,3,4,3,4,0,1,6,38,427,379,397,FALSE,0.929742388758782,2018,2018-2019
PA,2019-04-30,inter-ucfe,0,0,0,0,0,0,0,0,0,0,0,0,0,0,FALSE,0,2018,2018-2019
PA,2019-04-30,inter-ucx,0,0,0,0,0,0,0,0,0,0,0,0,0,0,FALSE,0,2018,2018-2019
PA,2019-04-30,inter-ui,341,18,9,3,4,3,4,0,1,6,38,427,379,397,FALSE,0.929742388758782,2018,2018-2019
PA,2019-04-30,intra-total,9749,621,253,155,116,150,154,103,75,207,2173,13756,11922,12543,FALSE,0.911820296597848,2018,2018-2019
PA,2019-04-30,intra-ucfe,19,6,4,4,1,4,0,0,0,2,10,50,29,35,FALSE,0.7,2018,2018-2019
PA,2019-04-30,intra-ucx,30,1,0,1,0,1,0,0,0,0,2,35,32,33,FALSE,0.942857142857143,2018,2018-2019
PA,2019-04-30,intra-ui,9700,614,249,150,115,145,154,103,75,205,2161,13671,11861,12475,FALSE,0.912515543851949,2018,2018-2019
PA,2019-05-31,inter-total,442,15,5,7,3,3,1,5,2,9,74,566,516,531,FALSE,0.938162544169611,2018,2018-2019
PA,2019-05-31,inter-ucfe,1,0,0,0,0,0,0,0,0,0,0,1,1,1,FALSE,1,2018,2018-2019
PA,2019-05-31,inter-ucx,0,0,0,0,0,0,0,0,0,0,0,0,0,0,FALSE,0,2018,2018-2019
PA,2019-05-31,inter-ui,441,15,5,7,3,3,1,5,2,9,74,565,515,530,FALSE,0.938053097345133,2018,2018-2019
PA,2019-05-31,intra-total,12078,662,288,174,173,164,126,84,55,191,2379,16374,14457,15119,FALSE,0.923354097960181,2018,2018-2019
PA,2019-05-31,intra-ucfe,20,4,1,1,1,0,1,0,0,1,12,41,32,36,FALSE,0.878048780487805,2018,2018-2019
PA,2019-05-31,intra-ucx,34,1,0,0,0,0,2,0,0,0,1,38,35,36,FALSE,0.947368421052632,2018,2018-2019
PA,2019-05-31,intra-ui,12024,657,287,173,172,164,123,84,55,190,2366,16295,14390,15047,FALSE,0.923412089598036,2018,2018-2019
PA,2019-06-30,inter-total,338,23,15,3,4,6,0,1,0,6,68,464,406,429,FALSE,0.924568965517241,2018,2018-2019
PA,2019-06-30,inter-ucfe,0,0,1,0,1,1,0,0,0,0,1,4,1,1,FALSE,0.25,2018,2018-2019
PA,2019-06-30,inter-ucx,0,0,0,0,0,0,0,0,0,0,0,0,0,0,FALSE,0,2018,2018-2019
PA,2019-06-30,inter-ui,338,23,14,3,3,5,0,1,0,6,67,460,405,428,FALSE,0.930434782608696,2018,2018-2019
PA,2019-06-30,intra-total,16164,617,282,108,142,183,143,90,55,145,1979,19908,18143,18760,FALSE,0.942334739803094,2018,2018-2019
PA,2019-06-30,intra-ucfe,11,4,4,1,1,0,1,0,0,3,5,30,16,20,FALSE,0.666666666666667,2018,2018-2019
PA,2019-06-30,intra-ucx,14,0,1,0,0,1,0,0,0,0,2,18,16,16,FALSE,0.888888888888889,2018,2018-2019
PA,2019-06-30,intra-ui,16139,613,277,107,141,182,142,90,55,142,1972,19860,18111,18724,FALSE,0.942799597180262,2018,2018-2019
PA,2019-07-31,inter-total,330,43,7,5,5,5,2,4,0,5,81,487,411,454,FALSE,0.932238193018481,2019,2019-2020
PA,2019-07-31,inter-ucfe,0,0,0,0,0,0,0,0,0,0,1,1,1,1,FALSE,1,2019,2019-2020
PA,2019-07-31,inter-ucx,1,0,0,0,0,0,0,0,0,0,0,1,1,1,FALSE,1,2019,2019-2020
PA,2019-07-31,inter-ui,329,43,7,5,5,5,2,4,0,5,80,485,409,452,FALSE,0.931958762886598,2019,2019-2020
PA,2019-07-31,intra-total,20550,1025,399,206,165,134,137,90,54,142,3157,26059,23707,24732,FALSE,0.949077094286043,2019,2019-2020
PA,2019-07-31,intra-ucfe,17,2,7,0,0,2,0,0,1,3,6,38,23,25,FALSE,0.657894736842105,2019,2019-2020
PA,2019-07-31,intra-ucx,27,0,1,0,0,0,0,0,0,0,5,33,32,32,FALSE,0.96969696969697,2019,2019-2020
PA,2019-07-31,intra-ui,20506,1023,391,206,165,132,137,90,53,139,3146,25988,23652,24675,FALSE,0.949476681545329,2019,2019-2020
PA,2019-08-31,inter-total,259,22,15,5,2,9,8,1,1,5,86,413,345,367,FALSE,0.88861985472155,2019,2019-2020
PA,2019-08-31,inter-ucfe,1,0,0,0,0,0,1,0,0,0,0,2,1,1,FALSE,0.5,2019,2019-2020
PA,2019-08-31,inter-ucx,0,0,0,0,0,0,0,0,0,0,0,0,0,0,FALSE,0,2019,2019-2020
PA,2019-08-31,inter-ui,258,22,15,5,2,9,7,1,1,5,86,411,344,366,FALSE,0.89051094890511,2019,2019-2020
PA,2019-08-31,intra-total,10016,933,491,376,232,180,125,100,51,124,2673,15301,12689,13622,FALSE,0.890268609894778,2019,2019-2020
PA,2019-08-31,intra-ucfe,18,9,6,2,2,4,3,1,0,2,11,58,29,38,FALSE,0.655172413793103,2019,2019-2020
PA,2019-08-31,intra-ucx,23,0,0,0,0,0,0,0,0,0,4,27,27,27,FALSE,1,2019,2019-2020
PA,2019-08-31,intra-ui,9975,924,485,374,230,176,122,99,51,122,2658,15216,12633,13557,FALSE,0.890970031545741,2019,2019-2020
PA,2019-09-30,inter-total,277,23,5,5,4,3,1,5,3,5,66,397,343,366,FALSE,0.92191435768262,2019,2019-2020
PA,2019-09-30,inter-ucfe,1,1,0,0,0,0,0,0,1,0,0,3,1,2,FALSE,0.666666666666667,2019,2019-2020
PA,2019-09-30,inter-ucx,0,0,0,0,0,0,0,0,0,0,1,1,1,1,FALSE,1,2019,2019-2020
PA,2019-09-30,inter-ui,276,22,5,5,4,3,1,5,2,5,65,393,341,363,FALSE,0.923664122137404,2019,2019-2020
PA,2019-09-30,intra-total,9211,683,303,227,184,199,156,109,79,96,2160,13407,11371,12054,FALSE,0.89908256880734,2019,2019-2020
PA,2019-09-30,intra-ucfe,9,5,1,2,3,2,1,1,0,1,7,32,16,21,FALSE,0.65625,2019,2019-2020
PA,2019-09-30,intra-ucx,16,2,0,0,1,0,0,0,0,0,1,20,17,19,FALSE,0.95,2019,2019-2020
PA,2019-09-30,intra-ui,9186,676,302,225,180,197,155,108,79,95,2152,13355,11338,12014,FALSE,0.899588169225009,2019,2019-2020
PA,2019-10-31,inter-total,386,11,6,5,5,7,4,2,2,9,82,519,468,479,FALSE,0.922928709055877,2019,2019-2020
PA,2019-10-31,inter-ucfe,1,0,0,0,0,0,0,0,0,0,0,1,1,1,FALSE,1,2019,2019-2020
PA,2019-10-31,inter-ucx,0,0,0,0,0,0,0,0,0,0,0,0,0,0,FALSE,0,2019,2019-2020
PA,2019-10-31,inter-ui,385,11,6,5,5,7,4,2,2,9,82,518,467,478,FALSE,0.922779922779923,2019,2019-2020
PA,2019-10-31,intra-total,10952,643,280,155,129,137,156,112,81,160,2521,15326,13473,14116,FALSE,0.921049197442255,2019,2019-2020
PA,2019-10-31,intra-ucfe,18,5,1,3,2,2,0,2,1,1,15,50,33,38,FALSE,0.76,2019,2019-2020
PA,2019-10-31,intra-ucx,31,0,1,2,0,0,0,0,0,0,7,41,38,38,FALSE,0.926829268292683,2019,2019-2020
PA,2019-10-31,intra-ui,10903,638,278,150,127,135,156,110,80,159,2499,15235,13402,14040,FALSE,0.921562192320315,2019,2019-2020
PA,2019-11-30,inter-total,410,24,15,8,3,3,1,0,3,3,95,565,505,529,FALSE,0.936283185840708,2019,2019-2020
PA,2019-11-30,inter-ucfe,1,0,0,0,0,1,0,0,0,0,0,2,1,1,FALSE,0.5,2019,2019-2020
PA,2019-11-30,inter-ucx,0,0,0,0,0,0,0,0,0,0,0,0,0,0,FALSE,0,2019,2019-2020
PA,2019-11-30,inter-ui,409,24,15,8,3,2,1,0,3,3,95,563,504,528,FALSE,0.937833037300178,2019,2019-2020
PA,2019-11-30,intra-total,10529,612,293,137,92,93,122,75,57,108,1947,14065,12476,13088,FALSE,0.930536793458941,2019,2019-2020
PA,2019-11-30,intra-ucfe,17,5,2,2,2,0,1,1,2,2,13,47,30,35,FALSE,0.74468085106383,2019,2019-2020
PA,2019-11-30,intra-ucx,12,4,2,0,0,0,0,0,0,0,3,21,15,19,FALSE,0.904761904761905,2019,2019-2020
PA,2019-11-30,intra-ui,10500,603,289,135,90,93,121,74,55,106,1931,13997,12431,13034,FALSE,0.931199542759163,2019,2019-2020
PA,2019-12-31,inter-total,382,35,21,5,8,6,1,0,2,3,130,593,512,547,FALSE,0.922428330522766,2019,2019-2020
PA,2019-12-31,inter-ucfe,0,1,1,0,0,0,0,0,0,0,0,2,0,1,FALSE,0.5,2019,2019-2020
PA,2019-12-31,inter-ucx,0,0,0,0,0,0,0,0,0,0,0,0,0,0,FALSE,0,2019,2019-2020
PA,2019-12-31,inter-ui,382,34,20,5,8,6,1,0,2,3,130,591,512,546,FALSE,0.923857868020305,2019,2019-2020
PA,2019-12-31,intra-total,19135,874,329,191,135,155,125,119,88,149,3223,24523,22358,23232,FALSE,0.947355543775231,2019,2019-2020
PA,2019-12-31,intra-ucfe,17,4,4,2,4,3,2,0,1,0,18,55,35,39,FALSE,0.709090909090909,2019,2019-2020
PA,2019-12-31,intra-ucx,17,1,0,1,0,0,0,0,1,0,3,23,20,21,FALSE,0.91304347826087,2019,2019-2020
PA,2019-12-31,intra-ui,19101,869,325,188,131,152,123,119,86,149,3202,24445,22303,23172,FALSE,0.947923910820209,2019,2019-2020
PA,2020-01-31,inter-total,624,44,24,12,12,5,1,1,0,5,148,876,772,816,FALSE,0.931506849315068,2019,2019-2020
PA,2020-01-31,inter-ucfe,1,0,0,0,0,0,0,0,0,0,0,1,1,1,FALSE,1,2019,2019-2020
PA,2020-01-31,inter-ucx,0,0,0,0,0,0,0,0,0,0,0,0,0,0,FALSE,0,2019,2019-2020
PA,2020-01-31,inter-ui,623,44,24,12,12,5,1,1,0,5,148,875,771,815,FALSE,0.931428571428571,2019,2019-2020
PA,2020-01-31,intra-total,35964,1063,420,214,121,129,148,112,101,215,3797,42284,39761,40824,FALSE,0.965471573171885,2019,2019-2020
PA,2020-01-31,intra-ucfe,22,8,2,4,3,5,2,0,0,1,12,59,34,42,FALSE,0.711864406779661,2019,2019-2020
PA,2020-01-31,intra-ucx,17,1,1,0,0,0,0,0,0,0,3,22,20,21,FALSE,0.954545454545455,2019,2019-2020
PA,2020-01-31,intra-ui,35925,1054,417,210,118,124,146,112,101,214,3782,42203,39707,40761,FALSE,0.965831812904296,2019,2019-2020
PA,2020-02-29,inter-total,317,46,13,12,9,5,1,0,4,4,108,519,425,471,FALSE,0.907514450867052,2019,2019-2020
PA,2020-02-29,inter-ucfe,0,0,1,1,0,0,0,0,0,0,1,3,1,1,FALSE,0.333333333333333,2019,2019-2020
PA,2020-02-29,inter-ucx,0,0,0,0,0,0,0,0,0,0,0,0,0,0,FALSE,0,2019,2019-2020
PA,2020-02-29,inter-ui,317,46,12,11,9,5,1,0,4,4,107,516,424,470,FALSE,0.910852713178295,2019,2019-2020
PA,2020-02-29,intra-total,17873,949,434,236,147,127,111,97,60,186,2956,23176,20829,21778,FALSE,0.939678978253366,2019,2019-2020
PA,2020-02-29,intra-ucfe,7,11,9,4,2,3,0,0,1,3,13,53,20,31,FALSE,0.584905660377359,2019,2019-2020
PA,2020-02-29,intra-ucx,22,3,0,1,1,0,0,0,0,0,5,32,27,30,FALSE,0.9375,2019,2019-2020
PA,2020-02-29,intra-ui,17844,935,425,231,144,124,111,97,59,183,2938,23091,20782,21717,FALSE,0.940496297258672,2019,2019-2020
PA,2020-03-31,inter-total,341,18,6,6,3,1,0,2,0,5,60,442,401,419,FALSE,0.947963800904977,2019,2019-2020
PA,2020-03-31,inter-ucfe,0,1,0,0,0,0,0,0,0,0,1,2,1,2,FALSE,1,2019,2019-2020
PA,2020-03-31,inter-ucx,0,0,0,0,0,0,0,0,0,0,0,0,0,0,FALSE,0,2019,2019-2020
PA,2020-03-31,inter-ui,341,17,6,6,3,1,0,2,0,5,59,440,400,417,FALSE,0.947727272727273,2019,2019-2020
PA,2020-03-31,intra-total,12278,548,213,119,124,130,102,54,48,112,1980,15708,14258,14806,FALSE,0.942577030812325,2019,2019-2020
PA,2020-03-31,intra-ucfe,9,9,6,2,3,1,2,1,1,1,8,43,17,26,FALSE,0.604651162790698,2019,2019-2020
PA,2020-03-31,intra-ucx,14,1,0,0,0,0,0,0,0,0,4,19,18,19,FALSE,1,2019,2019-2020
PA,2020-03-31,intra-ui,12255,538,207,117,121,129,100,53,47,111,1968,15646,14223,14761,FALSE,0.94343602198645,2019,2019-2020
PA,2020-04-30,inter-total,229,1351,728,382,84,3,1,1,1,10,4175,6965,4404,5755,FALSE,0.826274228284279,2019,2019-2020
PA,2020-04-30,inter-ucfe,0,0,0,0,0,0,0,0,0,0,0,0,0,0,FALSE,0,2019,2019-2020
PA,2020-04-30,inter-ucx,0,1,0,0,0,0,0,0,0,0,0,1,0,1,FALSE,1,2019,2019-2020
PA,2020-04-30,inter-ui,229,1350,728,382,84,3,1,1,1,10,4175,6964,4404,5754,FALSE,0.826249282021827,2019,2019-2020
PA,2020-04-30,intra-total,31258,116068,52243,12250,2114,70,58,59,56,184,414792,629152,446050,562118,FALSE,0.893453410304664,2019,2019-2020
PA,2020-04-30,intra-ucfe,0,8,9,7,2,4,1,0,0,1,5,37,5,13,FALSE,0.351351351351351,2019,2019-2020
PA,2020-04-30,intra-ucx,2,41,23,5,0,0,0,0,0,0,30,101,32,73,FALSE,0.722772277227723,2019,2019-2020
PA,2020-04-30,intra-ui,31256,116019,52211,12238,2112,66,57,59,56,183,414757,629014,446013,562032,FALSE,0.893512704009768,2019,2019-2020
PA,2020-05-31,inter-total,49,350,382,459,465,300,168,77,20,5,1043,3318,1092,1442,FALSE,0.434599156118144,2019,2019-2020
PA,2020-05-31,inter-ucfe,0,0,1,0,0,0,1,0,0,0,0,2,0,0,FALSE,0,2019,2019-2020
PA,2020-05-31,inter-ucx,0,0,0,0,1,0,0,0,0,0,1,2,1,1,FALSE,0.5,2019,2019-2020
PA,2020-05-31,inter-ui,49,350,381,459,464,300,167,77,20,5,1042,3314,1091,1441,FALSE,0.434821967410984,2019,2019-2020
PA,2020-05-31,intra-total,5511,19434,17713,19400,20093,11738,5759,2067,491,515,68658,171379,74169,93603,FALSE,0.546175435730165,2019,2019-2020
PA,2020-05-31,intra-ucfe,0,1,6,5,12,17,6,5,3,4,2,61,2,3,FALSE,0.0491803278688525,2019,2019-2020
PA,2020-05-31,intra-ucx,2,10,14,14,9,10,11,4,1,2,15,92,17,27,FALSE,0.293478260869565,2019,2019-2020
PA,2020-05-31,intra-ui,5509,19423,17693,19381,20072,11711,5742,2058,487,509,68641,171226,74150,93573,FALSE,0.546488266968802,2019,2019-2020
PA,2020-06-30,inter-total,23,159,143,117,145,128,149,159,142,268,516,1949,539,698,FALSE,0.358132375577219,2019,2019-2020
PA,2020-06-30,inter-ucfe,0,1,0,0,0,0,0,0,0,2,1,4,1,2,FALSE,0.5,2019,2019-2020
PA,2020-06-30,inter-ucx,0,0,0,0,0,0,0,0,1,0,0,1,0,0,FALSE,0,2019,2019-2020
PA,2020-06-30,inter-ui,23,158,143,117,145,128,149,159,141,266,515,1944,538,696,FALSE,0.358024691358025,2019,2019-2020
PA,2020-06-30,intra-total,3141,5446,3983,3632,4702,5050,5815,5077,5421,7844,35623,85734,38764,44210,FALSE,0.515664730445331,2019,2019-2020
PA,2020-06-30,intra-ucfe,1,2,4,3,2,4,2,7,5,31,1,62,2,4,FALSE,0.0645161290322581,2019,2019-2020
PA,2020-06-30,intra-ucx,0,9,12,8,9,8,3,4,9,10,15,87,15,24,FALSE,0.275862068965517,2019,2019-2020
PA,2020-06-30,intra-ui,3140,5435,3967,3621,4691,5038,5810,5066,5407,7803,35607,85585,38747,44182,FALSE,0.516235321610095,2019,2019-2020
PA,2020-07-31,inter-total,32,153,123,73,55,62,80,75,65,440,683,1841,715,868,FALSE,0.47148288973384,2020,2020-2021
PA,2020-07-31,inter-ucfe,0,0,0,0,0,0,0,0,0,2,0,2,0,0,FALSE,0,2020,2020-2021
PA,2020-07-31,inter-ucx,0,0,0,0,0,0,0,0,0,0,0,0,0,0,FALSE,0,2020,2020-2021
PA,2020-07-31,inter-ui,32,153,123,73,55,62,80,75,65,438,683,1839,715,868,FALSE,0.471995649809679,2020,2020-2021
PA,2020-07-31,intra-total,2669,4426,3053,2213,1917,1746,1695,1818,2073,15132,33617,70359,36286,40712,FALSE,0.578632442189343,2020,2020-2021
PA,2020-07-31,intra-ucfe,0,6,4,5,0,4,3,7,6,49,8,92,8,14,FALSE,0.152173913043478,2020,2020-2021
PA,2020-07-31,intra-ucx,0,6,11,5,3,9,8,4,4,18,19,87,19,25,FALSE,0.28735632183908,2020,2020-2021
PA,2020-07-31,intra-ui,2669,4414,3038,2203,1914,1733,1684,1807,2063,15065,33590,70180,36259,40673,FALSE,0.57955257908236,2020,2020-2021
PA,2020-08-31,inter-total,24,73,61,59,52,43,49,26,22,270,312,991,336,409,FALSE,0.412714429868819,2020,2020-2021
PA,2020-08-31,inter-ucfe,0,0,0,0,0,0,0,0,0,1,1,2,1,1,FALSE,0.5,2020,2020-2021
PA,2020-08-31,inter-ucx,0,0,0,0,0,0,0,0,0,0,0,0,0,0,FALSE,0,2020,2020-2021
PA,2020-08-31,inter-ui,24,73,61,59,52,43,49,26,22,269,311,989,335,408,FALSE,0.412537917087968,2020,2020-2021
PA,2020-08-31,intra-total,1257,2921,2596,2053,1803,1428,1268,1198,1222,13322,13192,42260,14449,17370,FALSE,0.411026975863701,2020,2020-2021
PA,2020-08-31,intra-ucfe,2,7,3,4,3,4,6,5,6,72,17,129,19,26,FALSE,0.201550387596899,2020,2020-2021
PA,2020-08-31,intra-ucx,0,10,7,3,3,4,3,5,5,21,16,77,16,26,FALSE,0.337662337662338,2020,2020-2021
PA,2020-08-31,intra-ui,1255,2904,2586,2046,1797,1420,1259,1188,1211,13229,13159,42054,14414,17318,FALSE,0.411803871213202,2020,2020-2021
PA,2020-09-30,inter-total,21,69,39,44,36,34,36,28,42,185,409,943,430,499,FALSE,0.529162248144221,2020,2020-2021
PA,2020-09-30,inter-ucfe,0,1,0,0,0,0,1,0,2,1,0,5,0,1,FALSE,0.2,2020,2020-2021
PA,2020-09-30,inter-ucx,0,0,0,0,0,0,1,0,0,0,0,1,0,0,FALSE,0,2020,2020-2021
PA,2020-09-30,inter-ui,21,68,39,44,36,34,34,28,40,184,409,937,430,498,FALSE,0.531483457844184,2020,2020-2021
PA,2020-09-30,intra-total,1019,1866,1005,739,734,714,690,682,729,7741,11144,27063,12163,14029,FALSE,0.518383032184163,2020,2020-2021
PA,2020-09-30,intra-ucfe,0,7,0,2,3,2,2,3,4,37,14,74,14,21,FALSE,0.283783783783784,2020,2020-2021
PA,2020-09-30,intra-ucx,1,12,8,6,3,5,3,4,3,13,11,69,12,24,FALSE,0.347826086956522,2020,2020-2021
PA,2020-09-30,intra-ui,1018,1847,997,731,728,707,685,675,722,7691,11119,26920,12137,13984,FALSE,0.519465081723626,2020,2020-2021
PA,2020-10-31,inter-total,30,72,27,28,18,25,15,25,26,205,339,810,369,441,FALSE,0.544444444444444,2020,2020-2021
PA,2020-10-31,inter-ucfe,0,1,1,0,1,1,0,0,0,0,0,4,0,1,FALSE,0.25,2020,2020-2021
PA,2020-10-31,inter-ucx,0,0,0,0,0,0,0,0,0,0,0,0,0,0,FALSE,0,2020,2020-2021
PA,2020-10-31,inter-ui,30,71,26,28,17,24,15,25,26,205,339,806,369,440,FALSE,0.54590570719603,2020,2020-2021
PA,2020-10-31,intra-total,893,1467,934,662,578,518,438,385,389,7896,8362,22522,9255,10722,FALSE,0.476067844773999,2020,2020-2021
PA,2020-10-31,intra-ucfe,0,5,5,1,5,4,1,3,0,39,13,76,13,18,FALSE,0.236842105263158,2020,2020-2021
PA,2020-10-31,intra-ucx,2,5,4,4,4,4,1,1,1,11,18,55,20,25,FALSE,0.454545454545455,2020,2020-2021
PA,2020-10-31,intra-ui,891,1457,925,657,569,510,436,381,388,7846,8331,22391,9222,10679,FALSE,0.476932696172569,2020,2020-2021
PA,2020-11-30,inter-total,15,68,54,33,38,27,11,14,28,200,260,748,275,343,FALSE,0.45855614973262,2020,2020-2021
PA,2020-11-30,inter-ucfe,0,0,0,0,0,0,0,0,0,1,1,2,1,1,FALSE,0.5,2020,2020-2021
PA,2020-11-30,inter-ucx,0,0,0,0,0,0,0,0,0,0,0,0,0,0,FALSE,0,2020,2020-2021
PA,2020-11-30,inter-ui,15,68,54,33,38,27,11,14,28,199,259,746,274,342,FALSE,0.458445040214477,2020,2020-2021
PA,2020-11-30,intra-total,936,1463,856,564,487,419,394,355,389,8014,9494,23371,10430,11893,FALSE,0.508878524667323,2020,2020-2021
PA,2020-11-30,intra-ucfe,1,27,12,15,8,1,2,1,1,39,19,126,20,47,FALSE,0.373015873015873,2020,2020-2021
PA,2020-11-30,intra-ucx,1,5,5,4,2,1,2,2,1,14,15,52,16,21,FALSE,0.403846153846154,2020,2020-2021
PA,2020-11-30,intra-ui,934,1431,839,545,477,417,390,352,387,7961,9460,23193,10394,11825,FALSE,0.509852110550597,2020,2020-2021
PA,2020-12-31,inter-total,21,104,39,32,19,20,25,20,27,254,314,875,335,439,FALSE,0.501714285714286,2020,2020-2021
PA,2020-12-31,inter-ucfe,0,0,1,0,0,0,0,0,1,2,0,4,0,0,FALSE,0,2020,2020-2021
PA,2020-12-31,inter-ucx,0,0,0,0,0,0,0,0,0,1,0,1,0,0,FALSE,0,2020,2020-2021
PA,2020-12-31,inter-ui,21,104,38,32,19,20,25,20,26,251,314,870,335,439,FALSE,0.504597701149425,2020,2020-2021
PA,2020-12-31,intra-total,2369,3320,1442,932,599,439,373,427,431,7848,23553,41733,25922,29242,FALSE,0.70069249754391,2020,2020-2021
PA,2020-12-31,intra-ucfe,1,16,12,12,9,5,7,5,4,55,28,154,29,45,FALSE,0.292207792207792,2020,2020-2021
PA,2020-12-31,intra-ucx,0,14,4,1,4,3,4,2,0,11,14,57,14,28,FALSE,0.491228070175439,2020,2020-2021
PA,2020-12-31,intra-ui,2368,3290,1426,919,586,431,362,420,427,7782,23511,41522,25879,29169,FALSE,0.702495062858244,2020,2020-2021
PA,2021-01-31,inter-total,16,68,45,32,36,30,27,21,24,158,243,700,259,327,FALSE,0.467142857142857,2020,2020-2021
PA,2021-01-31,inter-ucfe,0,2,0,0,0,0,0,0,0,0,1,3,1,3,FALSE,1,2020,2020-2021
PA,2021-01-31,inter-ucx,0,1,0,0,0,0,0,0,0,0,0,1,0,1,FALSE,1,2020,2020-2021
PA,2021-01-31,inter-ui,16,65,45,32,36,30,27,21,24,158,242,696,258,323,FALSE,0.464080459770115,2020,2020-2021
PA,2021-01-31,intra-total,2255,4002,1842,1210,822,557,437,335,326,6007,26672,44465,28927,32929,FALSE,0.740559991004161,2020,2020-2021
PA,2021-01-31,intra-ucfe,0,14,7,4,8,4,7,3,7,44,24,122,24,38,FALSE,0.311475409836066,2020,2020-2021
PA,2021-01-31,intra-ucx,0,11,6,12,4,4,6,3,11,19,12,88,12,23,FALSE,0.261363636363636,2020,2020-2021
PA,2021-01-31,intra-ui,2255,3977,1829,1194,810,549,424,329,308,5944,26636,44255,28891,32868,FALSE,0.742695740594283,2020,2020-2021
PA,2021-02-28,inter-total,14,103,47,29,30,27,22,21,10,161,251,715,265,368,FALSE,0.514685314685315,2020,2020-2021
PA,2021-02-28,inter-ucfe,0,1,0,0,0,0,0,0,0,3,1,5,1,2,FALSE,0.4,2020,2020-2021
PA,2021-02-28,inter-ucx,0,0,0,0,0,0,0,0,0,0,0,0,0,0,FALSE,0,2020,2020-2021
PA,2021-02-28,inter-ui,14,102,47,29,30,27,22,21,10,158,250,710,264,366,FALSE,0.515492957746479,2020,2020-2021
PA,2021-02-28,intra-total,1076,2991,1722,1429,1077,803,619,515,405,5210,16401,32248,17477,20468,FALSE,0.634706028280824,2020,2020-2021
PA,2021-02-28,intra-ucfe,0,10,10,10,7,12,5,5,8,46,23,136,23,33,FALSE,0.242647058823529,2020,2020-2021
PA,2021-02-28,intra-ucx,1,2,5,5,3,0,2,2,0,7,15,42,16,18,FALSE,0.428571428571429,2020,2020-2021
PA,2021-02-28,intra-ui,1075,2979,1707,1414,1067,791,612,508,397,5157,16363,32070,17438,20417,FALSE,0.636638603055816,2020,2020-2021
PA,2021-03-31,inter-total,19,60,38,26,21,21,20,13,20,219,261,718,280,340,FALSE,0.473537604456825,2020,2020-2021
PA,2021-03-31,inter-ucfe,0,0,0,0,0,0,0,0,1,1,0,2,0,0,FALSE,0,2020,2020-2021
PA,2021-03-31,inter-ucx,0,0,0,0,0,0,0,0,0,0,0,0,0,0,FALSE,0,2020,2020-2021
PA,2021-03-31,inter-ui,19,60,38,26,21,21,20,13,19,218,261,716,280,340,FALSE,0.474860335195531,2020,2020-2021
PA,2021-03-31,intra-total,1536,1819,1089,876,720,629,722,586,616,7217,14060,29870,15596,17415,FALSE,0.583026447941078,2020,2020-2021
PA,2021-03-31,intra-ucfe,1,15,7,8,8,6,10,7,2,68,16,148,17,32,FALSE,0.216216216216216,2020,2020-2021
PA,2021-03-31,intra-ucx,1,12,5,6,8,3,1,3,1,14,13,67,14,26,FALSE,0.388059701492537,2020,2020-2021
PA,2021-03-31,intra-ui,1534,1792,1077,862,704,620,711,576,613,7135,14031,29655,15565,17357,FALSE,0.585297588939471,2020,2020-2021
PA,2021-04-30,inter-total,94,72,36,17,18,7,7,5,5,157,221,639,315,387,FALSE,0.605633802816901,2020,2020-2021
PA,2021-04-30,inter-ucfe,0,0,0,0,2,0,0,0,0,1,0,3,0,0,FALSE,0,2020,2020-2021
PA,2021-04-30,inter-ucx,0,0,0,0,0,0,0,0,0,0,0,0,0,0,FALSE,0,2020,2020-2021
PA,2021-04-30,inter-ui,94,72,36,17,16,7,7,5,5,156,221,636,315,387,FALSE,0.608490566037736,2020,2020-2021
PA,2021-04-30,intra-total,8810,3116,1662,823,532,494,498,398,336,5058,16797,38524,25607,28723,FALSE,0.745587166441699,2020,2020-2021
PA,2021-04-30,intra-ucfe,5,11,7,7,5,2,3,3,2,36,24,105,29,40,FALSE,0.380952380952381,2020,2020-2021
PA,2021-04-30,intra-ucx,3,4,1,1,2,3,2,1,1,6,9,33,12,16,FALSE,0.484848484848485,2020,2020-2021
PA,2021-04-30,intra-ui,8802,3101,1654,815,525,489,493,394,333,5016,16764,38386,25566,28667,FALSE,0.746808732350336,2020,2020-2021
PA,2021-05-31,inter-total,251,69,46,33,25,13,12,7,7,118,502,1083,753,822,FALSE,0.759002770083102,2020,2020-2021
PA,2021-05-31,inter-ucfe,1,2,1,0,0,0,0,0,0,2,0,6,1,3,FALSE,0.5,2020,2020-2021
PA,2021-05-31,inter-ucx,0,0,0,0,0,0,0,0,0,0,1,1,1,1,FALSE,1,2020,2020-2021
PA,2021-05-31,inter-ui,250,67,45,33,25,13,12,7,7,116,501,1076,751,818,FALSE,0.760223048327138,2020,2020-2021
PA,2021-05-31,intra-total,4933,2009,1334,992,950,850,615,406,331,4032,11600,28052,16533,18542,FALSE,0.660986738913447,2020,2020-2021
PA,2021-05-31,intra-ucfe,6,11,4,6,8,5,2,2,0,17,15,76,21,32,FALSE,0.421052631578947,2020,2020-2021
PA,2021-05-31,intra-ucx,2,8,9,2,3,1,0,2,1,2,17,47,19,27,FALSE,0.574468085106383,2020,2020-2021
PA,2021-05-31,intra-ui,4925,1990,1321,984,939,844,613,402,330,4013,11568,27929,16493,18483,FALSE,0.661785241147195,2020,2020-2021
PA,2021-06-30,inter-total,356,123,94,67,46,23,15,11,11,101,281,1128,637,760,FALSE,0.673758865248227,2020,2020-2021
PA,2021-06-30,inter-ucfe,0,0,0,0,0,0,0,0,0,2,0,2,0,0,FALSE,0,2020,2020-2021
PA,2021-06-30,inter-ucx,0,0,0,0,0,0,0,0,0,0,0,0,0,0,FALSE,0,2020,2020-2021
PA,2021-06-30,inter-ui,356,123,94,67,46,23,15,11,11,99,281,1126,637,760,FALSE,0.674955595026643,2020,2020-2021
PA,2021-06-30,intra-total,11019,1499,971,664,441,345,307,188,195,1533,5092,22254,16111,17610,FALSE,0.791318414667026,2020,2020-2021
PA,2021-06-30,intra-ucfe,0,3,1,1,3,1,0,1,2,17,1,30,1,4,FALSE,0.133333333333333,2020,2020-2021
PA,2021-06-30,intra-ucx,2,4,2,0,0,2,0,1,0,1,2,14,4,8,FALSE,0.571428571428571,2020,2020-2021
PA,2021-06-30,intra-ui,11017,1492,968,663,438,342,307,186,193,1515,5089,22210,16106,17598,FALSE,0.792345790184602,2020,2020-2021
PA,2021-07-31,inter-total,742,40,25,13,22,21,15,6,6,147,85,1122,827,867,FALSE,0.772727272727273,2021,2021-2022
PA,2021-07-31,inter-ucfe,0,0,0,0,0,0,0,0,0,0,0,0,0,0,FALSE,0,2021,2021-2022
PA,2021-07-31,inter-ucx,0,0,0,0,0,0,0,0,0,0,0,0,0,0,FALSE,0,2021,2021-2022
PA,2021-07-31,inter-ui,742,40,25,13,22,21,15,6,6,147,85,1122,827,867,FALSE,0.772727272727273,2021,2021-2022
PA,2021-07-31,intra-total,22329,3418,2954,2429,2128,1391,670,444,274,7687,9489,53213,31818,35236,FALSE,0.662169018848778,2021,2021-2022
PA,2021-07-31,intra-ucfe,0,1,1,0,2,1,1,3,0,38,1,48,1,2,FALSE,0.0416666666666667,2021,2021-2022
PA,2021-07-31,intra-ucx,1,1,1,1,6,0,2,5,2,8,0,27,1,2,FALSE,0.0740740740740741,2021,2021-2022
PA,2021-07-31,intra-ui,22328,3416,2952,2428,2120,1390,667,436,272,7641,9488,53138,31816,35232,FALSE,0.663028341300011,2021,2021-2022
PA,2021-08-31,inter-total,18,14,12,13,8,8,10,16,19,140,8,266,26,40,FALSE,0.150375939849624,2021,2021-2022
PA,2021-08-31,inter-ucfe,0,0,0,0,0,0,0,0,0,1,0,1,0,0,FALSE,0,2021,2021-2022
PA,2021-08-31,inter-ucx,0,0,0,0,0,0,0,0,0,0,0,0,0,0,FALSE,0,2021,2021-2022
PA,2021-08-31,inter-ui,18,14,12,13,8,8,10,16,19,139,8,265,26,40,FALSE,0.150943396226415,2021,2021-2022
PA,2021-08-31,intra-total,3049,1349,1652,2188,831,983,945,821,906,5909,1125,19758,4174,5523,FALSE,0.279532341330094,2021,2021-2022
PA,2021-08-31,intra-ucfe,0,1,3,0,1,2,0,0,2,34,0,43,0,1,FALSE,0.0232558139534884,2021,2021-2022
PA,2021-08-31,intra-ucx,0,0,1,0,1,0,1,2,1,7,0,13,0,0,FALSE,0,2021,2021-2022
PA,2021-08-31,intra-ui,3049,1348,1648,2188,829,981,944,819,903,5868,1125,19702,4174,5522,FALSE,0.280276114100091,2021,2021-2022
PA,2021-09-30,inter-total,11,3,2,5,3,3,2,2,1,104,3,139,14,17,FALSE,0.122302158273381,2021,2021-2022
PA,2021-09-30,inter-ucfe,0,0,0,0,0,0,1,0,0,1,0,2,0,0,FALSE,0,2021,2021-2022
PA,2021-09-30,inter-ucx,0,0,0,0,0,0,0,0,0,0,0,0,0,0,FALSE,0,2021,2021-2022
PA,2021-09-30,inter-ui,11,3,2,5,3,3,1,2,1,103,3,137,14,17,FALSE,0.124087591240876,2021,2021-2022
PA,2021-09-30,intra-total,5529,1716,2483,1010,443,464,487,649,527,7994,2073,23375,7602,9318,FALSE,0.398631016042781,2021,2021-2022
PA,2021-09-30,intra-ucfe,1,0,1,0,0,1,0,0,1,26,0,30,1,1,FALSE,0.0333333333333333,2021,2021-2022
PA,2021-09-30,intra-ucx,0,0,1,0,0,0,1,0,1,9,1,13,1,1,FALSE,0.0769230769230769,2021,2021-2022
PA,2021-09-30,intra-ui,5528,1716,2481,1010,443,463,486,649,525,7959,2072,23332,7600,9316,FALSE,0.399279958854792,2021,2021-2022
PA,2021-10-31,inter-total,8,3,1,3,4,2,2,5,5,60,0,93,8,11,FALSE,0.118279569892473,2021,2021-2022
PA,2021-10-31,inter-ucfe,0,0,0,0,0,0,0,0,0,0,0,0,0,0,FALSE,0,2021,2021-2022
PA,2021-10-31,inter-ucx,0,0,0,0,0,0,0,0,0,0,0,0,0,0,FALSE,0,2021,2021-2022
PA,2021-10-31,inter-ui,8,3,1,3,4,2,2,5,5,60,0,93,8,11,FALSE,0.118279569892473,2021,2021-2022
PA,2021-10-31,intra-total,2592,789,484,456,509,390,370,343,524,6328,1106,13891,3698,4487,FALSE,0.323014901734936,2021,2021-2022
PA,2021-10-31,intra-ucfe,2,1,1,1,1,0,0,0,0,24,1,31,3,4,FALSE,0.129032258064516,2021,2021-2022
PA,2021-10-31,intra-ucx,0,1,2,0,1,0,1,0,0,8,0,13,0,1,FALSE,0.0769230769230769,2021,2021-2022
PA,2021-10-31,intra-ui,2590,787,481,455,507,390,369,343,524,6296,1105,13847,3695,4482,FALSE,0.323680219542139,2021,2021-2022
PA,2021-11-30,inter-total,17,8,5,6,4,3,1,5,2,76,2,129,19,27,FALSE,0.209302325581395,2021,2021-2022
PA,2021-11-30,inter-ucfe,0,0,0,0,0,0,0,0,0,0,0,0,0,0,FALSE,0,2021,2021-2022
PA,2021-11-30,inter-ucx,0,0,0,0,0,0,0,0,0,0,0,0,0,0,FALSE,0,2021,2021-2022
PA,2021-11-30,inter-ui,17,8,5,6,4,3,1,5,2,76,2,129,19,27,FALSE,0.209302325581395,2021,2021-2022
PA,2021-11-30,intra-total,2258,379,379,434,255,277,187,213,171,3001,456,8010,2714,3093,FALSE,0.386142322097378,2021,2021-2022
PA,2021-11-30,intra-ucfe,0,1,1,0,1,1,1,0,0,25,0,30,0,1,FALSE,0.0333333333333333,2021,2021-2022
PA,2021-11-30,intra-ucx,0,0,1,0,0,0,0,1,0,9,0,11,0,0,FALSE,0,2021,2021-2022
PA,2021-11-30,intra-ui,2258,378,377,434,254,276,186,212,171,2967,456,7969,2714,3092,FALSE,0.388003513615259,2021,2021-2022
PA,2021-12-31,inter-total,18,14,9,11,18,10,9,9,5,98,8,209,26,40,FALSE,0.191387559808612,2021,2021-2022
PA,2021-12-31,inter-ucfe,0,0,0,0,0,0,0,0,0,1,0,1,0,0,FALSE,0,2021,2021-2022
PA,2021-12-31,inter-ucx,0,0,0,0,0,0,0,0,0,0,0,0,0,0,FALSE,0,2021,2021-2022
PA,2021-12-31,inter-ui,18,14,9,11,18,10,9,9,5,97,8,208,26,40,FALSE,0.192307692307692,2021,2021-2022
PA,2021-12-31,intra-total,4090,675,525,426,395,319,307,245,247,3465,1016,11710,5106,5781,FALSE,0.493680614859095,2021,2021-2022
PA,2021-12-31,intra-ucfe,3,1,1,2,3,1,2,3,2,30,1,49,4,5,FALSE,0.102040816326531,2021,2021-2022
PA,2021-12-31,intra-ucx,3,0,0,1,1,0,0,2,0,4,1,12,4,4,FALSE,0.333333333333333,2021,2021-2022
PA,2021-12-31,intra-ui,4084,674,524,423,391,318,305,240,245,3431,1014,11649,5098,5772,FALSE,0.495493175379861,2021,2021-2022
PA,2022-01-31,inter-total,34,8,13,9,16,16,18,12,11,135,21,293,55,63,FALSE,0.215017064846416,2021,2021-2022
PA,2022-01-31,inter-ucfe,0,0,0,0,0,0,0,0,0,0,0,0,0,0,FALSE,0,2021,2021-2022
PA,2022-01-31,inter-ucx,0,0,0,0,0,0,0,0,0,1,0,1,0,0,FALSE,0,2021,2021-2022
PA,2022-01-31,inter-ui,34,8,13,9,16,16,18,12,11,134,21,292,55,63,FALSE,0.215753424657534,2021,2021-2022
PA,2022-01-31,intra-total,9246,1176,907,689,564,499,467,408,346,3677,2068,20047,11314,12490,FALSE,0.623035865715568,2021,2021-2022
PA,2022-01-31,intra-ucfe,11,3,2,0,1,1,2,2,2,31,2,57,13,16,FALSE,0.280701754385965,2021,2021-2022
PA,2022-01-31,intra-ucx,9,1,1,0,0,1,0,0,0,7,0,19,9,10,FALSE,0.526315789473684,2021,2021-2022
PA,2022-01-31,intra-ui,9226,1172,904,689,563,497,465,406,344,3639,2066,19971,11292,12464,FALSE,0.624104952180662,2021,2021-2022
PA,2022-02-28,inter-total,30,36,36,31,18,25,16,17,12,182,27,430,57,93,FALSE,0.216279069767442,2021,2021-2022
PA,2022-02-28,inter-ucfe,0,0,0,0,0,0,0,0,0,1,0,1,0,0,FALSE,0,2021,2021-2022
PA,2022-02-28,inter-ucx,0,0,0,0,0,0,0,0,0,0,0,0,0,0,FALSE,0,2021,2021-2022
PA,2022-02-28,inter-ui,30,36,36,31,18,25,16,17,12,181,27,429,57,93,FALSE,0.216783216783217,2021,2021-2022
PA,2022-02-28,intra-total,5049,1517,1541,1269,1005,815,641,628,551,4686,1503,19205,6552,8069,FALSE,0.42015100234314,2021,2021-2022
PA,2022-02-28,intra-ucfe,3,1,6,0,1,2,2,1,2,39,0,57,3,4,FALSE,0.0701754385964912,2021,2021-2022
PA,2022-02-28,intra-ucx,8,2,1,1,0,2,1,1,1,11,4,32,12,14,FALSE,0.4375,2021,2021-2022
PA,2022-02-28,intra-ui,5038,1514,1534,1268,1004,811,638,626,548,4636,1499,19116,6537,8051,FALSE,0.421165515798284,2021,2021-2022
PA,2022-03-31,inter-total,41,30,15,17,23,19,22,32,22,219,18,458,59,89,FALSE,0.194323144104804,2021,2021-2022
PA,2022-03-31,inter-ucfe,0,0,0,0,0,0,0,0,0,0,0,0,0,0,FALSE,0,2021,2021-2022
PA,2022-03-31,inter-ucx,0,0,0,0,0,0,0,0,0,0,0,0,0,0,FALSE,0,2021,2021-2022
PA,2022-03-31,inter-ui,41,30,15,17,23,19,22,32,22,219,18,458,59,89,FALSE,0.194323144104804,2021,2021-2022
PA,2022-03-31,intra-total,2929,832,754,687,745,826,781,746,737,5956,1059,16052,3988,4820,FALSE,0.300274109145278,2021,2021-2022
PA,2022-03-31,intra-ucfe,3,3,0,0,0,2,0,4,0,43,3,58,6,9,FALSE,0.155172413793103,2021,2021-2022
PA,2022-03-31,intra-ucx,7,3,1,1,1,0,0,0,0,7,3,23,10,13,FALSE,0.565217391304348,2021,2021-2022
PA,2022-03-31,intra-ui,2919,826,753,686,744,824,781,742,737,5906,1053,15971,3972,4798,FALSE,0.300419510362532,2021,2021-2022
PA,2022-04-30,inter-total,32,14,10,15,14,13,15,13,11,317,23,477,55,69,FALSE,0.144654088050314,2021,2021-2022
PA,2022-04-30,inter-ucfe,0,0,0,0,0,0,0,0,0,0,0,0,0,0,FALSE,0,2021,2021-2022
PA,2022-04-30,inter-ucx,0,0,0,0,0,0,0,0,0,0,0,0,0,0,FALSE,0,2021,2021-2022
PA,2022-04-30,inter-ui,32,14,10,15,14,13,15,13,11,317,23,477,55,69,FALSE,0.144654088050314,2021,2021-2022
PA,2022-04-30,intra-total,3008,453,359,308,299,316,322,362,348,6176,804,12755,3812,4265,FALSE,0.3343786750294,2021,2021-2022
PA,2022-04-30,intra-ucfe,4,3,2,1,1,2,0,1,0,50,1,65,5,8,FALSE,0.123076923076923,2021,2021-2022
PA,2022-04-30,intra-ucx,10,3,2,1,1,0,0,0,0,8,3,28,13,16,FALSE,0.571428571428571,2021,2021-2022
PA,2022-04-30,intra-ui,2994,447,355,306,297,314,322,361,348,6118,800,12662,3794,4241,FALSE,0.33493918812194,2021,2021-2022
PA,2022-05-31,inter-total,61,27,12,10,8,9,9,13,3,150,33,335,94,121,FALSE,0.361194029850746,2021,2021-2022
PA,2022-05-31,inter-ucfe,0,0,0,0,0,0,0,0,0,0,0,0,0,0,FALSE,0,2021,2021-2022
PA,2022-05-31,inter-ucx,1,0,0,0,0,0,0,0,0,0,0,1,1,1,FALSE,1,2021,2021-2022
PA,2022-05-31,inter-ui,60,27,12,10,8,9,9,13,3,150,33,334,93,120,FALSE,0.359281437125749,2021,2021-2022
PA,2022-05-31,intra-total,4092,537,409,303,262,225,240,215,237,5515,908,12943,5000,5537,FALSE,0.427798810167658,2021,2021-2022
PA,2022-05-31,intra-ucfe,1,0,0,3,1,0,2,4,1,36,1,49,2,2,FALSE,0.0408163265306122,2021,2021-2022
PA,2022-05-31,intra-ucx,9,2,2,1,1,0,0,1,0,15,1,32,10,12,FALSE,0.375,2021,2021-2022
PA,2022-05-31,intra-ui,4082,535,407,299,260,225,238,210,236,5464,906,12862,4988,5523,FALSE,0.429404447208832,2021,2021-2022
PA,2022-06-30,inter-total,45,23,22,23,10,7,9,8,7,128,24,306,69,92,FALSE,0.300653594771242,2021,2021-2022
PA,2022-06-30,inter-ucfe,0,0,0,0,0,0,0,0,0,1,0,1,0,0,FALSE,0,2021,2021-2022
PA,2022-06-30,inter-ucx,0,0,0,0,0,0,0,0,1,2,0,3,0,0,FALSE,0,2021,2021-2022
PA,2022-06-30,inter-ui,45,23,22,23,10,7,9,8,6,125,24,302,69,92,FALSE,0.304635761589404,2021,2021-2022
PA,2022-06-30,intra-total,7524,754,439,355,271,270,251,349,247,5053,1485,16998,9009,9763,FALSE,0.574361689610543,2021,2021-2022
PA,2022-06-30,intra-ucfe,4,2,1,1,1,2,0,2,2,16,3,34,7,9,FALSE,0.264705882352941,2021,2021-2022
PA,2022-06-30,intra-ucx,4,0,0,0,0,1,0,0,0,8,5,18,9,9,FALSE,0.5,2021,2021-2022
PA,2022-06-30,intra-ui,7516,752,438,354,270,267,251,347,245,5029,1477,16946,8993,9745,FALSE,0.575061961524844,2021,2021-2022
PA,2022-07-31,inter-total,47,20,19,10,10,13,10,12,18,110,26,295,73,93,FALSE,0.315254237288136,2022,2022-2023
PA,2022-07-31,inter-ucfe,0,0,0,0,0,1,0,0,0,2,0,3,0,0,FALSE,0,2022,2022-2023
PA,2022-07-31,inter-ucx,0,0,0,1,0,0,0,0,0,0,0,1,0,0,FALSE,0,2022,2022-2023
PA,2022-07-31,inter-ui,47,20,19,9,10,12,10,12,18,108,26,291,73,93,FALSE,0.319587628865979,2022,2022-2023
PA,2022-07-31,intra-total,6298,1278,1026,730,478,366,332,387,248,4121,1836,17100,8134,9412,FALSE,0.550409356725146,2022,2022-2023
PA,2022-07-31,intra-ucfe,1,2,0,1,1,1,0,3,5,12,1,27,2,4,FALSE,0.148148148148148,2022,2022-2023
PA,2022-07-31,intra-ucx,3,1,0,1,0,0,0,0,0,4,1,10,4,5,FALSE,0.5,2022,2022-2023
PA,2022-07-31,intra-ui,6294,1275,1026,728,477,365,332,384,243,4105,1834,17063,8128,9403,FALSE,0.551075426361132,2022,2022-2023
PA,2022-08-31,inter-total,41,35,24,22,24,18,15,12,10,158,28,387,69,104,FALSE,0.268733850129199,2022,2022-2023
PA,2022-08-31,inter-ucfe,0,0,0,0,0,0,0,0,0,2,0,2,0,0,FALSE,0,2022,2022-2023
PA,2022-08-31,inter-ucx,0,0,0,0,0,0,0,0,0,0,0,0,0,0,FALSE,0,2022,2022-2023
PA,2022-08-31,inter-ui,41,35,24,22,24,18,15,12,10,156,28,385,69,104,FALSE,0.27012987012987,2022,2022-2023
PA,2022-08-31,intra-total,3542,1004,844,769,710,638,545,439,396,5020,1162,15069,4704,5708,FALSE,0.378790895215343,2022,2022-2023
PA,2022-08-31,intra-ucfe,2,2,2,3,1,0,4,3,2,35,2,56,4,6,FALSE,0.107142857142857,2022,2022-2023
PA,2022-08-31,intra-ucx,7,0,1,1,1,0,1,0,0,10,2,23,9,9,FALSE,0.391304347826087,2022,2022-2023
PA,2022-08-31,intra-ui,3533,1002,841,765,708,638,540,436,394,4975,1158,14990,4691,5693,FALSE,0.379786524349566,2022,2022-2023
PA,2022-09-30,inter-total,30,28,34,25,20,22,14,13,16,144,29,375,59,87,FALSE,0.232,2022,2022-2023
PA,2022-09-30,inter-ucfe,0,0,0,0,0,0,1,0,0,2,0,3,0,0,FALSE,0,2022,2022-2023
PA,2022-09-30,inter-ucx,0,0,0,0,0,0,0,0,0,0,0,0,0,0,FALSE,0,2022,2022-2023
PA,2022-09-30,inter-ui,30,28,34,25,20,22,13,13,16,142,29,372,59,87,FALSE,0.233870967741935,2022,2022-2023
PA,2022-09-30,intra-total,2479,592,500,480,409,405,437,406,452,5328,849,12337,3328,3920,FALSE,0.317743373591635,2022,2022-2023
PA,2022-09-30,intra-ucfe,4,3,2,2,3,2,1,1,1,23,2,44,6,9,FALSE,0.204545454545455,2022,2022-2023
PA,2022-09-30,intra-ucx,6,0,1,2,2,0,0,0,1,10,2,24,8,8,FALSE,0.333333333333333,2022,2022-2023
PA,2022-09-30,intra-ui,2469,589,497,476,404,403,436,405,450,5295,845,12269,3314,3903,FALSE,0.318118836090961,2022,2022-2023
PA,2022-10-31,inter-total,40,23,14,17,11,13,10,16,14,145,28,331,68,91,FALSE,0.274924471299094,2022,2022-2023
PA,2022-10-31,inter-ucfe,0,0,0,0,0,0,0,0,0,1,1,2,1,1,FALSE,0.5,2022,2022-2023
PA,2022-10-31,inter-ucx,0,0,0,0,0,0,0,0,0,0,0,0,0,0,FALSE,0,2022,2022-2023
PA,2022-10-31,inter-ui,40,23,14,17,11,13,10,16,14,144,27,329,67,90,FALSE,0.27355623100304,2022,2022-2023
PA,2022-10-31,intra-total,3543,560,442,413,351,317,356,399,387,6029,872,13669,4415,4975,FALSE,0.363962250347502,2022,2022-2023
PA,2022-10-31,intra-ucfe,4,1,0,2,0,1,1,3,2,30,2,46,6,7,FALSE,0.152173913043478,2022,2022-2023
PA,2022-10-31,intra-ucx,10,2,1,0,0,1,0,1,1,4,3,23,13,15,FALSE,0.652173913043478,2022,2022-2023
PA,2022-10-31,intra-ui,3529,557,441,411,351,315,355,395,384,5995,867,13600,4396,4953,FALSE,0.364191176470588,2022,2022-2023
PA,2022-11-30,inter-total,105,30,25,16,11,19,14,13,7,227,40,507,145,175,FALSE,0.345167652859961,2022,2022-2023
PA,2022-11-30,inter-ucfe,0,1,0,1,0,0,0,0,0,0,0,2,0,1,FALSE,0.5,2022,2022-2023
PA,2022-11-30,inter-ucx,0,0,0,0,0,0,0,0,0,0,0,0,0,0,FALSE,0,2022,2022-2023
PA,2022-11-30,inter-ui,105,29,25,15,11,19,14,13,7,227,40,505,145,174,FALSE,0.344554455445545,2022,2022-2023
PA,2022-11-30,intra-total,6091,772,535,418,402,371,347,321,324,6526,1343,17450,7434,8206,FALSE,0.47025787965616,2022,2022-2023
PA,2022-11-30,intra-ucfe,6,1,3,0,0,3,1,1,1,30,3,49,9,10,FALSE,0.204081632653061,2022,2022-2023
PA,2022-11-30,intra-ucx,6,1,3,2,3,1,0,0,0,9,2,27,8,9,FALSE,0.333333333333333,2022,2022-2023
PA,2022-11-30,intra-ui,6079,770,529,416,399,367,346,320,323,6487,1338,17374,7417,8187,FALSE,0.471221365258432,2022,2022-2023
PA,2022-12-31,inter-total,248,32,24,29,19,19,11,9,9,209,59,668,307,339,FALSE,0.50748502994012,2022,2022-2023
PA,2022-12-31,inter-ucfe,1,0,0,0,0,0,0,0,0,1,0,2,1,1,FALSE,0.5,2022,2022-2023
PA,2022-12-31,inter-ucx,0,0,0,0,0,0,0,0,0,0,0,0,0,0,FALSE,0,2022,2022-2023
PA,2022-12-31,inter-ui,247,32,24,29,19,19,11,9,9,208,59,666,306,338,FALSE,0.507507507507508,2022,2022-2023
PA,2022-12-31,intra-total,9830,1224,806,576,467,404,408,340,312,6902,2085,23354,11915,13139,FALSE,0.562601695641004,2022,2022-2023
PA,2022-12-31,intra-ucfe,5,3,4,2,1,0,3,2,3,25,2,50,7,10,FALSE,0.2,2022,2022-2023
PA,2022-12-31,intra-ucx,9,3,1,1,0,2,1,0,0,11,3,31,12,15,FALSE,0.483870967741936,2022,2022-2023
PA,2022-12-31,intra-ui,9816,1218,801,573,466,402,404,338,309,6866,2080,23273,11896,13114,FALSE,0.563485584153311,2022,2022-2023
PA,2023-01-31,inter-total,621,85,40,28,30,21,18,26,14,245,129,1257,750,835,FALSE,0.664280031821798,2022,2022-2023
PA,2023-01-31,inter-ucfe,0,0,0,1,0,0,1,1,0,0,2,5,2,2,FALSE,0.4,2022,2022-2023
PA,2023-01-31,inter-ucx,0,0,0,0,0,0,0,0,0,0,0,0,0,0,FALSE,0,2022,2022-2023
PA,2023-01-31,inter-ui,621,85,40,27,30,21,17,25,14,245,127,1252,748,833,FALSE,0.665335463258786,2022,2022-2023
PA,2023-01-31,intra-total,18288,2008,1159,985,752,704,658,817,695,11593,3793,41452,22081,24089,FALSE,0.581129981665541,2022,2022-2023
PA,2023-01-31,intra-ucfe,11,3,2,5,3,0,2,2,0,28,9,65,20,23,FALSE,0.353846153846154,2022,2022-2023
PA,2023-01-31,intra-ucx,13,2,4,1,4,3,3,5,3,17,3,58,16,18,FALSE,0.310344827586207,2022,2022-2023
PA,2023-01-31,intra-ui,18264,2003,1153,979,745,701,653,810,692,11548,3781,41329,22045,24048,FALSE,0.581867453845968,2022,2022-2023
PA,2023-02-28,inter-total,106,37,34,22,19,32,14,17,17,119,30,447,136,173,FALSE,0.387024608501119,2022,2022-2023
PA,2023-02-28,inter-ucfe,0,0,1,0,0,1,0,0,0,1,0,3,0,0,FALSE,0,2022,2022-2023
PA,2023-02-28,inter-ucx,0,0,0,0,0,0,0,0,0,0,0,0,0,0,FALSE,0,2022,2022-2023
PA,2023-02-28,inter-ui,106,37,33,22,19,31,14,17,17,118,30,444,136,173,FALSE,0.38963963963964,2022,2022-2023
PA,2023-02-28,intra-total,8504,1496,1195,992,879,588,472,373,316,3180,2103,20098,10607,12103,FALSE,0.602199223803364,2022,2022-2023
PA,2023-02-28,intra-ucfe,6,4,3,2,5,3,1,3,0,11,4,42,10,14,FALSE,0.333333333333333,2022,2022-2023
PA,2023-02-28,intra-ucx,6,0,0,0,0,0,1,0,1,3,2,13,8,8,FALSE,0.615384615384615,2022,2022-2023
PA,2023-02-28,intra-ui,8492,1492,1192,990,874,585,470,370,315,3166,2097,20043,10589,12081,FALSE,0.602754078730729,2022,2022-2023
PA,2023-03-31,inter-total,78,26,18,17,12,23,10,19,21,148,26,398,104,130,FALSE,0.326633165829146,2022,2022-2023
PA,2023-03-31,inter-ucfe,0,0,0,0,0,0,0,0,0,1,0,1,0,0,FALSE,0,2022,2022-2023
PA,2023-03-31,inter-ucx,0,0,0,0,0,0,0,0,0,0,0,0,0,0,FALSE,0,2022,2022-2023
PA,2023-03-31,inter-ui,78,26,18,17,12,23,10,19,21,147,26,397,104,130,FALSE,0.327455919395466,2022,2022-2023
PA,2023-03-31,intra-total,5319,1154,887,859,848,815,728,590,481,3930,1549,17160,6868,8022,FALSE,0.467482517482518,2022,2022-2023
PA,2023-03-31,intra-ucfe,3,2,3,1,1,5,1,0,4,18,1,39,4,6,FALSE,0.153846153846154,2022,2022-2023
PA,2023-03-31,intra-ucx,11,5,6,1,1,2,1,2,0,3,3,35,14,19,FALSE,0.542857142857143,2022,2022-2023
PA,2023-03-31,intra-ui,5305,1147,878,857,846,808,726,588,477,3909,1545,17086,6850,7997,FALSE,0.468044012641929,2022,2022-2023
PA,2023-04-30,inter-total,96,21,17,13,10,20,12,9,6,114,32,350,128,149,FALSE,0.425714285714286,2022,2022-2023
PA,2023-04-30,inter-ucfe,0,0,0,0,0,1,0,0,0,0,0,1,0,0,FALSE,0,2022,2022-2023
PA,2023-04-30,inter-ucx,0,0,0,0,0,0,0,0,0,0,0,0,0,0,FALSE,0,2022,2022-2023
PA,2023-04-30,inter-ui,96,21,17,13,10,19,12,9,6,114,32,349,128,149,FALSE,0.426934097421203,2022,2022-2023
PA,2023-04-30,intra-total,5099,933,783,693,575,522,441,415,312,3279,1443,14495,6542,7475,FALSE,0.515695067264574,2022,2022-2023
PA,2023-04-30,intra-ucfe,6,1,3,2,2,3,2,4,7,19,4,53,10,11,FALSE,0.207547169811321,2022,2022-2023
PA,2023-04-30,intra-ucx,0,0,0,0,1,0,0,1,0,4,1,7,1,1,FALSE,0.142857142857143,2022,2022-2023
PA,2023-04-30,intra-ui,5093,932,780,691,572,519,439,410,305,3256,1438,14435,6531,7463,FALSE,0.517007273986838,2022,2022-2023
PA,2023-05-31,inter-total,163,20,23,10,16,15,8,8,9,100,38,410,201,221,FALSE,0.539024390243903,2022,2022-2023
PA,2023-05-31,inter-ucfe,1,0,1,0,0,0,0,0,0,2,0,4,1,1,FALSE,0.25,2022,2022-2023
PA,2023-05-31,inter-ucx,0,0,0,0,0,0,0,0,0,0,0,0,0,0,FALSE,0,2022,2022-2023
PA,2023-05-31,inter-ui,162,20,22,10,16,15,8,8,9,98,38,406,200,220,FALSE,0.541871921182266,2022,2022-2023
PA,2023-05-31,intra-total,7271,1063,883,690,648,451,384,368,317,3679,1599,17353,8870,9933,FALSE,0.572408229124647,2022,2022-2023
PA,2023-05-31,intra-ucfe,5,10,1,0,2,3,3,0,2,18,4,48,9,19,FALSE,0.395833333333333,2022,2022-2023
PA,2023-05-31,intra-ucx,12,3,2,1,4,2,1,0,1,2,4,32,16,19,FALSE,0.59375,2022,2022-2023
PA,2023-05-31,intra-ui,7254,1050,880,689,642,446,380,368,314,3659,1591,17273,8845,9895,FALSE,0.572859375904591,2022,2022-2023
PA,2023-06-30,inter-total,140,35,22,13,19,17,11,8,6,183,45,499,185,220,FALSE,0.440881763527054,2022,2022-2023
PA,2023-06-30,inter-ucfe,0,0,0,0,0,0,0,0,0,2,0,2,0,0,FALSE,0,2022,2022-2023
PA,2023-06-30,inter-ucx,0,0,0,0,0,0,0,0,0,0,0,0,0,0,FALSE,0,2022,2022-2023
PA,2023-06-30,inter-ui,140,35,22,13,19,17,11,8,6,181,45,497,185,220,FALSE,0.442655935613682,2022,2022-2023
PA,2023-06-30,intra-total,12730,1021,722,727,717,753,673,452,392,8638,2191,29016,14921,15942,FALSE,0.549421009098429,2022,2022-2023
PA,2023-06-30,intra-ucfe,2,2,4,4,4,2,4,3,2,33,4,64,6,8,FALSE,0.125,2022,2022-2023
PA,2023-06-30,intra-ucx,11,3,2,0,2,0,2,0,2,9,2,33,13,16,FALSE,0.484848484848485,2022,2022-2023
PA,2023-06-30,intra-ui,12717,1016,716,723,711,751,667,449,388,8596,2185,28919,14902,15918,FALSE,0.550433970745876,2022,2022-2023
PA,2023-07-31,inter-total,176,22,22,11,16,23,21,14,12,191,53,561,229,251,FALSE,0.447415329768271,2023,2023-2024
PA,2023-07-31,inter-ucfe,1,0,0,0,0,0,0,0,0,1,0,2,1,1,FALSE,0.5,2023,2023-2024
PA,2023-07-31,inter-ucx,0,0,0,0,0,0,0,0,0,0,0,0,0,0,FALSE,0,2023,2023-2024
PA,2023-07-31,inter-ui,175,22,22,11,16,23,21,14,12,190,53,559,228,250,FALSE,0.447227191413238,2023,2023-2024
PA,2023-07-31,intra-total,12967,1908,1297,887,701,1027,1026,779,522,5858,2884,29856,15851,17759,FALSE,0.5948218113612,2023,2023-2024
PA,2023-07-31,intra-ucfe,7,1,1,2,2,4,5,3,3,22,6,56,13,14,FALSE,0.25,2023,2023-2024
PA,2023-07-31,intra-ucx,18,0,0,0,0,3,0,0,0,8,5,34,23,23,FALSE,0.676470588235294,2023,2023-2024
PA,2023-07-31,intra-ui,12942,1907,1296,885,699,1020,1021,776,519,5828,2873,29766,15815,17722,FALSE,0.59537727608681,2023,2023-2024
PA,2023-08-31,inter-total,131,18,13,21,23,36,29,18,15,134,41,479,172,190,FALSE,0.396659707724426,2023,2023-2024
PA,2023-08-31,inter-ucfe,0,0,0,0,0,0,0,0,0,1,0,1,0,0,FALSE,0,2023,2023-2024
PA,2023-08-31,inter-ucx,0,0,0,0,0,0,0,0,0,0,0,0,0,0,FALSE,0,2023,2023-2024
PA,2023-08-31,inter-ui,131,18,13,21,23,36,29,18,15,133,41,478,172,190,FALSE,0.397489539748954,2023,2023-2024
PA,2023-08-31,intra-total,8188,1031,838,726,869,1625,1332,991,677,4189,1642,22108,9830,10861,FALSE,0.491270128460286,2023,2023-2024
PA,2023-08-31,intra-ucfe,6,2,4,0,2,2,2,2,3,21,4,48,10,12,FALSE,0.25,2023,2023-2024
PA,2023-08-31,intra-ucx,11,2,1,1,0,0,0,1,0,7,6,29,17,19,FALSE,0.655172413793103,2023,2023-2024
PA,2023-08-31,intra-ui,8171,1027,833,725,867,1623,1330,988,674,4161,1632,22031,9803,10830,FALSE,0.491580046298398,2023,2023-2024
PA,2023-09-30,inter-total,108,13,6,13,12,20,13,16,14,86,31,332,139,152,FALSE,0.457831325301205,2023,2023-2024
PA,2023-09-30,inter-ucfe,0,0,0,0,0,1,0,0,0,1,0,2,0,0,FALSE,0,2023,2023-2024
PA,2023-09-30,inter-ucx,0,0,0,0,0,0,0,0,0,0,0,0,0,0,FALSE,0,2023,2023-2024
PA,2023-09-30,inter-ui,108,13,6,13,12,19,13,16,14,85,31,330,139,152,FALSE,0.460606060606061,2023,2023-2024
PA,2023-09-30,intra-total,5606,622,524,470,505,1025,1069,1506,646,3068,1060,16101,6666,7288,FALSE,0.452642693000435,2023,2023-2024
PA,2023-09-30,intra-ucfe,3,2,1,2,1,5,2,2,3,13,3,37,6,8,FALSE,0.216216216216216,2023,2023-2024
PA,2023-09-30,intra-ucx,15,1,1,2,0,1,0,0,1,2,2,25,17,18,FALSE,0.72,2023,2023-2024
PA,2023-09-30,intra-ui,5588,619,522,466,504,1019,1067,1504,642,3053,1055,16039,6643,7262,FALSE,0.452771369786146,2023,2023-2024
PA,2023-10-31,inter-total,164,13,7,7,4,8,12,11,18,91,32,367,196,209,FALSE,0.569482288828338,2023,2023-2024
PA,2023-10-31,inter-ucfe,0,0,0,0,0,0,0,1,0,0,0,1,0,0,FALSE,0,2023,2023-2024
PA,2023-10-31,inter-ucx,0,0,0,0,0,0,0,0,0,0,0,0,0,0,FALSE,0,2023,2023-2024
PA,2023-10-31,inter-ui,164,13,7,7,4,8,12,10,18,91,32,366,196,209,FALSE,0.57103825136612,2023,2023-2024
PA,2023-10-31,intra-total,7667,618,456,413,351,376,472,632,643,3039,1253,15920,8920,9538,FALSE,0.599120603015075,2023,2023-2024
PA,2023-10-31,intra-ucfe,4,2,2,2,1,2,4,2,2,14,2,37,6,8,FALSE,0.216216216216216,2023,2023-2024
PA,2023-10-31,intra-ucx,28,4,2,3,0,0,0,1,2,2,2,44,30,34,FALSE,0.772727272727273,2023,2023-2024
PA,2023-10-31,intra-ui,7635,612,452,408,350,374,468,629,639,3023,1249,15839,8884,9496,FALSE,0.599532798787802,2023,2023-2024
PA,2023-11-30,inter-total,206,21,9,6,7,11,8,6,9,97,39,419,245,266,FALSE,0.634844868735084,2023,2023-2024
PA,2023-11-30,inter-ucfe,2,0,0,0,0,0,0,0,0,2,0,4,2,2,FALSE,0.5,2023,2023-2024
PA,2023-11-30,inter-ucx,0,0,0,0,0,0,0,0,0,0,0,0,0,0,FALSE,0,2023,2023-2024
PA,2023-11-30,inter-ui,204,21,9,6,7,11,8,6,9,95,39,415,243,264,FALSE,0.636144578313253,2023,2023-2024
PA,2023-11-30,intra-total,9950,694,478,429,361,338,274,280,382,3787,1452,18425,11402,12096,FALSE,0.656499321573948,2023,2023-2024
PA,2023-11-30,intra-ucfe,6,1,3,3,0,1,1,0,4,15,3,37,9,10,FALSE,0.27027027027027,2023,2023-2024
PA,2023-11-30,intra-ucx,16,0,1,1,1,1,0,0,0,2,6,28,22,22,FALSE,0.785714285714286,2023,2023-2024
PA,2023-11-30,intra-ui,9928,693,474,425,360,336,273,280,378,3770,1443,18360,11371,12064,FALSE,0.657080610021787,2023,2023-2024
PA,2023-12-31,inter-total,224,28,24,15,13,11,12,6,14,121,54,522,278,306,FALSE,0.586206896551724,2023,2023-2024
PA,2023-12-31,inter-ucfe,0,0,0,1,0,0,0,0,0,0,0,1,0,0,FALSE,0,2023,2023-2024
PA,2023-12-31,inter-ucx,0,0,0,0,0,0,0,0,0,2,0,2,0,0,FALSE,0,2023,2023-2024
PA,2023-12-31,inter-ui,224,28,24,14,13,11,12,6,14,119,54,519,278,306,FALSE,0.589595375722543,2023,2023-2024
PA,2023-12-31,intra-total,13698,1019,691,539,486,417,377,328,357,4899,1905,24716,15603,16622,FALSE,0.672519825214436,2023,2023-2024
PA,2023-12-31,intra-ucfe,8,3,1,3,2,3,1,3,1,22,4,51,12,15,FALSE,0.294117647058824,2023,2023-2024
PA,2023-12-31,intra-ucx,20,3,0,2,0,1,0,0,0,5,5,36,25,28,FALSE,0.777777777777778,2023,2023-2024
PA,2023-12-31,intra-ui,13670,1013,690,534,484,413,376,325,356,4872,1896,24629,15566,16579,FALSE,0.673149539161152,2023,2023-2024
PA,2024-01-31,inter-total,348,34,17,20,20,14,12,3,15,164,57,704,405,439,FALSE,0.623579545454545,2023,2023-2024
PA,2024-01-31,inter-ucfe,0,0,1,0,0,0,0,0,0,3,0,4,0,0,FALSE,0,2023,2023-2024
PA,2024-01-31,inter-ucx,0,0,0,0,0,0,0,0,0,0,0,0,0,0,FALSE,0,2023,2023-2024
PA,2024-01-31,inter-ui,348,34,16,20,20,14,12,3,15,161,57,700,405,439,FALSE,0.627142857142857,2023,2023-2024
PA,2024-01-31,intra-total,25413,1578,918,706,602,448,379,328,453,5715,3399,39939,28812,30390,FALSE,0.760910388342222,2023,2023-2024
PA,2024-01-31,intra-ucfe,12,1,2,2,4,3,3,1,1,12,5,46,17,18,FALSE,0.391304347826087,2023,2023-2024
PA,2024-01-31,intra-ucx,18,1,2,0,1,1,1,0,1,5,3,33,21,22,FALSE,0.666666666666667,2023,2023-2024
PA,2024-01-31,intra-ui,25383,1576,914,704,597,444,375,327,451,5698,3391,39860,28774,30350,FALSE,0.761414952333166,2023,2023-2024
PA,2024-02-29,inter-total,188,40,26,21,28,16,8,26,37,125,51,566,239,279,FALSE,0.492932862190813,2023,2023-2024
PA,2024-02-29,inter-ucfe,0,0,0,0,0,0,0,0,0,1,0,1,0,0,FALSE,0,2023,2023-2024
PA,2024-02-29,inter-ucx,0,0,0,0,0,0,0,0,0,0,0,0,0,0,FALSE,0,2023,2023-2024
PA,2024-02-29,inter-ui,188,40,26,21,28,16,8,26,37,124,51,565,239,279,FALSE,0.493805309734513,2023,2023-2024
PA,2024-02-29,intra-total,10885,1576,1187,943,953,787,929,1407,1380,4479,2378,26904,13263,14839,FALSE,0.551553672316384,2023,2023-2024
PA,2024-02-29,intra-ucfe,3,3,5,1,2,3,4,4,5,21,4,55,7,10,FALSE,0.181818181818182,2023,2023-2024
PA,2024-02-29,intra-ucx,13,1,0,1,2,1,1,1,3,4,4,31,17,18,FALSE,0.580645161290323,2023,2023-2024
PA,2024-02-29,intra-ui,10869,1572,1182,941,949,783,924,1402,1372,4454,2370,26818,13239,14811,FALSE,0.552278320530987,2023,2023-2024
PA,2024-03-31,inter-total,159,38,38,39,36,43,29,20,12,67,41,522,200,238,FALSE,0.455938697318008,2023,2023-2024
PA,2024-03-31,inter-ucfe,2,0,0,0,0,0,0,0,1,0,0,3,2,2,FALSE,0.666666666666667,2023,2023-2024
PA,2024-03-31,inter-ucx,0,0,0,0,0,0,0,0,0,0,0,0,0,0,FALSE,0,2023,2023-2024
PA,2024-03-31,inter-ui,157,38,38,39,36,43,29,20,11,67,41,519,198,236,FALSE,0.454720616570328,2023,2023-2024
PA,2024-03-31,intra-total,7063,2263,2332,1755,1569,1474,1468,1056,614,2021,1863,23478,8926,11189,FALSE,0.476573813783116,2023,2023-2024
PA,2024-03-31,intra-ucfe,6,4,8,4,5,4,3,5,0,12,2,53,8,12,FALSE,0.226415094339623,2023,2023-2024
PA,2024-03-31,intra-ucx,10,1,1,1,2,0,1,0,0,5,4,25,14,15,FALSE,0.6,2023,2023-2024
PA,2024-03-31,intra-ui,7047,2258,2323,1750,1562,1470,1464,1051,614,2004,1857,23400,8904,11162,FALSE,0.477008547008547,2023,2023-2024
PA,2024-04-30,inter-total,218,36,27,24,11,7,5,5,4,37,51,425,269,305,FALSE,0.717647058823529,2023,2023-2024
PA,2024-04-30,inter-ucfe,0,1,0,0,0,0,0,0,0,0,0,1,0,1,FALSE,1,2023,2023-2024
PA,2024-04-30,inter-ucx,0,0,0,0,0,0,0,0,0,0,0,0,0,0,FALSE,0,2023,2023-2024
PA,2024-04-30,inter-ui,218,35,27,24,11,7,5,5,4,37,51,424,269,304,FALSE,0.716981132075472,2023,2023-2024
PA,2024-04-30,intra-total,8125,2030,1501,954,541,292,177,114,79,1362,2295,17470,10420,12450,FALSE,0.71265025758443,2023,2023-2024
PA,2024-04-30,intra-ucfe,4,7,4,2,2,3,3,1,2,10,5,43,9,16,FALSE,0.372093023255814,2023,2023-2024
PA,2024-04-30,intra-ucx,30,2,1,2,2,0,2,0,0,5,3,47,33,35,FALSE,0.74468085106383,2023,2023-2024
PA,2024-04-30,intra-ui,8091,2021,1496,950,537,289,172,113,77,1347,2287,17380,10378,12399,FALSE,0.713406214039125,2023,2023-2024
PA,2024-05-31,inter-total,170,30,37,26,19,10,3,4,8,49,34,390,204,234,FALSE,0.6,2023,2023-2024
PA,2024-05-31,inter-ucfe,2,0,1,0,0,0,0,0,0,0,0,3,2,2,FALSE,0.666666666666667,2023,2023-2024
PA,2024-05-31,inter-ucx,0,0,0,0,0,0,0,0,0,0,0,0,0,0,FALSE,0,2023,2023-2024
PA,2024-05-31,inter-ui,168,30,36,26,19,10,3,4,8,49,34,387,202,232,FALSE,0.599483204134367,2023,2023-2024
PA,2024-05-31,intra-total,7321,1689,1748,1351,692,324,163,111,89,1299,1465,16252,8786,10475,FALSE,0.644536057100665,2023,2023-2024
PA,2024-05-31,intra-ucfe,6,3,6,6,4,2,1,0,0,7,5,40,11,14,FALSE,0.35,2023,2023-2024
PA,2024-05-31,intra-ucx,10,1,0,2,0,0,0,0,0,1,2,16,12,13,FALSE,0.8125,2023,2023-2024
PA,2024-05-31,intra-ui,7305,1685,1742,1343,688,322,162,111,89,1291,1458,16196,8763,10448,FALSE,0.64509755495184,2023,2023-2024
PA,2024-06-30,inter-total,137,21,31,27,27,11,7,3,3,33,33,333,170,191,FALSE,0.573573573573574,2023,2023-2024
PA,2024-06-30,inter-ucfe,0,0,0,1,0,1,0,0,0,0,0,2,0,0,FALSE,0,2023,2023-2024
PA,2024-06-30,inter-ucx,0,0,0,0,0,0,0,0,0,0,0,0,0,0,FALSE,0,2023,2023-2024
PA,2024-06-30,inter-ui,137,21,31,26,27,10,7,3,3,33,33,331,170,191,FALSE,0.577039274924471,2023,2023-2024
PA,2024-06-30,intra-total,14330,1288,1825,1520,971,461,220,116,92,947,2208,23978,16538,17826,FALSE,0.743431478855618,2023,2023-2024
PA,2024-06-30,intra-ucfe,6,4,3,10,5,5,0,0,2,3,1,39,7,11,FALSE,0.282051282051282,2023,2023-2024
PA,2024-06-30,intra-ucx,20,0,2,0,1,1,0,0,0,0,1,25,21,21,FALSE,0.84,2023,2023-2024
PA,2024-06-30,intra-ui,14304,1284,1820,1510,965,455,220,116,90,944,2206,23914,16510,17794,FALSE,0.744082963954169,2023,2023-2024
PA,2024-07-31,inter-total,189,46,32,32,22,9,8,2,3,35,70,448,259,305,FALSE,0.680803571428571,2024,2024-2025
PA,2024-07-31,inter-ucfe,0,0,0,0,0,0,0,0,0,0,0,0,0,0,FALSE,0,2024,2024-2025
PA,2024-07-31,inter-ucx,0,0,0,0,0,0,0,0,0,0,0,0,0,0,FALSE,0,2024,2024-2025
PA,2024-07-31,inter-ui,189,46,32,32,22,9,8,2,3,35,70,448,259,305,FALSE,0.680803571428571,2024,2024-2025
PA,2024-07-31,intra-total,16706,2767,2253,1897,1294,630,279,152,107,1072,4123,31280,20829,23596,FALSE,0.754347826086957,2024,2024-2025
PA,2024-07-31,intra-ucfe,3,4,3,10,4,1,1,1,2,5,7,41,10,14,FALSE,0.341463414634146,2024,2024-2025
PA,2024-07-31,intra-ucx,18,2,3,0,0,0,0,1,0,0,4,28,22,24,FALSE,0.857142857142857,2024,2024-2025
PA,2024-07-31,intra-ui,16685,2761,2247,1887,1290,629,278,150,105,1067,4112,31211,20797,23558,FALSE,0.754797987888885,2024,2024-2025
PA,2024-08-31,inter-total,171,34,31,27,13,14,4,6,1,36,57,394,228,262,FALSE,0.66497461928934,2024,2024-2025
PA,2024-08-31,inter-ucfe,0,0,0,0,0,0,0,0,0,1,0,1,0,0,FALSE,0,2024,2024-2025
PA,2024-08-31,inter-ucx,0,0,0,0,0,0,0,0,0,0,0,0,0,0,FALSE,0,2024,2024-2025
PA,2024-08-31,inter-ui,171,34,31,27,13,14,4,6,1,35,57,393,228,262,FALSE,0.666666666666667,2024,2024-2025
PA,2024-08-31,intra-total,8625,2085,1662,1224,785,414,245,167,110,1109,2950,19376,11575,13660,FALSE,0.704995871180842,2024,2024-2025
PA,2024-08-31,intra-ucfe,5,3,6,8,1,4,0,3,0,7,5,42,10,13,FALSE,0.30952380952381,2024,2024-2025
PA,2024-08-31,intra-ucx,15,3,2,2,2,0,0,0,0,0,4,28,19,22,FALSE,0.785714285714286,2024,2024-2025
PA,2024-08-31,intra-ui,8605,2079,1654,1214,782,410,245,164,110,1102,2941,19306,11546,13625,FALSE,0.705739148451259,2024,2024-2025
PA,2024-09-30,inter-total,160,30,28,14,9,4,8,6,2,34,44,339,204,234,FALSE,0.690265486725664,2024,2024-2025
PA,2024-09-30,inter-ucfe,0,0,0,0,0,0,0,0,1,1,0,2,0,0,FALSE,0,2024,2024-2025
PA,2024-09-30,inter-ucx,0,0,0,0,0,0,0,0,0,0,0,0,0,0,FALSE,0,2024,2024-2025
PA,2024-09-30,inter-ui,160,30,28,14,9,4,8,6,1,33,44,337,204,234,FALSE,0.694362017804154,2024,2024-2025
PA,2024-09-30,intra-total,7538,1842,1323,825,445,230,137,87,84,1051,2642,16204,10180,12022,FALSE,0.741915576400889,2024,2024-2025
PA,2024-09-30,intra-ucfe,4,6,6,4,2,3,1,2,1,5,4,38,8,14,FALSE,0.368421052631579,2024,2024-2025
PA,2024-09-30,intra-ucx,17,2,0,5,1,1,1,0,0,0,6,33,23,25,FALSE,0.757575757575758,2024,2024-2025
PA,2024-09-30,intra-ui,7517,1834,1317,816,442,226,135,85,83,1046,2632,16133,10149,11983,FALSE,0.742763280233063,2024,2024-2025
PA,2024-10-31,inter-total,184,27,19,9,3,4,2,0,3,35,52,338,236,263,FALSE,0.77810650887574,2024,2024-2025
PA,2024-10-31,inter-ucfe,0,0,0,1,0,0,0,0,0,1,0,2,0,0,FALSE,0,2024,2024-2025
PA,2024-10-31,inter-ucx,0,0,0,0,0,0,0,0,0,0,0,0,0,0,FALSE,0,2024,2024-2025
PA,2024-10-31,inter-ui,184,27,19,8,3,4,2,0,3,34,52,336,236,263,FALSE,0.782738095238095,2024,2024-2025
PA,2024-10-31,intra-total,9933,1619,785,314,161,93,59,50,58,1026,3169,17267,13102,14721,FALSE,0.852551109051949,2024,2024-2025
PA,2024-10-31,intra-ucfe,9,5,6,1,0,1,1,1,0,4,8,36,17,22,FALSE,0.611111111111111,2024,2024-2025
PA,2024-10-31,intra-ucx,26,1,6,1,1,0,0,0,0,2,8,45,34,35,FALSE,0.777777777777778,2024,2024-2025
PA,2024-10-31,intra-ui,9898,1613,773,312,160,92,58,49,58,1020,3153,17186,13051,14664,FALSE,0.853252647503782,2024,2024-2025
PA,2024-11-30,inter-total,215,22,10,3,4,2,2,2,1,21,56,338,271,293,FALSE,0.866863905325444,2024,2024-2025
PA,2024-11-30,inter-ucfe,0,0,0,0,0,0,0,0,0,0,0,0,0,0,FALSE,0,2024,2024-2025
PA,2024-11-30,inter-ucx,0,0,0,0,0,0,0,0,0,0,0,0,0,0,FALSE,0,2024,2024-2025
PA,2024-11-30,inter-ui,215,22,10,3,4,2,2,2,1,21,56,338,271,293,FALSE,0.866863905325444,2024,2024-2025
PA,2024-11-30,intra-total,11860,1004,357,157,78,54,49,28,36,809,2599,17031,14459,15463,FALSE,0.90793259350596,2024,2024-2025
PA,2024-11-30,intra-ucfe,8,4,3,2,0,1,5,0,0,9,4,36,12,16,FALSE,0.444444444444444,2024,2024-2025
PA,2024-11-30,intra-ucx,20,0,1,0,1,0,0,0,0,2,4,28,24,24,FALSE,0.857142857142857,2024,2024-2025
PA,2024-11-30,intra-ui,11832,1000,353,155,77,53,44,28,36,798,2591,16967,14423,15423,FALSE,0.908999823186185,2024,2024-2025
PA,2024-12-31,inter-total,248,34,26,7,4,2,3,4,1,27,73,429,321,355,FALSE,0.827505827505827,2024,2024-2025
PA,2024-12-31,inter-ucfe,1,0,0,0,0,0,0,0,0,0,1,2,2,2,FALSE,1,2024,2024-2025
PA,2024-12-31,inter-ucx,0,0,0,0,0,0,0,0,0,0,0,0,0,0,FALSE,0,2024,2024-2025
PA,2024-12-31,inter-ui,247,34,26,7,4,2,3,4,1,27,72,427,319,353,FALSE,0.826697892271663,2024,2024-2025
PA,2024-12-31,intra-total,22054,1577,719,289,121,76,62,48,38,963,4107,30054,26161,27738,FALSE,0.922938710321421,2024,2024-2025
PA,2024-12-31,intra-ucfe,22,6,6,3,1,1,1,0,0,6,5,51,27,33,FALSE,0.647058823529412,2024,2024-2025
PA,2024-12-31,intra-ucx,18,1,1,0,0,1,0,1,0,0,3,25,21,22,FALSE,0.88,2024,2024-2025
PA,2024-12-31,intra-ui,22014,1570,712,286,120,74,61,47,38,957,4099,29978,26113,27683,FALSE,0.923443858829808,2024,2024-2025
PR,2019-01-31,inter-total,9,1,1,2,1,0,1,0,0,0,10,25,19,20,FALSE,0.8,2018,2018-2019
PR,2019-01-31,inter-ucfe,0,0,0,1,1,0,0,0,0,0,0,2,0,0,FALSE,0,2018,2018-2019
PR,2019-01-31,inter-ucx,0,0,0,0,0,0,0,0,0,0,0,0,0,0,FALSE,0,2018,2018-2019
PR,2019-01-31,inter-ui,9,1,1,1,0,0,1,0,0,0,10,23,19,20,FALSE,0.869565217391304,2018,2018-2019
PR,2019-01-31,intra-total,1983,199,67,32,15,12,12,15,9,57,798,3199,2781,2980,FALSE,0.931541106595811,2018,2018-2019
PR,2019-01-31,intra-ucfe,147,4,3,1,0,0,0,0,0,1,19,175,166,170,FALSE,0.971428571428571,2018,2018-2019
PR,2019-01-31,intra-ucx,2,1,0,0,1,0,0,0,0,0,1,5,3,4,FALSE,0.8,2018,2018-2019
PR,2019-01-31,intra-ui,1834,194,64,31,14,12,12,15,9,56,778,3019,2612,2806,FALSE,0.929446836700894,2018,2018-2019
PR,2019-02-28,inter-total,7,5,0,1,0,0,0,0,1,3,11,28,18,23,FALSE,0.821428571428571,2018,2018-2019
PR,2019-02-28,inter-ucfe,0,1,0,0,0,0,0,0,1,0,0,2,0,1,FALSE,0.5,2018,2018-2019
PR,2019-02-28,inter-ucx,1,0,0,0,0,0,0,0,0,0,0,1,1,1,FALSE,1,2018,2018-2019
PR,2019-02-28,inter-ui,6,4,0,1,0,0,0,0,0,3,11,25,17,21,FALSE,0.84,2018,2018-2019
PR,2019-02-28,intra-total,1931,92,48,33,15,15,11,6,7,32,696,2886,2627,2719,FALSE,0.942134442134442,2018,2018-2019
PR,2019-02-28,intra-ucfe,25,7,1,2,0,0,0,1,0,0,11,47,36,43,FALSE,0.914893617021277,2018,2018-2019
PR,2019-02-28,intra-ucx,3,0,0,0,0,1,0,0,0,0,3,7,6,6,FALSE,0.857142857142857,2018,2018-2019
PR,2019-02-28,intra-ui,1903,85,47,31,15,14,11,5,7,32,682,2832,2585,2670,FALSE,0.942796610169492,2018,2018-2019
PR,2019-03-31,inter-total,9,1,1,1,0,1,0,0,1,1,13,28,22,23,FALSE,0.821428571428571,2018,2018-2019
PR,2019-03-31,inter-ucfe,0,0,0,0,0,0,0,0,0,0,0,0,0,0,FALSE,0,2018,2018-2019
PR,2019-03-31,inter-ucx,0,0,0,1,0,0,0,0,0,0,0,1,0,0,FALSE,0,2018,2018-2019
PR,2019-03-31,inter-ui,9,1,1,0,0,1,0,0,1,1,13,27,22,23,FALSE,0.851851851851852,2018,2018-2019
PR,2019-03-31,intra-total,1603,101,59,27,17,11,12,11,8,52,627,2528,2230,2331,FALSE,0.922072784810127,2018,2018-2019
PR,2019-03-31,intra-ucfe,19,4,2,0,1,0,0,0,0,0,12,38,31,35,FALSE,0.921052631578947,2018,2018-2019
PR,2019-03-31,intra-ucx,10,0,0,0,0,0,0,0,0,0,2,12,12,12,FALSE,1,2018,2018-2019
PR,2019-03-31,intra-ui,1574,97,57,27,16,11,12,11,8,52,613,2478,2187,2284,FALSE,0.921711057304278,2018,2018-2019
PR,2019-04-30,inter-total,6,3,0,0,0,1,0,1,0,2,4,17,10,13,FALSE,0.764705882352941,2018,2018-2019
PR,2019-04-30,inter-ucfe,0,0,0,0,0,0,0,0,0,0,0,0,0,0,FALSE,0,2018,2018-2019
PR,2019-04-30,inter-ucx,0,0,0,0,0,0,0,0,0,0,0,0,0,0,FALSE,0,2018,2018-2019
PR,2019-04-30,inter-ui,6,3,0,0,0,1,0,1,0,2,4,17,10,13,FALSE,0.764705882352941,2018,2018-2019
PR,2019-04-30,intra-total,1703,117,61,26,15,8,16,6,10,59,606,2627,2309,2426,FALSE,0.923486867148839,2018,2018-2019
PR,2019-04-30,intra-ucfe,12,1,1,1,0,3,0,0,0,0,4,22,16,17,FALSE,0.772727272727273,2018,2018-2019
PR,2019-04-30,intra-ucx,4,0,1,0,0,0,0,0,0,1,3,9,7,7,FALSE,0.777777777777778,2018,2018-2019
PR,2019-04-30,intra-ui,1687,116,59,25,15,5,16,6,10,58,599,2596,2286,2402,FALSE,0.925269645608629,2018,2018-2019
PR,2019-05-31,inter-total,5,0,2,0,0,2,0,0,0,1,3,13,8,8,FALSE,0.615384615384615,2018,2018-2019
PR,2019-05-31,inter-ucfe,2,0,0,0,0,0,0,0,0,0,0,2,2,2,FALSE,1,2018,2018-2019
PR,2019-05-31,inter-ucx,0,0,0,0,0,0,0,0,0,0,0,0,0,0,FALSE,0,2018,2018-2019
PR,2019-05-31,inter-ui,3,0,2,0,0,2,0,0,0,1,3,11,6,6,FALSE,0.545454545454545,2018,2018-2019
PR,2019-05-31,intra-total,1670,125,50,35,25,16,15,8,15,58,610,2627,2280,2405,FALSE,0.915492957746479,2018,2018-2019
PR,2019-05-31,intra-ucfe,17,1,2,1,1,1,1,0,0,1,3,28,20,21,FALSE,0.75,2018,2018-2019
PR,2019-05-31,intra-ucx,7,0,0,2,1,2,0,0,0,1,1,14,8,8,FALSE,0.571428571428571,2018,2018-2019
PR,2019-05-31,intra-ui,1646,124,48,32,23,13,14,8,15,56,606,2585,2252,2376,FALSE,0.919148936170213,2018,2018-2019
PR,2019-06-30,inter-total,9,1,0,0,0,0,0,0,0,2,4,16,13,14,FALSE,0.875,2018,2018-2019
PR,2019-06-30,inter-ucfe,0,0,0,0,0,0,0,0,0,0,0,0,0,0,FALSE,0,2018,2018-2019
PR,2019-06-30,inter-ucx,0,0,0,0,0,0,0,0,0,0,0,0,0,0,FALSE,0,2018,2018-2019
PR,2019-06-30,inter-ui,9,1,0,0,0,0,0,0,0,2,4,16,13,14,FALSE,0.875,2018,2018-2019
PR,2019-06-30,intra-total,4491,122,55,29,17,14,12,8,7,74,710,5539,5201,5323,FALSE,0.961003791298068,2018,2018-2019
PR,2019-06-30,intra-ucfe,12,1,2,0,1,0,1,0,0,2,5,24,17,18,FALSE,0.75,2018,2018-2019
PR,2019-06-30,intra-ucx,6,0,0,0,0,0,0,0,0,0,4,10,10,10,FALSE,1,2018,2018-2019
PR,2019-06-30,intra-ui,4473,121,53,29,16,14,11,8,7,72,701,5505,5174,5295,FALSE,0.961852861035422,2018,2018-2019
PR,2019-07-31,inter-total,13,1,0,1,0,0,0,0,0,0,18,33,31,32,FALSE,0.96969696969697,2019,2019-2020
PR,2019-07-31,inter-ucfe,0,0,0,0,0,0,0,0,0,0,1,1,1,1,FALSE,1,2019,2019-2020
PR,2019-07-31,inter-ucx,0,0,0,0,0,0,0,0,0,0,0,0,0,0,FALSE,0,2019,2019-2020
PR,2019-07-31,inter-ui,13,1,0,1,0,0,0,0,0,0,17,32,30,31,FALSE,0.96875,2019,2019-2020
PR,2019-07-31,intra-total,4954,217,89,36,30,19,15,14,11,68,1244,6697,6198,6415,FALSE,0.957891593250709,2019,2019-2020
PR,2019-07-31,intra-ucfe,22,4,2,0,0,0,0,0,0,2,9,39,31,35,FALSE,0.897435897435897,2019,2019-2020
PR,2019-07-31,intra-ucx,11,1,0,0,0,0,0,0,0,2,5,19,16,17,FALSE,0.894736842105263,2019,2019-2020
PR,2019-07-31,intra-ui,4921,212,87,36,30,19,15,14,11,64,1230,6639,6151,6363,FALSE,0.958427474017171,2019,2019-2020
PR,2019-08-31,inter-total,15,2,2,0,0,0,0,0,0,0,17,36,32,34,FALSE,0.944444444444444,2019,2019-2020
PR,2019-08-31,inter-ucfe,0,0,0,0,0,0,0,0,0,0,0,0,0,0,FALSE,0,2019,2019-2020
PR,2019-08-31,inter-ucx,0,0,0,0,0,0,0,0,0,0,0,0,0,0,FALSE,0,2019,2019-2020
PR,2019-08-31,inter-ui,15,2,2,0,0,0,0,0,0,0,17,36,32,34,FALSE,0.944444444444444,2019,2019-2020
PR,2019-08-31,intra-total,2769,182,73,45,35,20,21,13,12,60,1043,4273,3812,3994,FALSE,0.934706295342851,2019,2019-2020
PR,2019-08-31,intra-ucfe,19,1,2,1,1,0,1,1,0,1,4,31,23,24,FALSE,0.774193548387097,2019,2019-2020
PR,2019-08-31,intra-ucx,17,3,1,0,0,0,1,0,0,0,4,26,21,24,FALSE,0.923076923076923,2019,2019-2020
PR,2019-08-31,intra-ui,2733,178,70,44,34,20,19,12,12,59,1035,4216,3768,3946,FALSE,0.93595825426945,2019,2019-2020
PR,2019-09-30,inter-total,13,3,0,0,2,0,1,0,0,1,12,32,25,28,FALSE,0.875,2019,2019-2020
PR,2019-09-30,inter-ucfe,1,0,0,0,0,0,0,0,0,0,0,1,1,1,FALSE,1,2019,2019-2020
PR,2019-09-30,inter-ucx,0,0,0,0,0,0,0,0,0,0,0,0,0,0,FALSE,0,2019,2019-2020
PR,2019-09-30,inter-ui,12,3,0,0,2,0,1,0,0,1,12,31,24,27,FALSE,0.870967741935484,2019,2019-2020
PR,2019-09-30,intra-total,2343,180,61,47,22,16,18,9,8,53,954,3711,3297,3477,FALSE,0.936944219886823,2019,2019-2020
PR,2019-09-30,intra-ucfe,24,1,2,1,0,0,0,0,0,0,5,33,29,30,FALSE,0.909090909090909,2019,2019-2020
PR,2019-09-30,intra-ucx,12,2,0,0,1,0,0,0,0,0,4,19,16,18,FALSE,0.947368421052632,2019,2019-2020
PR,2019-09-30,intra-ui,2307,177,59,46,21,16,18,9,8,53,945,3659,3252,3429,FALSE,0.937141295435911,2019,2019-2020
PR,2019-10-31,inter-total,12,0,2,0,3,0,0,0,0,0,9,26,21,21,FALSE,0.807692307692308,2019,2019-2020
PR,2019-10-31,inter-ucfe,1,0,0,0,0,0,0,0,0,0,0,1,1,1,FALSE,1,2019,2019-2020
PR,2019-10-31,inter-ucx,0,0,0,0,0,0,0,0,0,0,0,0,0,0,FALSE,0,2019,2019-2020
PR,2019-10-31,inter-ui,11,0,2,0,3,0,0,0,0,0,9,25,20,20,FALSE,0.8,2019,2019-2020
PR,2019-10-31,intra-total,2423,143,44,40,24,19,17,14,18,48,806,3596,3229,3372,FALSE,0.937708565072303,2019,2019-2020
PR,2019-10-31,intra-ucfe,36,1,0,0,0,0,0,0,0,0,7,44,43,44,FALSE,1,2019,2019-2020
PR,2019-10-31,intra-ucx,15,3,0,1,0,0,0,0,0,0,4,23,19,22,FALSE,0.956521739130435,2019,2019-2020
PR,2019-10-31,intra-ui,2372,139,44,39,24,19,17,14,18,48,795,3529,3167,3306,FALSE,0.936809294417682,2019,2019-2020
PR,2019-11-30,inter-total,8,1,0,0,0,0,0,0,0,1,11,21,19,20,FALSE,0.952380952380952,2019,2019-2020
PR,2019-11-30,inter-ucfe,0,0,0,0,0,0,0,0,0,0,0,0,0,0,FALSE,0,2019,2019-2020
PR,2019-11-30,inter-ucx,0,0,0,0,0,0,0,0,0,0,0,0,0,0,FALSE,0,2019,2019-2020
PR,2019-11-30,inter-ui,8,1,0,0,0,0,0,0,0,1,11,21,19,20,FALSE,0.952380952380952,2019,2019-2020
PR,2019-11-30,intra-total,1643,86,45,23,16,12,10,19,8,39,641,2542,2284,2370,FALSE,0.932336742722266,2019,2019-2020
PR,2019-11-30,intra-ucfe,24,0,2,1,0,0,0,0,0,0,6,33,30,30,FALSE,0.909090909090909,2019,2019-2020
PR,2019-11-30,intra-ucx,17,0,0,0,0,0,0,0,0,3,4,24,21,21,FALSE,0.875,2019,2019-2020
PR,2019-11-30,intra-ui,1602,86,43,22,16,12,10,19,8,36,631,2485,2233,2319,FALSE,0.933199195171026,2019,2019-2020
PR,2019-12-31,inter-total,12,2,2,0,0,0,0,0,0,1,3,20,15,17,FALSE,0.85,2019,2019-2020
PR,2019-12-31,inter-ucfe,0,0,0,0,0,0,0,0,0,0,0,0,0,0,FALSE,0,2019,2019-2020
PR,2019-12-31,inter-ucx,0,0,0,0,0,0,0,0,0,0,0,0,0,0,FALSE,0,2019,2019-2020
PR,2019-12-31,inter-ui,12,2,2,0,0,0,0,0,0,1,3,20,15,17,FALSE,0.85,2019,2019-2020
PR,2019-12-31,intra-total,1564,118,55,19,23,11,10,9,11,38,623,2481,2187,2305,FALSE,0.929060862555421,2019,2019-2020
PR,2019-12-31,intra-ucfe,110,6,2,1,0,0,0,0,0,1,22,142,132,138,FALSE,0.971830985915493,2019,2019-2020
PR,2019-12-31,intra-ucx,10,0,0,0,0,0,0,0,0,0,8,18,18,18,FALSE,1,2019,2019-2020
PR,2019-12-31,intra-ui,1444,112,53,18,23,11,10,9,11,37,593,2321,2037,2149,FALSE,0.925894011202068,2019,2019-2020
PR,2020-01-31,inter-total,9,2,0,2,0,1,1,0,0,2,5,22,14,16,FALSE,0.727272727272727,2019,2019-2020
PR,2020-01-31,inter-ucfe,0,0,0,0,0,1,0,0,0,0,0,1,0,0,FALSE,0,2019,2019-2020
PR,2020-01-31,inter-ucx,0,0,0,0,0,0,0,0,0,0,0,0,0,0,FALSE,0,2019,2019-2020
PR,2020-01-31,inter-ui,9,2,0,2,0,0,1,0,0,2,5,21,14,16,FALSE,0.761904761904762,2019,2019-2020
PR,2020-01-31,intra-total,2041,479,179,95,45,20,14,11,9,76,1745,4714,3786,4265,FALSE,0.904751803139584,2019,2019-2020
PR,2020-01-31,intra-ucfe,9,10,8,3,1,0,1,0,1,2,15,50,24,34,FALSE,0.68,2019,2019-2020
PR,2020-01-31,intra-ucx,3,2,1,0,0,0,0,0,0,0,2,8,5,7,FALSE,0.875,2019,2019-2020
PR,2020-01-31,intra-ui,2029,467,170,92,44,20,13,11,8,74,1728,4656,3757,4224,FALSE,0.907216494845361,2019,2019-2020
PR,2020-02-29,inter-total,21,9,0,5,2,0,0,0,0,0,23,60,44,53,FALSE,0.883333333333333,2019,2019-2020
PR,2020-02-29,inter-ucfe,0,0,0,0,0,0,0,0,0,0,1,1,1,1,FALSE,1,2019,2019-2020
PR,2020-02-29,inter-ucx,0,0,0,0,0,0,0,0,0,0,0,0,0,0,FALSE,0,2019,2019-2020
PR,2020-02-29,inter-ui,21,9,0,5,2,0,0,0,0,0,22,59,43,52,FALSE,0.88135593220339,2019,2019-2020
PR,2020-02-29,intra-total,2173,551,244,140,87,22,17,12,9,56,952,4263,3125,3676,FALSE,0.862303542106498,2019,2019-2020
PR,2020-02-29,intra-ucfe,3,2,0,1,0,0,1,0,0,1,3,11,6,8,FALSE,0.727272727272727,2019,2019-2020
PR,2020-02-29,intra-ucx,7,4,1,0,1,0,1,0,0,0,2,16,9,13,FALSE,0.8125,2019,2019-2020
PR,2020-02-29,intra-ui,2163,545,243,139,86,22,15,12,9,55,947,4236,3110,3655,FALSE,0.862842304060435,2019,2019-2020
PR,2020-03-31,inter-total,10,4,0,0,0,0,0,0,0,1,13,28,23,27,FALSE,0.964285714285714,2019,2019-2020
PR,2020-03-31,inter-ucfe,0,0,0,0,0,0,0,0,0,0,0,0,0,0,FALSE,0,2019,2019-2020
PR,2020-03-31,inter-ucx,0,0,0,0,0,0,0,0,0,0,0,0,0,0,FALSE,0,2019,2019-2020
PR,2020-03-31,inter-ui,10,4,0,0,0,0,0,0,0,1,13,28,23,27,FALSE,0.964285714285714,2019,2019-2020
PR,2020-03-31,intra-total,2361,110,62,23,21,27,24,3,3,25,594,3253,2955,3065,FALSE,0.942207193359975,2019,2019-2020
PR,2020-03-31,intra-ucfe,13,0,0,0,0,0,0,0,0,0,1,14,14,14,FALSE,1,2019,2019-2020
PR,2020-03-31,intra-ucx,11,3,0,0,0,0,0,0,0,0,3,17,14,17,FALSE,1,2019,2019-2020
PR,2020-03-31,intra-ui,2337,107,62,23,21,27,24,3,3,25,590,3222,2927,3034,FALSE,0.941651148355059,2019,2019-2020
PR,2020-04-30,inter-total,15,27,13,4,3,1,1,0,0,2,28,94,43,70,FALSE,0.74468085106383,2019,2019-2020
PR,2020-04-30,inter-ucfe,0,0,1,0,0,0,0,0,0,0,0,1,0,0,FALSE,0,2019,2019-2020
PR,2020-04-30,inter-ucx,0,0,0,0,0,0,0,0,0,0,0,0,0,0,FALSE,0,2019,2019-2020
PR,2020-04-30,inter-ui,15,27,12,4,3,1,1,0,0,2,28,93,43,70,FALSE,0.752688172043011,2019,2019-2020
PR,2020-04-30,intra-total,25155,16943,8156,4164,1406,60,13,5,4,40,30000,85946,55155,72098,FALSE,0.838875573034231,2019,2019-2020
PR,2020-04-30,intra-ucfe,7,6,3,1,0,0,0,0,0,1,12,30,19,25,FALSE,0.833333333333333,2019,2019-2020
PR,2020-04-30,intra-ucx,2,2,2,1,0,0,0,0,0,0,3,10,5,7,FALSE,0.7,2019,2019-2020
PR,2020-04-30,intra-ui,25146,16935,8151,4162,1406,60,13,5,4,39,29985,85906,55131,72066,FALSE,0.83889367448141,2019,2019-2020
PR,2020-05-31,inter-total,0,18,6,26,13,7,3,6,2,1,26,108,26,44,FALSE,0.407407407407407,2019,2019-2020
PR,2020-05-31,inter-ucfe,0,0,0,0,0,0,0,0,0,0,0,0,0,0,FALSE,0,2019,2019-2020
PR,2020-05-31,inter-ucx,0,0,0,0,0,0,0,0,0,0,0,0,0,0,FALSE,0,2019,2019-2020
PR,2020-05-31,inter-ui,0,18,6,26,13,7,3,6,2,1,26,108,26,44,FALSE,0.407407407407407,2019,2019-2020
PR,2020-05-31,intra-total,383,5118,4556,5611,6227,5785,5469,4584,1222,82,17598,56635,17981,23099,FALSE,0.407857332038492,2019,2019-2020
PR,2020-05-31,intra-ucfe,2,0,3,1,7,6,7,4,1,0,8,39,10,10,FALSE,0.256410256410256,2019,2019-2020
PR,2020-05-31,intra-ucx,0,3,2,1,0,0,0,2,1,0,2,11,2,5,FALSE,0.454545454545455,2019,2019-2020
PR,2020-05-31,intra-ui,381,5115,4551,5609,6220,5779,5462,4578,1220,82,17588,56585,17969,23084,FALSE,0.407952637624812,2019,2019-2020
PR,2020-06-30,inter-total,1,7,2,2,1,5,6,6,1,24,11,66,12,19,FALSE,0.287878787878788,2019,2019-2020
PR,2020-06-30,inter-ucfe,0,0,0,0,0,0,0,0,0,0,0,0,0,0,FALSE,0,2019,2019-2020
PR,2020-06-30,inter-ucx,0,0,0,0,0,0,0,0,0,0,0,0,0,0,FALSE,0,2019,2019-2020
PR,2020-06-30,inter-ui,1,7,2,2,1,5,6,6,1,24,11,66,12,19,FALSE,0.287878787878788,2019,2019-2020
PR,2020-06-30,intra-total,658,1697,1148,1385,1561,1887,2612,3331,4152,20805,6705,45941,7363,9060,FALSE,0.197209464312923,2019,2019-2020
PR,2020-06-30,intra-ucfe,0,0,0,2,7,4,4,2,6,16,2,43,2,2,FALSE,0.0465116279069768,2019,2019-2020
PR,2020-06-30,intra-ucx,1,0,0,0,1,0,0,1,0,1,1,5,2,2,FALSE,0.4,2019,2019-2020
PR,2020-06-30,intra-ui,657,1697,1148,1383,1553,1883,2608,3328,4146,20788,6702,45893,7359,9056,FALSE,0.197328568627024,2019,2019-2020
PR,2020-07-31,inter-total,3,0,1,0,2,3,4,3,1,23,3,43,6,6,FALSE,0.13953488372093,2020,2020-2021
PR,2020-07-31,inter-ucfe,0,0,0,0,0,0,0,0,0,0,0,0,0,0,FALSE,0,2020,2020-2021
PR,2020-07-31,inter-ucx,0,0,0,0,0,0,0,0,0,0,0,0,0,0,FALSE,0,2020,2020-2021
PR,2020-07-31,inter-ui,3,0,1,0,2,3,4,3,1,23,3,43,6,6,FALSE,0.13953488372093,2020,2020-2021
PR,2020-07-31,intra-total,1375,1474,742,560,557,551,536,618,694,22694,2909,32710,4284,5758,FALSE,0.176031794558239,2020,2020-2021
PR,2020-07-31,intra-ucfe,4,3,0,0,0,3,2,0,0,11,3,26,7,10,FALSE,0.384615384615385,2020,2020-2021
PR,2020-07-31,intra-ucx,0,1,0,1,2,0,0,1,1,5,1,12,1,2,FALSE,0.166666666666667,2020,2020-2021
PR,2020-07-31,intra-ui,1371,1470,742,559,555,548,534,617,693,22678,2905,32672,4276,5746,FALSE,0.175869245837414,2020,2020-2021
PR,2020-08-31,inter-total,0,4,0,1,2,1,0,1,3,16,3,31,3,7,FALSE,0.225806451612903,2020,2020-2021
PR,2020-08-31,inter-ucfe,0,0,0,0,0,0,0,0,0,0,0,0,0,0,FALSE,0,2020,2020-2021
PR,2020-08-31,inter-ucx,0,0,0,0,0,0,0,0,0,0,0,0,0,0,FALSE,0,2020,2020-2021
PR,2020-08-31,inter-ui,0,4,0,1,2,1,0,1,3,16,3,31,3,7,FALSE,0.225806451612903,2020,2020-2021
PR,2020-08-31,intra-total,212,751,475,544,477,412,356,340,314,12435,2097,18413,2309,3060,FALSE,0.166186933145061,2020,2020-2021
PR,2020-08-31,intra-ucfe,0,0,0,4,2,0,1,0,0,12,2,21,2,2,FALSE,0.0952380952380952,2020,2020-2021
PR,2020-08-31,intra-ucx,0,1,0,0,0,0,1,0,1,1,0,4,0,1,FALSE,0.25,2020,2020-2021
PR,2020-08-31,intra-ui,212,750,475,540,475,412,354,340,313,12422,2095,18388,2307,3057,FALSE,0.166249728083533,2020,2020-2021
PR,2020-09-30,inter-total,0,1,1,1,0,1,2,2,0,11,4,23,4,5,FALSE,0.217391304347826,2020,2020-2021
PR,2020-09-30,inter-ucfe,0,0,0,0,0,0,0,0,0,0,0,0,0,0,FALSE,0,2020,2020-2021
PR,2020-09-30,inter-ucx,0,0,0,0,0,0,0,0,0,0,0,0,0,0,FALSE,0,2020,2020-2021
PR,2020-09-30,inter-ui,0,1,1,1,0,1,2,2,0,11,4,23,4,5,FALSE,0.217391304347826,2020,2020-2021
PR,2020-09-30,intra-total,17,215,156,181,186,211,225,264,365,6832,1003,9655,1020,1235,FALSE,0.127912998446401,2020,2020-2021
PR,2020-09-30,intra-ucfe,0,0,0,1,1,2,2,2,0,18,2,28,2,2,FALSE,0.0714285714285714,2020,2020-2021
PR,2020-09-30,intra-ucx,0,0,0,1,0,1,0,0,0,2,0,4,0,0,FALSE,0,2020,2020-2021
PR,2020-09-30,intra-ui,17,215,156,179,185,208,223,262,365,6812,1001,9623,1018,1233,FALSE,0.128130520627663,2020,2020-2021
PR,2020-10-31,inter-total,1,3,1,0,1,0,3,1,4,15,3,32,4,7,FALSE,0.21875,2020,2020-2021
PR,2020-10-31,inter-ucfe,0,0,1,0,0,0,0,0,0,0,0,1,0,0,FALSE,0,2020,2020-2021
PR,2020-10-31,inter-ucx,0,0,0,0,0,0,0,0,0,0,0,0,0,0,FALSE,0,2020,2020-2021
PR,2020-10-31,inter-ui,1,3,0,0,1,0,3,1,4,15,3,31,4,7,FALSE,0.225806451612903,2020,2020-2021
PR,2020-10-31,intra-total,25,197,122,99,111,112,119,129,124,4033,1142,6213,1167,1364,FALSE,0.219539674875262,2020,2020-2021
PR,2020-10-31,intra-ucfe,0,1,0,1,0,1,0,1,0,12,3,19,3,4,FALSE,0.210526315789474,2020,2020-2021
PR,2020-10-31,intra-ucx,0,1,0,0,0,0,0,0,0,2,0,3,0,1,FALSE,0.333333333333333,2020,2020-2021
PR,2020-10-31,intra-ui,25,195,122,98,111,111,119,128,124,4019,1139,6191,1164,1359,FALSE,0.219512195121951,2020,2020-2021
PR,2020-11-30,inter-total,0,0,0,1,1,0,1,0,1,10,3,17,3,3,FALSE,0.176470588235294,2020,2020-2021
PR,2020-11-30,inter-ucfe,0,0,0,0,1,0,0,0,0,0,0,1,0,0,FALSE,0,2020,2020-2021
PR,2020-11-30,inter-ucx,0,0,0,0,0,0,0,0,0,0,0,0,0,0,FALSE,0,2020,2020-2021
PR,2020-11-30,inter-ui,0,0,0,1,0,0,1,0,1,10,3,16,3,3,FALSE,0.1875,2020,2020-2021
PR,2020-11-30,intra-total,19,188,126,109,99,92,65,51,66,2776,879,4470,898,1086,FALSE,0.242953020134228,2020,2020-2021
PR,2020-11-30,intra-ucfe,1,4,5,1,2,2,1,0,0,13,9,38,10,14,FALSE,0.368421052631579,2020,2020-2021
PR,2020-11-30,intra-ucx,0,0,0,0,0,0,0,0,0,2,0,2,0,0,FALSE,0,2020,2020-2021
PR,2020-11-30,intra-ui,18,184,121,108,97,90,64,51,66,2761,870,4430,888,1072,FALSE,0.241986455981941,2020,2020-2021
PR,2020-12-31,inter-total,0,1,0,2,0,0,2,3,1,12,4,25,4,5,FALSE,0.2,2020,2020-2021
PR,2020-12-31,inter-ucfe,0,0,0,0,0,0,0,0,0,0,0,0,0,0,FALSE,0,2020,2020-2021
PR,2020-12-31,inter-ucx,0,0,0,0,0,0,0,0,0,0,0,0,0,0,FALSE,0,2020,2020-2021
PR,2020-12-31,inter-ui,0,1,0,2,0,0,2,3,1,12,4,25,4,5,FALSE,0.2,2020,2020-2021
PR,2020-12-31,intra-total,28,165,146,119,104,92,96,94,96,3193,429,4562,457,622,FALSE,0.136343708899605,2020,2020-2021
PR,2020-12-31,intra-ucfe,1,4,4,2,3,1,6,5,1,20,11,58,12,16,FALSE,0.275862068965517,2020,2020-2021
PR,2020-12-31,intra-ucx,0,0,1,0,0,0,0,0,1,2,0,4,0,0,FALSE,0,2020,2020-2021
PR,2020-12-31,intra-ui,27,161,141,117,101,91,90,89,94,3171,418,4500,445,606,FALSE,0.134666666666667,2020,2020-2021
PR,2021-01-31,inter-total,0,1,1,1,2,0,0,0,0,6,2,13,2,3,FALSE,0.230769230769231,2020,2020-2021
PR,2021-01-31,inter-ucfe,0,0,0,0,1,0,0,0,0,0,0,1,0,0,FALSE,0,2020,2020-2021
PR,2021-01-31,inter-ucx,0,0,0,0,0,0,0,0,0,0,0,0,0,0,FALSE,0,2020,2020-2021
PR,2021-01-31,inter-ui,0,1,1,1,1,0,0,0,0,6,2,12,2,3,FALSE,0.25,2020,2020-2021
PR,2021-01-31,intra-total,129,321,179,158,109,99,91,97,69,2136,1261,4649,1390,1711,FALSE,0.368036136803614,2020,2020-2021
PR,2021-01-31,intra-ucfe,0,3,1,3,4,2,2,3,4,23,6,51,6,9,FALSE,0.176470588235294,2020,2020-2021
PR,2021-01-31,intra-ucx,1,2,2,0,0,1,1,0,0,3,3,13,4,6,FALSE,0.461538461538462,2020,2020-2021
PR,2021-01-31,intra-ui,128,316,176,155,105,96,88,94,65,2110,1252,4585,1380,1696,FALSE,0.36990185387132,2020,2020-2021
PR,2021-02-28,inter-total,0,0,1,4,1,3,1,1,2,12,11,36,11,11,FALSE,0.305555555555556,2020,2020-2021
PR,2021-02-28,inter-ucfe,0,0,0,0,0,0,0,1,0,0,0,1,0,0,FALSE,0,2020,2020-2021
PR,2021-02-28,inter-ucx,0,0,0,0,0,0,0,0,0,0,0,0,0,0,FALSE,0,2020,2020-2021
PR,2021-02-28,inter-ui,0,0,1,4,1,3,1,0,2,12,11,35,11,11,FALSE,0.314285714285714,2020,2020-2021
PR,2021-02-28,intra-total,39,265,205,195,215,215,150,135,120,2107,1244,4890,1283,1548,FALSE,0.316564417177914,2020,2020-2021
PR,2021-02-28,intra-ucfe,0,7,3,7,8,4,3,5,8,50,15,110,15,22,FALSE,0.2,2020,2020-2021
PR,2021-02-28,intra-ucx,0,1,2,1,0,1,0,0,0,3,3,11,3,4,FALSE,0.363636363636364,2020,2020-2021
PR,2021-02-28,intra-ui,39,257,200,187,207,210,147,130,112,2054,1226,4769,1265,1522,FALSE,0.319144474732648,2020,2020-2021
PR,2021-03-31,inter-total,1,0,1,0,1,0,0,0,1,8,3,15,4,4,FALSE,0.266666666666667,2020,2020-2021
PR,2021-03-31,inter-ucfe,0,0,0,0,0,0,0,0,0,0,0,0,0,0,FALSE,0,2020,2020-2021
PR,2021-03-31,inter-ucx,0,0,0,0,0,0,0,0,0,0,0,0,0,0,FALSE,0,2020,2020-2021
PR,2021-03-31,inter-ui,1,0,1,0,1,0,0,0,1,8,3,15,4,4,FALSE,0.266666666666667,2020,2020-2021
PR,2021-03-31,intra-total,382,285,189,186,116,87,111,121,124,1522,1062,4185,1444,1729,FALSE,0.413142174432497,2020,2020-2021
PR,2021-03-31,intra-ucfe,2,5,2,3,3,1,2,4,3,51,9,85,11,16,FALSE,0.188235294117647,2020,2020-2021
PR,2021-03-31,intra-ucx,0,0,1,1,1,0,1,0,0,3,1,8,1,1,FALSE,0.125,2020,2020-2021
PR,2021-03-31,intra-ui,380,280,186,182,112,86,108,117,121,1468,1052,4092,1432,1712,FALSE,0.418377321603128,2020,2020-2021
PR,2021-04-30,inter-total,1,2,0,0,1,0,0,0,0,4,3,11,4,6,FALSE,0.545454545454545,2020,2020-2021
PR,2021-04-30,inter-ucfe,0,0,0,0,0,0,0,0,0,0,0,0,0,0,FALSE,0,2020,2020-2021
PR,2021-04-30,inter-ucx,0,0,0,0,0,0,0,0,0,0,0,0,0,0,FALSE,0,2020,2020-2021
PR,2021-04-30,inter-ui,1,2,0,0,1,0,0,0,0,4,3,11,4,6,FALSE,0.545454545454545,2020,2020-2021
PR,2021-04-30,intra-total,349,524,402,258,161,77,68,51,40,1038,1576,4544,1925,2449,FALSE,0.538952464788732,2020,2020-2021
PR,2021-04-30,intra-ucfe,1,4,1,3,0,2,0,1,0,23,8,43,9,13,FALSE,0.302325581395349,2020,2020-2021
PR,2021-04-30,intra-ucx,0,0,1,0,0,0,1,0,0,7,2,11,2,2,FALSE,0.181818181818182,2020,2020-2021
PR,2021-04-30,intra-ui,348,520,400,255,161,75,67,50,40,1008,1566,4490,1914,2434,FALSE,0.542093541202673,2020,2020-2021
PR,2021-05-31,inter-total,0,0,0,0,0,0,0,0,1,2,10,13,10,10,FALSE,0.769230769230769,2020,2020-2021
PR,2021-05-31,inter-ucfe,0,0,0,0,0,0,0,0,0,0,0,0,0,0,FALSE,0,2020,2020-2021
PR,2021-05-31,inter-ucx,0,0,0,0,0,0,0,0,0,0,0,0,0,0,FALSE,0,2020,2020-2021
PR,2021-05-31,inter-ui,0,0,0,0,0,0,0,0,1,2,10,13,10,10,FALSE,0.769230769230769,2020,2020-2021
PR,2021-05-31,intra-total,27,462,483,428,404,417,249,188,83,1011,4192,7944,4219,4681,FALSE,0.589249748237664,2020,2020-2021
PR,2021-05-31,intra-ucfe,1,2,2,1,0,1,0,2,0,15,12,36,13,15,FALSE,0.416666666666667,2020,2020-2021
PR,2021-05-31,intra-ucx,0,1,0,0,0,0,0,0,0,4,4,9,4,5,FALSE,0.555555555555556,2020,2020-2021
PR,2021-05-31,intra-ui,26,459,481,427,404,416,249,186,83,992,4176,7899,4202,4661,FALSE,0.590074692999114,2020,2020-2021
PR,2021-06-30,inter-total,0,0,0,0,1,0,0,0,1,2,9,13,9,9,FALSE,0.692307692307692,2020,2020-2021
PR,2021-06-30,inter-ucfe,0,0,0,0,0,0,0,0,0,0,0,0,0,0,FALSE,0,2020,2020-2021
PR,2021-06-30,inter-ucx,0,0,0,0,0,0,0,0,0,0,0,0,0,0,FALSE,0,2020,2020-2021
PR,2021-06-30,inter-ui,0,0,0,0,1,0,0,0,1,2,9,13,9,9,FALSE,0.692307692307692,2020,2020-2021
PR,2021-06-30,intra-total,65,742,401,320,297,235,220,250,216,1591,4535,8872,4600,5342,FALSE,0.602119026149684,2020,2020-2021
PR,2021-06-30,intra-ucfe,0,1,0,1,0,0,0,0,1,21,7,31,7,8,FALSE,0.258064516129032,2020,2020-2021
PR,2021-06-30,intra-ucx,0,0,0,2,0,0,0,1,0,4,4,11,4,4,FALSE,0.363636363636364,2020,2020-2021
PR,2021-06-30,intra-ui,65,741,401,317,297,235,220,249,215,1566,4524,8830,4589,5330,FALSE,0.603624009060023,2020,2020-2021
PR,2021-07-31,inter-total,1,0,0,0,2,1,0,1,0,5,4,14,5,5,FALSE,0.357142857142857,2021,2021-2022
PR,2021-07-31,inter-ucfe,0,0,0,0,0,0,0,0,0,0,0,0,0,0,FALSE,0,2021,2021-2022
PR,2021-07-31,inter-ucx,0,0,0,0,0,0,0,0,0,0,0,0,0,0,FALSE,0,2021,2021-2022
PR,2021-07-31,inter-ui,1,0,0,0,2,1,0,1,0,5,4,14,5,5,FALSE,0.357142857142857,2021,2021-2022
PR,2021-07-31,intra-total,62,614,449,367,317,235,186,180,149,1841,4460,8860,4522,5136,FALSE,0.579683972911964,2021,2021-2022
PR,2021-07-31,intra-ucfe,0,0,4,3,1,4,1,0,1,25,20,59,20,20,FALSE,0.338983050847458,2021,2021-2022
PR,2021-07-31,intra-ucx,0,2,2,0,0,0,0,0,0,0,5,9,5,7,FALSE,0.777777777777778,2021,2021-2022
PR,2021-07-31,intra-ui,62,612,443,364,316,231,185,180,148,1816,4435,8792,4497,5109,FALSE,0.581096451319381,2021,2021-2022
PR,2021-08-31,inter-total,0,1,0,0,2,0,0,0,2,6,22,33,22,23,FALSE,0.696969696969697,2021,2021-2022
PR,2021-08-31,inter-ucfe,0,0,0,0,0,0,0,0,0,0,0,0,0,0,FALSE,0,2021,2021-2022
PR,2021-08-31,inter-ucx,0,0,0,0,0,0,0,0,0,0,0,0,0,0,FALSE,0,2021,2021-2022
PR,2021-08-31,inter-ui,0,1,0,0,2,0,0,0,2,6,22,33,22,23,FALSE,0.696969696969697,2021,2021-2022
PR,2021-08-31,intra-total,44,420,497,359,262,217,196,208,151,2149,2402,6905,2446,2866,FALSE,0.415061549601738,2021,2021-2022
PR,2021-08-31,intra-ucfe,0,3,1,1,2,1,2,1,1,22,10,44,10,13,FALSE,0.295454545454545,2021,2021-2022
PR,2021-08-31,intra-ucx,0,2,1,1,1,1,0,0,1,8,2,17,2,4,FALSE,0.235294117647059,2021,2021-2022
PR,2021-08-31,intra-ui,44,415,495,357,259,215,194,207,149,2119,2390,6844,2434,2849,FALSE,0.416277030976037,2021,2021-2022
PR,2021-09-30,inter-total,0,5,0,0,1,1,0,1,1,6,34,49,34,39,FALSE,0.795918367346939,2021,2021-2022
PR,2021-09-30,inter-ucfe,0,0,0,0,0,0,0,0,0,1,0,1,0,0,FALSE,0,2021,2021-2022
PR,2021-09-30,inter-ucx,0,0,0,0,0,0,0,0,0,0,0,0,0,0,FALSE,0,2021,2021-2022
PR,2021-09-30,inter-ui,0,5,0,0,1,1,0,1,1,5,34,48,34,39,FALSE,0.8125,2021,2021-2022
PR,2021-09-30,intra-total,537,221,191,165,143,114,121,90,124,2102,1033,4841,1570,1791,FALSE,0.369964883288577,2021,2021-2022
PR,2021-09-30,intra-ucfe,4,3,3,1,5,2,2,0,1,29,2,52,6,9,FALSE,0.173076923076923,2021,2021-2022
PR,2021-09-30,intra-ucx,0,2,0,0,2,0,2,2,0,6,2,16,2,4,FALSE,0.25,2021,2021-2022
PR,2021-09-30,intra-ui,533,216,188,164,136,112,117,88,123,2067,1029,4773,1562,1778,FALSE,0.372512046930652,2021,2021-2022
PR,2021-10-31,inter-total,3,0,0,0,0,0,1,0,0,8,2,14,5,5,FALSE,0.357142857142857,2021,2021-2022
PR,2021-10-31,inter-ucfe,0,0,0,0,0,0,0,0,0,2,0,2,0,0,FALSE,0,2021,2021-2022
PR,2021-10-31,inter-ucx,0,0,0,0,0,0,0,0,0,0,0,0,0,0,FALSE,0,2021,2021-2022
PR,2021-10-31,inter-ui,3,0,0,0,0,0,1,0,0,6,2,12,5,5,FALSE,0.416666666666667,2021,2021-2022
PR,2021-10-31,intra-total,792,264,169,193,111,88,118,110,101,1832,301,4079,1093,1357,FALSE,0.332679578328022,2021,2021-2022
PR,2021-10-31,intra-ucfe,12,1,3,3,3,0,4,3,5,29,7,70,19,20,FALSE,0.285714285714286,2021,2021-2022
PR,2021-10-31,intra-ucx,2,0,2,2,0,2,3,1,1,10,2,25,4,4,FALSE,0.16,2021,2021-2022
PR,2021-10-31,intra-ui,778,263,164,188,108,86,111,106,95,1793,292,3984,1070,1333,FALSE,0.334588353413655,2021,2021-2022
PR,2021-11-30,inter-total,3,0,0,0,0,0,0,0,0,4,0,7,3,3,FALSE,0.428571428571429,2021,2021-2022
PR,2021-11-30,inter-ucfe,0,0,0,0,0,0,0,0,0,0,0,0,0,0,FALSE,0,2021,2021-2022
PR,2021-11-30,inter-ucx,0,0,0,0,0,0,0,0,0,0,0,0,0,0,FALSE,0,2021,2021-2022
PR,2021-11-30,inter-ui,3,0,0,0,0,0,0,0,0,4,0,7,3,3,FALSE,0.428571428571429,2021,2021-2022
PR,2021-11-30,intra-total,586,144,108,93,84,112,76,78,65,1422,164,2932,750,894,FALSE,0.304911323328786,2021,2021-2022
PR,2021-11-30,intra-ucfe,13,7,1,4,4,0,3,1,0,26,2,61,15,22,FALSE,0.360655737704918,2021,2021-2022
PR,2021-11-30,intra-ucx,0,1,2,1,1,1,1,1,0,9,0,17,0,1,FALSE,0.0588235294117647,2021,2021-2022
PR,2021-11-30,intra-ui,573,136,105,88,79,111,72,76,65,1387,162,2854,735,871,FALSE,0.305185704274702,2021,2021-2022
PR,2021-12-31,inter-total,5,1,0,0,0,0,1,0,0,6,0,13,5,6,FALSE,0.461538461538462,2021,2021-2022
PR,2021-12-31,inter-ucfe,0,0,0,0,0,0,0,0,0,0,0,0,0,0,FALSE,0,2021,2021-2022
PR,2021-12-31,inter-ucx,0,0,0,0,0,0,0,0,0,0,0,0,0,0,FALSE,0,2021,2021-2022
PR,2021-12-31,inter-ui,5,1,0,0,0,0,1,0,0,6,0,13,5,6,FALSE,0.461538461538462,2021,2021-2022
PR,2021-12-31,intra-total,446,110,95,76,77,65,47,50,46,1127,181,2320,627,737,FALSE,0.317672413793103,2021,2021-2022
PR,2021-12-31,intra-ucfe,10,3,3,1,4,2,1,2,1,22,3,52,13,16,FALSE,0.307692307692308,2021,2021-2022
PR,2021-12-31,intra-ucx,3,0,2,0,0,1,0,0,1,8,0,15,3,3,FALSE,0.2,2021,2021-2022
PR,2021-12-31,intra-ui,433,107,90,75,73,62,46,48,44,1097,178,2253,611,718,FALSE,0.318686196182867,2021,2021-2022
PR,2022-01-31,inter-total,11,1,1,0,0,1,0,0,0,9,0,23,11,12,FALSE,0.521739130434783,2021,2021-2022
PR,2022-01-31,inter-ucfe,0,0,0,0,0,0,0,0,0,0,0,0,0,0,FALSE,0,2021,2021-2022
PR,2022-01-31,inter-ucx,0,0,0,0,0,0,0,0,0,0,0,0,0,0,FALSE,0,2021,2021-2022
PR,2022-01-31,inter-ui,11,1,1,0,0,1,0,0,0,9,0,23,11,12,FALSE,0.521739130434783,2021,2021-2022
PR,2022-01-31,intra-total,1037,269,190,117,74,46,52,41,30,828,407,3091,1444,1713,FALSE,0.554189582659334,2021,2021-2022
PR,2022-01-31,intra-ucfe,5,0,1,2,2,0,1,0,2,10,2,25,7,7,FALSE,0.28,2021,2021-2022
PR,2022-01-31,intra-ucx,1,2,1,1,1,1,0,0,0,4,4,15,5,7,FALSE,0.466666666666667,2021,2021-2022
PR,2022-01-31,intra-ui,1031,267,188,114,71,45,51,41,28,814,401,3051,1432,1699,FALSE,0.556866601114389,2021,2021-2022
PR,2022-02-28,inter-total,22,1,0,3,0,0,0,0,0,9,0,35,22,23,FALSE,0.657142857142857,2021,2021-2022
PR,2022-02-28,inter-ucfe,0,0,0,0,0,0,0,0,0,0,0,0,0,0,FALSE,0,2021,2021-2022
PR,2022-02-28,inter-ucx,0,0,0,0,0,0,0,0,0,0,0,0,0,0,FALSE,0,2021,2021-2022
PR,2022-02-28,inter-ui,22,1,0,3,0,0,0,0,0,9,0,35,22,23,FALSE,0.657142857142857,2021,2021-2022
PR,2022-02-28,intra-total,1009,193,182,182,160,92,77,46,31,752,361,3085,1370,1563,FALSE,0.506645056726094,2021,2021-2022
PR,2022-02-28,intra-ucfe,11,3,1,2,1,2,3,0,1,18,9,51,20,23,FALSE,0.450980392156863,2021,2021-2022
PR,2022-02-28,intra-ucx,2,0,1,0,0,0,0,0,1,3,2,9,4,4,FALSE,0.444444444444444,2021,2021-2022
PR,2022-02-28,intra-ui,996,190,180,180,159,90,74,46,29,731,350,3025,1346,1536,FALSE,0.507768595041322,2021,2021-2022
PR,2022-03-31,inter-total,0,0,0,0,0,0,1,0,0,5,1,7,1,1,FALSE,0.142857142857143,2021,2021-2022
PR,2022-03-31,inter-ucfe,0,0,0,0,0,0,0,0,0,0,0,0,0,0,FALSE,0,2021,2021-2022
PR,2022-03-31,inter-ucx,0,0,0,0,0,0,0,0,0,0,0,0,0,0,FALSE,0,2021,2021-2022
PR,2022-03-31,inter-ui,0,0,0,0,0,0,1,0,0,5,1,7,1,1,FALSE,0.142857142857143,2021,2021-2022
PR,2022-03-31,intra-total,968,239,123,95,88,65,66,69,61,649,517,2940,1485,1724,FALSE,0.586394557823129,2021,2021-2022
PR,2022-03-31,intra-ucfe,12,7,2,2,4,1,0,0,3,15,4,50,16,23,FALSE,0.46,2021,2021-2022
PR,2022-03-31,intra-ucx,3,4,2,1,0,0,2,0,0,3,4,19,7,11,FALSE,0.578947368421053,2021,2021-2022
PR,2022-03-31,intra-ui,953,228,119,92,84,64,64,69,58,631,509,2871,1462,1690,FALSE,0.588645071403692,2021,2021-2022
PR,2022-04-30,inter-total,2,1,0,0,0,0,0,0,0,2,0,5,2,3,FALSE,0.6,2021,2021-2022
PR,2022-04-30,inter-ucfe,0,0,0,0,0,0,0,0,0,0,0,0,0,0,FALSE,0,2021,2021-2022
PR,2022-04-30,inter-ucx,0,0,0,0,0,0,0,0,0,0,0,0,0,0,FALSE,0,2021,2021-2022
PR,2022-04-30,inter-ui,2,1,0,0,0,0,0,0,0,2,0,5,2,3,FALSE,0.6,2021,2021-2022
PR,2022-04-30,intra-total,955,153,104,50,47,31,16,20,18,435,673,2502,1628,1781,FALSE,0.711830535571543,2021,2021-2022
PR,2022-04-30,intra-ucfe,16,2,3,1,1,3,0,1,0,7,11,45,27,29,FALSE,0.644444444444445,2021,2021-2022
PR,2022-04-30,intra-ucx,9,3,0,1,1,0,1,1,0,5,5,26,14,17,FALSE,0.653846153846154,2021,2021-2022
PR,2022-04-30,intra-ui,930,148,101,48,45,28,15,18,18,423,657,2431,1587,1735,FALSE,0.713698066639243,2021,2021-2022
PR,2022-05-31,inter-total,1,0,2,1,0,0,0,0,0,0,3,7,4,4,FALSE,0.571428571428571,2021,2021-2022
PR,2022-05-31,inter-ucfe,0,0,0,0,0,0,0,0,0,0,0,0,0,0,FALSE,0,2021,2021-2022
PR,2022-05-31,inter-ucx,0,0,0,0,0,0,0,0,0,0,0,0,0,0,FALSE,0,2021,2021-2022
PR,2022-05-31,inter-ui,1,0,2,1,0,0,0,0,0,0,3,7,4,4,FALSE,0.571428571428571,2021,2021-2022
PR,2022-05-31,intra-total,1503,275,100,74,50,26,24,16,14,403,753,3238,2256,2531,FALSE,0.7816553428042,2021,2021-2022
PR,2022-05-31,intra-ucfe,24,7,1,0,1,2,3,3,1,7,10,59,34,41,FALSE,0.694915254237288,2021,2021-2022
PR,2022-05-31,intra-ucx,5,4,2,1,0,0,1,0,0,1,3,17,8,12,FALSE,0.705882352941177,2021,2021-2022
PR,2022-05-31,intra-ui,1474,264,97,73,49,24,20,13,13,395,740,3162,2214,2478,FALSE,0.783681214421252,2021,2021-2022
PR,2022-06-30,inter-total,8,0,0,0,0,0,0,0,0,3,1,12,9,9,FALSE,0.75,2021,2021-2022
PR,2022-06-30,inter-ucfe,0,0,0,0,0,0,0,0,0,0,0,0,0,0,FALSE,0,2021,2021-2022
PR,2022-06-30,inter-ucx,0,0,0,0,0,0,0,0,0,0,0,0,0,0,FALSE,0,2021,2021-2022
PR,2022-06-30,inter-ui,8,0,0,0,0,0,0,0,0,3,1,12,9,9,FALSE,0.75,2021,2021-2022
PR,2022-06-30,intra-total,3904,258,104,61,44,24,24,23,22,289,1248,6001,5152,5410,FALSE,0.901516413931011,2021,2021-2022
PR,2022-06-30,intra-ucfe,14,2,3,1,0,0,0,1,2,5,14,42,28,30,FALSE,0.714285714285714,2021,2021-2022
PR,2022-06-30,intra-ucx,7,0,0,0,0,1,0,1,0,0,2,11,9,9,FALSE,0.818181818181818,2021,2021-2022
PR,2022-06-30,intra-ui,3883,256,101,60,44,23,24,21,20,284,1232,5948,5115,5371,FALSE,0.902992602555481,2021,2021-2022
PR,2022-07-31,inter-total,1,0,0,0,0,0,0,0,1,1,2,5,3,3,FALSE,0.6,2022,2022-2023
PR,2022-07-31,inter-ucfe,0,0,0,0,0,0,0,0,1,0,0,1,0,0,FALSE,0,2022,2022-2023
PR,2022-07-31,inter-ucx,0,0,0,0,0,0,0,0,0,0,0,0,0,0,FALSE,0,2022,2022-2023
PR,2022-07-31,inter-ui,1,0,0,0,0,0,0,0,0,1,2,4,3,3,FALSE,0.75,2022,2022-2023
PR,2022-07-31,intra-total,3517,317,131,88,45,24,17,15,16,235,1575,5980,5092,5409,FALSE,0.904515050167224,2022,2022-2023
PR,2022-07-31,intra-ucfe,19,9,3,5,2,2,1,0,1,4,32,78,51,60,FALSE,0.769230769230769,2022,2022-2023
PR,2022-07-31,intra-ucx,12,3,1,0,0,0,1,0,1,1,2,21,14,17,FALSE,0.80952380952381,2022,2022-2023
PR,2022-07-31,intra-ui,3486,305,127,83,43,22,15,15,14,230,1541,5881,5027,5332,FALSE,0.906648529161707,2022,2022-2023
PR,2022-08-31,inter-total,3,0,0,1,0,1,0,1,0,1,4,11,7,7,FALSE,0.636363636363636,2022,2022-2023
PR,2022-08-31,inter-ucfe,0,0,0,0,0,0,0,0,0,0,0,0,0,0,FALSE,0,2022,2022-2023
PR,2022-08-31,inter-ucx,0,0,0,0,0,0,0,0,0,0,0,0,0,0,FALSE,0,2022,2022-2023
PR,2022-08-31,inter-ui,3,0,0,1,0,1,0,1,0,1,4,11,7,7,FALSE,0.636363636363636,2022,2022-2023
PR,2022-08-31,intra-total,1976,324,202,134,100,66,29,31,30,269,1485,4646,3461,3785,FALSE,0.814679294016358,2022,2022-2023
PR,2022-08-31,intra-ucfe,31,6,1,4,2,4,0,0,1,1,21,71,52,58,FALSE,0.816901408450704,2022,2022-2023
PR,2022-08-31,intra-ucx,10,1,1,1,0,0,0,1,1,1,10,26,20,21,FALSE,0.807692307692308,2022,2022-2023
PR,2022-08-31,intra-ui,1935,317,200,129,98,62,29,30,28,267,1454,4549,3389,3706,FALSE,0.814684546054078,2022,2022-2023
PR,2022-09-30,inter-total,1,0,1,1,0,0,0,0,0,1,8,12,9,9,FALSE,0.75,2022,2022-2023
PR,2022-09-30,inter-ucfe,0,0,0,0,0,0,0,0,0,0,0,0,0,0,FALSE,0,2022,2022-2023
PR,2022-09-30,inter-ucx,0,0,0,0,0,0,0,0,0,0,0,0,0,0,FALSE,0,2022,2022-2023
PR,2022-09-30,inter-ui,1,0,1,1,0,0,0,0,0,1,8,12,9,9,FALSE,0.75,2022,2022-2023
PR,2022-09-30,intra-total,1246,170,82,53,36,36,32,19,22,204,656,2556,1902,2072,FALSE,0.810641627543036,2022,2022-2023
PR,2022-09-30,intra-ucfe,11,1,2,1,1,1,0,0,0,1,7,25,18,19,FALSE,0.76,2022,2022-2023
PR,2022-09-30,intra-ucx,20,2,2,0,0,0,0,0,0,0,10,34,30,32,FALSE,0.941176470588235,2022,2022-2023
PR,2022-09-30,intra-ui,1215,167,78,52,35,35,32,19,22,203,639,2497,1854,2021,FALSE,0.809371245494594,2022,2022-2023
PR,2022-10-31,inter-total,5,1,3,1,1,0,0,0,0,1,3,15,8,9,FALSE,0.6,2022,2022-2023
PR,2022-10-31,inter-ucfe,0,0,0,0,0,0,0,0,0,0,0,0,0,0,FALSE,0,2022,2022-2023
PR,2022-10-31,inter-ucx,0,0,0,0,0,0,0,0,0,0,0,0,0,0,FALSE,0,2022,2022-2023
PR,2022-10-31,inter-ui,5,1,3,1,1,0,0,0,0,1,3,15,8,9,FALSE,0.6,2022,2022-2023
PR,2022-10-31,intra-total,2766,579,364,168,64,50,30,16,18,231,1168,5454,3934,4513,FALSE,0.827466079941327,2022,2022-2023
PR,2022-10-31,intra-ucfe,7,1,1,3,0,0,0,0,0,2,1,15,8,9,FALSE,0.6,2022,2022-2023
PR,2022-10-31,intra-ucx,2,0,1,1,1,2,0,0,1,4,3,15,5,5,FALSE,0.333333333333333,2022,2022-2023
PR,2022-10-31,intra-ui,2757,578,362,164,63,48,30,16,17,225,1164,5424,3921,4499,FALSE,0.829461651917404,2022,2022-2023
PR,2022-11-30,inter-total,0,0,0,0,0,1,0,0,0,1,2,4,2,2,FALSE,0.5,2022,2022-2023
PR,2022-11-30,inter-ucfe,0,0,0,0,0,0,0,0,0,0,0,0,0,0,FALSE,0,2022,2022-2023
PR,2022-11-30,inter-ucx,0,0,0,0,0,0,0,0,0,0,0,0,0,0,FALSE,0,2022,2022-2023
PR,2022-11-30,inter-ui,0,0,0,0,0,1,0,0,0,1,2,4,2,2,FALSE,0.5,2022,2022-2023
PR,2022-11-30,intra-total,1696,344,210,235,178,140,92,48,20,182,661,3806,2357,2701,FALSE,0.70966894377299,2022,2022-2023
PR,2022-11-30,intra-ucfe,3,1,2,0,1,0,1,0,0,1,1,10,4,5,FALSE,0.5,2022,2022-2023
PR,2022-11-30,intra-ucx,6,2,1,2,0,1,0,0,0,0,7,19,13,15,FALSE,0.789473684210526,2022,2022-2023
PR,2022-11-30,intra-ui,1687,341,207,233,177,139,91,48,20,181,653,3777,2340,2681,FALSE,0.709822610537464,2022,2022-2023
PR,2022-12-31,inter-total,1,0,0,0,0,0,0,0,0,0,1,2,2,2,FALSE,1,2022,2022-2023
PR,2022-12-31,inter-ucfe,1,0,0,0,0,0,0,0,0,0,0,1,1,1,FALSE,1,2022,2022-2023
PR,2022-12-31,inter-ucx,0,0,0,0,0,0,0,0,0,0,0,0,0,0,FALSE,0,2022,2022-2023
PR,2022-12-31,inter-ui,0,0,0,0,0,0,0,0,0,0,1,1,1,1,FALSE,1,2022,2022-2023
PR,2022-12-31,intra-total,1143,190,140,245,97,101,82,93,105,642,533,3371,1676,1866,FALSE,0.553544942153664,2022,2022-2023
PR,2022-12-31,intra-ucfe,7,1,1,1,1,1,0,0,1,4,3,20,10,11,FALSE,0.55,2022,2022-2023
PR,2022-12-31,intra-ucx,6,1,0,1,1,1,0,0,0,2,3,15,9,10,FALSE,0.666666666666667,2022,2022-2023
PR,2022-12-31,intra-ui,1130,188,139,243,95,99,82,93,104,636,527,3336,1657,1845,FALSE,0.553057553956835,2022,2022-2023
PR,2023-01-31,inter-total,1,0,0,0,0,0,1,0,0,0,1,3,2,2,FALSE,0.666666666666667,2022,2022-2023
PR,2023-01-31,inter-ucfe,0,0,0,0,0,0,0,0,0,0,0,0,0,0,FALSE,0,2022,2022-2023
PR,2023-01-31,inter-ucx,0,0,0,0,0,0,0,0,0,0,0,0,0,0,FALSE,0,2022,2022-2023
PR,2023-01-31,inter-ui,1,0,0,0,0,0,1,0,0,0,1,3,2,2,FALSE,0.666666666666667,2022,2022-2023
PR,2023-01-31,intra-total,1628,272,137,82,61,57,52,48,47,366,742,3492,2370,2642,FALSE,0.756586483390607,2022,2022-2023
PR,2023-01-31,intra-ucfe,10,2,0,1,1,0,2,0,0,0,5,21,15,17,FALSE,0.80952380952381,2022,2022-2023
PR,2023-01-31,intra-ucx,12,3,1,2,1,0,1,1,0,0,5,26,17,20,FALSE,0.769230769230769,2022,2022-2023
PR,2023-01-31,intra-ui,1606,267,136,79,59,57,49,47,47,366,732,3445,2338,2605,FALSE,0.756168359941945,2022,2022-2023
PR,2023-02-28,inter-total,3,0,1,0,1,0,0,0,0,2,1,8,4,4,FALSE,0.5,2022,2022-2023
PR,2023-02-28,inter-ucfe,0,0,0,0,0,0,0,0,0,0,0,0,0,0,FALSE,0,2022,2022-2023
PR,2023-02-28,inter-ucx,0,0,0,0,0,0,0,0,0,0,0,0,0,0,FALSE,0,2022,2022-2023
PR,2023-02-28,inter-ui,3,0,1,0,1,0,0,0,0,2,1,8,4,4,FALSE,0.5,2022,2022-2023
PR,2023-02-28,intra-total,1370,204,143,107,74,56,41,25,21,245,665,2951,2035,2239,FALSE,0.758725855642155,2022,2022-2023
PR,2023-02-28,intra-ucfe,18,3,2,6,0,1,0,1,0,2,5,38,23,26,FALSE,0.68421052631579,2022,2022-2023
PR,2023-02-28,intra-ucx,14,5,1,1,1,3,0,1,0,2,11,39,25,30,FALSE,0.769230769230769,2022,2022-2023
PR,2023-02-28,intra-ui,1338,196,140,100,73,52,41,23,21,241,649,2874,1987,2183,FALSE,0.759568545581072,2022,2022-2023
PR,2023-03-31,inter-total,4,0,0,0,0,0,0,0,1,1,1,7,5,5,FALSE,0.714285714285714,2022,2022-2023
PR,2023-03-31,inter-ucfe,1,0,0,0,0,0,0,0,0,0,0,1,1,1,FALSE,1,2022,2022-2023
PR,2023-03-31,inter-ucx,0,0,0,0,0,0,0,0,0,0,0,0,0,0,FALSE,0,2022,2022-2023
PR,2023-03-31,inter-ui,3,0,0,0,0,0,0,0,1,1,1,6,4,4,FALSE,0.666666666666667,2022,2022-2023
PR,2023-03-31,intra-total,1188,202,100,81,63,54,43,36,23,185,547,2522,1735,1937,FALSE,0.768041237113402,2022,2022-2023
PR,2023-03-31,intra-ucfe,6,3,0,2,2,0,3,0,0,1,0,17,6,9,FALSE,0.529411764705882,2022,2022-2023
PR,2023-03-31,intra-ucx,6,0,1,1,1,1,1,0,0,1,2,14,8,8,FALSE,0.571428571428571,2022,2022-2023
PR,2023-03-31,intra-ui,1176,199,99,78,60,53,39,36,23,183,545,2491,1721,1920,FALSE,0.770774789241269,2022,2022-2023
PR,2023-04-30,inter-total,3,0,2,0,0,1,0,0,0,2,1,9,4,4,FALSE,0.444444444444444,2022,2022-2023
PR,2023-04-30,inter-ucfe,0,0,0,0,0,0,0,0,0,1,0,1,0,0,FALSE,0,2022,2022-2023
PR,2023-04-30,inter-ucx,0,0,0,0,0,0,0,0,0,0,0,0,0,0,FALSE,0,2022,2022-2023
PR,2023-04-30,inter-ui,3,0,2,0,0,1,0,0,0,1,1,8,4,4,FALSE,0.5,2022,2022-2023
PR,2023-04-30,intra-total,1393,206,96,64,46,46,31,17,21,159,505,2584,1898,2104,FALSE,0.814241486068111,2022,2022-2023
PR,2023-04-30,intra-ucfe,29,1,3,1,0,2,0,1,0,2,9,48,38,39,FALSE,0.8125,2022,2022-2023
PR,2023-04-30,intra-ucx,13,3,0,1,2,1,1,1,0,2,2,26,15,18,FALSE,0.692307692307692,2022,2022-2023
PR,2023-04-30,intra-ui,1351,202,93,62,44,43,30,15,21,155,494,2510,1845,2047,FALSE,0.815537848605578,2022,2022-2023
PR,2023-05-31,inter-total,2,0,1,0,0,0,0,0,0,0,0,3,2,2,FALSE,0.666666666666667,2022,2022-2023
PR,2023-05-31,inter-ucfe,0,0,0,0,0,0,0,0,0,0,0,0,0,0,FALSE,0,2022,2022-2023
PR,2023-05-31,inter-ucx,0,0,0,0,0,0,0,0,0,0,0,0,0,0,FALSE,0,2022,2022-2023
PR,2023-05-31,inter-ui,2,0,1,0,0,0,0,0,0,0,0,3,2,2,FALSE,0.666666666666667,2022,2022-2023
PR,2023-05-31,intra-total,1657,173,114,86,43,52,38,31,25,194,745,3158,2402,2575,FALSE,0.815389487017099,2022,2022-2023
PR,2023-05-31,intra-ucfe,23,1,2,1,0,2,1,0,0,0,3,33,26,27,FALSE,0.818181818181818,2022,2022-2023
PR,2023-05-31,intra-ucx,14,2,0,0,0,1,0,0,0,1,2,20,16,18,FALSE,0.9,2022,2022-2023
PR,2023-05-31,intra-ui,1620,170,112,85,43,49,37,31,25,193,740,3105,2360,2530,FALSE,0.814814814814815,2022,2022-2023
PR,2023-06-30,inter-total,1,2,0,0,0,0,0,0,0,1,0,4,1,3,FALSE,0.75,2022,2022-2023
PR,2023-06-30,inter-ucfe,0,0,0,0,0,0,0,0,0,0,0,0,0,0,FALSE,0,2022,2022-2023
PR,2023-06-30,inter-ucx,0,0,0,0,0,0,0,0,0,0,0,0,0,0,FALSE,0,2022,2022-2023
PR,2023-06-30,inter-ui,1,2,0,0,0,0,0,0,0,1,0,4,1,3,FALSE,0.75,2022,2022-2023
PR,2023-06-30,intra-total,4670,230,94,66,40,28,22,27,23,168,1020,6388,5690,5920,FALSE,0.926737633061991,2022,2022-2023
PR,2023-06-30,intra-ucfe,26,2,0,2,0,1,0,0,0,2,3,36,29,31,FALSE,0.861111111111111,2022,2022-2023
PR,2023-06-30,intra-ucx,11,0,0,1,0,0,0,1,0,0,3,16,14,14,FALSE,0.875,2022,2022-2023
PR,2023-06-30,intra-ui,4633,228,94,63,40,27,22,26,23,166,1014,6336,5647,5875,FALSE,0.927241161616162,2022,2022-2023
PR,2023-07-31,inter-total,2,0,0,0,0,0,0,0,0,1,3,6,5,5,FALSE,0.833333333333333,2023,2023-2024
PR,2023-07-31,inter-ucfe,0,0,0,0,0,0,0,0,0,0,0,0,0,0,FALSE,0,2023,2023-2024
PR,2023-07-31,inter-ucx,0,0,0,0,0,0,0,0,0,0,0,0,0,0,FALSE,0,2023,2023-2024
PR,2023-07-31,inter-ui,2,0,0,0,0,0,0,0,0,1,3,6,5,5,FALSE,0.833333333333333,2023,2023-2024
PR,2023-07-31,intra-total,4723,446,239,93,66,48,23,17,7,119,1527,7308,6250,6696,FALSE,0.916256157635468,2023,2023-2024
PR,2023-07-31,intra-ucfe,33,11,1,0,1,0,0,0,0,2,14,62,47,58,FALSE,0.935483870967742,2023,2023-2024
PR,2023-07-31,intra-ucx,3,3,0,0,0,0,0,0,0,0,6,12,9,12,FALSE,1,2023,2023-2024
PR,2023-07-31,intra-ui,4687,432,238,93,65,48,23,17,7,117,1507,7234,6194,6626,FALSE,0.915952446779099,2023,2023-2024
PR,2023-08-31,inter-total,4,3,2,1,1,0,0,0,0,2,4,17,8,11,FALSE,0.647058823529412,2023,2023-2024
PR,2023-08-31,inter-ucfe,0,1,1,0,0,0,0,0,0,0,1,3,1,2,FALSE,0.666666666666667,2023,2023-2024
PR,2023-08-31,inter-ucx,0,0,0,0,0,0,0,0,0,0,0,0,0,0,FALSE,0,2023,2023-2024
PR,2023-08-31,inter-ui,4,2,1,1,1,0,0,0,0,2,3,14,7,9,FALSE,0.642857142857143,2023,2023-2024
PR,2023-08-31,intra-total,2334,501,301,204,142,118,77,49,37,225,1086,5074,3420,3921,FALSE,0.772763106030745,2023,2023-2024
PR,2023-08-31,intra-ucfe,18,11,6,7,3,4,1,0,0,4,18,72,36,47,FALSE,0.652777777777778,2023,2023-2024
PR,2023-08-31,intra-ucx,2,1,1,0,0,0,0,0,0,1,3,8,5,6,FALSE,0.75,2023,2023-2024
PR,2023-08-31,intra-ui,2314,489,294,197,139,114,76,49,37,220,1065,4994,3379,3868,FALSE,0.774529435322387,2023,2023-2024
PR,2023-09-30,inter-total,8,1,0,0,0,0,0,0,0,0,3,12,11,12,FALSE,1,2023,2023-2024
PR,2023-09-30,inter-ucfe,1,0,0,0,0,0,0,0,0,0,0,1,1,1,FALSE,1,2023,2023-2024
PR,2023-09-30,inter-ucx,0,0,0,0,0,0,0,0,0,0,0,0,0,0,FALSE,0,2023,2023-2024
PR,2023-09-30,inter-ui,7,1,0,0,0,0,0,0,0,0,3,11,10,11,FALSE,1,2023,2023-2024
PR,2023-09-30,intra-total,1774,244,135,71,62,48,35,31,31,137,833,3401,2607,2851,FALSE,0.838282857982946,2023,2023-2024
PR,2023-09-30,intra-ucfe,14,5,1,2,3,0,1,0,0,1,6,33,20,25,FALSE,0.757575757575758,2023,2023-2024
PR,2023-09-30,intra-ucx,5,1,0,1,0,0,0,0,0,1,3,11,8,9,FALSE,0.818181818181818,2023,2023-2024
PR,2023-09-30,intra-ui,1755,238,134,68,59,48,34,31,31,135,824,3357,2579,2817,FALSE,0.839142091152815,2023,2023-2024
PR,2023-10-31,inter-total,1,0,0,0,0,0,0,0,0,2,0,3,1,1,FALSE,0.333333333333333,2023,2023-2024
PR,2023-10-31,inter-ucfe,0,0,0,0,0,0,0,0,0,0,0,0,0,0,FALSE,0,2023,2023-2024
PR,2023-10-31,inter-ucx,0,0,0,0,0,0,0,0,0,0,0,0,0,0,FALSE,0,2023,2023-2024
PR,2023-10-31,inter-ui,1,0,0,0,0,0,0,0,0,2,0,3,1,1,FALSE,0.333333333333333,2023,2023-2024
PR,2023-10-31,intra-total,2184,250,105,69,65,31,36,20,25,157,988,3930,3172,3422,FALSE,0.870737913486005,2023,2023-2024
PR,2023-10-31,intra-ucfe,20,2,0,1,0,0,0,0,1,0,11,35,31,33,FALSE,0.942857142857143,2023,2023-2024
PR,2023-10-31,intra-ucx,5,0,0,0,0,0,0,0,0,0,5,10,10,10,FALSE,1,2023,2023-2024
PR,2023-10-31,intra-ui,2159,248,105,68,65,31,36,20,24,157,972,3885,3131,3379,FALSE,0.86975546975547,2023,2023-2024
PR,2023-11-30,inter-total,1,1,0,1,0,0,0,0,0,0,1,4,2,3,FALSE,0.75,2023,2023-2024
PR,2023-11-30,inter-ucfe,1,0,0,0,0,0,0,0,0,0,0,1,1,1,FALSE,1,2023,2023-2024
PR,2023-11-30,inter-ucx,0,0,0,0,0,0,0,0,0,0,0,0,0,0,FALSE,0,2023,2023-2024
PR,2023-11-30,inter-ui,0,1,0,1,0,0,0,0,0,0,1,3,1,2,FALSE,0.666666666666667,2023,2023-2024
PR,2023-11-30,intra-total,1374,221,110,62,60,28,17,30,13,101,704,2720,2078,2299,FALSE,0.845220588235294,2023,2023-2024
PR,2023-11-30,intra-ucfe,8,4,0,1,0,1,0,0,1,1,6,22,14,18,FALSE,0.818181818181818,2023,2023-2024
PR,2023-11-30,intra-ucx,2,1,1,0,1,1,0,0,0,0,2,8,4,5,FALSE,0.625,2023,2023-2024
PR,2023-11-30,intra-ui,1364,216,109,61,59,26,17,30,12,100,696,2690,2060,2276,FALSE,0.846096654275093,2023,2023-2024
PR,2023-12-31,inter-total,6,1,0,0,0,0,0,0,0,0,1,8,7,8,FALSE,1,2023,2023-2024
PR,2023-12-31,inter-ucfe,0,0,0,0,0,0,0,0,0,0,0,0,0,0,FALSE,0,2023,2023-2024
PR,2023-12-31,inter-ucx,0,0,0,0,0,0,0,0,0,0,0,0,0,0,FALSE,0,2023,2023-2024
PR,2023-12-31,inter-ui,6,1,0,0,0,0,0,0,0,0,1,8,7,8,FALSE,1,2023,2023-2024
PR,2023-12-31,intra-total,1209,234,112,73,52,23,33,15,11,150,569,2481,1778,2012,FALSE,0.810963321241435,2023,2023-2024
PR,2023-12-31,intra-ucfe,7,1,2,1,0,1,1,0,0,3,4,20,11,12,FALSE,0.6,2023,2023-2024
PR,2023-12-31,intra-ucx,2,0,1,0,0,0,0,1,0,1,4,9,6,6,FALSE,0.666666666666667,2023,2023-2024
PR,2023-12-31,intra-ui,1200,233,109,72,52,22,32,14,11,146,561,2452,1761,1994,FALSE,0.813213703099511,2023,2023-2024
PR,2024-01-31,inter-total,6,2,0,0,0,0,0,0,0,1,2,11,8,10,FALSE,0.909090909090909,2023,2023-2024
PR,2024-01-31,inter-ucfe,0,0,0,0,0,0,0,0,0,0,0,0,0,0,FALSE,0,2023,2023-2024
PR,2024-01-31,inter-ucx,0,1,0,0,0,0,0,0,0,0,0,1,0,1,FALSE,1,2023,2023-2024
PR,2024-01-31,inter-ui,6,1,0,0,0,0,0,0,0,1,2,10,8,9,FALSE,0.9,2023,2023-2024
PR,2024-01-31,intra-total,2168,539,316,117,44,31,21,25,18,139,1072,4490,3240,3779,FALSE,0.841648106904232,2023,2023-2024
PR,2024-01-31,intra-ucfe,14,2,1,0,0,1,0,1,0,1,4,24,18,20,FALSE,0.833333333333333,2023,2023-2024
PR,2024-01-31,intra-ucx,2,0,0,0,1,0,0,0,0,0,2,5,4,4,FALSE,0.8,2023,2023-2024
PR,2024-01-31,intra-ui,2152,537,315,117,43,30,21,24,18,138,1066,4461,3218,3755,FALSE,0.841739520286931,2023,2023-2024
PR,2024-02-29,inter-total,5,0,0,0,0,0,0,0,0,1,0,6,5,5,FALSE,0.833333333333333,2023,2023-2024
PR,2024-02-29,inter-ucfe,0,0,0,0,0,0,0,0,0,0,0,0,0,0,FALSE,0,2023,2023-2024
PR,2024-02-29,inter-ucx,0,0,0,0,0,0,0,0,0,0,0,0,0,0,FALSE,0,2023,2023-2024
PR,2024-02-29,inter-ui,5,0,0,0,0,0,0,0,0,1,0,6,5,5,FALSE,0.833333333333333,2023,2023-2024
PR,2024-02-29,intra-total,677,233,170,150,98,78,45,20,19,135,504,2129,1181,1414,FALSE,0.66416157820573,2023,2023-2024
PR,2024-02-29,intra-ucfe,3,6,0,3,2,1,0,0,0,2,2,19,5,11,FALSE,0.578947368421053,2023,2023-2024
PR,2024-02-29,intra-ucx,6,0,2,3,0,0,0,0,1,1,2,15,8,8,FALSE,0.533333333333333,2023,2023-2024
PR,2024-02-29,intra-ui,668,227,168,144,96,77,45,20,18,132,500,2095,1168,1395,FALSE,0.665871121718377,2023,2023-2024
PR,2024-03-31,inter-total,5,0,0,0,0,0,0,1,0,0,0,6,5,5,FALSE,0.833333333333333,2023,2023-2024
PR,2024-03-31,inter-ucfe,0,0,0,0,0,0,0,0,0,0,0,0,0,0,FALSE,0,2023,2023-2024
PR,2024-03-31,inter-ucx,0,0,0,0,0,0,0,0,0,0,0,0,0,0,FALSE,0,2023,2023-2024
PR,2024-03-31,inter-ui,5,0,0,0,0,0,0,1,0,0,0,6,5,5,FALSE,0.833333333333333,2023,2023-2024
PR,2024-03-31,intra-total,665,230,188,104,107,86,52,40,36,133,465,2106,1130,1360,FALSE,0.645773979107313,2023,2023-2024
PR,2024-03-31,intra-ucfe,9,0,1,1,1,1,0,0,0,0,4,17,13,13,FALSE,0.764705882352941,2023,2023-2024
PR,2024-03-31,intra-ucx,4,1,2,0,1,1,0,2,0,1,1,13,5,6,FALSE,0.461538461538462,2023,2023-2024
PR,2024-03-31,intra-ui,652,229,185,103,105,84,52,38,36,132,460,2076,1112,1341,FALSE,0.645953757225434,2023,2023-2024
PR,2024-04-30,inter-total,3,2,2,0,0,1,1,0,0,1,0,10,3,5,FALSE,0.5,2023,2023-2024
PR,2024-04-30,inter-ucfe,0,0,0,0,0,0,0,0,0,0,0,0,0,0,FALSE,0,2023,2023-2024
PR,2024-04-30,inter-ucx,0,0,0,0,0,0,0,0,0,0,0,0,0,0,FALSE,0,2023,2023-2024
PR,2024-04-30,inter-ui,3,2,2,0,0,1,1,0,0,1,0,10,3,5,FALSE,0.5,2023,2023-2024
PR,2024-04-30,intra-total,847,222,135,97,79,75,78,65,51,231,501,2381,1348,1570,FALSE,0.659386812263755,2023,2023-2024
PR,2024-04-30,intra-ucfe,14,0,0,1,1,0,2,1,0,6,4,29,18,18,FALSE,0.620689655172414,2023,2023-2024
PR,2024-04-30,intra-ucx,0,1,2,0,0,1,1,0,0,1,3,9,3,4,FALSE,0.444444444444444,2023,2023-2024
PR,2024-04-30,intra-ui,833,221,133,96,78,74,75,64,51,224,494,2343,1327,1548,FALSE,0.660691421254802,2023,2023-2024
PR,2024-05-31,inter-total,0,0,0,0,0,0,0,0,0,1,0,1,0,0,FALSE,0,2023,2023-2024
PR,2024-05-31,inter-ucfe,0,0,0,0,0,0,0,0,0,0,0,0,0,0,FALSE,0,2023,2023-2024
PR,2024-05-31,inter-ucx,0,0,0,0,0,0,0,0,0,0,0,0,0,0,FALSE,0,2023,2023-2024
PR,2024-05-31,inter-ui,0,0,0,0,0,0,0,0,0,1,0,1,0,0,FALSE,0,2023,2023-2024
PR,2024-05-31,intra-total,925,235,109,91,65,58,50,38,37,206,546,2360,1471,1706,FALSE,0.722881355932203,2023,2023-2024
PR,2024-05-31,intra-ucfe,26,5,2,1,1,1,1,2,0,1,8,48,34,39,FALSE,0.8125,2023,2023-2024
PR,2024-05-31,intra-ucx,2,2,1,1,0,0,0,0,0,2,2,10,4,6,FALSE,0.6,2023,2023-2024
PR,2024-05-31,intra-ui,897,228,106,89,64,57,49,36,37,203,536,2302,1433,1661,FALSE,0.721546481320591,2023,2023-2024
PR,2024-06-30,inter-total,0,0,0,0,0,0,0,0,0,0,0,0,0,0,FALSE,0,2023,2023-2024
PR,2024-06-30,inter-ucfe,0,0,0,0,0,0,0,0,0,0,0,0,0,0,FALSE,0,2023,2023-2024
PR,2024-06-30,inter-ucx,0,0,0,0,0,0,0,0,0,0,0,0,0,0,FALSE,0,2023,2023-2024
PR,2024-06-30,inter-ui,0,0,0,0,0,0,0,0,0,0,0,0,0,0,FALSE,0,2023,2023-2024
PR,2024-06-30,intra-total,3305,242,129,98,57,65,41,31,18,211,820,5017,4125,4367,FALSE,0.870440502292207,2023,2023-2024
PR,2024-06-30,intra-ucfe,12,3,1,2,1,3,1,0,0,1,5,29,17,20,FALSE,0.689655172413793,2023,2023-2024
PR,2024-06-30,intra-ucx,5,1,1,1,1,0,0,0,0,0,2,11,7,8,FALSE,0.727272727272727,2023,2023-2024
PR,2024-06-30,intra-ui,3288,238,127,95,55,62,40,31,18,210,813,4977,4101,4339,FALSE,0.87181032750653,2023,2023-2024
PR,2024-07-31,inter-total,0,0,0,0,0,0,0,0,1,1,0,2,0,0,FALSE,0,2024,2024-2025
PR,2024-07-31,inter-ucfe,0,0,0,0,0,0,0,0,0,0,0,0,0,0,FALSE,0,2024,2024-2025
PR,2024-07-31,inter-ucx,0,0,0,0,0,0,0,0,0,0,0,0,0,0,FALSE,0,2024,2024-2025
PR,2024-07-31,inter-ui,0,0,0,0,0,0,0,0,1,1,0,2,0,0,FALSE,0,2024,2024-2025
PR,2024-07-31,intra-total,4231,846,513,257,138,90,41,46,30,210,1818,8220,6049,6895,FALSE,0.838807785888078,2024,2024-2025
PR,2024-07-31,intra-ucfe,15,4,6,3,2,2,0,1,0,1,13,47,28,32,FALSE,0.680851063829787,2024,2024-2025
PR,2024-07-31,intra-ucx,8,0,0,0,0,0,1,0,0,1,9,19,17,17,FALSE,0.894736842105263,2024,2024-2025
PR,2024-07-31,intra-ui,4208,842,507,254,136,88,40,45,30,208,1796,8154,6004,6846,FALSE,0.839587932303164,2024,2024-2025
PR,2024-08-31,inter-total,0,1,0,0,0,0,0,0,0,0,1,2,1,2,FALSE,1,2024,2024-2025
PR,2024-08-31,inter-ucfe,0,0,0,0,0,0,0,0,0,0,0,0,0,0,FALSE,0,2024,2024-2025
PR,2024-08-31,inter-ucx,0,0,0,0,0,0,0,0,0,0,0,0,0,0,FALSE,0,2024,2024-2025
PR,2024-08-31,inter-ui,0,1,0,0,0,0,0,0,0,0,1,2,1,2,FALSE,1,2024,2024-2025
PR,2024-08-31,intra-total,1564,630,402,250,207,185,102,65,60,246,1286,4997,2850,3480,FALSE,0.696417850710426,2024,2024-2025
PR,2024-08-31,intra-ucfe,7,2,2,1,1,2,0,3,2,2,3,25,10,12,FALSE,0.48,2024,2024-2025
PR,2024-08-31,intra-ucx,7,2,2,0,1,3,0,0,0,1,5,21,12,14,FALSE,0.666666666666667,2024,2024-2025
PR,2024-08-31,intra-ui,1550,626,398,249,205,180,102,62,58,243,1278,4951,2828,3454,FALSE,0.697636841042214,2024,2024-2025
PR,2024-09-30,inter-total,0,0,0,0,1,1,0,1,0,1,1,5,1,1,FALSE,0.2,2024,2024-2025
PR,2024-09-30,inter-ucfe,0,0,0,0,0,0,0,0,0,0,0,0,0,0,FALSE,0,2024,2024-2025
PR,2024-09-30,inter-ucx,0,0,0,0,0,0,0,0,0,0,0,0,0,0,FALSE,0,2024,2024-2025
PR,2024-09-30,inter-ui,0,0,0,0,1,1,0,1,0,1,1,5,1,1,FALSE,0.2,2024,2024-2025
PR,2024-09-30,intra-total,1533,361,251,201,158,117,143,83,85,365,869,4166,2402,2763,FALSE,0.663226116178589,2024,2024-2025
PR,2024-09-30,intra-ucfe,8,3,0,0,2,0,1,0,2,3,2,21,10,13,FALSE,0.619047619047619,2024,2024-2025
PR,2024-09-30,intra-ucx,4,3,0,1,2,0,0,0,1,0,6,17,10,13,FALSE,0.764705882352941,2024,2024-2025
PR,2024-09-30,intra-ui,1521,355,251,200,154,117,142,83,82,362,861,4128,2382,2737,FALSE,0.663032945736434,2024,2024-2025
PR,2024-10-31,inter-total,3,0,0,1,1,0,0,1,0,0,2,8,5,5,FALSE,0.625,2024,2024-2025
PR,2024-10-31,inter-ucfe,1,0,0,0,0,0,0,0,0,0,0,1,1,1,FALSE,1,2024,2024-2025
PR,2024-10-31,inter-ucx,0,0,0,0,0,0,0,0,0,0,0,0,0,0,FALSE,0,2024,2024-2025
PR,2024-10-31,inter-ui,2,0,0,1,1,0,0,1,0,0,2,7,4,4,FALSE,0.571428571428571,2024,2024-2025
PR,2024-10-31,intra-total,1527,308,138,134,75,68,73,54,39,307,860,3583,2387,2695,FALSE,0.752162991906224,2024,2024-2025
PR,2024-10-31,intra-ucfe,2,0,1,3,0,0,1,0,0,3,1,11,3,3,FALSE,0.272727272727273,2024,2024-2025
PR,2024-10-31,intra-ucx,8,1,1,0,0,0,0,0,0,2,0,12,8,9,FALSE,0.75,2024,2024-2025
PR,2024-10-31,intra-ui,1517,307,136,131,75,68,72,54,39,302,859,3560,2376,2683,FALSE,0.753651685393258,2024,2024-2025
PR,2024-11-30,inter-total,2,0,1,0,0,0,0,0,0,1,2,6,4,4,FALSE,0.666666666666667,2024,2024-2025
PR,2024-11-30,inter-ucfe,0,0,0,0,0,0,0,0,0,0,0,0,0,0,FALSE,0,2024,2024-2025
PR,2024-11-30,inter-ucx,0,0,0,0,0,0,0,0,0,0,0,0,0,0,FALSE,0,2024,2024-2025
PR,2024-11-30,inter-ui,2,0,1,0,0,0,0,0,0,1,2,6,4,4,FALSE,0.666666666666667,2024,2024-2025
PR,2024-11-30,intra-total,972,241,133,83,81,54,48,36,26,256,597,2527,1569,1810,FALSE,0.716264345073209,2024,2024-2025
PR,2024-11-30,intra-ucfe,5,0,1,1,0,0,0,0,0,0,3,10,8,8,FALSE,0.8,2024,2024-2025
PR,2024-11-30,intra-ucx,3,0,0,0,0,0,0,0,0,0,3,6,6,6,FALSE,1,2024,2024-2025
PR,2024-11-30,intra-ui,964,241,132,82,81,54,48,36,26,256,591,2511,1555,1796,FALSE,0.715252887295898,2024,2024-2025
PR,2024-12-31,inter-total,1,0,0,0,0,1,0,0,0,1,1,4,2,2,FALSE,0.5,2024,2024-2025
PR,2024-12-31,inter-ucfe,0,0,0,0,0,0,0,0,0,0,0,0,0,0,FALSE,0,2024,2024-2025
PR,2024-12-31,inter-ucx,0,0,0,0,0,0,0,0,0,0,0,0,0,0,FALSE,0,2024,2024-2025
PR,2024-12-31,inter-ui,1,0,0,0,0,1,0,0,0,1,1,4,2,2,FALSE,0.5,2024,2024-2025
PR,2024-12-31,intra-total,946,239,136,106,46,68,47,28,30,255,596,2497,1542,1781,FALSE,0.713255907088506,2024,2024-2025
PR,2024-12-31,intra-ucfe,7,2,0,0,1,1,0,0,0,0,1,12,8,10,FALSE,0.833333333333333,2024,2024-2025
PR,2024-12-31,intra-ucx,4,1,0,1,0,0,0,0,0,0,2,8,6,7,FALSE,0.875,2024,2024-2025
PR,2024-12-31,intra-ui,935,236,136,105,45,67,47,28,30,255,593,2477,1528,1764,FALSE,0.712151796528058,2024,2024-2025
RI,2019-01-31,inter-total,66,4,2,1,2,1,1,0,0,3,10,90,76,80,FALSE,0.888888888888889,2018,2018-2019
RI,2019-01-31,inter-ucfe,1,0,0,0,0,0,0,0,0,0,0,1,1,1,FALSE,1,2018,2018-2019
RI,2019-01-31,inter-ucx,0,0,0,0,0,0,0,0,0,0,0,0,0,0,FALSE,0,2018,2018-2019
RI,2019-01-31,inter-ui,65,4,2,1,2,1,1,0,0,3,10,89,75,79,FALSE,0.887640449438202,2018,2018-2019
RI,2019-01-31,intra-total,4108,131,54,29,18,21,9,7,4,13,583,4977,4691,4822,FALSE,0.96885674100864,2018,2018-2019
RI,2019-01-31,intra-ucfe,16,9,1,1,0,0,1,0,0,0,5,33,21,30,FALSE,0.909090909090909,2018,2018-2019
RI,2019-01-31,intra-ucx,1,1,1,0,0,0,0,0,0,0,1,4,2,3,FALSE,0.75,2018,2018-2019
RI,2019-01-31,intra-ui,4091,121,52,28,18,21,8,7,4,13,577,4940,4668,4789,FALSE,0.969433198380567,2018,2018-2019
RI,2019-02-28,inter-total,55,3,3,2,1,2,0,0,0,0,13,79,68,71,FALSE,0.89873417721519,2018,2018-2019
RI,2019-02-28,inter-ucfe,0,0,0,0,0,0,0,0,0,0,0,0,0,0,FALSE,0,2018,2018-2019
RI,2019-02-28,inter-ucx,0,0,0,0,0,0,0,0,0,0,0,0,0,0,FALSE,0,2018,2018-2019
RI,2019-02-28,inter-ui,55,3,3,2,1,2,0,0,0,0,13,79,68,71,FALSE,0.89873417721519,2018,2018-2019
RI,2019-02-28,intra-total,2457,140,79,57,30,16,8,3,2,6,414,3212,2871,3011,FALSE,0.937422166874222,2018,2018-2019
RI,2019-02-28,intra-ucfe,1,2,0,1,0,2,0,0,0,0,0,6,1,3,FALSE,0.5,2018,2018-2019
RI,2019-02-28,intra-ucx,3,0,1,0,0,1,0,0,0,0,2,7,5,5,FALSE,0.714285714285714,2018,2018-2019
RI,2019-02-28,intra-ui,2453,138,78,56,30,13,8,3,2,6,412,3199,2865,3003,FALSE,0.938730853391685,2018,2018-2019
RI,2019-03-31,inter-total,58,3,1,2,1,1,0,0,0,0,9,75,67,70,FALSE,0.933333333333333,2018,2018-2019
RI,2019-03-31,inter-ucfe,0,0,0,0,0,0,0,0,0,0,0,0,0,0,FALSE,0,2018,2018-2019
RI,2019-03-31,inter-ucx,0,0,0,0,0,0,0,0,0,0,0,0,0,0,FALSE,0,2018,2018-2019
RI,2019-03-31,inter-ui,58,3,1,2,1,1,0,0,0,0,9,75,67,70,FALSE,0.933333333333333,2018,2018-2019
RI,2019-03-31,intra-total,1346,73,43,31,24,27,15,12,2,14,269,1856,1615,1688,FALSE,0.90948275862069,2018,2018-2019
RI,2019-03-31,intra-ucfe,1,1,0,1,0,0,0,0,0,0,0,3,1,2,FALSE,0.666666666666667,2018,2018-2019
RI,2019-03-31,intra-ucx,0,0,1,0,0,0,0,0,0,0,1,2,1,1,FALSE,0.5,2018,2018-2019
RI,2019-03-31,intra-ui,1345,72,42,30,24,27,15,12,2,14,268,1851,1613,1685,FALSE,0.910318746623447,2018,2018-2019
RI,2019-04-30,inter-total,46,5,1,0,0,0,0,0,0,0,7,59,53,58,FALSE,0.983050847457627,2018,2018-2019
RI,2019-04-30,inter-ucfe,0,0,0,0,0,0,0,0,0,0,0,0,0,0,FALSE,0,2018,2018-2019
RI,2019-04-30,inter-ucx,0,0,0,0,0,0,0,0,0,0,0,0,0,0,FALSE,0,2018,2018-2019
RI,2019-04-30,inter-ui,46,5,1,0,0,0,0,0,0,0,7,59,53,58,FALSE,0.983050847457627,2018,2018-2019
RI,2019-04-30,intra-total,1471,57,12,23,20,7,6,4,2,18,243,1863,1714,1771,FALSE,0.950617283950617,2018,2018-2019
RI,2019-04-30,intra-ucfe,2,0,0,1,0,0,1,0,0,0,1,5,3,3,FALSE,0.6,2018,2018-2019
RI,2019-04-30,intra-ucx,2,0,0,0,0,0,0,0,0,0,2,4,4,4,FALSE,1,2018,2018-2019
RI,2019-04-30,intra-ui,1467,57,12,22,20,7,5,4,2,18,240,1854,1707,1764,FALSE,0.951456310679612,2018,2018-2019
RI,2019-05-31,inter-total,57,2,2,1,0,1,1,0,0,0,15,79,72,74,FALSE,0.936708860759494,2018,2018-2019
RI,2019-05-31,inter-ucfe,0,0,0,0,0,0,0,0,0,0,0,0,0,0,FALSE,0,2018,2018-2019
RI,2019-05-31,inter-ucx,0,0,0,0,0,0,0,0,0,0,0,0,0,0,FALSE,0,2018,2018-2019
RI,2019-05-31,inter-ui,57,2,2,1,0,1,1,0,0,0,15,79,72,74,FALSE,0.936708860759494,2018,2018-2019
RI,2019-05-31,intra-total,1111,56,23,25,9,11,3,2,0,18,195,1453,1306,1362,FALSE,0.937370956641432,2018,2018-2019
RI,2019-05-31,intra-ucfe,1,0,0,1,0,0,0,0,0,0,0,2,1,1,FALSE,0.5,2018,2018-2019
RI,2019-05-31,intra-ucx,1,1,0,0,0,1,0,0,0,0,1,4,2,3,FALSE,0.75,2018,2018-2019
RI,2019-05-31,intra-ui,1109,55,23,24,9,10,3,2,0,18,194,1447,1303,1358,FALSE,0.938493434692467,2018,2018-2019
RI,2019-06-30,inter-total,45,1,0,0,0,0,1,0,0,0,15,62,60,61,FALSE,0.983870967741936,2018,2018-2019
RI,2019-06-30,inter-ucfe,0,0,0,0,0,0,0,0,0,0,1,1,1,1,FALSE,1,2018,2018-2019
RI,2019-06-30,inter-ucx,0,0,0,0,0,0,0,0,0,0,0,0,0,0,FALSE,0,2018,2018-2019
RI,2019-06-30,inter-ui,45,1,0,0,0,0,1,0,0,0,14,61,59,60,FALSE,0.983606557377049,2018,2018-2019
RI,2019-06-30,intra-total,1275,20,19,12,17,11,7,6,4,7,199,1577,1474,1494,FALSE,0.947368421052632,2018,2018-2019
RI,2019-06-30,intra-ucfe,1,0,0,0,0,0,1,0,0,1,1,4,2,2,FALSE,0.5,2018,2018-2019
RI,2019-06-30,intra-ucx,1,0,0,0,0,0,0,0,0,0,0,1,1,1,FALSE,1,2018,2018-2019
RI,2019-06-30,intra-ui,1273,20,19,12,17,11,6,6,4,6,198,1572,1471,1491,FALSE,0.948473282442748,2018,2018-2019
RI,2019-07-31,inter-total,50,3,1,2,3,2,0,0,0,0,14,75,64,67,FALSE,0.893333333333333,2019,2019-2020
RI,2019-07-31,inter-ucfe,0,0,0,0,0,0,0,0,0,0,0,0,0,0,FALSE,0,2019,2019-2020
RI,2019-07-31,inter-ucx,0,0,0,0,0,0,0,0,0,0,0,0,0,0,FALSE,0,2019,2019-2020
RI,2019-07-31,inter-ui,50,3,1,2,3,2,0,0,0,0,14,75,64,67,FALSE,0.893333333333333,2019,2019-2020
RI,2019-07-31,intra-total,2430,67,28,18,10,8,0,7,1,11,409,2989,2839,2906,FALSE,0.972231515557042,2019,2019-2020
RI,2019-07-31,intra-ucfe,0,1,0,0,0,0,0,0,0,0,0,1,0,1,FALSE,1,2019,2019-2020
RI,2019-07-31,intra-ucx,1,0,0,0,0,0,0,0,0,0,1,2,2,2,FALSE,1,2019,2019-2020
RI,2019-07-31,intra-ui,2429,66,28,18,10,8,0,7,1,11,408,2986,2837,2903,FALSE,0.972203616878767,2019,2019-2020
RI,2019-08-31,inter-total,43,5,3,1,1,0,1,0,0,1,8,63,51,56,FALSE,0.888888888888889,2019,2019-2020
RI,2019-08-31,inter-ucfe,1,0,0,0,0,0,0,0,0,0,0,1,1,1,FALSE,1,2019,2019-2020
RI,2019-08-31,inter-ucx,0,0,0,0,0,0,0,0,0,0,0,0,0,0,FALSE,0,2019,2019-2020
RI,2019-08-31,inter-ui,42,5,3,1,1,0,1,0,0,1,8,62,50,55,FALSE,0.887096774193548,2019,2019-2020
RI,2019-08-31,intra-total,1113,54,39,26,12,14,3,1,0,6,204,1472,1317,1371,FALSE,0.931385869565217,2019,2019-2020
RI,2019-08-31,intra-ucfe,1,0,0,1,0,0,0,0,0,0,1,3,2,2,FALSE,0.666666666666667,2019,2019-2020
RI,2019-08-31,intra-ucx,2,1,1,0,0,0,0,0,0,0,1,5,3,4,FALSE,0.8,2019,2019-2020
RI,2019-08-31,intra-ui,1110,53,38,25,12,14,3,1,0,6,202,1464,1312,1365,FALSE,0.932377049180328,2019,2019-2020
RI,2019-09-30,inter-total,42,2,1,0,0,0,0,1,0,1,10,57,52,54,FALSE,0.947368421052632,2019,2019-2020
RI,2019-09-30,inter-ucfe,0,0,0,0,0,0,0,0,0,0,0,0,0,0,FALSE,0,2019,2019-2020
RI,2019-09-30,inter-ucx,0,0,0,0,0,0,0,0,0,0,0,0,0,0,FALSE,0,2019,2019-2020
RI,2019-09-30,inter-ui,42,2,1,0,0,0,0,1,0,1,10,57,52,54,FALSE,0.947368421052632,2019,2019-2020
RI,2019-09-30,intra-total,988,32,17,11,9,9,8,6,3,6,216,1305,1204,1236,FALSE,0.947126436781609,2019,2019-2020
RI,2019-09-30,intra-ucfe,0,0,2,0,0,1,0,0,0,0,0,3,0,0,FALSE,0,2019,2019-2020
RI,2019-09-30,intra-ucx,1,0,0,0,0,0,0,0,0,0,1,2,2,2,FALSE,1,2019,2019-2020
RI,2019-09-30,intra-ui,987,32,15,11,9,8,8,6,3,6,215,1300,1202,1234,FALSE,0.949230769230769,2019,2019-2020
RI,2019-10-31,inter-total,41,1,2,1,0,0,0,0,0,1,5,51,46,47,FALSE,0.92156862745098,2019,2019-2020
RI,2019-10-31,inter-ucfe,0,0,1,0,0,0,0,0,0,0,0,1,0,0,FALSE,0,2019,2019-2020
RI,2019-10-31,inter-ucx,0,0,0,0,0,0,0,0,0,0,0,0,0,0,FALSE,0,2019,2019-2020
RI,2019-10-31,inter-ui,41,1,1,1,0,0,0,0,0,1,5,50,46,47,FALSE,0.94,2019,2019-2020
RI,2019-10-31,intra-total,935,27,15,8,6,10,17,10,2,14,201,1245,1136,1163,FALSE,0.934136546184739,2019,2019-2020
RI,2019-10-31,intra-ucfe,0,1,0,0,0,0,0,0,0,0,2,3,2,3,FALSE,1,2019,2019-2020
RI,2019-10-31,intra-ucx,3,0,0,0,0,0,0,0,0,0,0,3,3,3,FALSE,1,2019,2019-2020
RI,2019-10-31,intra-ui,932,26,15,8,6,10,17,10,2,14,199,1239,1131,1157,FALSE,0.933817594834544,2019,2019-2020
RI,2019-11-30,inter-total,72,5,0,0,0,0,0,0,0,1,7,85,79,84,FALSE,0.988235294117647,2019,2019-2020
RI,2019-11-30,inter-ucfe,0,0,0,0,0,0,0,0,0,0,0,0,0,0,FALSE,0,2019,2019-2020
RI,2019-11-30,inter-ucx,0,0,0,0,0,0,0,0,0,0,0,0,0,0,FALSE,0,2019,2019-2020
RI,2019-11-30,inter-ui,72,5,0,0,0,0,0,0,0,1,7,85,79,84,FALSE,0.988235294117647,2019,2019-2020
RI,2019-11-30,intra-total,1268,48,17,14,9,8,10,10,5,6,208,1603,1476,1524,FALSE,0.950717404865877,2019,2019-2020
RI,2019-11-30,intra-ucfe,0,1,0,3,1,0,0,0,0,0,1,6,1,2,FALSE,0.333333333333333,2019,2019-2020
RI,2019-11-30,intra-ucx,1,0,0,0,0,0,0,0,0,0,2,3,3,3,FALSE,1,2019,2019-2020
RI,2019-11-30,intra-ui,1267,47,17,11,8,8,10,10,5,6,205,1594,1472,1519,FALSE,0.952948557089084,2019,2019-2020
RI,2019-12-31,inter-total,62,3,1,0,0,2,0,1,0,0,7,76,69,72,FALSE,0.947368421052632,2019,2019-2020
RI,2019-12-31,inter-ucfe,0,0,0,0,0,0,0,0,0,0,0,0,0,0,FALSE,0,2019,2019-2020
RI,2019-12-31,inter-ucx,0,0,0,0,0,0,0,0,0,0,0,0,0,0,FALSE,0,2019,2019-2020
RI,2019-12-31,inter-ui,62,3,1,0,0,2,0,1,0,0,7,76,69,72,FALSE,0.947368421052632,2019,2019-2020
RI,2019-12-31,intra-total,2528,28,15,11,6,5,6,13,8,8,199,2827,2727,2755,FALSE,0.974531305270605,2019,2019-2020
RI,2019-12-31,intra-ucfe,1,0,0,0,1,0,0,0,0,0,0,2,1,1,FALSE,0.5,2019,2019-2020
RI,2019-12-31,intra-ucx,4,0,0,0,0,0,0,0,0,0,0,4,4,4,FALSE,1,2019,2019-2020
RI,2019-12-31,intra-ui,2523,28,15,11,5,5,6,13,8,8,199,2821,2722,2750,FALSE,0.97483161999291,2019,2019-2020
RI,2020-01-31,inter-total,68,0,0,1,0,0,0,0,0,3,7,79,75,75,FALSE,0.949367088607595,2019,2019-2020
RI,2020-01-31,inter-ucfe,0,0,0,0,0,0,0,0,0,0,0,0,0,0,FALSE,0,2019,2019-2020
RI,2020-01-31,inter-ucx,0,0,0,0,0,0,0,0,0,0,0,0,0,0,FALSE,0,2019,2019-2020
RI,2020-01-31,inter-ui,68,0,0,1,0,0,0,0,0,3,7,79,75,75,FALSE,0.949367088607595,2019,2019-2020
RI,2020-01-31,intra-total,4272,56,34,3,9,4,2,4,4,30,462,4880,4734,4790,FALSE,0.98155737704918,2019,2019-2020
RI,2020-01-31,intra-ucfe,1,0,2,0,1,0,0,0,0,1,0,5,1,1,FALSE,0.2,2019,2019-2020
RI,2020-01-31,intra-ucx,0,0,1,0,0,0,0,0,0,0,0,1,0,0,FALSE,0,2019,2019-2020
RI,2020-01-31,intra-ui,4271,56,31,3,8,4,2,4,4,29,462,4874,4733,4789,FALSE,0.982560525235946,2019,2019-2020
RI,2020-02-29,inter-total,48,2,1,0,0,0,0,0,0,3,8,62,56,58,FALSE,0.935483870967742,2019,2019-2020
RI,2020-02-29,inter-ucfe,0,0,0,0,0,0,0,0,0,0,0,0,0,0,FALSE,0,2019,2019-2020
RI,2020-02-29,inter-ucx,0,0,0,0,0,0,0,0,0,0,0,0,0,0,FALSE,0,2019,2019-2020
RI,2020-02-29,inter-ui,48,2,1,0,0,0,0,0,0,3,8,62,56,58,FALSE,0.935483870967742,2019,2019-2020
RI,2020-02-29,intra-total,2212,76,43,33,6,3,7,7,8,22,247,2664,2459,2535,FALSE,0.951576576576577,2019,2019-2020
RI,2020-02-29,intra-ucfe,2,0,0,1,0,0,0,0,0,0,3,6,5,5,FALSE,0.833333333333333,2019,2019-2020
RI,2020-02-29,intra-ucx,1,0,0,0,0,0,0,0,0,0,2,3,3,3,FALSE,1,2019,2019-2020
RI,2020-02-29,intra-ui,2209,76,43,32,6,3,7,7,8,22,242,2655,2451,2527,FALSE,0.951789077212806,2019,2019-2020
RI,2020-03-31,inter-total,556,15,1,0,0,0,1,0,0,1,53,627,609,624,FALSE,0.995215311004785,2019,2019-2020
RI,2020-03-31,inter-ucfe,0,0,0,0,0,0,0,0,0,0,0,0,0,0,FALSE,0,2019,2019-2020
RI,2020-03-31,inter-ucx,1,0,0,0,0,0,0,0,0,0,0,1,1,1,FALSE,1,2019,2019-2020
RI,2020-03-31,inter-ui,555,15,1,0,0,0,1,0,0,1,53,626,608,623,FALSE,0.995207667731629,2019,2019-2020
RI,2020-03-31,intra-total,26649,412,10,2,8,6,6,10,8,16,2863,29990,29512,29924,FALSE,0.997799266422141,2019,2019-2020
RI,2020-03-31,intra-ucfe,3,0,0,0,0,0,0,0,0,0,0,3,3,3,FALSE,1,2019,2019-2020
RI,2020-03-31,intra-ucx,2,0,0,0,0,0,0,0,0,0,0,2,2,2,FALSE,1,2019,2019-2020
RI,2020-03-31,intra-ui,26644,412,10,2,8,6,6,10,8,16,2863,29985,29507,29919,FALSE,0.997798899449725,2019,2019-2020
RI,2020-04-30,inter-total,729,133,34,10,2,0,0,0,1,2,218,1129,947,1080,FALSE,0.956598759964571,2019,2019-2020
RI,2020-04-30,inter-ucfe,1,0,0,0,0,0,0,0,1,0,0,2,1,1,FALSE,0.5,2019,2019-2020
RI,2020-04-30,inter-ucx,0,0,0,0,0,0,0,0,0,0,0,0,0,0,FALSE,0,2019,2019-2020
RI,2020-04-30,inter-ui,728,133,34,10,2,0,0,0,0,2,218,1127,946,1079,FALSE,0.957409050576752,2019,2019-2020
RI,2020-04-30,intra-total,35565,6408,1192,294,117,16,7,5,11,19,12620,56254,48185,54593,FALSE,0.970473210793899,2019,2019-2020
RI,2020-04-30,intra-ucfe,0,0,2,1,1,0,0,0,0,0,0,4,0,0,FALSE,0,2019,2019-2020
RI,2020-04-30,intra-ucx,0,4,6,3,0,0,0,0,0,0,0,13,0,4,FALSE,0.307692307692308,2019,2019-2020
RI,2020-04-30,intra-ui,35565,6404,1184,290,116,16,7,5,11,19,12620,56237,48185,54589,FALSE,0.970695449615022,2019,2019-2020
RI,2020-05-31,inter-total,150,24,7,17,7,8,2,2,0,1,76,294,226,250,FALSE,0.850340136054422,2019,2019-2020
RI,2020-05-31,inter-ucfe,0,0,0,1,0,0,0,0,0,0,0,1,0,0,FALSE,0,2019,2019-2020
RI,2020-05-31,inter-ucx,0,0,0,0,0,0,0,0,0,0,0,0,0,0,FALSE,0,2019,2019-2020
RI,2020-05-31,inter-ui,150,24,7,16,7,8,2,2,0,1,76,293,226,250,FALSE,0.853242320819113,2019,2019-2020
RI,2020-05-31,intra-total,6282,1237,410,460,432,362,105,53,21,18,2608,11988,8890,10127,FALSE,0.844761428094761,2019,2019-2020
RI,2020-05-31,intra-ucfe,1,11,4,7,8,6,1,1,0,1,0,40,1,12,FALSE,0.3,2019,2019-2020
RI,2020-05-31,intra-ucx,2,3,1,5,4,2,1,0,0,0,1,19,3,6,FALSE,0.315789473684211,2019,2019-2020
RI,2020-05-31,intra-ui,6279,1223,405,448,420,354,103,52,21,17,2607,11929,8886,10109,FALSE,0.847430631234806,2019,2019-2020
RI,2020-06-30,inter-total,86,3,3,0,3,1,4,1,4,6,9,120,95,98,FALSE,0.816666666666667,2019,2019-2020
RI,2020-06-30,inter-ucfe,0,0,1,0,0,0,0,0,0,0,1,2,1,1,FALSE,0.5,2019,2019-2020
RI,2020-06-30,inter-ucx,0,0,0,0,0,0,0,0,0,0,0,0,0,0,FALSE,0,2019,2019-2020
RI,2020-06-30,inter-ui,86,3,2,0,3,1,4,1,4,6,8,118,94,97,FALSE,0.822033898305085,2019,2019-2020
RI,2020-06-30,intra-total,5890,133,101,68,51,63,54,33,38,97,402,6930,6292,6425,FALSE,0.927128427128427,2019,2019-2020
RI,2020-06-30,intra-ucfe,4,2,1,0,0,1,0,0,0,0,0,8,4,6,FALSE,0.75,2019,2019-2020
RI,2020-06-30,intra-ucx,6,0,0,0,1,0,0,0,0,0,1,8,7,7,FALSE,0.875,2019,2019-2020
RI,2020-06-30,intra-ui,5880,131,100,68,50,62,54,33,38,97,401,6914,6281,6412,FALSE,0.927393693954296,2019,2019-2020
RI,2020-07-31,inter-total,47,1,3,0,0,0,1,0,0,1,8,61,55,56,FALSE,0.918032786885246,2020,2020-2021
RI,2020-07-31,inter-ucfe,0,0,0,0,0,0,0,0,0,0,0,0,0,0,FALSE,0,2020,2020-2021
RI,2020-07-31,inter-ucx,0,0,0,0,0,0,0,0,0,0,0,0,0,0,FALSE,0,2020,2020-2021
RI,2020-07-31,inter-ui,47,1,3,0,0,0,1,0,0,1,8,61,55,56,FALSE,0.918032786885246,2020,2020-2021
RI,2020-07-31,intra-total,5408,172,109,54,45,29,34,26,27,167,480,6551,5888,6060,FALSE,0.925049610746451,2020,2020-2021
RI,2020-07-31,intra-ucfe,0,0,0,1,0,1,0,0,0,2,0,4,0,0,FALSE,0,2020,2020-2021
RI,2020-07-31,intra-ucx,3,0,0,0,0,1,0,0,0,0,1,5,4,4,FALSE,0.8,2020,2020-2021
RI,2020-07-31,intra-ui,5405,172,109,53,45,27,34,26,27,165,479,6542,5884,6056,FALSE,0.925710791806787,2020,2020-2021
RI,2020-08-31,inter-total,30,3,5,2,0,2,0,0,1,7,9,59,39,42,FALSE,0.711864406779661,2020,2020-2021
RI,2020-08-31,inter-ucfe,0,0,0,0,0,0,0,0,0,0,0,0,0,0,FALSE,0,2020,2020-2021
RI,2020-08-31,inter-ucx,0,0,0,0,0,0,0,0,0,0,0,0,0,0,FALSE,0,2020,2020-2021
RI,2020-08-31,inter-ui,30,3,5,2,0,2,0,0,1,7,9,59,39,42,FALSE,0.711864406779661,2020,2020-2021
RI,2020-08-31,intra-total,4455,119,105,79,58,46,40,23,27,164,240,5356,4695,4814,FALSE,0.898805078416729,2020,2020-2021
RI,2020-08-31,intra-ucfe,0,2,0,0,0,0,0,0,0,1,0,3,0,2,FALSE,0.666666666666667,2020,2020-2021
RI,2020-08-31,intra-ucx,0,0,0,0,0,0,0,0,0,0,0,0,0,0,FALSE,0,2020,2020-2021
RI,2020-08-31,intra-ui,4455,117,105,79,58,46,40,23,27,163,240,5353,4695,4812,FALSE,0.898935176536522,2020,2020-2021
RI,2020-09-30,inter-total,24,1,1,0,0,1,2,0,0,6,5,40,29,30,FALSE,0.75,2020,2020-2021
RI,2020-09-30,inter-ucfe,0,0,0,0,0,0,0,0,0,1,0,1,0,0,FALSE,0,2020,2020-2021
RI,2020-09-30,inter-ucx,0,0,0,0,0,0,0,0,0,0,0,0,0,0,FALSE,0,2020,2020-2021
RI,2020-09-30,inter-ui,24,1,1,0,0,1,2,0,0,5,5,39,29,30,FALSE,0.769230769230769,2020,2020-2021
RI,2020-09-30,intra-total,2024,66,50,33,19,18,25,15,16,128,193,2587,2217,2283,FALSE,0.882489369926556,2020,2020-2021
RI,2020-09-30,intra-ucfe,1,0,0,0,0,0,0,0,0,3,0,4,1,1,FALSE,0.25,2020,2020-2021
RI,2020-09-30,intra-ucx,0,0,1,0,0,0,0,0,0,0,0,1,0,0,FALSE,0,2020,2020-2021
RI,2020-09-30,intra-ui,2023,66,49,33,19,18,25,15,16,125,193,2582,2216,2282,FALSE,0.883810999225407,2020,2020-2021
RI,2020-10-31,inter-total,32,1,2,1,1,1,1,1,1,6,10,57,42,43,FALSE,0.754385964912281,2020,2020-2021
RI,2020-10-31,inter-ucfe,0,0,0,0,0,0,0,0,0,0,0,0,0,0,FALSE,0,2020,2020-2021
RI,2020-10-31,inter-ucx,0,0,0,0,0,0,0,0,0,0,0,0,0,0,FALSE,0,2020,2020-2021
RI,2020-10-31,inter-ui,32,1,2,1,1,1,1,1,1,6,10,57,42,43,FALSE,0.754385964912281,2020,2020-2021
RI,2020-10-31,intra-total,2020,83,47,38,14,12,14,9,9,108,148,2502,2168,2251,FALSE,0.899680255795364,2020,2020-2021
RI,2020-10-31,intra-ucfe,1,1,0,0,0,0,1,0,1,3,0,7,1,2,FALSE,0.285714285714286,2020,2020-2021
RI,2020-10-31,intra-ucx,2,0,0,1,0,0,0,0,0,0,1,4,3,3,FALSE,0.75,2020,2020-2021
RI,2020-10-31,intra-ui,2017,82,47,37,14,12,13,9,8,105,147,2491,2164,2246,FALSE,0.901645925331192,2020,2020-2021
RI,2020-11-30,inter-total,39,1,0,2,1,0,0,0,0,2,4,49,43,44,FALSE,0.897959183673469,2020,2020-2021
RI,2020-11-30,inter-ucfe,0,0,0,0,0,0,0,0,0,0,0,0,0,0,FALSE,0,2020,2020-2021
RI,2020-11-30,inter-ucx,0,0,0,0,0,0,0,0,0,0,0,0,0,0,FALSE,0,2020,2020-2021
RI,2020-11-30,inter-ui,39,1,0,2,1,0,0,0,0,2,4,49,43,44,FALSE,0.897959183673469,2020,2020-2021
RI,2020-11-30,intra-total,4572,96,79,47,20,14,8,10,5,73,163,5087,4735,4831,FALSE,0.949675643797916,2020,2020-2021
RI,2020-11-30,intra-ucfe,0,2,3,1,0,0,0,1,0,2,0,9,0,2,FALSE,0.222222222222222,2020,2020-2021
RI,2020-11-30,intra-ucx,0,0,0,1,0,0,0,0,0,2,1,4,1,1,FALSE,0.25,2020,2020-2021
RI,2020-11-30,intra-ui,4572,94,76,45,20,14,8,9,5,69,162,5074,4734,4828,FALSE,0.95151754040205,2020,2020-2021
RI,2020-12-31,inter-total,36,2,1,0,1,1,0,1,0,4,3,49,39,41,FALSE,0.836734693877551,2020,2020-2021
RI,2020-12-31,inter-ucfe,0,1,0,0,0,0,0,0,0,0,0,1,0,1,FALSE,1,2020,2020-2021
RI,2020-12-31,inter-ucx,0,0,0,0,0,0,0,0,0,0,0,0,0,0,FALSE,0,2020,2020-2021
RI,2020-12-31,inter-ui,36,1,1,0,1,1,0,1,0,4,3,48,39,40,FALSE,0.833333333333333,2020,2020-2021
RI,2020-12-31,intra-total,7169,125,83,49,29,32,16,8,3,58,245,7817,7414,7539,FALSE,0.964436484584879,2020,2020-2021
RI,2020-12-31,intra-ucfe,0,1,2,0,1,2,2,0,0,1,2,11,2,3,FALSE,0.272727272727273,2020,2020-2021
RI,2020-12-31,intra-ucx,0,0,1,0,0,0,0,0,0,2,1,4,1,1,FALSE,0.25,2020,2020-2021
RI,2020-12-31,intra-ui,7169,124,80,49,28,30,14,8,3,55,242,7802,7411,7535,FALSE,0.96577800563958,2020,2020-2021
RI,2021-01-31,inter-total,56,1,2,0,1,0,0,0,1,3,5,69,61,62,FALSE,0.898550724637681,2020,2020-2021
RI,2021-01-31,inter-ucfe,0,0,0,0,0,0,0,0,0,0,0,0,0,0,FALSE,0,2020,2020-2021
RI,2021-01-31,inter-ucx,0,0,0,0,0,0,0,0,0,0,0,0,0,0,FALSE,0,2020,2020-2021
RI,2021-01-31,inter-ui,56,1,2,0,1,0,0,0,1,3,5,69,61,62,FALSE,0.898550724637681,2020,2020-2021
RI,2021-01-31,intra-total,12419,218,104,74,40,22,8,10,6,38,452,13391,12871,13089,FALSE,0.977447539392129,2020,2020-2021
RI,2021-01-31,intra-ucfe,11,0,2,2,0,1,0,2,1,3,1,23,12,12,FALSE,0.521739130434783,2020,2020-2021
RI,2021-01-31,intra-ucx,1,2,0,1,0,1,0,2,1,0,0,8,1,3,FALSE,0.375,2020,2020-2021
RI,2021-01-31,intra-ui,12407,216,102,71,40,20,8,6,4,35,451,13360,12858,13074,FALSE,0.978592814371257,2020,2020-2021
RI,2021-02-28,inter-total,47,3,2,3,0,1,0,0,0,4,4,64,51,54,FALSE,0.84375,2020,2020-2021
RI,2021-02-28,inter-ucfe,0,0,0,0,0,0,0,0,0,0,0,0,0,0,FALSE,0,2020,2020-2021
RI,2021-02-28,inter-ucx,0,0,0,0,0,0,0,0,0,0,0,0,0,0,FALSE,0,2020,2020-2021
RI,2021-02-28,inter-ui,47,3,2,3,0,1,0,0,0,4,4,64,51,54,FALSE,0.84375,2020,2020-2021
RI,2021-02-28,intra-total,10275,167,126,88,53,26,21,7,7,46,341,11157,10616,10783,FALSE,0.966478444026172,2020,2020-2021
RI,2021-02-28,intra-ucfe,1,0,0,0,0,0,0,1,0,1,1,4,2,2,FALSE,0.5,2020,2020-2021
RI,2021-02-28,intra-ucx,2,1,1,0,0,0,0,0,0,0,1,5,3,4,FALSE,0.8,2020,2020-2021
RI,2021-02-28,intra-ui,10272,166,125,88,53,26,21,6,7,45,339,11148,10611,10777,FALSE,0.966720487979907,2020,2020-2021
RI,2021-03-31,inter-total,22,2,0,1,0,0,0,0,1,1,3,30,25,27,FALSE,0.9,2020,2020-2021
RI,2021-03-31,inter-ucfe,0,0,0,0,0,0,0,0,0,0,0,0,0,0,FALSE,0,2020,2020-2021
RI,2021-03-31,inter-ucx,0,0,0,0,0,0,0,0,0,0,0,0,0,0,FALSE,0,2020,2020-2021
RI,2021-03-31,inter-ui,22,2,0,1,0,0,0,0,1,1,3,30,25,27,FALSE,0.9,2020,2020-2021
RI,2021-03-31,intra-total,6998,155,98,70,59,42,28,22,16,98,291,7877,7289,7444,FALSE,0.94502983369303,2020,2020-2021
RI,2021-03-31,intra-ucfe,2,1,1,2,3,1,0,2,0,3,0,15,2,3,FALSE,0.2,2020,2020-2021
RI,2021-03-31,intra-ucx,1,0,0,0,0,1,0,0,0,0,1,3,2,2,FALSE,0.666666666666667,2020,2020-2021
RI,2021-03-31,intra-ui,6995,154,97,68,56,40,28,20,16,95,290,7859,7285,7439,FALSE,0.946558086270518,2020,2020-2021
RI,2021-04-30,inter-total,35,5,2,2,1,0,0,0,0,5,4,54,39,44,FALSE,0.814814814814815,2020,2020-2021
RI,2021-04-30,inter-ucfe,0,0,0,0,0,0,0,0,0,0,0,0,0,0,FALSE,0,2020,2020-2021
RI,2021-04-30,inter-ucx,0,0,0,0,0,0,0,0,0,0,0,0,0,0,FALSE,0,2020,2020-2021
RI,2021-04-30,inter-ui,35,5,2,2,1,0,0,0,0,5,4,54,39,44,FALSE,0.814814814814815,2020,2020-2021
RI,2021-04-30,intra-total,9427,252,165,102,56,30,23,22,18,114,541,10750,9968,10220,FALSE,0.950697674418605,2020,2020-2021
RI,2021-04-30,intra-ucfe,1,0,1,0,1,0,1,0,0,2,0,6,1,1,FALSE,0.166666666666667,2020,2020-2021
RI,2021-04-30,intra-ucx,2,0,0,0,0,0,0,0,0,4,0,6,2,2,FALSE,0.333333333333333,2020,2020-2021
RI,2021-04-30,intra-ui,9424,252,164,102,55,30,22,22,18,108,541,10738,9965,10217,FALSE,0.951480722667163,2020,2020-2021
RI,2021-05-31,inter-total,22,3,1,2,2,1,2,1,0,1,1,36,23,26,FALSE,0.722222222222222,2020,2020-2021
RI,2021-05-31,inter-ucfe,0,0,0,0,0,0,0,0,0,0,0,0,0,0,FALSE,0,2020,2020-2021
RI,2021-05-31,inter-ucx,0,0,0,0,0,0,0,0,0,0,0,0,0,0,FALSE,0,2020,2020-2021
RI,2021-05-31,inter-ui,22,3,1,2,2,1,2,1,0,1,1,36,23,26,FALSE,0.722222222222222,2020,2020-2021
RI,2021-05-31,intra-total,11483,120,114,88,77,45,34,36,17,105,226,12345,11709,11829,FALSE,0.95820170109356,2020,2020-2021
RI,2021-05-31,intra-ucfe,1,0,0,0,0,0,0,0,0,1,0,2,1,1,FALSE,0.5,2020,2020-2021
RI,2021-05-31,intra-ucx,5,2,1,0,1,0,0,0,0,1,1,11,6,8,FALSE,0.727272727272727,2020,2020-2021
RI,2021-05-31,intra-ui,11477,118,113,88,76,45,34,36,17,103,225,12332,11702,11820,FALSE,0.958481998053844,2020,2020-2021
RI,2021-06-30,inter-total,19,1,2,1,0,0,1,0,1,4,3,32,22,23,FALSE,0.71875,2020,2020-2021
RI,2021-06-30,inter-ucfe,0,0,0,0,0,0,0,0,0,0,0,0,0,0,FALSE,0,2020,2020-2021
RI,2021-06-30,inter-ucx,0,0,0,0,0,0,0,0,0,0,0,0,0,0,FALSE,0,2020,2020-2021
RI,2021-06-30,inter-ui,19,1,2,1,0,0,1,0,1,4,3,32,22,23,FALSE,0.71875,2020,2020-2021
RI,2021-06-30,intra-total,10353,115,83,67,41,48,25,28,31,102,231,11124,10584,10699,FALSE,0.961794318590435,2020,2020-2021
RI,2021-06-30,intra-ucfe,3,1,0,2,0,0,0,0,2,0,1,9,4,5,FALSE,0.555555555555556,2020,2020-2021
RI,2021-06-30,intra-ucx,1,0,0,0,0,0,0,0,0,3,2,6,3,3,FALSE,0.5,2020,2020-2021
RI,2021-06-30,intra-ui,10349,114,83,65,41,48,25,28,29,99,228,11109,10577,10691,FALSE,0.96237285084166,2020,2020-2021
RI,2021-07-31,inter-total,20,1,3,1,0,1,0,0,0,3,8,37,28,29,FALSE,0.783783783783784,2021,2021-2022
RI,2021-07-31,inter-ucfe,0,0,0,0,0,0,0,0,0,0,0,0,0,0,FALSE,0,2021,2021-2022
RI,2021-07-31,inter-ucx,0,0,0,0,0,0,0,0,0,0,0,0,0,0,FALSE,0,2021,2021-2022
RI,2021-07-31,inter-ui,20,1,3,1,0,1,0,0,0,3,8,37,28,29,FALSE,0.783783783783784,2021,2021-2022
RI,2021-07-31,intra-total,3368,154,82,66,49,30,26,16,15,123,339,4268,3707,3861,FALSE,0.904639175257732,2021,2021-2022
RI,2021-07-31,intra-ucfe,0,1,0,1,0,0,0,0,0,3,0,5,0,1,FALSE,0.2,2021,2021-2022
RI,2021-07-31,intra-ucx,1,0,0,0,0,0,0,0,0,0,2,3,3,3,FALSE,1,2021,2021-2022
RI,2021-07-31,intra-ui,3367,153,82,65,49,30,26,16,15,120,337,4260,3704,3857,FALSE,0.905399061032864,2021,2021-2022
RI,2021-08-31,inter-total,17,0,3,1,3,2,0,0,1,4,1,32,18,18,FALSE,0.5625,2021,2021-2022
RI,2021-08-31,inter-ucfe,0,0,0,0,0,0,0,0,0,0,0,0,0,0,FALSE,0,2021,2021-2022
RI,2021-08-31,inter-ucx,0,0,0,0,0,0,0,0,0,0,0,0,0,0,FALSE,0,2021,2021-2022
RI,2021-08-31,inter-ui,17,0,3,1,3,2,0,0,1,4,1,32,18,18,FALSE,0.5625,2021,2021-2022
RI,2021-08-31,intra-total,2024,117,122,91,53,52,22,7,9,103,218,2818,2242,2359,FALSE,0.837118523775727,2021,2021-2022
RI,2021-08-31,intra-ucfe,1,0,0,0,0,0,0,0,0,0,0,1,1,1,FALSE,1,2021,2021-2022
RI,2021-08-31,intra-ucx,1,0,1,0,0,0,0,0,0,0,0,2,1,1,FALSE,0.5,2021,2021-2022
RI,2021-08-31,intra-ui,2022,117,121,91,53,52,22,7,9,103,218,2815,2240,2357,FALSE,0.837300177619893,2021,2021-2022
RI,2021-09-30,inter-total,16,2,0,1,1,2,0,0,1,4,6,33,22,24,FALSE,0.727272727272727,2021,2021-2022
RI,2021-09-30,inter-ucfe,0,0,0,0,0,0,0,0,0,0,0,0,0,0,FALSE,0,2021,2021-2022
RI,2021-09-30,inter-ucx,0,0,0,0,0,0,0,0,0,0,0,0,0,0,FALSE,0,2021,2021-2022
RI,2021-09-30,inter-ui,16,2,0,1,1,2,0,0,1,4,6,33,22,24,FALSE,0.727272727272727,2021,2021-2022
RI,2021-09-30,intra-total,823,108,97,67,52,35,36,26,12,100,148,1504,971,1079,FALSE,0.717420212765958,2021,2021-2022
RI,2021-09-30,intra-ucfe,0,0,1,0,2,0,2,0,0,3,0,8,0,0,FALSE,0,2021,2021-2022
RI,2021-09-30,intra-ucx,1,2,2,0,0,0,4,1,0,0,0,10,1,3,FALSE,0.3,2021,2021-2022
RI,2021-09-30,intra-ui,822,106,94,67,50,35,30,25,12,97,148,1486,970,1076,FALSE,0.724091520861373,2021,2021-2022
RI,2021-10-31,inter-total,16,2,2,3,0,0,0,1,0,5,3,32,19,21,FALSE,0.65625,2021,2021-2022
RI,2021-10-31,inter-ucfe,0,0,0,0,0,0,0,0,0,0,0,0,0,0,FALSE,0,2021,2021-2022
RI,2021-10-31,inter-ucx,0,0,0,0,0,0,0,0,0,0,0,0,0,0,FALSE,0,2021,2021-2022
RI,2021-10-31,inter-ui,16,2,2,3,0,0,0,1,0,5,3,32,19,21,FALSE,0.65625,2021,2021-2022
RI,2021-10-31,intra-total,622,116,73,78,64,37,27,17,9,86,156,1285,778,894,FALSE,0.695719844357977,2021,2021-2022
RI,2021-10-31,intra-ucfe,0,1,0,0,0,0,1,1,0,1,1,5,1,2,FALSE,0.4,2021,2021-2022
RI,2021-10-31,intra-ucx,0,1,0,1,0,0,0,1,0,1,0,4,0,1,FALSE,0.25,2021,2021-2022
RI,2021-10-31,intra-ui,622,114,73,77,64,37,26,15,9,84,155,1276,777,891,FALSE,0.698275862068966,2021,2021-2022
RI,2021-11-30,inter-total,31,5,4,0,3,1,0,0,0,1,9,54,40,45,FALSE,0.833333333333333,2021,2021-2022
RI,2021-11-30,inter-ucfe,0,0,0,0,0,0,0,0,0,0,0,0,0,0,FALSE,0,2021,2021-2022
RI,2021-11-30,inter-ucx,0,0,0,0,0,0,0,0,0,0,0,0,0,0,FALSE,0,2021,2021-2022
RI,2021-11-30,inter-ui,31,5,4,0,3,1,0,0,0,1,9,54,40,45,FALSE,0.833333333333333,2021,2021-2022
RI,2021-11-30,intra-total,805,96,72,48,48,33,26,25,8,86,126,1373,931,1027,FALSE,0.747997086671522,2021,2021-2022
RI,2021-11-30,intra-ucfe,0,1,0,1,1,1,0,0,0,1,1,6,1,2,FALSE,0.333333333333333,2021,2021-2022
RI,2021-11-30,intra-ucx,3,1,0,0,0,2,1,1,0,0,1,9,4,5,FALSE,0.555555555555556,2021,2021-2022
RI,2021-11-30,intra-ui,802,94,72,47,47,30,25,24,8,85,124,1358,926,1020,FALSE,0.751104565537555,2021,2021-2022
RI,2021-12-31,inter-total,45,2,2,0,1,0,0,0,0,3,3,56,48,50,FALSE,0.892857142857143,2021,2021-2022
RI,2021-12-31,inter-ucfe,0,0,0,0,0,0,0,0,0,0,0,0,0,0,FALSE,0,2021,2021-2022
RI,2021-12-31,inter-ucx,0,0,0,0,0,0,0,0,0,0,0,0,0,0,FALSE,0,2021,2021-2022
RI,2021-12-31,inter-ui,45,2,2,0,1,0,0,0,0,3,3,56,48,50,FALSE,0.892857142857143,2021,2021-2022
RI,2021-12-31,intra-total,1441,68,60,38,26,30,8,13,10,88,125,1907,1566,1634,FALSE,0.856843209229156,2021,2021-2022
RI,2021-12-31,intra-ucfe,0,0,0,2,2,1,0,0,1,4,0,10,0,0,FALSE,0,2021,2021-2022
RI,2021-12-31,intra-ucx,2,1,0,0,0,1,0,1,1,1,1,8,3,4,FALSE,0.5,2021,2021-2022
RI,2021-12-31,intra-ui,1439,67,60,36,24,28,8,12,8,83,124,1889,1563,1630,FALSE,0.862890418210693,2021,2021-2022
RI,2022-01-31,inter-total,74,7,2,2,0,1,1,0,0,1,13,101,87,94,FALSE,0.930693069306931,2021,2021-2022
RI,2022-01-31,inter-ucfe,0,0,0,0,0,0,0,0,0,0,0,0,0,0,FALSE,0,2021,2021-2022
RI,2022-01-31,inter-ucx,0,0,0,0,0,0,0,0,0,0,0,0,0,0,FALSE,0,2021,2021-2022
RI,2022-01-31,inter-ui,74,7,2,2,0,1,1,0,0,1,13,101,87,94,FALSE,0.930693069306931,2021,2021-2022
RI,2022-01-31,intra-total,3629,129,57,31,40,21,23,14,11,101,386,4442,4015,4144,FALSE,0.932913102206213,2021,2021-2022
RI,2022-01-31,intra-ucfe,0,0,0,0,0,1,0,1,0,2,0,4,0,0,FALSE,0,2021,2021-2022
RI,2022-01-31,intra-ucx,0,2,1,0,1,0,1,1,0,1,0,7,0,2,FALSE,0.285714285714286,2021,2021-2022
RI,2022-01-31,intra-ui,3629,127,56,31,39,20,22,12,11,98,386,4431,4015,4142,FALSE,0.934777702550214,2021,2021-2022
RI,2022-02-28,inter-total,36,2,3,0,0,0,0,0,0,5,8,54,44,46,FALSE,0.851851851851852,2021,2021-2022
RI,2022-02-28,inter-ucfe,0,0,0,0,0,0,0,0,0,0,0,0,0,0,FALSE,0,2021,2021-2022
RI,2022-02-28,inter-ucx,0,0,0,0,0,0,0,0,0,0,0,0,0,0,FALSE,0,2021,2021-2022
RI,2022-02-28,inter-ui,36,2,3,0,0,0,0,0,0,5,8,54,44,46,FALSE,0.851851851851852,2021,2021-2022
RI,2022-02-28,intra-total,1879,157,83,56,36,13,11,6,2,70,248,2561,2127,2284,FALSE,0.891839125341664,2021,2021-2022
RI,2022-02-28,intra-ucfe,1,1,0,0,1,0,0,0,0,3,0,6,1,2,FALSE,0.333333333333333,2021,2021-2022
RI,2022-02-28,intra-ucx,0,0,0,0,0,1,0,0,0,0,0,1,0,0,FALSE,0,2021,2021-2022
RI,2022-02-28,intra-ui,1878,156,83,56,35,12,11,6,2,67,248,2554,2126,2282,FALSE,0.893500391542678,2021,2021-2022
RI,2022-03-31,inter-total,29,4,1,0,0,0,0,2,0,3,6,45,35,39,FALSE,0.866666666666667,2021,2021-2022
RI,2022-03-31,inter-ucfe,0,0,0,0,0,0,0,0,0,0,0,0,0,0,FALSE,0,2021,2021-2022
RI,2022-03-31,inter-ucx,0,0,0,0,0,0,0,0,0,0,0,0,0,0,FALSE,0,2021,2021-2022
RI,2022-03-31,inter-ui,29,4,1,0,0,0,0,2,0,3,6,45,35,39,FALSE,0.866666666666667,2021,2021-2022
RI,2022-03-31,intra-total,1132,66,44,30,33,26,12,7,5,73,213,1641,1345,1411,FALSE,0.859841560024375,2021,2021-2022
RI,2022-03-31,intra-ucfe,0,0,1,2,0,0,0,0,1,0,3,7,3,3,FALSE,0.428571428571429,2021,2021-2022
RI,2022-03-31,intra-ucx,0,0,1,0,2,1,0,0,0,2,0,6,0,0,FALSE,0,2021,2021-2022
RI,2022-03-31,intra-ui,1132,66,42,28,31,25,12,7,4,71,210,1628,1342,1408,FALSE,0.864864864864865,2021,2021-2022
RI,2022-04-30,inter-total,17,4,0,0,0,0,0,0,0,6,2,29,19,23,FALSE,0.793103448275862,2021,2021-2022
RI,2022-04-30,inter-ucfe,0,0,0,0,0,0,0,0,0,0,0,0,0,0,FALSE,0,2021,2021-2022
RI,2022-04-30,inter-ucx,0,0,0,0,0,0,0,0,0,0,0,0,0,0,FALSE,0,2021,2021-2022
RI,2022-04-30,inter-ui,17,4,0,0,0,0,0,0,0,6,2,29,19,23,FALSE,0.793103448275862,2021,2021-2022
RI,2022-04-30,intra-total,1032,40,18,12,8,5,4,10,5,82,193,1409,1225,1265,FALSE,0.897799858055359,2021,2021-2022
RI,2022-04-30,intra-ucfe,0,0,0,1,1,0,1,0,0,0,0,3,0,0,FALSE,0,2021,2021-2022
RI,2022-04-30,intra-ucx,0,0,0,0,0,0,0,0,0,0,0,0,0,0,FALSE,0,2021,2021-2022
RI,2022-04-30,intra-ui,1032,40,18,11,7,5,3,10,5,82,193,1406,1225,1265,FALSE,0.899715504978663,2021,2021-2022
RI,2022-05-31,inter-total,28,1,0,0,0,0,0,1,0,2,2,34,30,31,FALSE,0.911764705882353,2021,2021-2022
RI,2022-05-31,inter-ucfe,0,0,0,0,0,0,0,0,0,0,0,0,0,0,FALSE,0,2021,2021-2022
RI,2022-05-31,inter-ucx,0,0,0,0,0,0,0,0,0,0,0,0,0,0,FALSE,0,2021,2021-2022
RI,2022-05-31,inter-ui,28,1,0,0,0,0,0,1,0,2,2,34,30,31,FALSE,0.911764705882353,2021,2021-2022
RI,2022-05-31,intra-total,1017,62,30,18,11,8,7,4,3,57,213,1430,1230,1292,FALSE,0.903496503496504,2021,2021-2022
RI,2022-05-31,intra-ucfe,0,0,0,0,1,2,1,0,0,1,0,5,0,0,FALSE,0,2021,2021-2022
RI,2022-05-31,intra-ucx,2,0,0,0,0,0,1,0,1,0,0,4,2,2,FALSE,0.5,2021,2021-2022
RI,2022-05-31,intra-ui,1015,62,30,18,10,6,5,4,2,56,213,1421,1228,1290,FALSE,0.907811400422238,2021,2021-2022
RI,2022-06-30,inter-total,24,2,3,1,0,0,0,0,0,7,5,42,29,31,FALSE,0.738095238095238,2021,2021-2022
RI,2022-06-30,inter-ucfe,1,0,0,0,0,0,0,0,0,0,0,1,1,1,FALSE,1,2021,2021-2022
RI,2022-06-30,inter-ucx,0,0,0,0,0,0,0,0,0,0,0,0,0,0,FALSE,0,2021,2021-2022
RI,2022-06-30,inter-ui,23,2,3,1,0,0,0,0,0,7,5,41,28,30,FALSE,0.731707317073171,2021,2021-2022
RI,2022-06-30,intra-total,1146,44,21,16,9,9,10,7,6,45,230,1543,1376,1420,FALSE,0.920285158781594,2021,2021-2022
RI,2022-06-30,intra-ucfe,1,1,0,0,0,1,0,0,0,1,0,4,1,2,FALSE,0.5,2021,2021-2022
RI,2022-06-30,intra-ucx,0,0,0,0,0,1,0,0,0,0,2,3,2,2,FALSE,0.666666666666667,2021,2021-2022
RI,2022-06-30,intra-ui,1145,43,21,16,9,7,10,7,6,44,228,1536,1373,1416,FALSE,0.921875,2021,2021-2022
RI,2022-07-31,inter-total,20,5,0,0,0,0,0,0,0,0,7,32,27,32,FALSE,1,2022,2022-2023
RI,2022-07-31,inter-ucfe,0,0,0,0,0,0,0,0,0,0,0,0,0,0,FALSE,0,2022,2022-2023
RI,2022-07-31,inter-ucx,0,0,0,0,0,0,0,0,0,0,0,0,0,0,FALSE,0,2022,2022-2023
RI,2022-07-31,inter-ui,20,5,0,0,0,0,0,0,0,0,7,32,27,32,FALSE,1,2022,2022-2023
RI,2022-07-31,intra-total,2186,63,22,12,8,3,8,7,7,25,326,2667,2512,2575,FALSE,0.965504311961005,2022,2022-2023
RI,2022-07-31,intra-ucfe,2,0,1,1,0,0,1,0,0,0,0,5,2,2,FALSE,0.4,2022,2022-2023
RI,2022-07-31,intra-ucx,1,1,1,0,1,0,4,0,0,0,1,9,2,3,FALSE,0.333333333333333,2022,2022-2023
RI,2022-07-31,intra-ui,2183,62,20,11,7,3,3,7,7,25,325,2653,2508,2570,FALSE,0.968714662646061,2022,2022-2023
RI,2022-08-31,inter-total,14,3,3,0,2,0,1,1,2,0,10,36,24,27,FALSE,0.75,2022,2022-2023
RI,2022-08-31,inter-ucfe,0,0,0,0,1,0,0,0,1,0,0,2,0,0,FALSE,0,2022,2022-2023
RI,2022-08-31,inter-ucx,0,0,0,0,0,0,0,0,0,0,0,0,0,0,FALSE,0,2022,2022-2023
RI,2022-08-31,inter-ui,14,3,3,0,1,0,1,1,1,0,10,34,24,27,FALSE,0.794117647058824,2022,2022-2023
RI,2022-08-31,intra-total,1187,117,60,34,14,14,6,9,9,32,292,1774,1479,1596,FALSE,0.899661781285231,2022,2022-2023
RI,2022-08-31,intra-ucfe,0,0,0,2,1,1,0,0,0,1,0,5,0,0,FALSE,0,2022,2022-2023
RI,2022-08-31,intra-ucx,1,0,1,0,1,1,0,1,0,0,0,5,1,1,FALSE,0.2,2022,2022-2023
RI,2022-08-31,intra-ui,1186,117,59,32,12,12,6,8,9,31,292,1764,1478,1595,FALSE,0.904195011337869,2022,2022-2023
RI,2022-09-30,inter-total,25,6,1,2,1,2,1,0,0,2,7,47,32,38,FALSE,0.808510638297872,2022,2022-2023
RI,2022-09-30,inter-ucfe,0,0,0,0,0,0,0,0,0,0,0,0,0,0,FALSE,0,2022,2022-2023
RI,2022-09-30,inter-ucx,0,0,0,0,0,0,0,0,0,0,0,0,0,0,FALSE,0,2022,2022-2023
RI,2022-09-30,inter-ui,25,6,1,2,1,2,1,0,0,2,7,47,32,38,FALSE,0.808510638297872,2022,2022-2023
RI,2022-09-30,intra-total,744,90,57,36,15,16,16,20,13,24,215,1246,959,1049,FALSE,0.841894060995185,2022,2022-2023
RI,2022-09-30,intra-ucfe,1,0,1,0,1,1,2,1,0,1,2,10,3,3,FALSE,0.3,2022,2022-2023
RI,2022-09-30,intra-ucx,2,0,4,0,0,0,0,0,0,0,0,6,2,2,FALSE,0.333333333333333,2022,2022-2023
RI,2022-09-30,intra-ui,741,90,52,36,14,15,14,19,13,23,213,1230,954,1044,FALSE,0.848780487804878,2022,2022-2023
RI,2022-10-31,inter-total,25,2,1,1,0,0,0,0,0,1,13,43,38,40,FALSE,0.930232558139535,2022,2022-2023
RI,2022-10-31,inter-ucfe,0,0,0,0,0,0,0,0,0,0,0,0,0,0,FALSE,0,2022,2022-2023
RI,2022-10-31,inter-ucx,0,0,0,0,0,0,0,0,0,0,0,0,0,0,FALSE,0,2022,2022-2023
RI,2022-10-31,inter-ui,25,2,1,1,0,0,0,0,0,1,13,43,38,40,FALSE,0.930232558139535,2022,2022-2023
RI,2022-10-31,intra-total,797,60,39,22,34,20,12,11,7,28,282,1312,1079,1139,FALSE,0.868140243902439,2022,2022-2023
RI,2022-10-31,intra-ucfe,0,0,0,1,0,0,0,0,0,0,2,3,2,2,FALSE,0.666666666666667,2022,2022-2023
RI,2022-10-31,intra-ucx,1,1,0,1,0,0,0,0,1,0,0,4,1,2,FALSE,0.5,2022,2022-2023
RI,2022-10-31,intra-ui,796,59,39,20,34,20,12,11,6,28,280,1305,1076,1135,FALSE,0.869731800766284,2022,2022-2023
RI,2022-11-30,inter-total,39,3,2,1,1,0,0,0,0,0,11,57,50,53,FALSE,0.929824561403509,2022,2022-2023
RI,2022-11-30,inter-ucfe,0,0,0,0,0,0,0,0,0,0,0,0,0,0,FALSE,0,2022,2022-2023
RI,2022-11-30,inter-ucx,0,0,0,0,0,0,0,0,0,0,0,0,0,0,FALSE,0,2022,2022-2023
RI,2022-11-30,inter-ui,39,3,2,1,1,0,0,0,0,0,11,57,50,53,FALSE,0.929824561403509,2022,2022-2023
RI,2022-11-30,intra-total,1025,94,51,37,16,11,10,2,1,19,237,1503,1262,1356,FALSE,0.902195608782435,2022,2022-2023
RI,2022-11-30,intra-ucfe,0,0,0,1,0,0,0,0,0,0,0,1,0,0,FALSE,0,2022,2022-2023
RI,2022-11-30,intra-ucx,0,1,1,0,0,0,0,0,0,0,0,2,0,1,FALSE,0.5,2022,2022-2023
RI,2022-11-30,intra-ui,1025,93,50,36,16,11,10,2,1,19,237,1500,1262,1355,FALSE,0.903333333333333,2022,2022-2023
RI,2022-12-31,inter-total,38,2,4,0,2,3,0,0,0,1,8,58,46,48,FALSE,0.827586206896552,2022,2022-2023
RI,2022-12-31,inter-ucfe,0,0,0,0,0,0,0,0,0,0,0,0,0,0,FALSE,0,2022,2022-2023
RI,2022-12-31,inter-ucx,0,0,0,0,0,0,0,0,0,0,0,0,0,0,FALSE,0,2022,2022-2023
RI,2022-12-31,inter-ui,38,2,4,0,2,3,0,0,0,1,8,58,46,48,FALSE,0.827586206896552,2022,2022-2023
RI,2022-12-31,intra-total,1646,101,80,54,20,14,9,5,3,16,274,2222,1920,2021,FALSE,0.90954095409541,2022,2022-2023
RI,2022-12-31,intra-ucfe,0,0,1,0,0,0,1,0,0,1,1,4,1,1,FALSE,0.25,2022,2022-2023
RI,2022-12-31,intra-ucx,1,0,0,0,0,0,0,0,0,0,0,1,1,1,FALSE,1,2022,2022-2023
RI,2022-12-31,intra-ui,1645,101,79,54,20,14,8,5,3,15,273,2217,1918,2019,FALSE,0.910690121786198,2022,2022-2023
RI,2023-01-31,inter-total,37,6,2,2,0,0,1,1,0,4,7,60,44,50,FALSE,0.833333333333333,2022,2022-2023
RI,2023-01-31,inter-ucfe,0,0,0,0,0,0,0,0,0,0,0,0,0,0,FALSE,0,2022,2022-2023
RI,2023-01-31,inter-ucx,0,0,0,0,0,0,0,0,0,0,0,0,0,0,FALSE,0,2022,2022-2023
RI,2023-01-31,inter-ui,37,6,2,2,0,0,1,1,0,4,7,60,44,50,FALSE,0.833333333333333,2022,2022-2023
RI,2023-01-31,intra-total,4106,167,73,32,25,22,18,12,12,27,576,5070,4682,4849,FALSE,0.956410256410256,2022,2022-2023
RI,2023-01-31,intra-ucfe,0,0,0,0,0,0,1,0,1,0,0,2,0,0,FALSE,0,2022,2022-2023
RI,2023-01-31,intra-ucx,1,0,0,0,2,2,0,0,0,0,0,5,1,1,FALSE,0.2,2022,2022-2023
RI,2023-01-31,intra-ui,4105,167,73,32,23,20,17,12,11,27,576,5063,4681,4848,FALSE,0.95753505826585,2022,2022-2023
RI,2023-02-28,inter-total,14,1,0,0,0,4,0,1,0,2,3,25,17,18,FALSE,0.72,2022,2022-2023
RI,2023-02-28,inter-ucfe,0,0,0,0,0,0,0,0,0,0,0,0,0,0,FALSE,0,2022,2022-2023
RI,2023-02-28,inter-ucx,0,0,0,0,0,0,0,0,0,0,0,0,0,0,FALSE,0,2022,2022-2023
RI,2023-02-28,inter-ui,14,1,0,0,0,4,0,1,0,2,3,25,17,18,FALSE,0.72,2022,2022-2023
RI,2023-02-28,intra-total,2272,105,98,54,32,29,13,10,3,26,403,3045,2675,2780,FALSE,0.912972085385879,2022,2022-2023
RI,2023-02-28,intra-ucfe,0,1,2,2,0,0,0,0,0,1,1,7,1,2,FALSE,0.285714285714286,2022,2022-2023
RI,2023-02-28,intra-ucx,1,0,0,0,0,0,0,1,0,0,4,6,5,5,FALSE,0.833333333333333,2022,2022-2023
RI,2023-02-28,intra-ui,2271,104,96,52,32,29,13,9,3,25,398,3032,2669,2773,FALSE,0.91457783641161,2022,2022-2023
RI,2023-03-31,inter-total,37,2,1,0,0,0,0,0,0,1,5,46,42,44,FALSE,0.956521739130435,2022,2022-2023
RI,2023-03-31,inter-ucfe,0,0,0,0,0,0,0,0,0,0,0,0,0,0,FALSE,0,2022,2022-2023
RI,2023-03-31,inter-ucx,0,0,0,0,0,0,0,0,0,0,0,0,0,0,FALSE,0,2022,2022-2023
RI,2023-03-31,inter-ui,37,2,1,0,0,0,0,0,0,1,5,46,42,44,FALSE,0.956521739130435,2022,2022-2023
RI,2023-03-31,intra-total,1250,70,41,29,25,23,13,10,6,15,301,1783,1551,1621,FALSE,0.909141895681436,2022,2022-2023
RI,2023-03-31,intra-ucfe,1,0,0,0,0,0,0,1,0,0,1,3,2,2,FALSE,0.666666666666667,2022,2022-2023
RI,2023-03-31,intra-ucx,3,1,0,0,0,0,0,0,0,0,1,5,4,5,FALSE,1,2022,2022-2023
RI,2023-03-31,intra-ui,1246,69,41,29,25,23,13,9,6,15,299,1775,1545,1614,FALSE,0.909295774647887,2022,2022-2023
RI,2023-04-30,inter-total,20,4,2,1,0,0,0,0,0,2,10,39,30,34,FALSE,0.871794871794872,2022,2022-2023
RI,2023-04-30,inter-ucfe,0,0,0,0,0,0,0,0,0,0,0,0,0,0,FALSE,0,2022,2022-2023
RI,2023-04-30,inter-ucx,0,0,0,0,0,0,0,0,0,0,0,0,0,0,FALSE,0,2022,2022-2023
RI,2023-04-30,inter-ui,20,4,2,1,0,0,0,0,0,2,10,39,30,34,FALSE,0.871794871794872,2022,2022-2023
RI,2023-04-30,intra-total,1112,55,36,30,23,13,10,5,2,22,269,1577,1381,1436,FALSE,0.910589727330374,2022,2022-2023
RI,2023-04-30,intra-ucfe,1,0,0,0,0,0,0,0,0,0,0,1,1,1,FALSE,1,2022,2022-2023
RI,2023-04-30,intra-ucx,2,0,0,0,0,0,0,0,0,0,1,3,3,3,FALSE,1,2022,2022-2023
RI,2023-04-30,intra-ui,1109,55,36,30,23,13,10,5,2,22,268,1573,1377,1432,FALSE,0.910362364907819,2022,2022-2023
RI,2023-05-31,inter-total,33,2,3,0,2,0,0,0,0,0,7,47,40,42,FALSE,0.893617021276596,2022,2022-2023
RI,2023-05-31,inter-ucfe,0,0,0,0,0,0,0,0,0,0,0,0,0,0,FALSE,0,2022,2022-2023
RI,2023-05-31,inter-ucx,0,0,0,0,0,0,0,0,0,0,0,0,0,0,FALSE,0,2022,2022-2023
RI,2023-05-31,inter-ui,33,2,3,0,2,0,0,0,0,0,7,47,40,42,FALSE,0.893617021276596,2022,2022-2023
RI,2023-05-31,intra-total,1086,66,39,24,18,12,10,4,3,20,249,1531,1335,1401,FALSE,0.915088177661659,2022,2022-2023
RI,2023-05-31,intra-ucfe,0,1,0,0,0,0,0,0,1,0,0,2,0,1,FALSE,0.5,2022,2022-2023
RI,2023-05-31,intra-ucx,1,1,0,0,0,0,0,0,0,1,2,5,3,4,FALSE,0.8,2022,2022-2023
RI,2023-05-31,intra-ui,1085,64,39,24,18,12,10,4,2,19,247,1524,1332,1396,FALSE,0.916010498687664,2022,2022-2023
RI,2023-06-30,inter-total,29,2,1,1,3,1,0,0,0,0,14,51,43,45,FALSE,0.882352941176471,2022,2022-2023
RI,2023-06-30,inter-ucfe,0,0,0,0,0,0,0,0,0,0,0,0,0,0,FALSE,0,2022,2022-2023
RI,2023-06-30,inter-ucx,0,0,0,0,0,0,0,0,0,0,0,0,0,0,FALSE,0,2022,2022-2023
RI,2023-06-30,inter-ui,29,2,1,1,3,1,0,0,0,0,14,51,43,45,FALSE,0.882352941176471,2022,2022-2023
RI,2023-06-30,intra-total,1093,91,49,24,18,15,5,11,8,17,296,1627,1389,1480,FALSE,0.909649661954517,2022,2022-2023
RI,2023-06-30,intra-ucfe,1,0,1,0,1,0,0,0,0,0,0,3,1,1,FALSE,0.333333333333333,2022,2022-2023
RI,2023-06-30,intra-ucx,1,0,0,0,0,0,1,0,0,0,0,2,1,1,FALSE,0.5,2022,2022-2023
RI,2023-06-30,intra-ui,1091,91,48,24,17,15,4,11,8,17,296,1622,1387,1478,FALSE,0.911220715166461,2022,2022-2023
RI,2023-07-31,inter-total,33,3,1,0,1,0,1,0,0,1,10,50,43,46,FALSE,0.92,2023,2023-2024
RI,2023-07-31,inter-ucfe,0,0,1,0,0,0,1,0,0,0,0,2,0,0,FALSE,0,2023,2023-2024
RI,2023-07-31,inter-ucx,0,0,0,0,0,0,0,0,0,0,0,0,0,0,FALSE,0,2023,2023-2024
RI,2023-07-31,inter-ui,33,3,0,0,1,0,0,0,0,1,10,48,43,46,FALSE,0.958333333333333,2023,2023-2024
RI,2023-07-31,intra-total,2683,50,33,23,26,16,9,9,6,15,451,3321,3134,3184,FALSE,0.95874736525143,2023,2023-2024
RI,2023-07-31,intra-ucfe,1,0,1,0,2,0,0,0,0,0,0,4,1,1,FALSE,0.25,2023,2023-2024
RI,2023-07-31,intra-ucx,0,0,1,3,2,0,0,0,0,0,0,6,0,0,FALSE,0,2023,2023-2024
RI,2023-07-31,intra-ui,2682,50,31,20,22,16,9,9,6,15,451,3311,3133,3183,FALSE,0.961340984596798,2023,2023-2024
RI,2023-08-31,inter-total,30,1,2,1,2,0,1,0,1,2,4,44,34,35,FALSE,0.795454545454545,2023,2023-2024
RI,2023-08-31,inter-ucfe,0,0,1,0,0,0,0,0,0,0,0,1,0,0,FALSE,0,2023,2023-2024
RI,2023-08-31,inter-ucx,1,0,0,0,0,0,0,0,0,0,0,1,1,1,FALSE,1,2023,2023-2024
RI,2023-08-31,inter-ui,29,1,1,1,2,0,1,0,1,2,4,42,33,34,FALSE,0.80952380952381,2023,2023-2024
RI,2023-08-31,intra-total,1323,80,49,36,22,19,9,4,3,25,332,1902,1655,1735,FALSE,0.912197686645636,2023,2023-2024
RI,2023-08-31,intra-ucfe,1,0,0,1,0,0,0,0,0,0,2,4,3,3,FALSE,0.75,2023,2023-2024
RI,2023-08-31,intra-ucx,1,0,0,0,0,0,0,0,0,0,1,2,2,2,FALSE,1,2023,2023-2024
RI,2023-08-31,intra-ui,1321,80,49,35,22,19,9,4,3,25,329,1896,1650,1730,FALSE,0.912447257383966,2023,2023-2024
RI,2023-09-30,inter-total,21,3,1,0,0,0,0,0,1,0,9,35,30,33,FALSE,0.942857142857143,2023,2023-2024
RI,2023-09-30,inter-ucfe,0,0,0,0,0,0,0,0,0,0,0,0,0,0,FALSE,0,2023,2023-2024
RI,2023-09-30,inter-ucx,0,0,0,0,0,0,0,0,1,0,0,1,0,0,FALSE,0,2023,2023-2024
RI,2023-09-30,inter-ui,21,3,1,0,0,0,0,0,0,0,9,34,30,33,FALSE,0.970588235294118,2023,2023-2024
RI,2023-09-30,intra-total,870,143,63,34,20,14,15,15,7,16,215,1412,1085,1228,FALSE,0.869688385269122,2023,2023-2024
RI,2023-09-30,intra-ucfe,1,0,1,0,0,0,0,0,0,0,0,2,1,1,FALSE,0.5,2023,2023-2024
RI,2023-09-30,intra-ucx,7,0,1,0,0,0,0,0,0,0,2,10,9,9,FALSE,0.9,2023,2023-2024
RI,2023-09-30,intra-ui,862,143,61,34,20,14,15,15,7,16,213,1400,1075,1218,FALSE,0.87,2023,2023-2024
RI,2023-10-31,inter-total,39,0,3,1,1,0,0,0,0,1,5,50,44,44,FALSE,0.88,2023,2023-2024
RI,2023-10-31,inter-ucfe,0,0,0,0,0,0,0,0,0,0,0,0,0,0,FALSE,0,2023,2023-2024
RI,2023-10-31,inter-ucx,0,0,0,0,0,0,0,0,0,0,0,0,0,0,FALSE,0,2023,2023-2024
RI,2023-10-31,inter-ui,39,0,3,1,1,0,0,0,0,1,5,50,44,44,FALSE,0.88,2023,2023-2024
RI,2023-10-31,intra-total,1102,93,65,44,38,14,16,5,8,31,253,1669,1355,1448,FALSE,0.867585380467346,2023,2023-2024
RI,2023-10-31,intra-ucfe,0,1,0,0,0,0,0,0,0,0,0,1,0,1,FALSE,1,2023,2023-2024
RI,2023-10-31,intra-ucx,1,0,0,0,0,0,0,0,0,0,1,2,2,2,FALSE,1,2023,2023-2024
RI,2023-10-31,intra-ui,1101,92,65,44,38,14,16,5,8,31,252,1666,1353,1445,FALSE,0.86734693877551,2023,2023-2024
RI,2023-11-30,inter-total,63,5,2,0,2,0,1,1,0,1,5,80,68,73,FALSE,0.9125,2023,2023-2024
RI,2023-11-30,inter-ucfe,0,0,0,0,0,0,0,0,0,0,0,0,0,0,FALSE,0,2023,2023-2024
RI,2023-11-30,inter-ucx,0,0,0,0,0,0,0,0,0,0,0,0,0,0,FALSE,0,2023,2023-2024
RI,2023-11-30,inter-ui,63,5,2,0,2,0,1,1,0,1,5,80,68,73,FALSE,0.9125,2023,2023-2024
RI,2023-11-30,intra-total,1307,58,45,38,28,12,13,3,9,12,329,1854,1636,1694,FALSE,0.913700107874865,2023,2023-2024
RI,2023-11-30,intra-ucfe,0,0,0,0,0,0,0,0,0,0,2,2,2,2,FALSE,1,2023,2023-2024
RI,2023-11-30,intra-ucx,2,0,1,4,0,0,0,0,0,0,0,7,2,2,FALSE,0.285714285714286,2023,2023-2024
RI,2023-11-30,intra-ui,1305,58,44,34,28,12,13,3,9,12,327,1845,1632,1690,FALSE,0.915989159891599,2023,2023-2024
RI,2023-12-31,inter-total,68,1,2,0,0,0,0,0,0,0,4,75,72,73,FALSE,0.973333333333333,2023,2023-2024
RI,2023-12-31,inter-ucfe,1,0,0,0,0,0,0,0,0,0,0,1,1,1,FALSE,1,2023,2023-2024
RI,2023-12-31,inter-ucx,0,0,0,0,0,0,0,0,0,0,0,0,0,0,FALSE,0,2023,2023-2024
RI,2023-12-31,inter-ui,67,1,2,0,0,0,0,0,0,0,4,74,71,72,FALSE,0.972972972972973,2023,2023-2024
RI,2023-12-31,intra-total,1954,50,32,15,18,17,9,6,6,18,264,2389,2218,2268,FALSE,0.949351192967769,2023,2023-2024
RI,2023-12-31,intra-ucfe,1,0,2,0,0,0,0,0,1,0,0,4,1,1,FALSE,0.25,2023,2023-2024
RI,2023-12-31,intra-ucx,4,2,0,0,1,0,0,0,0,0,0,7,4,6,FALSE,0.857142857142857,2023,2023-2024
RI,2023-12-31,intra-ui,1949,48,30,15,17,17,9,6,5,18,264,2378,2213,2261,FALSE,0.950798990748528,2023,2023-2024
RI,2024-01-31,inter-total,45,3,0,0,0,0,0,1,0,3,9,61,54,57,FALSE,0.934426229508197,2023,2023-2024
RI,2024-01-31,inter-ucfe,0,0,0,0,0,0,0,1,0,0,0,1,0,0,FALSE,0,2023,2023-2024
RI,2024-01-31,inter-ucx,0,0,0,0,0,0,0,0,0,0,0,0,0,0,FALSE,0,2023,2023-2024
RI,2024-01-31,inter-ui,45,3,0,0,0,0,0,0,0,3,9,60,54,57,FALSE,0.95,2023,2023-2024
RI,2024-01-31,intra-total,4483,87,38,16,13,10,8,4,5,17,468,5149,4951,5038,FALSE,0.978442416003107,2023,2023-2024
RI,2024-01-31,intra-ucfe,0,1,0,0,1,0,0,0,0,0,0,2,0,1,FALSE,0.5,2023,2023-2024
RI,2024-01-31,intra-ucx,0,2,1,0,0,0,0,0,0,0,4,7,4,6,FALSE,0.857142857142857,2023,2023-2024
RI,2024-01-31,intra-ui,4483,84,37,16,12,10,8,4,5,17,464,5140,4947,5031,FALSE,0.978793774319066,2023,2023-2024
RI,2024-02-29,inter-total,24,2,0,0,0,0,0,0,0,2,2,30,26,28,FALSE,0.933333333333333,2023,2023-2024
RI,2024-02-29,inter-ucfe,0,0,0,0,0,0,0,0,0,0,0,0,0,0,FALSE,0,2023,2023-2024
RI,2024-02-29,inter-ucx,0,0,0,0,0,0,0,0,0,0,0,0,0,0,FALSE,0,2023,2023-2024
RI,2024-02-29,inter-ui,24,2,0,0,0,0,0,0,0,2,2,30,26,28,FALSE,0.933333333333333,2023,2023-2024
RI,2024-02-29,intra-total,2502,118,57,31,17,21,10,5,4,23,382,3170,2884,3002,FALSE,0.947003154574132,2023,2023-2024
RI,2024-02-29,intra-ucfe,0,1,0,0,0,0,0,0,1,0,0,2,0,1,FALSE,0.5,2023,2023-2024
RI,2024-02-29,intra-ucx,1,3,0,0,0,0,0,0,0,0,0,4,1,4,FALSE,1,2023,2023-2024
RI,2024-02-29,intra-ui,2501,114,57,31,17,21,10,5,3,23,382,3164,2883,2997,FALSE,0.947218710493047,2023,2023-2024
RI,2024-03-31,inter-total,17,0,2,0,0,0,1,0,0,2,4,26,21,21,FALSE,0.807692307692308,2023,2023-2024
RI,2024-03-31,inter-ucfe,0,0,0,0,0,0,0,0,0,0,0,0,0,0,FALSE,0,2023,2023-2024
RI,2024-03-31,inter-ucx,0,0,0,0,0,0,0,0,0,0,0,0,0,0,FALSE,0,2023,2023-2024
RI,2024-03-31,inter-ui,17,0,2,0,0,0,1,0,0,2,4,26,21,21,FALSE,0.807692307692308,2023,2023-2024
RI,2024-03-31,intra-total,1362,71,28,21,21,27,8,10,11,20,327,1906,1689,1760,FALSE,0.923399790136411,2023,2023-2024
RI,2024-03-31,intra-ucfe,2,2,1,1,0,0,1,1,1,0,0,9,2,4,FALSE,0.444444444444444,2023,2023-2024
RI,2024-03-31,intra-ucx,1,1,0,0,0,0,0,0,0,0,1,3,2,3,FALSE,1,2023,2023-2024
RI,2024-03-31,intra-ui,1359,68,27,20,21,27,7,9,10,20,326,1894,1685,1753,FALSE,0.925554382259768,2023,2023-2024
RI,2024-04-30,inter-total,22,2,2,1,1,1,0,0,0,1,6,36,28,30,FALSE,0.833333333333333,2023,2023-2024
RI,2024-04-30,inter-ucfe,0,0,0,0,0,0,0,0,0,0,0,0,0,0,FALSE,0,2023,2023-2024
RI,2024-04-30,inter-ucx,0,0,0,0,0,0,0,0,0,0,0,0,0,0,FALSE,0,2023,2023-2024
RI,2024-04-30,inter-ui,22,2,2,1,1,1,0,0,0,1,6,36,28,30,FALSE,0.833333333333333,2023,2023-2024
RI,2024-04-30,intra-total,1474,59,20,9,12,22,12,9,2,16,286,1921,1760,1819,FALSE,0.946902654867257,2023,2023-2024
RI,2024-04-30,intra-ucfe,1,4,0,0,1,1,0,0,0,2,0,9,1,5,FALSE,0.555555555555556,2023,2023-2024
RI,2024-04-30,intra-ucx,0,0,1,0,0,0,0,0,0,1,8,10,8,8,FALSE,0.8,2023,2023-2024
RI,2024-04-30,intra-ui,1473,55,19,9,11,21,12,9,2,13,278,1902,1751,1806,FALSE,0.949526813880126,2023,2023-2024
RI,2024-05-31,inter-total,18,1,0,1,0,1,1,1,1,0,8,32,26,27,FALSE,0.84375,2023,2023-2024
RI,2024-05-31,inter-ucfe,0,0,0,0,0,0,0,0,0,0,0,0,0,0,FALSE,0,2023,2023-2024
RI,2024-05-31,inter-ucx,0,0,0,0,0,0,0,0,0,0,0,0,0,0,FALSE,0,2023,2023-2024
RI,2024-05-31,inter-ui,18,1,0,1,0,1,1,1,1,0,8,32,26,27,FALSE,0.84375,2023,2023-2024
RI,2024-05-31,intra-total,1086,52,29,18,21,20,13,6,4,24,226,1499,1312,1364,FALSE,0.909939959973316,2023,2023-2024
RI,2024-05-31,intra-ucfe,4,0,1,0,3,0,2,0,0,2,0,12,4,4,FALSE,0.333333333333333,2023,2023-2024
RI,2024-05-31,intra-ucx,3,0,0,1,0,0,2,0,0,0,0,6,3,3,FALSE,0.5,2023,2023-2024
RI,2024-05-31,intra-ui,1079,52,28,17,18,20,9,6,4,22,226,1481,1305,1357,FALSE,0.916272788656313,2023,2023-2024
RI,2024-06-30,inter-total,10,0,0,0,0,1,0,1,0,2,8,22,18,18,FALSE,0.818181818181818,2023,2023-2024
RI,2024-06-30,inter-ucfe,0,0,0,0,0,0,0,0,0,0,0,0,0,0,FALSE,0,2023,2023-2024
RI,2024-06-30,inter-ucx,0,0,0,0,0,0,0,0,0,0,0,0,0,0,FALSE,0,2023,2023-2024
RI,2024-06-30,inter-ui,10,0,0,0,0,1,0,1,0,2,8,22,18,18,FALSE,0.818181818181818,2023,2023-2024
RI,2024-06-30,intra-total,1329,54,19,19,12,12,9,8,13,7,282,1764,1611,1665,FALSE,0.943877551020408,2023,2023-2024
RI,2024-06-30,intra-ucfe,1,0,0,1,0,0,0,0,0,0,1,3,2,2,FALSE,0.666666666666667,2023,2023-2024
RI,2024-06-30,intra-ucx,3,0,0,0,0,0,0,0,0,0,0,3,3,3,FALSE,1,2023,2023-2024
RI,2024-06-30,intra-ui,1325,54,19,18,12,12,9,8,13,7,281,1758,1606,1660,FALSE,0.944254835039818,2023,2023-2024
RI,2024-07-31,inter-total,32,2,2,3,0,0,0,0,0,1,4,44,36,38,FALSE,0.863636363636364,2024,2024-2025
RI,2024-07-31,inter-ucfe,0,0,0,0,0,0,0,0,0,0,0,0,0,0,FALSE,0,2024,2024-2025
RI,2024-07-31,inter-ucx,0,0,0,0,0,0,0,0,0,0,0,0,0,0,FALSE,0,2024,2024-2025
RI,2024-07-31,inter-ui,32,2,2,3,0,0,0,0,0,1,4,44,36,38,FALSE,0.863636363636364,2024,2024-2025
RI,2024-07-31,intra-total,3000,114,47,31,22,12,16,13,10,28,544,3837,3544,3658,FALSE,0.953348970549909,2024,2024-2025
RI,2024-07-31,intra-ucfe,1,1,0,0,0,0,0,0,0,4,2,8,3,4,FALSE,0.5,2024,2024-2025
RI,2024-07-31,intra-ucx,5,0,0,0,0,0,0,0,0,0,0,5,5,5,FALSE,1,2024,2024-2025
RI,2024-07-31,intra-ui,2994,113,47,31,22,12,16,13,10,24,542,3824,3536,3649,FALSE,0.95423640167364,2024,2024-2025
RI,2024-08-31,inter-total,24,1,1,2,1,1,0,0,0,0,5,35,29,30,FALSE,0.857142857142857,2024,2024-2025
RI,2024-08-31,inter-ucfe,0,0,0,0,0,0,0,0,0,0,0,0,0,0,FALSE,0,2024,2024-2025
RI,2024-08-31,inter-ucx,0,0,0,0,0,0,0,0,0,0,0,0,0,0,FALSE,0,2024,2024-2025
RI,2024-08-31,inter-ui,24,1,1,2,1,1,0,0,0,0,5,35,29,30,FALSE,0.857142857142857,2024,2024-2025
RI,2024-08-31,intra-total,1215,114,76,31,35,29,21,16,15,26,326,1904,1541,1655,FALSE,0.86922268907563,2024,2024-2025
RI,2024-08-31,intra-ucfe,0,0,0,0,1,0,0,1,0,1,1,4,1,1,FALSE,0.25,2024,2024-2025
RI,2024-08-31,intra-ucx,2,0,0,0,0,0,0,0,0,0,1,3,3,3,FALSE,1,2024,2024-2025
RI,2024-08-31,intra-ui,1213,114,76,31,34,29,21,15,15,25,324,1897,1537,1651,FALSE,0.870321560358461,2024,2024-2025
RI,2024-09-30,inter-total,24,2,2,0,1,0,0,1,0,2,3,35,27,29,FALSE,0.828571428571429,2024,2024-2025
RI,2024-09-30,inter-ucfe,0,0,0,0,0,0,0,0,0,0,0,0,0,0,FALSE,0,2024,2024-2025
RI,2024-09-30,inter-ucx,0,0,0,0,0,0,0,0,0,0,1,1,1,1,FALSE,1,2024,2024-2025
RI,2024-09-30,inter-ui,24,2,2,0,1,0,0,1,0,2,2,34,26,28,FALSE,0.823529411764706,2024,2024-2025
RI,2024-09-30,intra-total,1141,71,31,17,29,21,15,14,10,48,280,1677,1421,1492,FALSE,0.889683959451401,2024,2024-2025
RI,2024-09-30,intra-ucfe,2,2,0,0,0,1,0,0,0,1,1,7,3,5,FALSE,0.714285714285714,2024,2024-2025
RI,2024-09-30,intra-ucx,0,0,0,0,0,0,0,0,0,0,0,0,0,0,FALSE,0,2024,2024-2025
RI,2024-09-30,intra-ui,1139,69,31,17,29,20,15,14,10,47,279,1670,1418,1487,FALSE,0.890419161676647,2024,2024-2025
RI,2024-10-31,inter-total,41,3,1,0,1,0,0,0,0,0,7,53,48,51,FALSE,0.962264150943396,2024,2024-2025
RI,2024-10-31,inter-ucfe,0,0,0,0,0,0,0,0,0,0,0,0,0,0,FALSE,0,2024,2024-2025
RI,2024-10-31,inter-ucx,0,0,0,0,0,0,0,0,0,0,0,0,0,0,FALSE,0,2024,2024-2025
RI,2024-10-31,inter-ui,41,3,1,0,1,0,0,0,0,0,7,53,48,51,FALSE,0.962264150943396,2024,2024-2025
RI,2024-10-31,intra-total,1090,42,32,17,18,11,10,15,10,44,302,1591,1392,1434,FALSE,0.901319924575738,2024,2024-2025
RI,2024-10-31,intra-ucfe,0,1,0,0,0,0,0,0,0,0,1,2,1,2,FALSE,1,2024,2024-2025
RI,2024-10-31,intra-ucx,2,0,0,0,0,0,0,0,0,0,1,3,3,3,FALSE,1,2024,2024-2025
RI,2024-10-31,intra-ui,1088,41,32,17,18,11,10,15,10,44,300,1586,1388,1429,FALSE,0.901008827238335,2024,2024-2025
RI,2024-11-30,inter-total,64,1,3,2,2,0,0,1,0,2,9,84,73,74,FALSE,0.880952380952381,2024,2024-2025
RI,2024-11-30,inter-ucfe,0,1,0,0,0,0,0,0,0,0,0,1,0,1,FALSE,1,2024,2024-2025
RI,2024-11-30,inter-ucx,0,0,0,0,0,0,0,0,0,0,0,0,0,0,FALSE,0,2024,2024-2025
RI,2024-11-30,inter-ui,64,0,3,2,2,0,0,1,0,2,9,83,73,73,FALSE,0.879518072289157,2024,2024-2025
RI,2024-11-30,intra-total,1216,71,46,21,20,11,5,12,17,47,281,1747,1497,1568,FALSE,0.897538637664568,2024,2024-2025
RI,2024-11-30,intra-ucfe,3,0,0,1,2,0,0,0,0,1,1,8,4,4,FALSE,0.5,2024,2024-2025
RI,2024-11-30,intra-ucx,2,0,1,0,0,1,0,0,0,0,1,5,3,3,FALSE,0.6,2024,2024-2025
RI,2024-11-30,intra-ui,1211,71,45,20,18,10,5,12,17,46,279,1734,1490,1561,FALSE,0.900230680507497,2024,2024-2025
RI,2024-12-31,inter-total,86,4,1,1,0,0,0,1,0,4,8,105,94,98,FALSE,0.933333333333333,2024,2024-2025
RI,2024-12-31,inter-ucfe,0,0,0,0,0,0,0,0,0,0,0,0,0,0,FALSE,0,2024,2024-2025
RI,2024-12-31,inter-ucx,0,0,0,0,0,0,0,0,0,0,0,0,0,0,FALSE,0,2024,2024-2025
RI,2024-12-31,inter-ui,86,4,1,1,0,0,0,1,0,4,8,105,94,98,FALSE,0.933333333333333,2024,2024-2025
RI,2024-12-31,intra-total,2813,57,52,26,21,14,10,11,14,44,377,3439,3190,3247,FALSE,0.944169816807211,2024,2024-2025
RI,2024-12-31,intra-ucfe,0,1,0,0,0,0,0,0,0,1,1,3,1,2,FALSE,0.666666666666667,2024,2024-2025
RI,2024-12-31,intra-ucx,5,0,0,0,0,0,0,0,0,0,0,5,5,5,FALSE,1,2024,2024-2025
RI,2024-12-31,intra-ui,2808,56,52,26,21,14,10,11,14,43,376,3431,3184,3240,FALSE,0.944331098805013,2024,2024-2025
SC,2019-01-31,inter-total,145,9,10,4,4,5,1,1,0,3,53,235,198,207,FALSE,0.880851063829787,2018,2018-2019
SC,2019-01-31,inter-ucfe,2,0,0,0,0,0,0,0,0,1,1,4,3,3,FALSE,0.75,2018,2018-2019
SC,2019-01-31,inter-ucx,0,0,0,0,0,0,0,0,0,0,0,0,0,0,FALSE,0,2018,2018-2019
SC,2019-01-31,inter-ui,143,9,10,4,4,5,1,1,0,2,52,231,195,204,FALSE,0.883116883116883,2018,2018-2019
SC,2019-01-31,intra-total,3890,392,165,66,39,33,16,12,16,42,1572,6243,5462,5854,FALSE,0.937690213038603,2018,2018-2019
SC,2019-01-31,intra-ucfe,27,4,0,0,0,1,0,0,0,1,4,37,31,35,FALSE,0.945945945945946,2018,2018-2019
SC,2019-01-31,intra-ucx,5,0,0,2,0,0,0,0,0,0,2,9,7,7,FALSE,0.777777777777778,2018,2018-2019
SC,2019-01-31,intra-ui,3858,388,165,64,39,32,16,12,16,41,1566,6197,5424,5812,FALSE,0.937873164434404,2018,2018-2019
SC,2019-02-28,inter-total,122,11,6,2,1,0,0,1,0,3,26,172,148,159,FALSE,0.924418604651163,2018,2018-2019
SC,2019-02-28,inter-ucfe,1,0,0,0,1,0,0,0,0,0,0,2,1,1,FALSE,0.5,2018,2018-2019
SC,2019-02-28,inter-ucx,0,0,0,0,0,0,0,0,0,0,0,0,0,0,FALSE,0,2018,2018-2019
SC,2019-02-28,inter-ui,121,11,6,2,0,0,0,1,0,3,26,170,147,158,FALSE,0.929411764705882,2018,2018-2019
SC,2019-02-28,intra-total,2247,128,71,70,46,31,16,8,3,25,441,3086,2688,2816,FALSE,0.91250810110175,2018,2018-2019
SC,2019-02-28,intra-ucfe,3,1,4,0,0,0,1,1,1,1,2,14,5,6,FALSE,0.428571428571429,2018,2018-2019
SC,2019-02-28,intra-ucx,12,1,0,0,0,1,0,0,0,0,1,15,13,14,FALSE,0.933333333333333,2018,2018-2019
SC,2019-02-28,intra-ui,2232,126,67,70,46,30,15,7,2,24,438,3057,2670,2796,FALSE,0.914622178606477,2018,2018-2019
SC,2019-03-31,inter-total,69,5,4,2,0,2,4,0,1,3,20,110,89,94,FALSE,0.854545454545455,2018,2018-2019
SC,2019-03-31,inter-ucfe,0,0,0,0,0,0,0,0,0,0,0,0,0,0,FALSE,0,2018,2018-2019
SC,2019-03-31,inter-ucx,0,0,0,0,0,0,0,0,0,0,0,0,0,0,FALSE,0,2018,2018-2019
SC,2019-03-31,inter-ui,69,5,4,2,0,2,4,0,1,3,20,110,89,94,FALSE,0.854545454545455,2018,2018-2019
SC,2019-03-31,intra-total,1966,96,56,43,37,36,13,9,9,32,324,2621,2290,2386,FALSE,0.910339565051507,2018,2018-2019
SC,2019-03-31,intra-ucfe,1,0,0,0,0,0,0,2,0,1,0,4,1,1,FALSE,0.25,2018,2018-2019
SC,2019-03-31,intra-ucx,10,0,0,0,0,0,0,0,0,0,1,11,11,11,FALSE,1,2018,2018-2019
SC,2019-03-31,intra-ui,1955,96,56,43,37,36,13,7,9,31,323,2606,2278,2374,FALSE,0.910974673829624,2018,2018-2019
SC,2019-04-30,inter-total,86,6,0,1,1,0,1,1,1,3,17,117,103,109,FALSE,0.931623931623932,2018,2018-2019
SC,2019-04-30,inter-ucfe,0,0,0,0,0,0,1,0,0,1,0,2,0,0,FALSE,0,2018,2018-2019
SC,2019-04-30,inter-ucx,0,0,0,0,0,0,0,0,0,0,0,0,0,0,FALSE,0,2018,2018-2019
SC,2019-04-30,inter-ui,86,6,0,1,1,0,0,1,1,2,17,115,103,109,FALSE,0.947826086956522,2018,2018-2019
SC,2019-04-30,intra-total,1987,68,47,38,21,13,6,4,4,18,331,2537,2318,2386,FALSE,0.940480882932598,2018,2018-2019
SC,2019-04-30,intra-ucfe,1,0,0,1,0,0,0,0,0,0,1,3,2,2,FALSE,0.666666666666667,2018,2018-2019
SC,2019-04-30,intra-ucx,8,0,0,0,0,0,0,0,0,0,2,10,10,10,FALSE,1,2018,2018-2019
SC,2019-04-30,intra-ui,1978,68,47,37,21,13,6,4,4,18,328,2524,2306,2374,FALSE,0.940570522979398,2018,2018-2019
SC,2019-05-31,inter-total,93,3,2,3,1,1,1,0,0,0,20,124,113,116,FALSE,0.935483870967742,2018,2018-2019
SC,2019-05-31,inter-ucfe,0,0,0,0,0,0,0,0,0,0,0,0,0,0,FALSE,0,2018,2018-2019
SC,2019-05-31,inter-ucx,0,0,0,0,0,0,0,0,0,0,0,0,0,0,FALSE,0,2018,2018-2019
SC,2019-05-31,inter-ui,93,3,2,3,1,1,1,0,0,0,20,124,113,116,FALSE,0.935483870967742,2018,2018-2019
SC,2019-05-31,intra-total,2012,95,48,51,22,11,5,2,2,13,380,2641,2392,2487,FALSE,0.94168875425975,2018,2018-2019
SC,2019-05-31,intra-ucfe,0,1,2,0,0,1,0,0,0,0,1,5,1,2,FALSE,0.4,2018,2018-2019
SC,2019-05-31,intra-ucx,4,0,0,0,1,0,0,0,0,2,1,8,5,5,FALSE,0.625,2018,2018-2019
SC,2019-05-31,intra-ui,2008,94,46,51,21,10,5,2,2,11,378,2628,2386,2480,FALSE,0.943683409436834,2018,2018-2019
SC,2019-06-30,inter-total,94,7,7,2,2,1,1,0,0,2,15,131,109,116,FALSE,0.885496183206107,2018,2018-2019
SC,2019-06-30,inter-ucfe,0,0,0,1,0,0,0,0,0,0,1,2,1,1,FALSE,0.5,2018,2018-2019
SC,2019-06-30,inter-ucx,0,0,0,0,0,0,0,0,0,0,0,0,0,0,FALSE,0,2018,2018-2019
SC,2019-06-30,inter-ui,94,7,7,1,2,1,1,0,0,2,14,129,108,115,FALSE,0.891472868217054,2018,2018-2019
SC,2019-06-30,intra-total,3036,64,37,24,21,7,3,5,1,11,392,3601,3428,3492,FALSE,0.96973063038045,2018,2018-2019
SC,2019-06-30,intra-ucfe,3,1,1,0,0,1,0,0,0,1,1,8,4,5,FALSE,0.625,2018,2018-2019
SC,2019-06-30,intra-ucx,6,0,0,0,0,0,0,0,0,0,0,6,6,6,FALSE,1,2018,2018-2019
SC,2019-06-30,intra-ui,3027,63,36,24,21,6,3,5,1,10,391,3587,3418,3481,FALSE,0.970448843044327,2018,2018-2019
SC,2019-07-31,inter-total,93,10,3,2,2,0,0,0,1,1,19,131,112,122,FALSE,0.931297709923664,2019,2019-2020
SC,2019-07-31,inter-ucfe,0,1,0,0,0,0,0,0,0,0,0,1,0,1,FALSE,1,2019,2019-2020
SC,2019-07-31,inter-ucx,1,0,0,0,0,0,0,0,0,0,0,1,1,1,FALSE,1,2019,2019-2020
SC,2019-07-31,inter-ui,92,9,3,2,2,0,0,0,1,1,19,129,111,120,FALSE,0.930232558139535,2019,2019-2020
SC,2019-07-31,intra-total,2671,122,58,30,25,16,8,4,4,15,429,3382,3100,3222,FALSE,0.952690715552927,2019,2019-2020
SC,2019-07-31,intra-ucfe,2,2,3,0,0,0,0,0,0,0,0,7,2,4,FALSE,0.571428571428571,2019,2019-2020
SC,2019-07-31,intra-ucx,5,0,0,0,1,0,0,0,2,0,3,11,8,8,FALSE,0.727272727272727,2019,2019-2020
SC,2019-07-31,intra-ui,2664,120,55,30,24,16,8,4,2,15,426,3364,3090,3210,FALSE,0.954221165279429,2019,2019-2020
SC,2019-08-31,inter-total,99,9,3,3,3,0,1,0,0,0,19,137,118,127,FALSE,0.927007299270073,2019,2019-2020
SC,2019-08-31,inter-ucfe,0,0,0,0,1,0,0,0,0,0,0,1,0,0,FALSE,0,2019,2019-2020
SC,2019-08-31,inter-ucx,0,0,0,0,0,0,0,0,0,0,0,0,0,0,FALSE,0,2019,2019-2020
SC,2019-08-31,inter-ui,99,9,3,3,2,0,1,0,0,0,19,136,118,127,FALSE,0.933823529411765,2019,2019-2020
SC,2019-08-31,intra-total,2096,92,45,43,28,15,6,1,6,14,373,2719,2469,2561,FALSE,0.941890400882678,2019,2019-2020
SC,2019-08-31,intra-ucfe,4,0,0,0,0,1,0,0,0,0,0,5,4,4,FALSE,0.8,2019,2019-2020
SC,2019-08-31,intra-ucx,11,0,0,0,1,0,0,0,0,0,0,12,11,11,FALSE,0.916666666666667,2019,2019-2020
SC,2019-08-31,intra-ui,2081,92,45,43,27,14,6,1,6,14,373,2702,2454,2546,FALSE,0.942264988897113,2019,2019-2020
SC,2019-09-30,inter-total,52,6,3,4,2,1,2,0,0,0,14,84,66,72,FALSE,0.857142857142857,2019,2019-2020
SC,2019-09-30,inter-ucfe,0,0,1,0,0,0,1,0,0,0,0,2,0,0,FALSE,0,2019,2019-2020
SC,2019-09-30,inter-ucx,0,0,0,0,0,0,0,0,0,0,0,0,0,0,FALSE,0,2019,2019-2020
SC,2019-09-30,inter-ui,52,6,2,4,2,1,1,0,0,0,14,82,66,72,FALSE,0.878048780487805,2019,2019-2020
SC,2019-09-30,intra-total,2042,89,38,40,20,12,5,1,5,9,370,2631,2412,2501,FALSE,0.950589129608514,2019,2019-2020
SC,2019-09-30,intra-ucfe,0,0,0,0,0,1,0,0,0,1,0,2,0,0,FALSE,0,2019,2019-2020
SC,2019-09-30,intra-ucx,10,1,1,0,0,0,0,0,0,0,2,14,12,13,FALSE,0.928571428571429,2019,2019-2020
SC,2019-09-30,intra-ui,2032,88,37,40,20,11,5,1,5,8,368,2615,2400,2488,FALSE,0.951434034416826,2019,2019-2020
SC,2019-10-31,inter-total,78,2,3,1,1,0,0,0,0,0,9,94,87,89,FALSE,0.946808510638298,2019,2019-2020
SC,2019-10-31,inter-ucfe,0,0,0,0,1,0,0,0,0,0,0,1,0,0,FALSE,0,2019,2019-2020
SC,2019-10-31,inter-ucx,0,0,0,0,0,0,0,0,0,0,0,0,0,0,FALSE,0,2019,2019-2020
SC,2019-10-31,inter-ui,78,2,3,1,0,0,0,0,0,0,9,93,87,89,FALSE,0.956989247311828,2019,2019-2020
SC,2019-10-31,intra-total,2355,104,52,27,20,6,7,2,5,10,436,3024,2791,2895,FALSE,0.95734126984127,2019,2019-2020
SC,2019-10-31,intra-ucfe,1,2,0,0,0,1,1,0,0,1,1,7,2,4,FALSE,0.571428571428571,2019,2019-2020
SC,2019-10-31,intra-ucx,8,3,0,0,1,0,1,0,0,0,4,17,12,15,FALSE,0.882352941176471,2019,2019-2020
SC,2019-10-31,intra-ui,2346,99,52,27,19,5,5,2,5,9,431,3000,2777,2876,FALSE,0.958666666666667,2019,2019-2020
SC,2019-11-30,inter-total,59,2,2,2,1,0,0,1,0,1,10,78,69,71,FALSE,0.91025641025641,2019,2019-2020
SC,2019-11-30,inter-ucfe,0,0,0,2,0,0,0,0,0,0,0,2,0,0,FALSE,0,2019,2019-2020
SC,2019-11-30,inter-ucx,0,0,0,0,0,0,0,0,0,1,1,2,1,1,FALSE,0.5,2019,2019-2020
SC,2019-11-30,inter-ui,59,2,2,0,1,0,0,1,0,0,9,74,68,70,FALSE,0.945945945945946,2019,2019-2020
SC,2019-11-30,intra-total,1967,97,46,24,22,10,2,2,4,9,446,2629,2413,2510,FALSE,0.95473564092811,2019,2019-2020
SC,2019-11-30,intra-ucfe,1,0,1,0,0,0,0,0,0,1,0,3,1,1,FALSE,0.333333333333333,2019,2019-2020
SC,2019-11-30,intra-ucx,7,1,0,0,0,1,0,0,0,1,0,10,7,8,FALSE,0.8,2019,2019-2020
SC,2019-11-30,intra-ui,1959,96,45,24,22,9,2,2,4,7,446,2616,2405,2501,FALSE,0.956039755351682,2019,2019-2020
SC,2019-12-31,inter-total,92,11,2,3,0,1,1,1,1,2,28,142,120,131,FALSE,0.922535211267606,2019,2019-2020
SC,2019-12-31,inter-ucfe,0,0,0,1,0,0,0,0,1,0,0,2,0,0,FALSE,0,2019,2019-2020
SC,2019-12-31,inter-ucx,0,0,0,0,0,0,0,0,0,0,0,0,0,0,FALSE,0,2019,2019-2020
SC,2019-12-31,inter-ui,92,11,2,2,0,1,1,1,0,2,28,140,120,131,FALSE,0.935714285714286,2019,2019-2020
SC,2019-12-31,intra-total,2785,254,74,54,23,12,3,6,4,6,714,3935,3499,3753,FALSE,0.953748411689962,2019,2019-2020
SC,2019-12-31,intra-ucfe,0,1,0,0,0,1,1,0,0,2,0,5,0,1,FALSE,0.2,2019,2019-2020
SC,2019-12-31,intra-ucx,12,1,1,0,0,1,0,0,0,0,1,16,13,14,FALSE,0.875,2019,2019-2020
SC,2019-12-31,intra-ui,2773,252,73,54,23,10,2,6,4,4,713,3914,3486,3738,FALSE,0.955033214103219,2019,2019-2020
SC,2020-01-31,inter-total,104,8,6,8,1,0,0,0,2,2,41,172,145,153,FALSE,0.88953488372093,2019,2019-2020
SC,2020-01-31,inter-ucfe,0,0,0,0,0,0,0,0,0,0,0,0,0,0,FALSE,0,2019,2019-2020
SC,2020-01-31,inter-ucx,0,0,0,0,0,0,0,0,0,0,0,0,0,0,FALSE,0,2019,2019-2020
SC,2020-01-31,inter-ui,104,8,6,8,1,0,0,0,2,2,41,172,145,153,FALSE,0.88953488372093,2019,2019-2020
SC,2020-01-31,intra-total,4203,344,130,82,45,32,10,8,2,26,1916,6798,6119,6463,FALSE,0.950720800235363,2019,2019-2020
SC,2020-01-31,intra-ucfe,1,1,1,0,0,0,0,0,0,3,2,8,3,4,FALSE,0.5,2019,2019-2020
SC,2020-01-31,intra-ucx,4,2,2,1,1,0,0,0,0,1,0,11,4,6,FALSE,0.545454545454545,2019,2019-2020
SC,2020-01-31,intra-ui,4198,341,127,81,44,32,10,8,2,22,1914,6779,6112,6453,FALSE,0.951910311255347,2019,2019-2020
SC,2020-02-29,inter-total,63,7,5,4,1,0,2,2,0,0,19,103,82,89,FALSE,0.864077669902913,2019,2019-2020
SC,2020-02-29,inter-ucfe,0,0,0,0,0,0,0,1,0,0,0,1,0,0,FALSE,0,2019,2019-2020
SC,2020-02-29,inter-ucx,0,0,0,0,0,0,0,0,0,0,0,0,0,0,FALSE,0,2019,2019-2020
SC,2020-02-29,inter-ui,63,7,5,4,1,0,2,1,0,0,19,102,82,89,FALSE,0.872549019607843,2019,2019-2020
SC,2020-02-29,intra-total,2193,131,64,44,36,19,11,8,3,10,448,2967,2641,2772,FALSE,0.93427704752275,2019,2019-2020
SC,2020-02-29,intra-ucfe,2,1,0,0,0,0,0,0,0,1,0,4,2,3,FALSE,0.75,2019,2019-2020
SC,2020-02-29,intra-ucx,9,0,0,0,0,0,0,0,0,0,2,11,11,11,FALSE,1,2019,2019-2020
SC,2020-02-29,intra-ui,2182,130,64,44,36,19,11,8,3,9,446,2952,2628,2758,FALSE,0.934281842818428,2019,2019-2020
SC,2020-03-31,inter-total,90,5,1,2,2,0,0,0,2,1,16,119,106,111,FALSE,0.932773109243698,2019,2019-2020
SC,2020-03-31,inter-ucfe,0,0,0,0,0,0,0,0,0,0,0,0,0,0,FALSE,0,2019,2019-2020
SC,2020-03-31,inter-ucx,0,0,0,0,0,0,0,0,0,0,0,0,0,0,FALSE,0,2019,2019-2020
SC,2020-03-31,inter-ui,90,5,1,2,2,0,0,0,2,1,16,119,106,111,FALSE,0.932773109243698,2019,2019-2020
SC,2020-03-31,intra-total,3136,67,31,35,37,19,4,9,4,14,358,3714,3494,3561,FALSE,0.958804523424879,2019,2019-2020
SC,2020-03-31,intra-ucfe,0,2,2,0,0,0,0,0,0,0,1,5,1,3,FALSE,0.6,2019,2019-2020
SC,2020-03-31,intra-ucx,3,1,0,0,1,1,0,0,0,0,0,6,3,4,FALSE,0.666666666666667,2019,2019-2020
SC,2020-03-31,intra-ui,3133,64,29,35,36,18,4,9,4,14,357,3703,3490,3554,FALSE,0.959762354847421,2019,2019-2020
SC,2020-04-30,inter-total,1798,391,67,12,1,1,0,0,0,0,1562,3832,3360,3751,FALSE,0.978862212943632,2019,2019-2020
SC,2020-04-30,inter-ucfe,1,0,0,0,0,0,0,0,0,0,1,2,2,2,FALSE,1,2019,2019-2020
SC,2020-04-30,inter-ucx,0,0,0,0,0,0,0,0,0,0,0,0,0,0,FALSE,0,2019,2019-2020
SC,2020-04-30,inter-ui,1797,391,67,12,1,1,0,0,0,0,1561,3830,3358,3749,FALSE,0.978851174934726,2019,2019-2020
SC,2020-04-30,intra-total,88911,22733,4268,746,126,9,3,9,1,25,74037,190868,162948,185681,FALSE,0.972824150721965,2019,2019-2020
SC,2020-04-30,intra-ucfe,1,4,0,0,0,2,0,1,0,1,1,10,2,6,FALSE,0.6,2019,2019-2020
SC,2020-04-30,intra-ucx,19,2,2,0,0,0,0,0,0,1,8,32,27,29,FALSE,0.90625,2019,2019-2020
SC,2020-04-30,intra-ui,88891,22727,4266,746,126,7,3,8,1,23,74028,190826,162919,185646,FALSE,0.972854852064184,2019,2019-2020
SC,2020-05-31,inter-total,705,70,95,54,46,30,9,2,1,0,498,1510,1203,1273,FALSE,0.843046357615894,2019,2019-2020
SC,2020-05-31,inter-ucfe,0,0,0,0,0,0,0,0,0,0,0,0,0,0,FALSE,0,2019,2019-2020
SC,2020-05-31,inter-ucx,0,0,0,0,0,0,0,0,0,0,0,0,0,0,FALSE,0,2019,2019-2020
SC,2020-05-31,inter-ui,705,70,95,54,46,30,9,2,1,0,498,1510,1203,1273,FALSE,0.843046357615894,2019,2019-2020
SC,2020-05-31,intra-total,29430,3315,3322,2313,1639,1102,642,213,59,32,17992,60059,47422,50737,FALSE,0.844785960472202,2019,2019-2020
SC,2020-05-31,intra-ucfe,1,0,3,1,3,1,0,0,0,0,0,9,1,1,FALSE,0.111111111111111,2019,2019-2020
SC,2020-05-31,intra-ucx,13,1,1,1,2,0,1,0,1,0,3,23,16,17,FALSE,0.739130434782609,2019,2019-2020
SC,2020-05-31,intra-ui,29416,3314,3318,2311,1634,1101,641,213,58,32,17989,60027,47405,50719,FALSE,0.844936445266297,2019,2019-2020
SC,2020-06-30,inter-total,238,62,47,13,25,19,34,33,15,19,222,727,460,522,FALSE,0.718019257221458,2019,2019-2020
SC,2020-06-30,inter-ucfe,0,0,0,0,0,0,0,0,0,1,0,1,0,0,FALSE,0,2019,2019-2020
SC,2020-06-30,inter-ucx,0,0,0,0,0,0,0,0,0,0,0,0,0,0,FALSE,0,2019,2019-2020
SC,2020-06-30,inter-ui,238,62,47,13,25,19,34,33,15,18,222,726,460,522,FALSE,0.71900826446281,2019,2019-2020
SC,2020-06-30,intra-total,9199,1962,2071,1070,787,864,942,814,665,625,7411,26410,16610,18572,FALSE,0.7032184778493,2019,2019-2020
SC,2020-06-30,intra-ucfe,0,0,0,2,0,0,2,2,1,1,1,9,1,1,FALSE,0.111111111111111,2019,2019-2020
SC,2020-06-30,intra-ucx,6,3,2,2,2,1,5,1,1,1,1,25,7,10,FALSE,0.4,2019,2019-2020
SC,2020-06-30,intra-ui,9193,1959,2069,1066,785,863,935,811,663,623,7409,26376,16602,18561,FALSE,0.703707916287534,2019,2019-2020
SC,2020-07-31,inter-total,238,62,47,13,25,19,34,33,15,19,222,727,460,522,FALSE,0.718019257221458,2020,2020-2021
SC,2020-07-31,inter-ucfe,0,0,0,0,0,0,0,0,0,1,0,1,0,0,FALSE,0,2020,2020-2021
SC,2020-07-31,inter-ucx,0,0,0,0,0,0,0,0,0,0,0,0,0,0,FALSE,0,2020,2020-2021
SC,2020-07-31,inter-ui,238,62,47,13,25,19,34,33,15,18,222,726,460,522,FALSE,0.71900826446281,2020,2020-2021
SC,2020-07-31,intra-total,9199,1962,2071,1070,787,864,942,814,665,625,7411,26410,16610,18572,FALSE,0.7032184778493,2020,2020-2021
SC,2020-07-31,intra-ucfe,0,0,0,2,0,0,2,2,1,1,1,9,1,1,FALSE,0.111111111111111,2020,2020-2021
SC,2020-07-31,intra-ucx,6,3,2,2,2,1,5,1,1,1,1,25,7,10,FALSE,0.4,2020,2020-2021
SC,2020-07-31,intra-ui,9193,1959,2069,1066,785,863,935,811,663,623,7409,26376,16602,18561,FALSE,0.703707916287534,2020,2020-2021
SC,2020-08-31,inter-total,35,21,41,30,9,10,8,12,2,50,35,253,70,91,FALSE,0.359683794466403,2020,2020-2021
SC,2020-08-31,inter-ucfe,0,0,0,0,0,0,0,0,0,1,0,1,0,0,FALSE,0,2020,2020-2021
SC,2020-08-31,inter-ucx,0,0,0,0,0,0,0,0,0,0,0,0,0,0,FALSE,0,2020,2020-2021
SC,2020-08-31,inter-ui,35,21,41,30,9,10,8,12,2,49,35,252,70,91,FALSE,0.361111111111111,2020,2020-2021
SC,2020-08-31,intra-total,1744,1099,1670,972,513,428,376,325,278,1548,1445,10398,3189,4288,FALSE,0.412386997499519,2020,2020-2021
SC,2020-08-31,intra-ucfe,0,1,2,1,0,0,3,0,2,7,0,16,0,1,FALSE,0.0625,2020,2020-2021
SC,2020-08-31,intra-ucx,11,3,0,0,2,1,1,0,1,9,1,29,12,15,FALSE,0.517241379310345,2020,2020-2021
SC,2020-08-31,intra-ui,1733,1095,1668,971,511,427,372,325,275,1532,1444,10353,3177,4272,FALSE,0.412634019124891,2020,2020-2021
SC,2020-09-30,inter-total,16,30,24,10,9,14,10,7,3,29,38,190,54,84,FALSE,0.442105263157895,2020,2020-2021
SC,2020-09-30,inter-ucfe,0,0,0,0,0,0,2,0,0,0,0,2,0,0,FALSE,0,2020,2020-2021
SC,2020-09-30,inter-ucx,0,0,0,0,0,0,0,0,0,0,0,0,0,0,FALSE,0,2020,2020-2021
SC,2020-09-30,inter-ui,16,30,24,10,9,14,8,7,3,29,38,188,54,84,FALSE,0.446808510638298,2020,2020-2021
SC,2020-09-30,intra-total,961,585,805,405,391,412,371,396,196,1136,1129,6787,2090,2675,FALSE,0.3941358479446,2020,2020-2021
SC,2020-09-30,intra-ucfe,0,0,0,0,0,0,0,0,0,9,0,9,0,0,FALSE,0,2020,2020-2021
SC,2020-09-30,intra-ucx,9,1,1,0,1,0,1,1,0,12,5,31,14,15,FALSE,0.483870967741936,2020,2020-2021
SC,2020-09-30,intra-ui,952,584,804,405,390,412,370,395,196,1115,1124,6747,2076,2660,FALSE,0.3942492959834,2020,2020-2021
SC,2020-10-31,inter-total,21,15,14,10,10,5,3,3,5,40,37,163,58,73,FALSE,0.447852760736196,2020,2020-2021
SC,2020-10-31,inter-ucfe,0,0,0,0,0,0,0,0,0,0,0,0,0,0,FALSE,0,2020,2020-2021
SC,2020-10-31,inter-ucx,0,0,0,0,0,0,0,0,0,1,0,1,0,0,FALSE,0,2020,2020-2021
SC,2020-10-31,inter-ui,21,15,14,10,10,5,3,3,5,39,37,162,58,73,FALSE,0.450617283950617,2020,2020-2021
SC,2020-10-31,intra-total,579,469,401,245,265,219,196,137,117,901,804,4333,1383,1852,FALSE,0.427417493653358,2020,2020-2021
SC,2020-10-31,intra-ucfe,0,0,0,0,0,0,0,0,0,5,0,5,0,0,FALSE,0,2020,2020-2021
SC,2020-10-31,intra-ucx,9,2,2,2,2,2,0,1,1,24,3,48,12,14,FALSE,0.291666666666667,2020,2020-2021
SC,2020-10-31,intra-ui,570,467,399,243,263,217,196,136,116,872,801,4280,1371,1838,FALSE,0.429439252336449,2020,2020-2021
SC,2020-11-30,inter-total,20,18,15,11,3,6,2,4,4,69,35,187,55,73,FALSE,0.390374331550802,2020,2020-2021
SC,2020-11-30,inter-ucfe,0,0,0,0,0,0,0,0,0,0,0,0,0,0,FALSE,0,2020,2020-2021
SC,2020-11-30,inter-ucx,0,0,0,0,0,0,0,0,0,0,0,0,0,0,FALSE,0,2020,2020-2021
SC,2020-11-30,inter-ui,20,18,15,11,3,6,2,4,4,69,35,187,55,73,FALSE,0.390374331550802,2020,2020-2021
SC,2020-11-30,intra-total,770,356,359,228,251,251,198,132,131,1291,732,4699,1502,1858,FALSE,0.395403277293041,2020,2020-2021
SC,2020-11-30,intra-ucfe,0,0,1,1,0,1,0,2,0,7,0,12,0,0,FALSE,0,2020,2020-2021
SC,2020-11-30,intra-ucx,1,5,1,3,0,1,1,1,0,8,3,24,4,9,FALSE,0.375,2020,2020-2021
SC,2020-11-30,intra-ui,769,351,357,224,251,249,197,129,131,1276,729,4663,1498,1849,FALSE,0.39652584173279,2020,2020-2021
SC,2020-12-31,inter-total,35,18,19,16,7,7,6,1,4,35,39,187,74,92,FALSE,0.491978609625669,2020,2020-2021
SC,2020-12-31,inter-ucfe,0,0,0,0,0,0,0,0,0,1,0,1,0,0,FALSE,0,2020,2020-2021
SC,2020-12-31,inter-ucx,0,1,0,0,0,0,0,0,0,1,0,2,0,1,FALSE,0.5,2020,2020-2021
SC,2020-12-31,inter-ui,35,17,19,16,7,7,6,1,4,33,39,184,74,91,FALSE,0.494565217391304,2020,2020-2021
SC,2020-12-31,intra-total,1844,340,435,355,263,231,206,179,136,1109,1214,6312,3058,3398,FALSE,0.538339670468948,2020,2020-2021
SC,2020-12-31,intra-ucfe,1,0,2,2,1,1,2,1,0,6,0,16,1,1,FALSE,0.0625,2020,2020-2021
SC,2020-12-31,intra-ucx,1,8,2,0,0,3,1,1,0,5,3,24,4,12,FALSE,0.5,2020,2020-2021
SC,2020-12-31,intra-ui,1842,332,431,353,262,227,203,177,136,1098,1211,6272,3053,3385,FALSE,0.539700255102041,2020,2020-2021
SC,2021-01-31,inter-total,28,27,14,7,2,3,3,5,1,20,34,144,62,89,FALSE,0.618055555555556,2020,2020-2021
SC,2021-01-31,inter-ucfe,0,0,0,0,0,0,0,0,0,0,0,0,0,0,FALSE,0,2020,2020-2021
SC,2021-01-31,inter-ucx,1,0,0,0,0,0,0,0,0,0,0,1,1,1,FALSE,1,2020,2020-2021
SC,2021-01-31,inter-ui,27,27,14,7,2,3,3,5,1,20,34,143,61,88,FALSE,0.615384615384615,2020,2020-2021
SC,2021-01-31,intra-total,1543,804,458,192,141,111,68,70,55,610,1307,5359,2850,3654,FALSE,0.681843627542452,2020,2020-2021
SC,2021-01-31,intra-ucfe,0,0,0,0,0,2,0,1,1,2,1,7,1,1,FALSE,0.142857142857143,2020,2020-2021
SC,2021-01-31,intra-ucx,6,4,1,1,1,0,1,0,0,1,4,19,10,14,FALSE,0.736842105263158,2020,2020-2021
SC,2021-01-31,intra-ui,1537,800,457,191,140,109,67,69,54,607,1302,5333,2839,3639,FALSE,0.6823551471967,2020,2020-2021
SC,2021-02-28,inter-total,16,37,19,8,19,1,9,9,5,27,24,174,40,77,FALSE,0.442528735632184,2020,2020-2021
SC,2021-02-28,inter-ucfe,0,0,0,0,0,0,0,0,1,0,0,1,0,0,FALSE,0,2020,2020-2021
SC,2021-02-28,inter-ucx,0,0,0,0,0,0,0,0,0,0,0,0,0,0,FALSE,0,2020,2020-2021
SC,2021-02-28,inter-ui,16,37,19,8,19,1,9,9,4,27,24,173,40,77,FALSE,0.445086705202312,2020,2020-2021
SC,2021-02-28,intra-total,1028,642,417,321,814,260,339,260,203,909,573,5766,1601,2243,FALSE,0.389004509191814,2020,2020-2021
SC,2021-02-28,intra-ucfe,0,0,1,1,1,2,0,0,0,3,0,8,0,0,FALSE,0,2020,2020-2021
SC,2021-02-28,intra-ucx,7,1,1,1,1,1,1,0,0,4,1,18,8,9,FALSE,0.5,2020,2020-2021
SC,2021-02-28,intra-ui,1021,641,415,319,812,257,338,260,203,902,572,5740,1593,2234,FALSE,0.389198606271777,2020,2020-2021
SC,2021-03-31,inter-total,18,20,13,11,10,10,6,12,8,50,25,183,43,63,FALSE,0.344262295081967,2020,2020-2021
SC,2021-03-31,inter-ucfe,0,0,0,0,0,0,0,0,0,0,0,0,0,0,FALSE,0,2020,2020-2021
SC,2021-03-31,inter-ucx,0,0,0,0,0,0,0,0,0,0,0,0,0,0,FALSE,0,2020,2020-2021
SC,2021-03-31,inter-ui,18,20,13,11,10,10,6,12,8,50,25,183,43,63,FALSE,0.344262295081967,2020,2020-2021
SC,2021-03-31,intra-total,1221,486,405,309,274,272,257,261,296,1419,787,5987,2008,2494,FALSE,0.416569233338901,2020,2020-2021
SC,2021-03-31,intra-ucfe,2,1,1,0,0,1,0,2,2,9,0,18,2,3,FALSE,0.166666666666667,2020,2020-2021
SC,2021-03-31,intra-ucx,2,1,1,1,2,2,0,0,0,1,3,13,5,6,FALSE,0.461538461538462,2020,2020-2021
SC,2021-03-31,intra-ui,1217,484,403,308,272,269,257,259,294,1409,784,5956,2001,2485,FALSE,0.417226326393553,2020,2020-2021
SC,2021-04-30,inter-total,53,17,7,7,2,2,2,4,1,29,13,137,66,83,FALSE,0.605839416058394,2020,2020-2021
SC,2021-04-30,inter-ucfe,0,0,0,0,0,0,0,0,0,0,0,0,0,0,FALSE,0,2020,2020-2021
SC,2021-04-30,inter-ucx,0,0,0,0,0,0,0,0,0,0,0,0,0,0,FALSE,0,2020,2020-2021
SC,2021-04-30,inter-ui,53,17,7,7,2,2,2,4,1,29,13,137,66,83,FALSE,0.605839416058394,2020,2020-2021
SC,2021-04-30,intra-total,3243,807,469,346,134,65,87,81,70,893,784,6979,4027,4834,FALSE,0.692649376701533,2020,2020-2021
SC,2021-04-30,intra-ucfe,0,1,0,0,0,0,0,0,1,8,0,10,0,1,FALSE,0.1,2020,2020-2021
SC,2021-04-30,intra-ucx,2,2,0,0,0,2,0,0,0,2,1,9,3,5,FALSE,0.555555555555556,2020,2020-2021
SC,2021-04-30,intra-ui,3241,804,469,346,134,63,87,81,69,883,783,6960,4024,4828,FALSE,0.69367816091954,2020,2020-2021
SC,2021-05-31,inter-total,39,24,18,18,13,7,4,3,4,30,25,185,64,88,FALSE,0.475675675675676,2020,2020-2021
SC,2021-05-31,inter-ucfe,0,0,0,0,0,0,0,0,0,0,0,0,0,0,FALSE,0,2020,2020-2021
SC,2021-05-31,inter-ucx,1,0,0,0,0,0,0,0,0,0,0,1,1,1,FALSE,1,2020,2020-2021
SC,2021-05-31,inter-ui,38,24,18,18,13,7,4,3,4,30,25,184,63,87,FALSE,0.472826086956522,2020,2020-2021
SC,2021-05-31,intra-total,1533,659,846,744,570,360,232,197,159,783,868,6951,2401,3060,FALSE,0.440224428139836,2020,2020-2021
SC,2021-05-31,intra-ucfe,0,1,0,0,0,0,0,0,0,7,0,8,0,1,FALSE,0.125,2020,2020-2021
SC,2021-05-31,intra-ucx,7,1,1,0,0,0,0,0,0,4,2,15,9,10,FALSE,0.666666666666667,2020,2020-2021
SC,2021-05-31,intra-ui,1526,657,845,744,570,360,232,197,159,772,866,6928,2392,3049,FALSE,0.440098152424942,2020,2020-2021
SC,2021-06-30,inter-total,29,11,15,4,5,1,4,5,8,40,18,140,47,58,FALSE,0.414285714285714,2020,2020-2021
SC,2021-06-30,inter-ucfe,0,0,0,0,0,0,0,0,0,1,0,1,0,0,FALSE,0,2020,2020-2021
SC,2021-06-30,inter-ucx,0,0,0,0,0,0,0,0,0,0,0,0,0,0,FALSE,0,2020,2020-2021
SC,2021-06-30,inter-ui,29,11,15,4,5,1,4,5,8,39,18,139,47,58,FALSE,0.41726618705036,2020,2020-2021
SC,2021-06-30,intra-total,958,184,189,154,137,177,268,301,330,964,515,4177,1473,1657,FALSE,0.396696193440268,2020,2020-2021
SC,2021-06-30,intra-ucfe,0,0,0,0,0,0,0,1,2,8,0,11,0,0,FALSE,0,2020,2020-2021
SC,2021-06-30,intra-ucx,8,2,1,0,1,1,0,0,2,6,4,25,12,14,FALSE,0.56,2020,2020-2021
SC,2021-06-30,intra-ui,950,182,188,154,136,176,268,300,326,950,511,4141,1461,1643,FALSE,0.396764066650568,2020,2020-2021
SC,2021-07-31,inter-total,30,6,3,7,3,11,5,3,2,29,6,105,36,42,FALSE,0.4,2021,2021-2022
SC,2021-07-31,inter-ucfe,0,0,0,0,0,0,0,0,0,0,0,0,0,0,FALSE,0,2021,2021-2022
SC,2021-07-31,inter-ucx,0,0,0,0,0,0,0,0,0,0,0,0,0,0,FALSE,0,2021,2021-2022
SC,2021-07-31,inter-ui,30,6,3,7,3,11,5,3,2,29,6,105,36,42,FALSE,0.4,2021,2021-2022
SC,2021-07-31,intra-total,1945,166,130,116,93,103,141,110,139,815,280,4038,2225,2391,FALSE,0.592124814264487,2021,2021-2022
SC,2021-07-31,intra-ucfe,0,1,1,0,0,0,1,0,0,3,1,7,1,2,FALSE,0.285714285714286,2021,2021-2022
SC,2021-07-31,intra-ucx,6,2,0,0,0,0,1,0,0,3,0,12,6,8,FALSE,0.666666666666667,2021,2021-2022
SC,2021-07-31,intra-ui,1939,163,129,116,93,103,139,110,139,809,279,4019,2218,2381,FALSE,0.592435929335656,2021,2021-2022
SC,2021-08-31,inter-total,24,4,2,4,2,5,3,2,5,32,3,86,27,31,FALSE,0.36046511627907,2021,2021-2022
SC,2021-08-31,inter-ucfe,0,0,0,0,0,0,0,0,0,1,0,1,0,0,FALSE,0,2021,2021-2022
SC,2021-08-31,inter-ucx,0,0,0,0,0,0,0,0,0,0,0,0,0,0,FALSE,0,2021,2021-2022
SC,2021-08-31,inter-ui,24,4,2,4,2,5,3,2,5,31,3,85,27,31,FALSE,0.364705882352941,2021,2021-2022
SC,2021-08-31,intra-total,889,157,139,162,159,131,125,79,71,787,212,2911,1101,1258,FALSE,0.432153899003779,2021,2021-2022
SC,2021-08-31,intra-ucfe,0,1,0,0,1,0,1,0,0,5,0,8,0,1,FALSE,0.125,2021,2021-2022
SC,2021-08-31,intra-ucx,9,3,0,0,0,1,1,0,0,4,2,20,11,14,FALSE,0.7,2021,2021-2022
SC,2021-08-31,intra-ui,880,153,139,162,158,130,123,79,71,778,210,2883,1090,1243,FALSE,0.431148109608047,2021,2021-2022
SC,2021-09-30,inter-total,11,8,7,0,1,3,2,4,3,37,3,79,14,22,FALSE,0.278481012658228,2021,2021-2022
SC,2021-09-30,inter-ucfe,0,0,0,0,0,0,0,0,0,1,0,1,0,0,FALSE,0,2021,2021-2022
SC,2021-09-30,inter-ucx,0,0,0,0,0,0,0,0,0,0,0,0,0,0,FALSE,0,2021,2021-2022
SC,2021-09-30,inter-ui,11,8,7,0,1,3,2,4,3,36,3,78,14,22,FALSE,0.282051282051282,2021,2021-2022
SC,2021-09-30,intra-total,939,145,123,114,103,105,124,130,140,1148,228,3299,1167,1312,FALSE,0.397696271597454,2021,2021-2022
SC,2021-09-30,intra-ucfe,1,0,0,0,1,1,0,1,0,10,0,14,1,1,FALSE,0.0714285714285714,2021,2021-2022
SC,2021-09-30,intra-ucx,4,0,1,0,0,0,1,0,0,5,0,11,4,4,FALSE,0.363636363636364,2021,2021-2022
SC,2021-09-30,intra-ui,934,145,122,114,102,104,123,129,140,1133,228,3274,1162,1307,FALSE,0.399205864386072,2021,2021-2022
SC,2021-10-31,inter-total,18,5,1,4,3,1,1,2,0,26,16,77,34,39,FALSE,0.506493506493507,2021,2021-2022
SC,2021-10-31,inter-ucfe,0,0,0,0,0,0,0,0,0,0,0,0,0,0,FALSE,0,2021,2021-2022
SC,2021-10-31,inter-ucx,0,0,0,0,0,0,0,0,0,0,0,0,0,0,FALSE,0,2021,2021-2022
SC,2021-10-31,inter-ui,18,5,1,4,3,1,1,2,0,26,16,77,34,39,FALSE,0.506493506493507,2021,2021-2022
SC,2021-10-31,intra-total,677,159,136,123,74,74,61,50,74,1076,320,2824,997,1156,FALSE,0.409348441926346,2021,2021-2022
SC,2021-10-31,intra-ucfe,1,0,1,1,0,0,0,0,0,6,0,9,1,1,FALSE,0.111111111111111,2021,2021-2022
SC,2021-10-31,intra-ucx,5,1,1,0,0,0,0,0,0,4,4,15,9,10,FALSE,0.666666666666667,2021,2021-2022
SC,2021-10-31,intra-ui,671,158,134,122,74,74,61,50,74,1066,316,2800,987,1145,FALSE,0.408928571428571,2021,2021-2022
SC,2021-11-30,inter-total,40,3,1,3,1,2,3,1,1,15,10,80,50,53,FALSE,0.6625,2021,2021-2022
SC,2021-11-30,inter-ucfe,0,0,0,0,0,0,0,0,0,0,0,0,0,0,FALSE,0,2021,2021-2022
SC,2021-11-30,inter-ucx,0,0,0,0,0,0,0,0,0,0,0,0,0,0,FALSE,0,2021,2021-2022
SC,2021-11-30,inter-ui,40,3,1,3,1,2,3,1,1,15,10,80,50,53,FALSE,0.6625,2021,2021-2022
SC,2021-11-30,intra-total,1012,152,79,55,53,45,41,25,32,677,254,2425,1266,1418,FALSE,0.584742268041237,2021,2021-2022
SC,2021-11-30,intra-ucfe,0,0,0,1,1,0,0,0,0,3,0,5,0,0,FALSE,0,2021,2021-2022
SC,2021-11-30,intra-ucx,5,4,0,1,1,0,0,0,0,1,1,13,6,10,FALSE,0.769230769230769,2021,2021-2022
SC,2021-11-30,intra-ui,1007,148,79,53,51,45,41,25,32,673,253,2407,1260,1408,FALSE,0.584960531782302,2021,2021-2022
SC,2021-12-31,inter-total,48,3,4,3,4,2,3,1,0,16,18,102,66,69,FALSE,0.676470588235294,2021,2021-2022
SC,2021-12-31,inter-ucfe,0,0,0,0,1,0,0,0,0,0,0,1,0,0,FALSE,0,2021,2021-2022
SC,2021-12-31,inter-ucx,0,0,0,0,0,0,0,0,0,1,0,1,0,0,FALSE,0,2021,2021-2022
SC,2021-12-31,inter-ui,48,3,4,3,3,2,3,1,0,15,18,100,66,69,FALSE,0.69,2021,2021-2022
SC,2021-12-31,intra-total,1078,167,116,82,60,33,24,20,11,505,335,2431,1413,1580,FALSE,0.649938296997121,2021,2021-2022
SC,2021-12-31,intra-ucfe,0,0,0,1,1,0,0,0,0,2,1,5,1,1,FALSE,0.2,2021,2021-2022
SC,2021-12-31,intra-ucx,4,0,0,1,0,0,0,1,0,4,1,11,5,5,FALSE,0.454545454545455,2021,2021-2022
SC,2021-12-31,intra-ui,1074,167,116,80,59,33,24,19,11,499,333,2415,1407,1574,FALSE,0.65175983436853,2021,2021-2022
SC,2022-01-31,inter-total,70,12,3,2,2,1,2,0,0,7,38,137,108,120,FALSE,0.875912408759124,2021,2021-2022
SC,2022-01-31,inter-ucfe,0,0,0,0,0,0,0,0,0,0,0,0,0,0,FALSE,0,2021,2021-2022
SC,2022-01-31,inter-ucx,0,0,0,0,0,0,0,0,0,0,0,0,0,0,FALSE,0,2021,2021-2022
SC,2022-01-31,inter-ui,70,12,3,2,2,1,2,0,0,7,38,137,108,120,FALSE,0.875912408759124,2021,2021-2022
SC,2022-01-31,intra-total,2308,291,180,93,48,20,21,17,11,364,1584,4937,3892,4183,FALSE,0.847275673485923,2021,2021-2022
SC,2022-01-31,intra-ucfe,0,0,0,0,1,0,0,0,1,4,0,6,0,0,FALSE,0,2021,2021-2022
SC,2022-01-31,intra-ucx,5,2,1,0,3,0,0,1,0,2,0,14,5,7,FALSE,0.5,2021,2021-2022
SC,2022-01-31,intra-ui,2303,289,179,93,44,20,21,16,10,358,1584,4917,3887,4176,FALSE,0.849298352654057,2021,2021-2022
SC,2022-02-28,inter-total,41,6,5,6,1,1,3,1,0,14,8,86,49,55,FALSE,0.63953488372093,2021,2021-2022
SC,2022-02-28,inter-ucfe,0,0,0,0,0,0,0,0,0,0,0,0,0,0,FALSE,0,2021,2021-2022
SC,2022-02-28,inter-ucx,0,0,0,0,0,0,0,0,0,0,0,0,0,0,FALSE,0,2021,2021-2022
SC,2022-02-28,inter-ui,41,6,5,6,1,1,3,1,0,14,8,86,49,55,FALSE,0.63953488372093,2021,2021-2022
SC,2022-02-28,intra-total,1150,196,129,106,110,81,53,26,13,347,441,2652,1591,1787,FALSE,0.673831070889895,2021,2021-2022
SC,2022-02-28,intra-ucfe,2,1,1,0,1,0,3,0,0,1,2,11,4,5,FALSE,0.454545454545455,2021,2021-2022
SC,2022-02-28,intra-ucx,2,2,2,0,1,2,0,0,0,0,2,11,4,6,FALSE,0.545454545454545,2021,2021-2022
SC,2022-02-28,intra-ui,1146,193,126,106,108,79,50,26,13,346,437,2630,1583,1776,FALSE,0.675285171102662,2021,2021-2022
SC,2022-03-31,inter-total,38,8,3,3,0,1,0,4,1,12,4,74,42,50,FALSE,0.675675675675676,2021,2021-2022
SC,2022-03-31,inter-ucfe,0,0,0,1,0,0,0,0,0,1,0,2,0,0,FALSE,0,2021,2021-2022
SC,2022-03-31,inter-ucx,0,0,0,0,0,0,0,0,0,0,0,0,0,0,FALSE,0,2021,2021-2022
SC,2022-03-31,inter-ui,38,8,3,2,0,1,0,4,1,11,4,72,42,50,FALSE,0.694444444444445,2021,2021-2022
SC,2022-03-31,intra-total,1076,113,69,57,36,19,32,54,33,344,330,2163,1406,1519,FALSE,0.702265372168285,2021,2021-2022
SC,2022-03-31,intra-ucfe,1,0,0,0,0,1,2,1,0,3,0,8,1,1,FALSE,0.125,2021,2021-2022
SC,2022-03-31,intra-ucx,2,1,1,0,1,0,0,0,0,1,3,9,5,6,FALSE,0.666666666666667,2021,2021-2022
SC,2022-03-31,intra-ui,1073,112,68,57,35,18,30,53,33,340,327,2146,1400,1512,FALSE,0.704566635601118,2021,2021-2022
SC,2022-04-30,inter-total,30,3,2,0,0,1,0,0,0,6,10,52,40,43,FALSE,0.826923076923077,2021,2021-2022
SC,2022-04-30,inter-ucfe,0,0,0,0,0,0,0,0,0,0,0,0,0,0,FALSE,0,2021,2021-2022
SC,2022-04-30,inter-ucx,0,0,0,0,0,0,0,0,0,0,0,0,0,0,FALSE,0,2021,2021-2022
SC,2022-04-30,inter-ui,30,3,2,0,0,1,0,0,0,6,10,52,40,43,FALSE,0.826923076923077,2021,2021-2022
SC,2022-04-30,intra-total,1548,95,51,33,17,17,15,7,5,218,327,2333,1875,1970,FALSE,0.844406343763395,2021,2021-2022
SC,2022-04-30,intra-ucfe,1,0,0,0,0,0,0,0,1,1,1,4,2,2,FALSE,0.5,2021,2021-2022
SC,2022-04-30,intra-ucx,6,1,0,0,0,0,0,0,0,2,0,9,6,7,FALSE,0.777777777777778,2021,2021-2022
SC,2022-04-30,intra-ui,1541,94,51,33,17,17,15,7,4,215,326,2320,1867,1961,FALSE,0.845258620689655,2021,2021-2022
SC,2022-05-31,inter-total,43,4,1,1,3,1,0,1,0,5,4,63,47,51,FALSE,0.80952380952381,2021,2021-2022
SC,2022-05-31,inter-ucfe,0,0,0,0,0,0,0,0,0,0,0,0,0,0,FALSE,0,2021,2021-2022
SC,2022-05-31,inter-ucx,1,0,0,0,0,0,0,0,0,0,0,1,1,1,FALSE,1,2021,2021-2022
SC,2022-05-31,inter-ui,42,4,1,1,3,1,0,1,0,5,4,62,46,50,FALSE,0.806451612903226,2021,2021-2022
SC,2022-05-31,intra-total,1722,118,71,66,29,16,10,9,9,111,351,2512,2073,2191,FALSE,0.872213375796178,2021,2021-2022
SC,2022-05-31,intra-ucfe,3,2,1,2,0,1,0,0,0,3,2,14,5,7,FALSE,0.5,2021,2021-2022
SC,2022-05-31,intra-ucx,9,0,1,0,1,1,1,1,0,0,2,16,11,11,FALSE,0.6875,2021,2021-2022
SC,2022-05-31,intra-ui,1710,116,69,64,28,14,9,8,9,108,347,2482,2057,2173,FALSE,0.875503626107977,2021,2021-2022
SC,2022-06-30,inter-total,71,5,1,0,1,2,0,0,0,8,9,97,80,85,FALSE,0.876288659793815,2021,2021-2022
SC,2022-06-30,inter-ucfe,0,0,0,0,0,0,0,0,0,0,0,0,0,0,FALSE,0,2021,2021-2022
SC,2022-06-30,inter-ucx,0,0,0,0,0,0,0,0,0,0,0,0,0,0,FALSE,0,2021,2021-2022
SC,2022-06-30,inter-ui,71,5,1,0,1,2,0,0,0,8,9,97,80,85,FALSE,0.876288659793815,2021,2021-2022
SC,2022-06-30,intra-total,2198,136,68,54,30,17,12,10,2,162,496,3185,2694,2830,FALSE,0.888540031397174,2021,2021-2022
SC,2022-06-30,intra-ucfe,3,0,0,0,0,0,1,0,0,2,3,9,6,6,FALSE,0.666666666666667,2021,2021-2022
SC,2022-06-30,intra-ucx,9,0,0,0,0,0,0,0,0,0,1,10,10,10,FALSE,1,2021,2021-2022
SC,2022-06-30,intra-ui,2186,136,68,54,30,17,11,10,2,160,492,3166,2678,2814,FALSE,0.888818698673405,2021,2021-2022
SC,2022-07-31,inter-total,92,7,2,5,2,1,1,0,0,3,18,131,110,117,FALSE,0.893129770992367,2022,2022-2023
SC,2022-07-31,inter-ucfe,0,0,0,0,0,0,0,0,0,0,0,0,0,0,FALSE,0,2022,2022-2023
SC,2022-07-31,inter-ucx,0,0,0,0,0,0,0,0,0,0,0,0,0,0,FALSE,0,2022,2022-2023
SC,2022-07-31,inter-ui,92,7,2,5,2,1,1,0,0,3,18,131,110,117,FALSE,0.893129770992367,2022,2022-2023
SC,2022-07-31,intra-total,2264,182,91,52,41,20,8,11,11,123,489,3292,2753,2935,FALSE,0.891555285540705,2022,2022-2023
SC,2022-07-31,intra-ucfe,2,0,4,1,1,0,0,1,2,0,0,11,2,2,FALSE,0.181818181818182,2022,2022-2023
SC,2022-07-31,intra-ucx,8,0,0,0,0,0,0,0,1,0,2,11,10,10,FALSE,0.909090909090909,2022,2022-2023
SC,2022-07-31,intra-ui,2254,182,87,51,40,20,8,10,8,123,487,3270,2741,2923,FALSE,0.89388379204893,2022,2022-2023
SC,2022-08-31,inter-total,65,9,5,3,0,1,6,2,0,6,18,115,83,92,FALSE,0.8,2022,2022-2023
SC,2022-08-31,inter-ucfe,0,0,0,0,0,0,1,0,0,0,0,1,0,0,FALSE,0,2022,2022-2023
SC,2022-08-31,inter-ucx,0,0,0,0,0,0,0,0,0,0,0,0,0,0,FALSE,0,2022,2022-2023
SC,2022-08-31,inter-ui,65,9,5,3,0,1,5,2,0,6,18,114,83,92,FALSE,0.807017543859649,2022,2022-2023
SC,2022-08-31,intra-total,1857,222,132,96,52,26,15,12,5,73,518,3008,2375,2597,FALSE,0.863364361702128,2022,2022-2023
SC,2022-08-31,intra-ucfe,0,2,0,0,0,2,0,0,0,1,2,7,2,4,FALSE,0.571428571428571,2022,2022-2023
SC,2022-08-31,intra-ucx,8,0,0,0,0,0,0,0,0,0,3,11,11,11,FALSE,1,2022,2022-2023
SC,2022-08-31,intra-ui,1849,220,132,96,52,24,15,12,5,72,513,2990,2362,2582,FALSE,0.863545150501672,2022,2022-2023
SC,2022-09-30,inter-total,66,6,5,1,1,1,0,1,0,3,9,93,75,81,FALSE,0.870967741935484,2022,2022-2023
SC,2022-09-30,inter-ucfe,1,0,0,0,0,0,0,0,0,0,0,1,1,1,FALSE,1,2022,2022-2023
SC,2022-09-30,inter-ucx,0,0,0,0,0,0,0,0,0,0,0,0,0,0,FALSE,0,2022,2022-2023
SC,2022-09-30,inter-ui,65,6,5,1,1,1,0,1,0,3,9,92,74,80,FALSE,0.869565217391304,2022,2022-2023
SC,2022-09-30,intra-total,1386,138,67,58,42,27,15,13,6,41,377,2170,1763,1901,FALSE,0.876036866359447,2022,2022-2023
SC,2022-09-30,intra-ucfe,1,0,1,1,0,1,0,1,0,1,2,8,3,3,FALSE,0.375,2022,2022-2023
SC,2022-09-30,intra-ucx,16,2,1,0,0,0,0,0,0,0,0,19,16,18,FALSE,0.947368421052632,2022,2022-2023
SC,2022-09-30,intra-ui,1369,136,65,57,42,26,15,12,6,40,375,2143,1744,1880,FALSE,0.877274848343444,2022,2022-2023
SC,2022-10-31,inter-total,69,6,0,2,2,1,1,1,0,3,14,99,83,89,FALSE,0.898989898989899,2022,2022-2023
SC,2022-10-31,inter-ucfe,0,0,0,0,0,0,0,0,0,0,0,0,0,0,FALSE,0,2022,2022-2023
SC,2022-10-31,inter-ucx,0,0,0,0,0,0,0,0,0,0,0,0,0,0,FALSE,0,2022,2022-2023
SC,2022-10-31,inter-ui,69,6,0,2,2,1,1,1,0,3,14,99,83,89,FALSE,0.898989898989899,2022,2022-2023
SC,2022-10-31,intra-total,1706,89,52,39,38,11,11,8,3,48,346,2351,2052,2141,FALSE,0.910676307954062,2022,2022-2023
SC,2022-10-31,intra-ucfe,0,0,0,0,0,0,1,0,0,0,2,3,2,2,FALSE,0.666666666666667,2022,2022-2023
SC,2022-10-31,intra-ucx,5,0,1,0,0,0,0,0,0,0,0,6,5,5,FALSE,0.833333333333333,2022,2022-2023
SC,2022-10-31,intra-ui,1701,89,51,39,38,11,10,8,3,48,344,2342,2045,2134,FALSE,0.911187019641332,2022,2022-2023
SC,2022-11-30,inter-total,77,4,1,1,0,1,1,1,0,4,20,110,97,101,FALSE,0.918181818181818,2022,2022-2023
SC,2022-11-30,inter-ucfe,0,0,0,0,0,0,0,0,0,0,0,0,0,0,FALSE,0,2022,2022-2023
SC,2022-11-30,inter-ucx,0,0,0,0,0,0,0,0,0,0,0,0,0,0,FALSE,0,2022,2022-2023
SC,2022-11-30,inter-ui,77,4,1,1,0,1,1,1,0,4,20,110,97,101,FALSE,0.918181818181818,2022,2022-2023
SC,2022-11-30,intra-total,1848,128,65,47,21,19,11,4,6,42,454,2645,2302,2430,FALSE,0.918714555765595,2022,2022-2023
SC,2022-11-30,intra-ucfe,0,0,0,1,1,0,1,1,0,2,1,7,1,1,FALSE,0.142857142857143,2022,2022-2023
SC,2022-11-30,intra-ucx,6,0,0,0,0,0,0,0,0,0,2,8,8,8,FALSE,1,2022,2022-2023
SC,2022-11-30,intra-ui,1842,128,65,46,20,19,10,3,6,40,451,2630,2293,2421,FALSE,0.920532319391635,2022,2022-2023
SC,2022-12-31,inter-total,83,4,5,4,2,1,0,0,0,2,20,121,103,107,FALSE,0.884297520661157,2022,2022-2023
SC,2022-12-31,inter-ucfe,0,0,0,0,0,0,0,0,0,0,0,0,0,0,FALSE,0,2022,2022-2023
SC,2022-12-31,inter-ucx,0,0,0,0,0,0,0,0,0,0,0,0,0,0,FALSE,0,2022,2022-2023
SC,2022-12-31,inter-ui,83,4,5,4,2,1,0,0,0,2,20,121,103,107,FALSE,0.884297520661157,2022,2022-2023
SC,2022-12-31,intra-total,2004,204,85,63,39,22,17,6,7,35,443,2925,2447,2651,FALSE,0.906324786324786,2022,2022-2023
SC,2022-12-31,intra-ucfe,1,0,0,2,1,0,1,0,0,1,1,7,2,2,FALSE,0.285714285714286,2022,2022-2023
SC,2022-12-31,intra-ucx,3,0,1,0,0,0,0,0,0,0,3,7,6,6,FALSE,0.857142857142857,2022,2022-2023
SC,2022-12-31,intra-ui,2000,204,84,61,38,22,16,6,7,34,439,2911,2439,2643,FALSE,0.907935417382343,2022,2022-2023
SC,2023-01-31,inter-total,112,12,8,5,4,2,0,1,1,4,41,190,153,165,FALSE,0.868421052631579,2022,2022-2023
SC,2023-01-31,inter-ucfe,0,0,0,0,0,0,0,0,0,0,0,0,0,0,FALSE,0,2022,2022-2023
SC,2023-01-31,inter-ucx,1,0,0,0,0,0,0,0,0,0,0,1,1,1,FALSE,1,2022,2022-2023
SC,2023-01-31,inter-ui,111,12,8,5,4,2,0,1,1,4,41,189,152,164,FALSE,0.867724867724868,2022,2022-2023
SC,2023-01-31,intra-total,3675,403,222,91,61,26,13,14,4,70,942,5521,4617,5020,FALSE,0.909255569643181,2022,2022-2023
SC,2023-01-31,intra-ucfe,0,2,0,0,0,0,0,0,0,1,1,4,1,3,FALSE,0.75,2022,2022-2023
SC,2023-01-31,intra-ucx,5,1,0,1,0,0,0,0,0,0,1,8,6,7,FALSE,0.875,2022,2022-2023
SC,2023-01-31,intra-ui,3670,400,222,90,61,26,13,14,4,69,940,5509,4610,5010,FALSE,0.909420947540388,2022,2022-2023
SC,2023-02-28,inter-total,93,4,4,5,3,1,1,0,1,2,16,130,109,113,FALSE,0.869230769230769,2022,2022-2023
SC,2023-02-28,inter-ucfe,0,0,0,0,0,0,0,0,0,0,0,0,0,0,FALSE,0,2022,2022-2023
SC,2023-02-28,inter-ucx,0,0,0,0,0,0,0,0,0,0,0,0,0,0,FALSE,0,2022,2022-2023
SC,2023-02-28,inter-ui,93,4,4,5,3,1,1,0,1,2,16,130,109,113,FALSE,0.869230769230769,2022,2022-2023
SC,2023-02-28,intra-total,2155,139,113,76,53,35,19,12,5,52,438,3097,2593,2732,FALSE,0.88214401033258,2022,2022-2023
SC,2023-02-28,intra-ucfe,0,1,1,2,0,0,0,0,0,0,1,5,1,2,FALSE,0.4,2022,2022-2023
SC,2023-02-28,intra-ucx,8,1,0,0,0,0,0,0,0,0,3,12,11,12,FALSE,1,2022,2022-2023
SC,2023-02-28,intra-ui,2147,137,112,74,53,35,19,12,5,52,434,3080,2581,2718,FALSE,0.882467532467533,2022,2022-2023
SC,2023-03-31,inter-total,68,6,1,4,3,1,5,0,0,2,14,104,82,88,FALSE,0.846153846153846,2022,2022-2023
SC,2023-03-31,inter-ucfe,0,0,0,0,0,0,0,0,0,0,0,0,0,0,FALSE,0,2022,2022-2023
SC,2023-03-31,inter-ucx,0,0,0,0,0,0,0,0,0,0,0,0,0,0,FALSE,0,2022,2022-2023
SC,2023-03-31,inter-ui,68,6,1,4,3,1,5,0,0,2,14,104,82,88,FALSE,0.846153846153846,2022,2022-2023
SC,2023-03-31,intra-total,1980,105,54,55,63,25,12,6,13,85,421,2819,2401,2506,FALSE,0.888967719049308,2022,2022-2023
SC,2023-03-31,intra-ucfe,0,0,1,0,0,1,0,0,0,0,0,2,0,0,FALSE,0,2022,2022-2023
SC,2023-03-31,intra-ucx,6,0,0,0,0,0,0,0,0,0,0,6,6,6,FALSE,1,2022,2022-2023
SC,2023-03-31,intra-ui,1974,105,53,55,63,24,12,6,13,85,421,2811,2395,2500,FALSE,0.889363215937389,2022,2022-2023
SC,2023-04-30,inter-total,60,2,1,0,1,1,2,0,1,6,13,87,73,75,FALSE,0.862068965517241,2022,2022-2023
SC,2023-04-30,inter-ucfe,0,0,0,0,0,0,0,0,0,0,0,0,0,0,FALSE,0,2022,2022-2023
SC,2023-04-30,inter-ucx,1,0,0,0,0,0,0,0,0,1,0,2,1,1,FALSE,0.5,2022,2022-2023
SC,2023-04-30,inter-ui,59,2,1,0,1,1,2,0,1,5,13,85,72,74,FALSE,0.870588235294118,2022,2022-2023
SC,2023-04-30,intra-total,2369,82,36,44,29,22,11,8,7,124,407,3139,2776,2858,FALSE,0.910481044918764,2022,2022-2023
SC,2023-04-30,intra-ucfe,1,1,0,0,0,0,0,0,0,0,3,5,4,5,FALSE,1,2022,2022-2023
SC,2023-04-30,intra-ucx,7,0,0,1,0,1,0,0,0,0,0,9,7,7,FALSE,0.777777777777778,2022,2022-2023
SC,2023-04-30,intra-ui,2361,81,36,43,29,21,11,8,7,124,404,3125,2765,2846,FALSE,0.91072,2022,2022-2023
SC,2023-05-31,inter-total,76,1,1,1,1,0,2,1,0,1,12,96,88,89,FALSE,0.927083333333333,2022,2022-2023
SC,2023-05-31,inter-ucfe,0,0,0,0,0,0,0,0,0,0,0,0,0,0,FALSE,0,2022,2022-2023
SC,2023-05-31,inter-ucx,0,0,0,0,0,0,0,0,0,0,0,0,0,0,FALSE,0,2022,2022-2023
SC,2023-05-31,inter-ui,76,1,1,1,1,0,2,1,0,1,12,96,88,89,FALSE,0.927083333333333,2022,2022-2023
SC,2023-05-31,intra-total,2425,88,44,43,27,21,5,9,4,52,411,3129,2836,2924,FALSE,0.934483860658357,2022,2022-2023
SC,2023-05-31,intra-ucfe,1,1,0,2,1,0,0,0,0,0,4,9,5,6,FALSE,0.666666666666667,2022,2022-2023
SC,2023-05-31,intra-ucx,8,2,0,0,0,0,1,0,0,0,1,12,9,11,FALSE,0.916666666666667,2022,2022-2023
SC,2023-05-31,intra-ui,2416,85,44,41,26,21,4,9,4,52,406,3108,2822,2907,FALSE,0.935328185328185,2022,2022-2023
SC,2023-06-30,inter-total,108,1,2,2,2,0,1,1,0,1,19,137,127,128,FALSE,0.934306569343066,2022,2022-2023
SC,2023-06-30,inter-ucfe,0,0,0,1,0,0,0,0,0,0,0,1,0,0,FALSE,0,2022,2022-2023
SC,2023-06-30,inter-ucx,0,0,0,0,0,0,0,0,0,0,0,0,0,0,FALSE,0,2022,2022-2023
SC,2023-06-30,inter-ui,108,1,2,1,2,0,1,1,0,1,19,136,127,128,FALSE,0.941176470588235,2022,2022-2023
SC,2023-06-30,intra-total,3532,102,54,46,38,23,5,8,4,72,570,4454,4102,4204,FALSE,0.943870678042209,2022,2022-2023
SC,2023-06-30,intra-ucfe,2,0,0,0,0,1,0,0,0,0,1,4,3,3,FALSE,0.75,2022,2022-2023
SC,2023-06-30,intra-ucx,3,1,0,0,0,0,0,0,0,1,0,5,3,4,FALSE,0.8,2022,2022-2023
SC,2023-06-30,intra-ui,3527,101,54,46,38,22,5,8,4,71,569,4445,4096,4197,FALSE,0.944206974128234,2022,2022-2023
SC,2023-07-31,inter-total,96,12,2,1,2,0,0,0,0,2,17,132,113,125,FALSE,0.946969696969697,2023,2023-2024
SC,2023-07-31,inter-ucfe,0,0,0,0,0,0,0,0,0,0,0,0,0,0,FALSE,0,2023,2023-2024
SC,2023-07-31,inter-ucx,0,0,0,0,0,0,0,0,0,0,0,0,0,0,FALSE,0,2023,2023-2024
SC,2023-07-31,inter-ui,96,12,2,1,2,0,0,0,0,2,17,132,113,125,FALSE,0.946969696969697,2023,2023-2024
SC,2023-07-31,intra-total,3443,302,54,29,33,18,2,4,1,66,549,4501,3992,4294,FALSE,0.954010219951122,2023,2023-2024
SC,2023-07-31,intra-ucfe,4,0,0,0,0,0,0,0,0,0,3,7,7,7,FALSE,1,2023,2023-2024
SC,2023-07-31,intra-ucx,8,1,1,0,0,0,0,0,0,0,3,13,11,12,FALSE,0.923076923076923,2023,2023-2024
SC,2023-07-31,intra-ui,3431,301,53,29,33,18,2,4,1,66,543,4481,3974,4275,FALSE,0.954028118723499,2023,2023-2024
SC,2023-08-31,inter-total,63,2,4,5,0,0,0,1,0,2,12,89,75,77,FALSE,0.865168539325843,2023,2023-2024
SC,2023-08-31,inter-ucfe,0,0,0,0,0,0,0,0,0,0,0,0,0,0,FALSE,0,2023,2023-2024
SC,2023-08-31,inter-ucx,0,0,0,0,0,0,0,0,0,0,0,0,0,0,FALSE,0,2023,2023-2024
SC,2023-08-31,inter-ui,63,2,4,5,0,0,0,1,0,2,12,89,75,77,FALSE,0.865168539325843,2023,2023-2024
SC,2023-08-31,intra-total,2393,84,53,35,30,13,6,6,4,39,424,3087,2817,2901,FALSE,0.939747327502429,2023,2023-2024
SC,2023-08-31,intra-ucfe,1,0,0,0,0,1,1,0,0,0,0,3,1,1,FALSE,0.333333333333333,2023,2023-2024
SC,2023-08-31,intra-ucx,6,2,0,1,0,0,0,0,1,1,0,11,6,8,FALSE,0.727272727272727,2023,2023-2024
SC,2023-08-31,intra-ui,2386,82,53,34,30,12,5,6,3,38,424,3073,2810,2892,FALSE,0.941099902375529,2023,2023-2024
SC,2023-09-30,inter-total,81,3,4,3,1,0,1,0,0,1,10,104,91,94,FALSE,0.903846153846154,2023,2023-2024
SC,2023-09-30,inter-ucfe,0,0,0,0,0,0,0,0,0,0,0,0,0,0,FALSE,0,2023,2023-2024
SC,2023-09-30,inter-ucx,0,0,0,0,0,0,0,0,0,0,0,0,0,0,FALSE,0,2023,2023-2024
SC,2023-09-30,inter-ui,81,3,4,3,1,0,1,0,0,1,10,104,91,94,FALSE,0.903846153846154,2023,2023-2024
SC,2023-09-30,intra-total,2224,54,51,27,21,8,6,4,3,42,350,2790,2574,2628,FALSE,0.941935483870968,2023,2023-2024
SC,2023-09-30,intra-ucfe,0,1,0,1,1,1,0,0,0,1,0,5,0,1,FALSE,0.2,2023,2023-2024
SC,2023-09-30,intra-ucx,6,0,0,0,0,0,0,0,0,0,3,9,9,9,FALSE,1,2023,2023-2024
SC,2023-09-30,intra-ui,2218,53,51,26,20,7,6,4,3,41,347,2776,2565,2618,FALSE,0.943083573487032,2023,2023-2024
SC,2023-10-31,inter-total,68,3,0,3,0,1,1,0,0,2,11,89,79,82,FALSE,0.921348314606742,2023,2023-2024
SC,2023-10-31,inter-ucfe,0,0,0,0,0,0,1,0,0,0,0,1,0,0,FALSE,0,2023,2023-2024
SC,2023-10-31,inter-ucx,0,0,0,0,0,0,0,0,0,0,0,0,0,0,FALSE,0,2023,2023-2024
SC,2023-10-31,inter-ui,68,3,0,3,0,1,0,0,0,2,11,88,79,82,FALSE,0.931818181818182,2023,2023-2024
SC,2023-10-31,intra-total,2382,65,35,20,15,6,4,1,1,33,322,2884,2704,2769,FALSE,0.960124826629681,2023,2023-2024
SC,2023-10-31,intra-ucfe,1,1,0,1,0,0,0,0,0,2,2,7,3,4,FALSE,0.571428571428571,2023,2023-2024
SC,2023-10-31,intra-ucx,9,0,0,0,0,0,0,0,0,0,1,10,10,10,FALSE,1,2023,2023-2024
SC,2023-10-31,intra-ui,2372,64,35,19,15,6,4,1,1,31,319,2867,2691,2755,FALSE,0.96093477502616,2023,2023-2024
SC,2023-11-30,inter-total,76,1,3,2,0,2,0,0,1,0,18,103,94,95,FALSE,0.922330097087379,2023,2023-2024
SC,2023-11-30,inter-ucfe,0,0,0,0,0,0,0,0,0,0,0,0,0,0,FALSE,0,2023,2023-2024
SC,2023-11-30,inter-ucx,0,0,0,0,0,0,0,0,0,0,0,0,0,0,FALSE,0,2023,2023-2024
SC,2023-11-30,inter-ui,76,1,3,2,0,2,0,0,1,0,18,103,94,95,FALSE,0.922330097087379,2023,2023-2024
SC,2023-11-30,intra-total,2378,63,38,32,11,7,2,3,3,24,510,3071,2888,2951,FALSE,0.960924780201889,2023,2023-2024
SC,2023-11-30,intra-ucfe,1,0,0,0,0,0,0,0,0,1,0,2,1,1,FALSE,0.5,2023,2023-2024
SC,2023-11-30,intra-ucx,3,0,1,1,0,0,0,0,0,0,2,7,5,5,FALSE,0.714285714285714,2023,2023-2024
SC,2023-11-30,intra-ui,2374,63,37,31,11,7,2,3,3,23,508,3062,2882,2945,FALSE,0.961789679947747,2023,2023-2024
SC,2023-12-31,inter-total,79,4,1,0,0,1,0,0,1,1,11,98,90,94,FALSE,0.959183673469388,2023,2023-2024
SC,2023-12-31,inter-ucfe,0,0,0,0,0,0,0,0,0,0,1,1,1,1,FALSE,1,2023,2023-2024
SC,2023-12-31,inter-ucx,1,0,0,0,0,0,0,0,0,0,0,1,1,1,FALSE,1,2023,2023-2024
SC,2023-12-31,inter-ui,78,4,1,0,0,1,0,0,1,1,10,96,88,92,FALSE,0.958333333333333,2023,2023-2024
SC,2023-12-31,intra-total,2317,78,37,38,13,12,3,2,3,13,379,2895,2696,2774,FALSE,0.958203799654577,2023,2023-2024
SC,2023-12-31,intra-ucfe,1,0,0,0,0,1,0,0,0,1,1,4,2,2,FALSE,0.5,2023,2023-2024
SC,2023-12-31,intra-ucx,2,2,2,0,1,0,0,0,0,0,6,13,8,10,FALSE,0.769230769230769,2023,2023-2024
SC,2023-12-31,intra-ui,2314,76,35,38,12,11,3,2,3,12,372,2878,2686,2762,FALSE,0.959694232105629,2023,2023-2024
SC,2024-01-31,inter-total,104,5,2,2,1,0,1,0,0,0,20,135,124,129,FALSE,0.955555555555556,2023,2023-2024
SC,2024-01-31,inter-ucfe,0,0,0,0,0,0,0,0,0,0,0,0,0,0,FALSE,0,2023,2023-2024
SC,2024-01-31,inter-ucx,0,0,0,0,0,0,0,0,0,0,0,0,0,0,FALSE,0,2023,2023-2024
SC,2024-01-31,inter-ui,104,5,2,2,1,0,1,0,0,0,20,135,124,129,FALSE,0.955555555555556,2023,2023-2024
SC,2024-01-31,intra-total,3854,342,62,59,37,11,9,4,0,23,881,5282,4735,5077,FALSE,0.961188943581977,2023,2023-2024
SC,2024-01-31,intra-ucfe,0,1,1,0,2,0,0,0,0,0,3,7,3,4,FALSE,0.571428571428571,2023,2023-2024
SC,2024-01-31,intra-ucx,9,0,0,0,1,0,0,0,0,1,3,14,12,12,FALSE,0.857142857142857,2023,2023-2024
SC,2024-01-31,intra-ui,3845,341,61,59,34,11,9,4,0,22,875,5261,4720,5061,FALSE,0.96198441360958,2023,2023-2024
SC,2024-02-29,inter-total,76,4,5,3,0,1,0,0,0,1,12,102,88,92,FALSE,0.901960784313725,2023,2023-2024
SC,2024-02-29,inter-ucfe,1,0,0,0,0,0,0,0,0,0,0,1,1,1,FALSE,1,2023,2023-2024
SC,2024-02-29,inter-ucx,1,0,0,0,0,0,0,0,0,0,0,1,1,1,FALSE,1,2023,2023-2024
SC,2024-02-29,inter-ui,74,4,5,3,0,1,0,0,0,1,12,100,86,90,FALSE,0.9,2023,2023-2024
SC,2024-02-29,intra-total,2349,115,70,29,21,14,9,3,4,15,435,3064,2784,2899,FALSE,0.946148825065274,2023,2023-2024
SC,2024-02-29,intra-ucfe,1,2,0,0,0,0,0,0,0,0,1,4,2,4,FALSE,1,2023,2023-2024
SC,2024-02-29,intra-ucx,4,1,1,0,0,0,0,0,0,0,0,6,4,5,FALSE,0.833333333333333,2023,2023-2024
SC,2024-02-29,intra-ui,2344,112,69,29,21,14,9,3,4,15,434,3054,2778,2890,FALSE,0.946299934512115,2023,2023-2024
SC,2024-03-31,inter-total,66,2,3,0,0,0,0,0,1,5,10,87,76,78,FALSE,0.896551724137931,2023,2023-2024
SC,2024-03-31,inter-ucfe,0,1,1,0,0,0,0,0,0,0,0,2,0,1,FALSE,0.5,2023,2023-2024
SC,2024-03-31,inter-ucx,0,0,0,0,0,0,0,0,0,0,0,0,0,0,FALSE,0,2023,2023-2024
SC,2024-03-31,inter-ui,66,1,2,0,0,0,0,0,1,5,10,85,76,77,FALSE,0.905882352941176,2023,2023-2024
SC,2024-03-31,intra-total,2137,61,60,32,27,6,6,0,2,24,326,2681,2463,2524,FALSE,0.941439761283103,2023,2023-2024
SC,2024-03-31,intra-ucfe,0,0,0,0,0,0,0,0,0,0,2,2,2,2,FALSE,1,2023,2023-2024
SC,2024-03-31,intra-ucx,6,0,0,0,0,0,0,0,0,0,2,8,8,8,FALSE,1,2023,2023-2024
SC,2024-03-31,intra-ui,2131,61,60,32,27,6,6,0,2,24,322,2671,2453,2514,FALSE,0.941220516660427,2023,2023-2024
SC,2024-04-30,inter-total,58,2,0,2,0,1,0,1,0,2,14,80,72,74,FALSE,0.925,2023,2023-2024
SC,2024-04-30,inter-ucfe,0,0,0,0,0,0,0,0,0,0,0,0,0,0,FALSE,0,2023,2023-2024
SC,2024-04-30,inter-ucx,0,0,0,0,0,0,0,0,0,0,0,0,0,0,FALSE,0,2023,2023-2024
SC,2024-04-30,inter-ui,58,2,0,2,0,1,0,1,0,2,14,80,72,74,FALSE,0.925,2023,2023-2024
SC,2024-04-30,intra-total,2455,72,34,26,14,7,3,1,2,22,369,3005,2824,2896,FALSE,0.963727121464226,2023,2023-2024
SC,2024-04-30,intra-ucfe,4,3,1,0,0,0,0,0,0,0,3,11,7,10,FALSE,0.909090909090909,2023,2023-2024
SC,2024-04-30,intra-ucx,11,1,0,0,0,0,0,0,0,0,1,13,12,13,FALSE,1,2023,2023-2024
SC,2024-04-30,intra-ui,2440,68,33,26,14,7,3,1,2,22,365,2981,2805,2873,FALSE,0.963770546796377,2023,2023-2024
SC,2024-05-31,inter-total,102,3,3,1,1,0,0,0,0,2,8,120,110,113,FALSE,0.941666666666667,2023,2023-2024
SC,2024-05-31,inter-ucfe,0,0,0,0,0,0,0,0,0,0,0,0,0,0,FALSE,0,2023,2023-2024
SC,2024-05-31,inter-ucx,0,0,0,0,0,0,0,0,0,0,0,0,0,0,FALSE,0,2023,2023-2024
SC,2024-05-31,inter-ui,102,3,3,1,1,0,0,0,0,2,8,120,110,113,FALSE,0.941666666666667,2023,2023-2024
SC,2024-05-31,intra-total,2322,55,43,32,11,14,4,1,1,42,446,2971,2768,2823,FALSE,0.950185122854258,2023,2023-2024
SC,2024-05-31,intra-ucfe,1,2,0,0,0,0,0,0,0,0,2,5,3,5,FALSE,1,2023,2023-2024
SC,2024-05-31,intra-ucx,5,0,0,1,0,1,0,0,0,0,4,11,9,9,FALSE,0.818181818181818,2023,2023-2024
SC,2024-05-31,intra-ui,2316,53,43,31,11,13,4,1,1,42,440,2955,2756,2809,FALSE,0.950592216582064,2023,2023-2024
SC,2024-06-30,inter-total,101,1,0,1,3,1,0,0,0,0,15,122,116,117,FALSE,0.959016393442623,2023,2023-2024
SC,2024-06-30,inter-ucfe,0,0,0,0,0,0,0,0,0,0,0,0,0,0,FALSE,0,2023,2023-2024
SC,2024-06-30,inter-ucx,0,0,0,0,0,0,0,0,0,0,0,0,0,0,FALSE,0,2023,2023-2024
SC,2024-06-30,inter-ui,101,1,0,1,3,1,0,0,0,0,15,122,116,117,FALSE,0.959016393442623,2023,2023-2024
SC,2024-06-30,intra-total,3119,80,36,25,9,4,4,3,2,16,510,3808,3629,3709,FALSE,0.974002100840336,2023,2023-2024
SC,2024-06-30,intra-ucfe,2,1,0,0,0,1,0,0,0,1,2,7,4,5,FALSE,0.714285714285714,2023,2023-2024
SC,2024-06-30,intra-ucx,7,1,1,0,0,0,0,1,0,0,2,12,9,10,FALSE,0.833333333333333,2023,2023-2024
SC,2024-06-30,intra-ui,3110,78,35,25,9,3,4,2,2,15,506,3789,3616,3694,FALSE,0.974927421483241,2023,2023-2024
SC,2024-07-31,inter-total,81,4,1,1,0,1,0,0,2,1,18,109,99,103,FALSE,0.944954128440367,2024,2024-2025
SC,2024-07-31,inter-ucfe,0,0,0,0,0,0,0,0,0,0,0,0,0,0,FALSE,0,2024,2024-2025
SC,2024-07-31,inter-ucx,0,0,0,0,0,0,0,0,0,0,0,0,0,0,FALSE,0,2024,2024-2025
SC,2024-07-31,inter-ui,81,4,1,1,0,1,0,0,2,1,18,109,99,103,FALSE,0.944954128440367,2024,2024-2025
SC,2024-07-31,intra-total,3557,244,70,38,15,11,2,5,5,13,861,4821,4418,4662,FALSE,0.967019290603609,2024,2024-2025
SC,2024-07-31,intra-ucfe,2,0,0,0,0,1,0,1,1,1,1,7,3,3,FALSE,0.428571428571429,2024,2024-2025
SC,2024-07-31,intra-ucx,11,1,0,0,0,0,0,0,0,0,2,14,13,14,FALSE,1,2024,2024-2025
SC,2024-07-31,intra-ui,3544,243,70,38,15,10,2,4,4,12,858,4800,4402,4645,FALSE,0.967708333333333,2024,2024-2025
SC,2024-08-31,inter-total,65,0,1,1,1,0,2,0,0,0,10,80,75,75,FALSE,0.9375,2024,2024-2025
SC,2024-08-31,inter-ucfe,0,0,0,0,0,0,0,0,0,0,0,0,0,0,FALSE,0,2024,2024-2025
SC,2024-08-31,inter-ucx,0,0,0,0,0,0,0,0,0,0,0,0,0,0,FALSE,0,2024,2024-2025
SC,2024-08-31,inter-ui,65,0,1,1,1,0,2,0,0,0,10,80,75,75,FALSE,0.9375,2024,2024-2025
SC,2024-08-31,intra-total,2455,69,37,42,18,13,13,5,5,18,451,3126,2906,2975,FALSE,0.951695457453615,2024,2024-2025
SC,2024-08-31,intra-ucfe,1,0,1,1,0,0,0,0,0,0,0,3,1,1,FALSE,0.333333333333333,2024,2024-2025
SC,2024-08-31,intra-ucx,9,0,2,0,0,0,0,0,0,0,0,11,9,9,FALSE,0.818181818181818,2024,2024-2025
SC,2024-08-31,intra-ui,2445,69,34,41,18,13,13,5,5,18,451,3112,2896,2965,FALSE,0.952763496143959,2024,2024-2025
SC,2024-09-30,inter-total,68,3,0,2,1,0,0,0,0,1,9,84,77,80,FALSE,0.952380952380952,2024,2024-2025
SC,2024-09-30,inter-ucfe,0,0,0,0,0,0,0,0,0,0,0,0,0,0,FALSE,0,2024,2024-2025
SC,2024-09-30,inter-ucx,0,0,0,0,0,0,0,0,0,0,0,0,0,0,FALSE,0,2024,2024-2025
SC,2024-09-30,inter-ui,68,3,0,2,1,0,0,0,0,1,9,84,77,80,FALSE,0.952380952380952,2024,2024-2025
SC,2024-09-30,intra-total,2257,60,25,30,18,10,3,3,3,8,401,2818,2658,2718,FALSE,0.964513839602555,2024,2024-2025
SC,2024-09-30,intra-ucfe,0,0,0,0,0,0,0,1,0,1,0,2,0,0,FALSE,0,2024,2024-2025
SC,2024-09-30,intra-ucx,9,1,1,0,0,0,0,0,1,0,2,14,11,12,FALSE,0.857142857142857,2024,2024-2025
SC,2024-09-30,intra-ui,2248,59,24,30,18,10,3,2,2,7,399,2802,2647,2706,FALSE,0.965738758029979,2024,2024-2025
SC,2024-10-31,inter-total,47,3,2,3,1,1,0,1,0,1,11,70,58,61,FALSE,0.871428571428572,2024,2024-2025
SC,2024-10-31,inter-ucfe,0,0,1,0,0,0,0,0,0,0,0,1,0,0,FALSE,0,2024,2024-2025
SC,2024-10-31,inter-ucx,0,0,0,0,0,0,0,0,0,0,0,0,0,0,FALSE,0,2024,2024-2025
SC,2024-10-31,inter-ui,47,3,1,3,1,1,0,1,0,1,11,69,58,61,FALSE,0.884057971014493,2024,2024-2025
SC,2024-10-31,intra-total,1999,126,48,65,40,10,8,4,3,17,502,2822,2501,2627,FALSE,0.930900070871722,2024,2024-2025
SC,2024-10-31,intra-ucfe,1,0,0,1,0,0,0,0,0,0,2,4,3,3,FALSE,0.75,2024,2024-2025
SC,2024-10-31,intra-ucx,6,2,2,0,0,0,0,0,0,0,1,11,7,9,FALSE,0.818181818181818,2024,2024-2025
SC,2024-10-31,intra-ui,1992,124,46,64,40,10,8,4,3,17,499,2807,2491,2615,FALSE,0.931599572497328,2024,2024-2025
SC,2024-11-30,inter-total,62,5,0,2,3,0,0,0,0,1,14,87,76,81,FALSE,0.931034482758621,2024,2024-2025
SC,2024-11-30,inter-ucfe,0,0,0,0,0,0,0,0,0,0,0,0,0,0,FALSE,0,2024,2024-2025
SC,2024-11-30,inter-ucx,0,0,0,0,0,0,0,0,0,0,0,0,0,0,FALSE,0,2024,2024-2025
SC,2024-11-30,inter-ui,62,5,0,2,3,0,0,0,0,1,14,87,76,81,FALSE,0.931034482758621,2024,2024-2025
SC,2024-11-30,intra-total,1759,65,39,38,42,21,14,7,6,18,421,2430,2180,2245,FALSE,0.923868312757202,2024,2024-2025
SC,2024-11-30,intra-ucfe,1,0,1,0,0,0,1,0,1,0,1,5,2,2,FALSE,0.4,2024,2024-2025
SC,2024-11-30,intra-ucx,11,1,1,1,0,0,0,0,1,0,3,18,14,15,FALSE,0.833333333333333,2024,2024-2025
SC,2024-11-30,intra-ui,1747,64,37,37,42,21,13,7,4,18,417,2407,2164,2228,FALSE,0.92563356875779,2024,2024-2025
SC,2024-12-31,inter-total,84,5,1,3,0,0,0,0,0,2,21,116,105,110,FALSE,0.948275862068965,2024,2024-2025
SC,2024-12-31,inter-ucfe,0,0,0,0,0,0,0,0,0,0,0,0,0,0,FALSE,0,2024,2024-2025
SC,2024-12-31,inter-ucx,0,0,0,0,0,0,0,0,0,0,0,0,0,0,FALSE,0,2024,2024-2025
SC,2024-12-31,inter-ui,84,5,1,3,0,0,0,0,0,2,21,116,105,110,FALSE,0.948275862068965,2024,2024-2025
SC,2024-12-31,intra-total,2465,123,44,39,38,17,11,2,4,26,549,3318,3014,3137,FALSE,0.94544906570223,2024,2024-2025
SC,2024-12-31,intra-ucfe,0,0,0,0,0,1,0,0,0,1,0,2,0,0,FALSE,0,2024,2024-2025
SC,2024-12-31,intra-ucx,5,1,2,1,0,0,0,0,0,0,0,9,5,6,FALSE,0.666666666666667,2024,2024-2025
SC,2024-12-31,intra-ui,2460,122,42,38,38,16,11,2,4,25,549,3307,3009,3131,FALSE,0.946779558512247,2024,2024-2025
SD,2019-01-31,inter-total,43,5,1,0,1,0,0,0,0,0,34,84,77,82,FALSE,0.976190476190476,2018,2018-2019
SD,2019-01-31,inter-ucfe,3,0,0,0,0,0,0,0,0,0,2,5,5,5,FALSE,1,2018,2018-2019
SD,2019-01-31,inter-ucx,0,0,0,0,0,0,0,0,0,0,0,0,0,0,FALSE,0,2018,2018-2019
SD,2019-01-31,inter-ui,40,5,1,0,1,0,0,0,0,0,32,79,72,77,FALSE,0.974683544303798,2018,2018-2019
SD,2019-01-31,intra-total,892,57,9,2,1,3,0,0,1,0,514,1479,1406,1463,FALSE,0.989181879648411,2018,2018-2019
SD,2019-01-31,intra-ucfe,53,10,1,0,0,0,0,0,0,0,63,127,116,126,FALSE,0.992125984251969,2018,2018-2019
SD,2019-01-31,intra-ucx,1,0,1,0,0,0,0,0,0,0,0,2,1,1,FALSE,0.5,2018,2018-2019
SD,2019-01-31,intra-ui,838,47,7,2,1,3,0,0,1,0,451,1350,1289,1336,FALSE,0.98962962962963,2018,2018-2019
SD,2019-02-28,inter-total,15,0,1,1,1,0,0,0,0,0,18,36,33,33,FALSE,0.916666666666667,2018,2018-2019
SD,2019-02-28,inter-ucfe,1,0,0,0,0,0,0,0,0,0,1,2,2,2,FALSE,1,2018,2018-2019
SD,2019-02-28,inter-ucx,0,0,0,0,0,0,0,0,0,0,0,0,0,0,FALSE,0,2018,2018-2019
SD,2019-02-28,inter-ui,14,0,1,1,1,0,0,0,0,0,17,34,31,31,FALSE,0.911764705882353,2018,2018-2019
SD,2019-02-28,intra-total,472,21,6,0,2,4,2,0,0,0,244,751,716,737,FALSE,0.981358189081225,2018,2018-2019
SD,2019-02-28,intra-ucfe,6,3,0,0,0,0,0,0,0,0,3,12,9,12,FALSE,1,2018,2018-2019
SD,2019-02-28,intra-ucx,1,0,0,0,0,0,0,0,0,0,1,2,2,2,FALSE,1,2018,2018-2019
SD,2019-02-28,intra-ui,465,18,6,0,2,4,2,0,0,0,240,737,705,723,FALSE,0.981004070556309,2018,2018-2019
SD,2019-03-31,inter-total,21,0,1,2,0,0,0,0,0,0,10,34,31,31,FALSE,0.911764705882353,2018,2018-2019
SD,2019-03-31,inter-ucfe,0,0,0,0,0,0,0,0,0,0,0,0,0,0,FALSE,0,2018,2018-2019
SD,2019-03-31,inter-ucx,0,0,0,0,0,0,0,0,0,0,0,0,0,0,FALSE,0,2018,2018-2019
SD,2019-03-31,inter-ui,21,0,1,2,0,0,0,0,0,0,10,34,31,31,FALSE,0.911764705882353,2018,2018-2019
SD,2019-03-31,intra-total,283,13,3,1,2,0,0,0,0,1,153,456,436,449,FALSE,0.984649122807017,2018,2018-2019
SD,2019-03-31,intra-ucfe,3,0,0,0,0,0,0,0,0,0,0,3,3,3,FALSE,1,2018,2018-2019
SD,2019-03-31,intra-ucx,0,0,0,0,0,0,0,0,0,0,0,0,0,0,FALSE,0,2018,2018-2019
SD,2019-03-31,intra-ui,280,13,3,1,2,0,0,0,0,1,153,453,433,446,FALSE,0.984547461368653,2018,2018-2019
SD,2019-04-30,inter-total,9,1,0,0,0,0,0,0,0,0,10,20,19,20,FALSE,1,2018,2018-2019
SD,2019-04-30,inter-ucfe,0,0,0,0,0,0,0,0,0,0,0,0,0,0,FALSE,0,2018,2018-2019
SD,2019-04-30,inter-ucx,0,0,0,0,0,0,0,0,0,0,0,0,0,0,FALSE,0,2018,2018-2019
SD,2019-04-30,inter-ui,9,1,0,0,0,0,0,0,0,0,10,20,19,20,FALSE,1,2018,2018-2019
SD,2019-04-30,intra-total,106,12,2,1,1,0,0,0,0,0,66,188,172,184,FALSE,0.978723404255319,2018,2018-2019
SD,2019-04-30,intra-ucfe,1,0,0,0,0,0,0,0,0,0,1,2,2,2,FALSE,1,2018,2018-2019
SD,2019-04-30,intra-ucx,0,0,0,0,0,0,0,0,0,0,0,0,0,0,FALSE,0,2018,2018-2019
SD,2019-04-30,intra-ui,105,12,2,1,1,0,0,0,0,0,65,186,170,182,FALSE,0.978494623655914,2018,2018-2019
SD,2019-05-31,inter-total,8,0,1,1,0,0,0,0,0,0,4,14,12,12,FALSE,0.857142857142857,2018,2018-2019
SD,2019-05-31,inter-ucfe,0,0,0,0,0,0,0,0,0,0,0,0,0,0,FALSE,0,2018,2018-2019
SD,2019-05-31,inter-ucx,0,0,0,0,0,0,0,0,0,0,0,0,0,0,FALSE,0,2018,2018-2019
SD,2019-05-31,inter-ui,8,0,1,1,0,0,0,0,0,0,4,14,12,12,FALSE,0.857142857142857,2018,2018-2019
SD,2019-05-31,intra-total,148,8,2,2,1,1,0,1,0,0,60,223,208,216,FALSE,0.968609865470852,2018,2018-2019
SD,2019-05-31,intra-ucfe,8,0,0,0,0,0,0,0,0,0,4,12,12,12,FALSE,1,2018,2018-2019
SD,2019-05-31,intra-ucx,0,0,0,0,0,0,0,0,0,0,0,0,0,0,FALSE,0,2018,2018-2019
SD,2019-05-31,intra-ui,140,8,2,2,1,1,0,1,0,0,56,211,196,204,FALSE,0.966824644549763,2018,2018-2019
SD,2019-06-30,inter-total,11,0,0,0,0,0,1,0,0,0,6,18,17,17,FALSE,0.944444444444444,2018,2018-2019
SD,2019-06-30,inter-ucfe,0,0,0,0,0,0,0,0,0,0,0,0,0,0,FALSE,0,2018,2018-2019
SD,2019-06-30,inter-ucx,0,0,0,0,0,0,0,0,0,0,0,0,0,0,FALSE,0,2018,2018-2019
SD,2019-06-30,inter-ui,11,0,0,0,0,0,1,0,0,0,6,18,17,17,FALSE,0.944444444444444,2018,2018-2019
SD,2019-06-30,intra-total,258,15,2,1,0,0,1,0,0,0,97,374,355,370,FALSE,0.989304812834225,2018,2018-2019
SD,2019-06-30,intra-ucfe,80,0,0,0,0,0,0,0,0,0,16,96,96,96,FALSE,1,2018,2018-2019
SD,2019-06-30,intra-ucx,1,0,0,0,0,0,0,0,0,0,0,1,1,1,FALSE,1,2018,2018-2019
SD,2019-06-30,intra-ui,177,15,2,1,0,0,1,0,0,0,81,277,258,273,FALSE,0.985559566787004,2018,2018-2019
SD,2019-07-31,inter-total,11,0,1,0,0,0,0,0,0,0,9,21,20,20,FALSE,0.952380952380952,2019,2019-2020
SD,2019-07-31,inter-ucfe,0,0,0,0,0,0,0,0,0,0,2,2,2,2,FALSE,1,2019,2019-2020
SD,2019-07-31,inter-ucx,0,0,0,0,0,0,0,0,0,0,0,0,0,0,FALSE,0,2019,2019-2020
SD,2019-07-31,inter-ui,11,0,1,0,0,0,0,0,0,0,7,19,18,18,FALSE,0.947368421052632,2019,2019-2020
SD,2019-07-31,intra-total,285,10,3,0,0,0,2,0,1,0,107,408,392,402,FALSE,0.985294117647059,2019,2019-2020
SD,2019-07-31,intra-ucfe,89,0,0,0,0,0,0,0,0,0,17,106,106,106,FALSE,1,2019,2019-2020
SD,2019-07-31,intra-ucx,0,0,0,0,0,0,0,0,0,0,0,0,0,0,FALSE,0,2019,2019-2020
SD,2019-07-31,intra-ui,196,10,3,0,0,0,2,0,1,0,90,302,286,296,FALSE,0.980132450331126,2019,2019-2020
SD,2019-08-31,inter-total,7,0,1,0,0,0,1,0,0,0,6,15,13,13,FALSE,0.866666666666667,2019,2019-2020
SD,2019-08-31,inter-ucfe,0,0,0,0,0,0,0,0,0,0,1,1,1,1,FALSE,1,2019,2019-2020
SD,2019-08-31,inter-ucx,0,0,0,0,0,0,0,0,0,0,0,0,0,0,FALSE,0,2019,2019-2020
SD,2019-08-31,inter-ui,7,0,1,0,0,0,1,0,0,0,5,14,12,12,FALSE,0.857142857142857,2019,2019-2020
SD,2019-08-31,intra-total,160,10,0,3,2,2,1,0,0,0,63,241,223,233,FALSE,0.966804979253112,2019,2019-2020
SD,2019-08-31,intra-ucfe,30,0,0,0,0,0,0,0,0,0,12,42,42,42,FALSE,1,2019,2019-2020
SD,2019-08-31,intra-ucx,0,0,0,0,0,0,0,0,0,0,0,0,0,0,FALSE,0,2019,2019-2020
SD,2019-08-31,intra-ui,130,10,0,3,2,2,1,0,0,0,51,199,181,191,FALSE,0.959798994974874,2019,2019-2020
SD,2019-09-30,inter-total,5,1,0,1,0,0,0,0,0,0,7,14,12,13,FALSE,0.928571428571429,2019,2019-2020
SD,2019-09-30,inter-ucfe,0,0,0,0,0,0,0,0,0,0,0,0,0,0,FALSE,0,2019,2019-2020
SD,2019-09-30,inter-ucx,0,0,0,0,0,0,0,0,0,0,0,0,0,0,FALSE,0,2019,2019-2020
SD,2019-09-30,inter-ui,5,1,0,1,0,0,0,0,0,0,7,14,12,13,FALSE,0.928571428571429,2019,2019-2020
SD,2019-09-30,intra-total,77,6,0,1,0,0,0,0,0,1,57,142,134,140,FALSE,0.985915492957746,2019,2019-2020
SD,2019-09-30,intra-ucfe,0,0,0,0,0,0,0,0,0,0,0,0,0,0,FALSE,0,2019,2019-2020
SD,2019-09-30,intra-ucx,0,0,0,0,0,0,0,0,0,0,1,1,1,1,FALSE,1,2019,2019-2020
SD,2019-09-30,intra-ui,77,6,0,1,0,0,0,0,0,1,56,141,133,139,FALSE,0.985815602836879,2019,2019-2020
SD,2019-10-31,inter-total,15,1,0,1,0,0,0,0,0,0,4,21,19,20,FALSE,0.952380952380952,2019,2019-2020
SD,2019-10-31,inter-ucfe,1,0,0,0,0,0,0,0,0,0,0,1,1,1,FALSE,1,2019,2019-2020
SD,2019-10-31,inter-ucx,0,0,0,0,0,0,0,0,0,0,0,0,0,0,FALSE,0,2019,2019-2020
SD,2019-10-31,inter-ui,14,1,0,1,0,0,0,0,0,0,4,20,18,19,FALSE,0.95,2019,2019-2020
SD,2019-10-31,intra-total,128,4,2,0,3,0,0,2,0,1,54,194,182,186,FALSE,0.958762886597938,2019,2019-2020
SD,2019-10-31,intra-ucfe,1,0,1,0,0,0,0,0,0,0,1,3,2,2,FALSE,0.666666666666667,2019,2019-2020
SD,2019-10-31,intra-ucx,0,0,0,0,0,0,0,0,0,0,0,0,0,0,FALSE,0,2019,2019-2020
SD,2019-10-31,intra-ui,127,4,1,0,3,0,0,2,0,1,53,191,180,184,FALSE,0.963350785340314,2019,2019-2020
SD,2019-11-30,inter-total,17,2,0,0,0,0,0,0,0,0,8,27,25,27,FALSE,1,2019,2019-2020
SD,2019-11-30,inter-ucfe,0,0,0,0,0,0,0,0,0,0,1,1,1,1,FALSE,1,2019,2019-2020
SD,2019-11-30,inter-ucx,0,0,0,0,0,0,0,0,0,0,0,0,0,0,FALSE,0,2019,2019-2020
SD,2019-11-30,inter-ui,17,2,0,0,0,0,0,0,0,0,7,26,24,26,FALSE,1,2019,2019-2020
SD,2019-11-30,intra-total,181,5,2,4,0,0,0,0,0,0,83,275,264,269,FALSE,0.978181818181818,2019,2019-2020
SD,2019-11-30,intra-ucfe,6,1,0,0,0,0,0,0,0,0,1,8,7,8,FALSE,1,2019,2019-2020
SD,2019-11-30,intra-ucx,0,0,0,0,0,0,0,0,0,0,0,0,0,0,FALSE,0,2019,2019-2020
SD,2019-11-30,intra-ui,175,4,2,4,0,0,0,0,0,0,82,267,257,261,FALSE,0.97752808988764,2019,2019-2020
SD,2019-12-31,inter-total,43,1,2,2,0,0,0,0,0,0,25,73,68,69,FALSE,0.945205479452055,2019,2019-2020
SD,2019-12-31,inter-ucfe,1,1,0,0,0,0,0,0,0,0,2,4,3,4,FALSE,1,2019,2019-2020
SD,2019-12-31,inter-ucx,0,0,0,0,0,0,0,0,0,0,0,0,0,0,FALSE,0,2019,2019-2020
SD,2019-12-31,inter-ui,42,0,2,2,0,0,0,0,0,0,23,69,65,65,FALSE,0.942028985507246,2019,2019-2020
SD,2019-12-31,intra-total,548,17,3,2,1,0,0,0,0,0,273,844,821,838,FALSE,0.992890995260663,2019,2019-2020
SD,2019-12-31,intra-ucfe,5,0,0,0,0,0,0,0,0,0,3,8,8,8,FALSE,1,2019,2019-2020
SD,2019-12-31,intra-ucx,1,0,0,0,0,0,0,0,0,0,0,1,1,1,FALSE,1,2019,2019-2020
SD,2019-12-31,intra-ui,542,17,3,2,1,0,0,0,0,0,270,835,812,829,FALSE,0.992814371257485,2019,2019-2020
SD,2020-01-31,inter-total,45,5,2,1,0,0,0,0,0,0,35,88,80,85,FALSE,0.965909090909091,2019,2019-2020
SD,2020-01-31,inter-ucfe,1,0,0,0,0,0,0,0,0,0,1,2,2,2,FALSE,1,2019,2019-2020
SD,2020-01-31,inter-ucx,1,0,0,0,0,0,0,0,0,0,0,1,1,1,FALSE,1,2019,2019-2020
SD,2020-01-31,inter-ui,43,5,2,1,0,0,0,0,0,0,34,85,77,82,FALSE,0.964705882352941,2019,2019-2020
SD,2020-01-31,intra-total,697,31,11,4,2,3,2,0,0,1,454,1205,1151,1182,FALSE,0.980912863070539,2019,2019-2020
SD,2020-01-31,intra-ucfe,11,0,2,0,0,0,0,0,0,0,3,16,14,14,FALSE,0.875,2019,2019-2020
SD,2020-01-31,intra-ucx,1,0,0,0,0,0,0,0,0,0,0,1,1,1,FALSE,1,2019,2019-2020
SD,2020-01-31,intra-ui,685,31,9,4,2,3,2,0,0,1,451,1188,1136,1167,FALSE,0.982323232323232,2019,2019-2020
SD,2020-02-29,inter-total,15,3,0,2,1,1,0,0,0,0,16,38,31,34,FALSE,0.894736842105263,2019,2019-2020
SD,2020-02-29,inter-ucfe,0,0,0,0,0,0,0,0,0,0,1,1,1,1,FALSE,1,2019,2019-2020
SD,2020-02-29,inter-ucx,0,0,0,0,0,0,0,0,0,0,0,0,0,0,FALSE,0,2019,2019-2020
SD,2020-02-29,inter-ui,15,3,0,2,1,1,0,0,0,0,15,37,30,33,FALSE,0.891891891891892,2019,2019-2020
SD,2020-02-29,intra-total,391,13,6,1,3,4,1,1,0,2,187,609,578,591,FALSE,0.970443349753695,2019,2019-2020
SD,2020-02-29,intra-ucfe,6,0,0,0,0,0,0,0,0,0,7,13,13,13,FALSE,1,2019,2019-2020
SD,2020-02-29,intra-ucx,1,0,0,0,0,0,0,0,0,0,0,1,1,1,FALSE,1,2019,2019-2020
SD,2020-02-29,intra-ui,384,13,6,1,3,4,1,1,0,2,180,595,564,577,FALSE,0.969747899159664,2019,2019-2020
SD,2020-03-31,inter-total,32,1,2,1,0,0,0,0,0,0,5,41,37,38,FALSE,0.926829268292683,2019,2019-2020
SD,2020-03-31,inter-ucfe,0,0,0,0,0,0,0,0,0,0,0,0,0,0,FALSE,0,2019,2019-2020
SD,2020-03-31,inter-ucx,0,0,0,0,0,0,0,0,0,0,0,0,0,0,FALSE,0,2019,2019-2020
SD,2020-03-31,inter-ui,32,1,2,1,0,0,0,0,0,0,5,41,37,38,FALSE,0.926829268292683,2019,2019-2020
SD,2020-03-31,intra-total,633,9,1,2,0,0,1,0,0,1,120,767,753,762,FALSE,0.99348109517601,2019,2019-2020
SD,2020-03-31,intra-ucfe,5,0,0,0,0,0,0,0,0,0,0,5,5,5,FALSE,1,2019,2019-2020
SD,2020-03-31,intra-ucx,0,0,0,0,0,0,0,0,0,0,1,1,1,1,FALSE,1,2019,2019-2020
SD,2020-03-31,intra-ui,628,9,1,2,0,0,1,0,0,1,119,761,747,756,FALSE,0.993429697766097,2019,2019-2020
SD,2020-04-30,inter-total,499,20,2,0,0,0,0,0,0,0,60,581,559,579,FALSE,0.996557659208262,2019,2019-2020
SD,2020-04-30,inter-ucfe,0,0,0,0,0,0,0,0,0,0,0,0,0,0,FALSE,0,2019,2019-2020
SD,2020-04-30,inter-ucx,0,0,0,0,0,0,0,0,0,0,0,0,0,0,FALSE,0,2019,2019-2020
SD,2020-04-30,inter-ui,499,20,2,0,0,0,0,0,0,0,60,581,559,579,FALSE,0.996557659208262,2019,2019-2020
SD,2020-04-30,intra-total,14964,501,125,6,2,1,1,1,0,0,1921,17522,16885,17386,FALSE,0.992238328957882,2019,2019-2020
SD,2020-04-30,intra-ucfe,0,0,0,0,0,0,0,0,0,0,0,0,0,0,FALSE,0,2019,2019-2020
SD,2020-04-30,intra-ucx,0,0,0,0,0,0,0,0,0,0,0,0,0,0,FALSE,0,2019,2019-2020
SD,2020-04-30,intra-ui,14964,501,125,6,2,1,1,1,0,0,1921,17522,16885,17386,FALSE,0.992238328957882,2019,2019-2020
SD,2020-05-31,inter-total,121,35,30,20,12,7,2,0,0,0,52,279,173,208,FALSE,0.745519713261649,2019,2019-2020
SD,2020-05-31,inter-ucfe,0,0,0,0,0,0,0,0,0,0,0,0,0,0,FALSE,0,2019,2019-2020
SD,2020-05-31,inter-ucx,0,0,0,0,0,0,0,0,0,0,0,0,0,0,FALSE,0,2019,2019-2020
SD,2020-05-31,inter-ui,121,35,30,20,12,7,2,0,0,0,52,279,173,208,FALSE,0.745519713261649,2019,2019-2020
SD,2020-05-31,intra-total,3417,620,507,477,244,83,31,5,0,1,1310,6695,4727,5347,FALSE,0.79865571321882,2019,2019-2020
SD,2020-05-31,intra-ucfe,5,2,3,0,0,0,0,0,0,0,4,14,9,11,FALSE,0.785714285714286,2019,2019-2020
SD,2020-05-31,intra-ucx,2,2,1,1,0,1,0,0,0,0,0,7,2,4,FALSE,0.571428571428571,2019,2019-2020
SD,2020-05-31,intra-ui,3410,616,503,476,244,82,31,5,0,1,1306,6674,4716,5332,FALSE,0.798921186694636,2019,2019-2020
SD,2020-06-30,inter-total,54,4,7,10,5,8,9,2,8,2,13,122,67,71,FALSE,0.581967213114754,2019,2019-2020
SD,2020-06-30,inter-ucfe,0,0,0,0,0,0,0,0,0,0,0,0,0,0,FALSE,0,2019,2019-2020
SD,2020-06-30,inter-ucx,0,0,0,0,0,0,0,0,0,0,0,0,0,0,FALSE,0,2019,2019-2020
SD,2020-06-30,inter-ui,54,4,7,10,5,8,9,2,8,2,13,122,67,71,FALSE,0.581967213114754,2019,2019-2020
SD,2020-06-30,intra-total,2496,207,241,225,222,212,212,172,98,41,454,4580,2950,3157,FALSE,0.689301310043668,2019,2019-2020
SD,2020-06-30,intra-ucfe,24,27,5,5,1,0,0,0,1,0,10,73,34,61,FALSE,0.835616438356164,2019,2019-2020
SD,2020-06-30,intra-ucx,2,1,0,0,0,0,0,0,0,0,0,3,2,3,FALSE,1,2019,2019-2020
SD,2020-06-30,intra-ui,2470,179,236,220,221,212,212,172,97,41,444,4504,2914,3093,FALSE,0.686722912966252,2019,2019-2020
SD,2020-07-31,inter-total,9,3,6,6,8,2,0,2,1,11,4,52,13,16,FALSE,0.307692307692308,2020,2020-2021
SD,2020-07-31,inter-ucfe,1,0,0,0,0,0,0,0,0,0,0,1,1,1,FALSE,1,2020,2020-2021
SD,2020-07-31,inter-ucx,0,0,0,0,0,0,0,0,0,0,0,0,0,0,FALSE,0,2020,2020-2021
SD,2020-07-31,inter-ui,8,3,6,6,8,2,0,2,1,11,4,51,12,15,FALSE,0.294117647058824,2020,2020-2021
SD,2020-07-31,intra-total,665,73,69,83,54,46,71,79,114,268,271,1793,936,1009,FALSE,0.562744004461796,2020,2020-2021
SD,2020-07-31,intra-ucfe,25,6,6,5,5,4,4,2,0,2,13,72,38,44,FALSE,0.611111111111111,2020,2020-2021
SD,2020-07-31,intra-ucx,3,0,1,1,0,0,0,0,0,0,0,5,3,3,FALSE,0.6,2020,2020-2021
SD,2020-07-31,intra-ui,637,67,62,77,49,42,67,77,114,266,258,1716,895,962,FALSE,0.560606060606061,2020,2020-2021
SD,2020-08-31,inter-total,4,4,6,2,5,2,3,0,2,25,2,55,6,10,FALSE,0.181818181818182,2020,2020-2021
SD,2020-08-31,inter-ucfe,0,0,0,0,0,0,0,0,1,2,0,3,0,0,FALSE,0,2020,2020-2021
SD,2020-08-31,inter-ucx,0,0,0,0,0,0,0,0,0,0,0,0,0,0,FALSE,0,2020,2020-2021
SD,2020-08-31,inter-ui,4,4,6,2,5,2,3,0,1,23,2,52,6,10,FALSE,0.192307692307692,2020,2020-2021
SD,2020-08-31,intra-total,120,78,98,125,152,71,56,34,34,465,91,1324,211,289,FALSE,0.218277945619335,2020,2020-2021
SD,2020-08-31,intra-ucfe,2,9,17,15,5,6,4,3,2,7,12,82,14,23,FALSE,0.280487804878049,2020,2020-2021
SD,2020-08-31,intra-ucx,0,0,0,0,0,0,0,0,0,0,0,0,0,0,FALSE,0,2020,2020-2021
SD,2020-08-31,intra-ui,118,69,81,110,147,65,52,31,32,458,79,1242,197,266,FALSE,0.214170692431562,2020,2020-2021
SD,2020-09-30,inter-total,3,2,3,6,2,3,0,2,3,20,4,48,7,9,FALSE,0.1875,2020,2020-2021
SD,2020-09-30,inter-ucfe,0,0,0,0,0,0,0,0,0,0,0,0,0,0,FALSE,0,2020,2020-2021
SD,2020-09-30,inter-ucx,0,0,0,0,0,0,0,0,0,0,0,0,0,0,FALSE,0,2020,2020-2021
SD,2020-09-30,inter-ui,3,2,3,6,2,3,0,2,3,20,4,48,7,9,FALSE,0.1875,2020,2020-2021
SD,2020-09-30,intra-total,81,21,20,17,29,30,21,17,18,409,38,701,119,140,FALSE,0.199714693295292,2020,2020-2021
SD,2020-09-30,intra-ucfe,0,1,4,4,7,5,3,1,0,10,2,37,2,3,FALSE,0.0810810810810811,2020,2020-2021
SD,2020-09-30,intra-ucx,0,0,0,0,0,0,0,0,0,0,0,0,0,0,FALSE,0,2020,2020-2021
SD,2020-09-30,intra-ui,81,20,16,13,22,25,18,16,18,399,36,664,117,137,FALSE,0.206325301204819,2020,2020-2021
SD,2020-10-31,inter-total,5,1,1,1,1,1,0,0,0,22,1,33,6,7,FALSE,0.212121212121212,2020,2020-2021
SD,2020-10-31,inter-ucfe,0,0,0,0,0,0,0,0,0,0,0,0,0,0,FALSE,0,2020,2020-2021
SD,2020-10-31,inter-ucx,0,0,0,0,0,0,0,0,0,0,0,0,0,0,FALSE,0,2020,2020-2021
SD,2020-10-31,inter-ui,5,1,1,1,1,1,0,0,0,22,1,33,6,7,FALSE,0.212121212121212,2020,2020-2021
SD,2020-10-31,intra-total,50,11,4,4,6,4,4,11,11,370,34,509,84,95,FALSE,0.18664047151277,2020,2020-2021
SD,2020-10-31,intra-ucfe,1,0,0,0,0,0,1,0,0,3,0,5,1,1,FALSE,0.2,2020,2020-2021
SD,2020-10-31,intra-ucx,0,0,0,0,0,0,1,0,0,0,0,1,0,0,FALSE,0,2020,2020-2021
SD,2020-10-31,intra-ui,49,11,4,4,6,4,2,11,11,367,34,503,83,94,FALSE,0.186878727634195,2020,2020-2021
SD,2020-11-30,inter-total,21,7,5,1,2,1,0,1,1,22,17,78,38,45,FALSE,0.576923076923077,2020,2020-2021
SD,2020-11-30,inter-ucfe,1,0,1,0,0,0,0,0,0,0,2,4,3,3,FALSE,0.75,2020,2020-2021
SD,2020-11-30,inter-ucx,0,0,0,0,0,0,0,0,0,0,0,0,0,0,FALSE,0,2020,2020-2021
SD,2020-11-30,inter-ui,20,7,4,1,2,1,0,1,1,22,15,74,35,42,FALSE,0.567567567567568,2020,2020-2021
SD,2020-11-30,intra-total,99,46,19,9,7,4,8,4,5,297,126,624,225,271,FALSE,0.434294871794872,2020,2020-2021
SD,2020-11-30,intra-ucfe,0,1,2,1,0,0,0,0,0,3,4,11,4,5,FALSE,0.454545454545455,2020,2020-2021
SD,2020-11-30,intra-ucx,0,0,0,0,0,0,0,0,0,0,0,0,0,0,FALSE,0,2020,2020-2021
SD,2020-11-30,intra-ui,99,45,17,8,7,4,8,4,5,294,122,613,221,266,FALSE,0.433931484502447,2020,2020-2021
SD,2020-12-31,inter-total,33,12,4,3,1,0,3,0,1,20,35,112,68,80,FALSE,0.714285714285714,2020,2020-2021
SD,2020-12-31,inter-ucfe,0,0,0,0,0,0,0,0,0,1,0,1,0,0,FALSE,0,2020,2020-2021
SD,2020-12-31,inter-ucx,0,0,0,0,0,0,0,0,0,0,0,0,0,0,FALSE,0,2020,2020-2021
SD,2020-12-31,inter-ui,33,12,4,3,1,0,3,0,1,19,35,111,68,80,FALSE,0.720720720720721,2020,2020-2021
SD,2020-12-31,intra-total,351,68,15,14,8,10,9,9,6,285,337,1112,688,756,FALSE,0.679856115107914,2020,2020-2021
SD,2020-12-31,intra-ucfe,6,2,0,0,0,0,1,0,0,8,6,23,12,14,FALSE,0.608695652173913,2020,2020-2021
SD,2020-12-31,intra-ucx,1,0,0,0,0,0,0,0,0,1,0,2,1,1,FALSE,0.5,2020,2020-2021
SD,2020-12-31,intra-ui,344,66,15,14,8,10,8,9,6,276,331,1087,675,741,FALSE,0.681692732290708,2020,2020-2021
SD,2021-01-31,inter-total,32,6,3,0,1,0,0,0,2,18,35,97,67,73,FALSE,0.752577319587629,2020,2020-2021
SD,2021-01-31,inter-ucfe,0,0,0,0,0,0,0,0,0,0,0,0,0,0,FALSE,0,2020,2020-2021
SD,2021-01-31,inter-ucx,0,0,0,0,0,0,0,0,0,0,0,0,0,0,FALSE,0,2020,2020-2021
SD,2021-01-31,inter-ui,32,6,3,0,1,0,0,0,2,18,35,97,67,73,FALSE,0.752577319587629,2020,2020-2021
SD,2021-01-31,intra-total,498,43,26,14,5,7,8,3,1,208,492,1305,990,1033,FALSE,0.791570881226054,2020,2020-2021
SD,2021-01-31,intra-ucfe,4,0,0,0,2,1,1,0,0,1,15,24,19,19,FALSE,0.791666666666667,2020,2020-2021
SD,2021-01-31,intra-ucx,0,0,0,0,0,0,0,0,0,0,0,0,0,0,FALSE,0,2020,2020-2021
SD,2021-01-31,intra-ui,494,43,26,14,3,6,7,3,1,207,477,1281,971,1014,FALSE,0.791569086651054,2020,2020-2021
SD,2021-02-28,inter-total,16,5,7,5,2,0,1,0,1,14,28,79,44,49,FALSE,0.620253164556962,2020,2020-2021
SD,2021-02-28,inter-ucfe,0,0,0,1,0,0,0,0,1,0,0,2,0,0,FALSE,0,2020,2020-2021
SD,2021-02-28,inter-ucx,0,0,0,0,0,0,0,0,0,0,0,0,0,0,FALSE,0,2020,2020-2021
SD,2021-02-28,inter-ui,16,5,7,4,2,0,1,0,0,14,28,77,44,49,FALSE,0.636363636363636,2020,2020-2021
SD,2021-02-28,intra-total,304,58,32,21,14,7,6,5,7,196,302,952,606,664,FALSE,0.697478991596639,2020,2020-2021
SD,2021-02-28,intra-ucfe,2,1,1,3,0,0,1,0,0,1,4,13,6,7,FALSE,0.538461538461538,2020,2020-2021
SD,2021-02-28,intra-ucx,0,0,0,0,0,0,0,0,0,0,0,0,0,0,FALSE,0,2020,2020-2021
SD,2021-02-28,intra-ui,302,57,31,18,14,7,5,5,7,195,298,939,600,657,FALSE,0.699680511182109,2020,2020-2021
SD,2021-03-31,inter-total,24,7,3,2,1,3,5,4,4,24,31,108,55,62,FALSE,0.574074074074074,2020,2020-2021
SD,2021-03-31,inter-ucfe,0,1,0,0,0,0,0,0,0,1,0,2,0,1,FALSE,0.5,2020,2020-2021
SD,2021-03-31,inter-ucx,0,0,0,0,0,0,0,0,0,0,0,0,0,0,FALSE,0,2020,2020-2021
SD,2021-03-31,inter-ui,24,6,3,2,1,3,5,4,4,23,31,106,55,61,FALSE,0.575471698113208,2020,2020-2021
SD,2021-03-31,intra-total,137,22,14,17,11,16,12,13,23,223,196,684,333,355,FALSE,0.519005847953216,2020,2020-2021
SD,2021-03-31,intra-ucfe,1,1,0,1,0,2,0,0,0,2,3,10,4,5,FALSE,0.5,2020,2020-2021
SD,2021-03-31,intra-ucx,0,0,0,0,0,0,0,0,1,0,0,1,0,0,FALSE,0,2020,2020-2021
SD,2021-03-31,intra-ui,136,21,14,16,11,14,12,13,22,221,193,673,329,350,FALSE,0.520059435364042,2020,2020-2021
SD,2021-04-30,inter-total,8,3,2,2,2,4,4,2,3,19,7,56,15,18,FALSE,0.321428571428571,2020,2020-2021
SD,2021-04-30,inter-ucfe,0,0,0,0,0,0,0,2,0,0,0,2,0,0,FALSE,0,2020,2020-2021
SD,2021-04-30,inter-ucx,0,0,0,0,0,0,0,0,0,0,0,0,0,0,FALSE,0,2020,2020-2021
SD,2021-04-30,inter-ui,8,3,2,2,2,4,4,0,3,19,7,54,15,18,FALSE,0.333333333333333,2020,2020-2021
SD,2021-04-30,intra-total,103,14,8,7,13,14,13,17,35,113,108,445,211,225,FALSE,0.50561797752809,2020,2020-2021
SD,2021-04-30,intra-ucfe,5,1,0,0,0,0,0,1,1,0,1,9,6,7,FALSE,0.777777777777778,2020,2020-2021
SD,2021-04-30,intra-ucx,0,0,0,0,0,0,0,0,0,0,0,0,0,0,FALSE,0,2020,2020-2021
SD,2021-04-30,intra-ui,98,13,8,7,13,14,13,16,34,113,107,436,205,218,FALSE,0.5,2020,2020-2021
SD,2021-05-31,inter-total,7,1,0,1,2,1,2,0,0,8,4,26,11,12,FALSE,0.461538461538462,2020,2020-2021
SD,2021-05-31,inter-ucfe,0,0,0,0,0,0,0,0,0,0,0,0,0,0,FALSE,0,2020,2020-2021
SD,2021-05-31,inter-ucx,1,0,0,0,0,0,0,0,0,0,0,1,1,1,FALSE,1,2020,2020-2021
SD,2021-05-31,inter-ui,6,1,0,1,2,1,2,0,0,8,4,25,10,11,FALSE,0.44,2020,2020-2021
SD,2021-05-31,intra-total,64,25,18,21,20,16,13,10,7,51,61,306,125,150,FALSE,0.490196078431373,2020,2020-2021
SD,2021-05-31,intra-ucfe,2,2,0,0,0,0,0,0,0,0,5,9,7,9,FALSE,1,2020,2020-2021
SD,2021-05-31,intra-ucx,0,0,0,0,0,0,0,0,0,0,0,0,0,0,FALSE,0,2020,2020-2021
SD,2021-05-31,intra-ui,62,23,18,21,20,16,13,10,7,51,56,297,118,141,FALSE,0.474747474747475,2020,2020-2021
SD,2021-06-30,inter-total,8,5,2,2,2,0,0,0,1,6,2,28,10,15,FALSE,0.535714285714286,2020,2020-2021
SD,2021-06-30,inter-ucfe,0,0,0,0,0,0,0,0,0,0,0,0,0,0,FALSE,0,2020,2020-2021
SD,2021-06-30,inter-ucx,0,0,0,0,0,0,0,0,0,0,0,0,0,0,FALSE,0,2020,2020-2021
SD,2021-06-30,inter-ui,8,5,2,2,2,0,0,0,1,6,2,28,10,15,FALSE,0.535714285714286,2020,2020-2021
SD,2021-06-30,intra-total,112,33,12,18,6,4,2,1,3,55,107,353,219,252,FALSE,0.713881019830028,2020,2020-2021
SD,2021-06-30,intra-ucfe,9,0,0,0,1,0,0,0,0,2,1,13,10,10,FALSE,0.769230769230769,2020,2020-2021
SD,2021-06-30,intra-ucx,0,0,0,0,0,0,0,0,0,0,0,0,0,0,FALSE,0,2020,2020-2021
SD,2021-06-30,intra-ui,103,33,12,18,5,4,2,1,3,53,106,340,209,242,FALSE,0.711764705882353,2020,2020-2021
SD,2021-07-31,inter-total,8,3,0,0,0,0,0,0,1,8,2,22,10,13,FALSE,0.590909090909091,2021,2021-2022
SD,2021-07-31,inter-ucfe,1,0,0,0,0,0,0,0,0,0,0,1,1,1,FALSE,1,2021,2021-2022
SD,2021-07-31,inter-ucx,0,0,0,0,0,0,0,0,0,0,0,0,0,0,FALSE,0,2021,2021-2022
SD,2021-07-31,inter-ui,7,3,0,0,0,0,0,0,1,8,2,21,9,12,FALSE,0.571428571428571,2021,2021-2022
SD,2021-07-31,intra-total,220,19,10,9,1,2,3,1,2,50,108,425,328,347,FALSE,0.816470588235294,2021,2021-2022
SD,2021-07-31,intra-ucfe,96,5,0,1,0,0,0,0,0,0,31,133,127,132,FALSE,0.992481203007519,2021,2021-2022
SD,2021-07-31,intra-ucx,0,0,0,0,0,0,0,0,0,0,0,0,0,0,FALSE,0,2021,2021-2022
SD,2021-07-31,intra-ui,124,14,10,8,1,2,3,1,2,50,77,292,201,215,FALSE,0.736301369863014,2021,2021-2022
SD,2021-08-31,inter-total,6,1,0,1,1,0,0,0,0,2,3,14,9,10,FALSE,0.714285714285714,2021,2021-2022
SD,2021-08-31,inter-ucfe,0,0,0,0,0,0,0,0,0,0,0,0,0,0,FALSE,0,2021,2021-2022
SD,2021-08-31,inter-ucx,0,0,0,0,0,0,0,0,0,0,0,0,0,0,FALSE,0,2021,2021-2022
SD,2021-08-31,inter-ui,6,1,0,1,1,0,0,0,0,2,3,14,9,10,FALSE,0.714285714285714,2021,2021-2022
SD,2021-08-31,intra-total,122,7,6,0,1,2,0,1,2,50,59,250,181,188,FALSE,0.752,2021,2021-2022
SD,2021-08-31,intra-ucfe,27,0,1,0,0,0,0,0,0,0,18,46,45,45,FALSE,0.978260869565217,2021,2021-2022
SD,2021-08-31,intra-ucx,0,0,0,0,0,0,0,0,0,0,0,0,0,0,FALSE,0,2021,2021-2022
SD,2021-08-31,intra-ui,95,7,5,0,1,2,0,1,2,50,41,204,136,143,FALSE,0.700980392156863,2021,2021-2022
SD,2021-09-30,inter-total,3,1,0,0,0,0,0,0,0,1,7,12,10,11,FALSE,0.916666666666667,2021,2021-2022
SD,2021-09-30,inter-ucfe,0,0,0,0,0,0,0,0,0,0,0,0,0,0,FALSE,0,2021,2021-2022
SD,2021-09-30,inter-ucx,0,0,0,0,0,0,0,0,0,0,0,0,0,0,FALSE,0,2021,2021-2022
SD,2021-09-30,inter-ui,3,1,0,0,0,0,0,0,0,1,7,12,10,11,FALSE,0.916666666666667,2021,2021-2022
SD,2021-09-30,intra-total,78,4,2,1,1,2,1,0,1,12,38,140,116,120,FALSE,0.857142857142857,2021,2021-2022
SD,2021-09-30,intra-ucfe,0,0,0,0,0,0,0,0,0,0,0,0,0,0,FALSE,0,2021,2021-2022
SD,2021-09-30,intra-ucx,0,0,0,0,0,0,0,0,0,0,0,0,0,0,FALSE,0,2021,2021-2022
SD,2021-09-30,intra-ui,78,4,2,1,1,2,1,0,1,12,38,140,116,120,FALSE,0.857142857142857,2021,2021-2022
SD,2021-10-31,inter-total,9,1,2,0,0,0,0,0,0,3,1,16,10,11,FALSE,0.6875,2021,2021-2022
SD,2021-10-31,inter-ucfe,0,0,0,0,0,0,0,0,0,0,0,0,0,0,FALSE,0,2021,2021-2022
SD,2021-10-31,inter-ucx,0,0,0,0,0,0,0,0,0,0,0,0,0,0,FALSE,0,2021,2021-2022
SD,2021-10-31,inter-ui,9,1,2,0,0,0,0,0,0,3,1,16,10,11,FALSE,0.6875,2021,2021-2022
SD,2021-10-31,intra-total,65,5,6,2,1,0,0,0,0,9,36,124,101,106,FALSE,0.854838709677419,2021,2021-2022
SD,2021-10-31,intra-ucfe,1,0,0,0,0,0,0,0,0,0,0,1,1,1,FALSE,1,2021,2021-2022
SD,2021-10-31,intra-ucx,0,0,0,0,0,0,0,0,0,0,0,0,0,0,FALSE,0,2021,2021-2022
SD,2021-10-31,intra-ui,64,5,6,2,1,0,0,0,0,9,36,123,100,105,FALSE,0.853658536585366,2021,2021-2022
SD,2021-11-30,inter-total,18,2,0,0,1,1,1,0,0,5,15,43,33,35,FALSE,0.813953488372093,2021,2021-2022
SD,2021-11-30,inter-ucfe,1,0,0,0,0,0,0,0,0,0,1,2,2,2,FALSE,1,2021,2021-2022
SD,2021-11-30,inter-ucx,0,0,0,0,0,0,0,0,0,0,0,0,0,0,FALSE,0,2021,2021-2022
SD,2021-11-30,inter-ui,17,2,0,0,1,1,1,0,0,5,14,41,31,33,FALSE,0.804878048780488,2021,2021-2022
SD,2021-11-30,intra-total,92,16,0,0,2,1,0,0,0,21,81,213,173,189,FALSE,0.887323943661972,2021,2021-2022
SD,2021-11-30,intra-ucfe,4,0,0,0,0,0,0,0,0,0,2,6,6,6,FALSE,1,2021,2021-2022
SD,2021-11-30,intra-ucx,0,0,0,0,0,0,0,0,0,1,0,1,0,0,FALSE,0,2021,2021-2022
SD,2021-11-30,intra-ui,88,16,0,0,2,1,0,0,0,20,79,206,167,183,FALSE,0.888349514563107,2021,2021-2022
SD,2021-12-31,inter-total,52,1,2,2,0,0,0,1,0,1,19,78,71,72,FALSE,0.923076923076923,2021,2021-2022
SD,2021-12-31,inter-ucfe,1,0,1,0,0,0,0,0,0,0,2,4,3,3,FALSE,0.75,2021,2021-2022
SD,2021-12-31,inter-ucx,0,0,0,0,0,0,0,0,0,0,0,0,0,0,FALSE,0,2021,2021-2022
SD,2021-12-31,inter-ui,51,1,1,2,0,0,0,1,0,1,17,74,68,69,FALSE,0.932432432432432,2021,2021-2022
SD,2021-12-31,intra-total,442,4,6,1,0,0,1,1,0,3,159,617,601,605,FALSE,0.980551053484603,2021,2021-2022
SD,2021-12-31,intra-ucfe,9,0,0,0,0,0,0,0,0,0,5,14,14,14,FALSE,1,2021,2021-2022
SD,2021-12-31,intra-ucx,2,0,0,0,0,0,0,0,0,0,0,2,2,2,FALSE,1,2021,2021-2022
SD,2021-12-31,intra-ui,431,4,6,1,0,0,1,1,0,3,154,601,585,589,FALSE,0.980033277870216,2021,2021-2022
SD,2022-01-31,inter-total,46,1,4,1,2,1,0,0,0,3,29,87,75,76,FALSE,0.873563218390805,2021,2021-2022
SD,2022-01-31,inter-ucfe,0,0,0,0,0,0,0,0,0,1,1,2,1,1,FALSE,0.5,2021,2021-2022
SD,2022-01-31,inter-ucx,0,0,0,0,0,0,0,0,0,0,0,0,0,0,FALSE,0,2021,2021-2022
SD,2022-01-31,inter-ui,46,1,4,1,2,1,0,0,0,2,28,85,74,75,FALSE,0.882352941176471,2021,2021-2022
SD,2022-01-31,intra-total,807,41,10,4,2,1,1,1,1,4,306,1178,1113,1154,FALSE,0.979626485568761,2021,2021-2022
SD,2022-01-31,intra-ucfe,11,0,0,1,0,0,0,0,0,0,5,17,16,16,FALSE,0.941176470588235,2021,2021-2022
SD,2022-01-31,intra-ucx,0,0,0,0,0,0,0,0,0,0,0,0,0,0,FALSE,0,2021,2021-2022
SD,2022-01-31,intra-ui,796,41,10,3,2,1,1,1,1,4,301,1161,1097,1138,FALSE,0.980189491817399,2021,2021-2022
SD,2022-02-28,inter-total,16,2,3,1,1,0,0,0,0,2,12,37,28,30,FALSE,0.810810810810811,2021,2021-2022
SD,2022-02-28,inter-ucfe,0,0,0,0,0,0,0,0,0,1,1,2,1,1,FALSE,0.5,2021,2021-2022
SD,2022-02-28,inter-ucx,0,0,0,0,0,0,0,0,0,0,0,0,0,0,FALSE,0,2021,2021-2022
SD,2022-02-28,inter-ui,16,2,3,1,1,0,0,0,0,1,11,35,27,29,FALSE,0.828571428571429,2021,2021-2022
SD,2022-02-28,intra-total,357,16,8,0,2,0,1,0,0,0,136,520,493,509,FALSE,0.978846153846154,2021,2021-2022
SD,2022-02-28,intra-ucfe,1,0,1,0,0,0,0,0,0,0,3,5,4,4,FALSE,0.8,2021,2021-2022
SD,2022-02-28,intra-ucx,1,0,0,0,0,0,0,0,0,0,0,1,1,1,FALSE,1,2021,2021-2022
SD,2022-02-28,intra-ui,355,16,7,0,2,0,1,0,0,0,133,514,488,504,FALSE,0.980544747081712,2021,2021-2022
SD,2022-03-31,inter-total,7,5,2,0,1,0,0,0,0,2,9,26,16,21,FALSE,0.807692307692308,2021,2021-2022
SD,2022-03-31,inter-ucfe,0,0,0,0,0,0,0,0,0,0,0,0,0,0,FALSE,0,2021,2021-2022
SD,2022-03-31,inter-ucx,0,0,0,0,0,0,0,0,0,0,0,0,0,0,FALSE,0,2021,2021-2022
SD,2022-03-31,inter-ui,7,5,2,0,1,0,0,0,0,2,9,26,16,21,FALSE,0.807692307692308,2021,2021-2022
SD,2022-03-31,intra-total,155,14,8,0,1,1,1,0,0,5,76,261,231,245,FALSE,0.938697318007663,2021,2021-2022
SD,2022-03-31,intra-ucfe,4,1,1,0,0,1,0,0,0,0,0,7,4,5,FALSE,0.714285714285714,2021,2021-2022
SD,2022-03-31,intra-ucx,0,0,0,0,0,0,0,0,0,0,0,0,0,0,FALSE,0,2021,2021-2022
SD,2022-03-31,intra-ui,151,13,7,0,1,0,1,0,0,5,76,254,227,240,FALSE,0.944881889763779,2021,2021-2022
SD,2022-04-30,inter-total,5,1,1,0,0,0,0,0,0,0,3,10,8,9,FALSE,0.9,2021,2021-2022
SD,2022-04-30,inter-ucfe,0,0,0,0,0,0,0,0,0,0,0,0,0,0,FALSE,0,2021,2021-2022
SD,2022-04-30,inter-ucx,0,0,0,0,0,0,0,0,0,0,0,0,0,0,FALSE,0,2021,2021-2022
SD,2022-04-30,inter-ui,5,1,1,0,0,0,0,0,0,0,3,10,8,9,FALSE,0.9,2021,2021-2022
SD,2022-04-30,intra-total,52,11,0,0,1,0,0,1,0,3,55,123,107,118,FALSE,0.959349593495935,2021,2021-2022
SD,2022-04-30,intra-ucfe,5,0,0,0,0,0,0,0,0,0,0,5,5,5,FALSE,1,2021,2021-2022
SD,2022-04-30,intra-ucx,1,0,0,0,0,0,0,0,0,0,0,1,1,1,FALSE,1,2021,2021-2022
SD,2022-04-30,intra-ui,46,11,0,0,1,0,0,1,0,3,55,117,101,112,FALSE,0.957264957264957,2021,2021-2022
SD,2022-05-31,inter-total,5,0,0,0,0,0,0,0,0,2,4,11,9,9,FALSE,0.818181818181818,2021,2021-2022
SD,2022-05-31,inter-ucfe,0,0,0,0,0,0,0,0,0,0,0,0,0,0,FALSE,0,2021,2021-2022
SD,2022-05-31,inter-ucx,0,0,0,0,0,0,0,0,0,0,0,0,0,0,FALSE,0,2021,2021-2022
SD,2022-05-31,inter-ui,5,0,0,0,0,0,0,0,0,2,4,11,9,9,FALSE,0.818181818181818,2021,2021-2022
SD,2022-05-31,intra-total,73,5,5,1,0,0,0,0,1,4,55,144,128,133,FALSE,0.923611111111111,2021,2021-2022
SD,2022-05-31,intra-ucfe,4,1,1,1,0,0,0,0,0,0,4,11,8,9,FALSE,0.818181818181818,2021,2021-2022
SD,2022-05-31,intra-ucx,1,0,0,0,0,0,0,0,0,0,0,1,1,1,FALSE,1,2021,2021-2022
SD,2022-05-31,intra-ui,68,4,4,0,0,0,0,0,1,4,51,132,119,123,FALSE,0.931818181818182,2021,2021-2022
SD,2022-06-30,inter-total,5,0,0,0,0,0,0,0,0,0,7,12,12,12,FALSE,1,2021,2021-2022
SD,2022-06-30,inter-ucfe,0,0,0,0,0,0,0,0,0,0,0,0,0,0,FALSE,0,2021,2021-2022
SD,2022-06-30,inter-ucx,0,0,0,0,0,0,0,0,0,0,0,0,0,0,FALSE,0,2021,2021-2022
SD,2022-06-30,inter-ui,5,0,0,0,0,0,0,0,0,0,7,12,12,12,FALSE,1,2021,2021-2022
SD,2022-06-30,intra-total,148,11,5,0,0,0,0,0,0,5,61,230,209,220,FALSE,0.956521739130435,2021,2021-2022
SD,2022-06-30,intra-ucfe,32,1,0,0,0,0,0,0,0,0,3,36,35,36,FALSE,1,2021,2021-2022
SD,2022-06-30,intra-ucx,0,0,0,0,0,0,0,0,0,0,0,0,0,0,FALSE,0,2021,2021-2022
SD,2022-06-30,intra-ui,116,10,5,0,0,0,0,0,0,5,58,194,174,184,FALSE,0.948453608247423,2021,2021-2022
SD,2022-07-31,inter-total,5,1,0,0,0,0,0,0,0,0,6,12,11,12,FALSE,1,2022,2022-2023
SD,2022-07-31,inter-ucfe,0,0,0,0,0,0,0,0,0,0,2,2,2,2,FALSE,1,2022,2022-2023
SD,2022-07-31,inter-ucx,0,0,0,0,0,0,0,0,0,0,0,0,0,0,FALSE,0,2022,2022-2023
SD,2022-07-31,inter-ui,5,1,0,0,0,0,0,0,0,0,4,10,9,10,FALSE,1,2022,2022-2023
SD,2022-07-31,intra-total,140,9,3,0,2,1,2,0,0,4,85,246,225,234,FALSE,0.951219512195122,2022,2022-2023
SD,2022-07-31,intra-ucfe,27,6,0,0,0,0,0,0,0,0,24,57,51,57,FALSE,1,2022,2022-2023
SD,2022-07-31,intra-ucx,1,0,0,0,0,0,0,0,0,0,0,1,1,1,FALSE,1,2022,2022-2023
SD,2022-07-31,intra-ui,112,3,3,0,2,1,2,0,0,4,61,188,173,176,FALSE,0.936170212765957,2022,2022-2023
SD,2022-08-31,inter-total,3,0,0,0,1,0,0,0,0,0,4,8,7,7,FALSE,0.875,2022,2022-2023
SD,2022-08-31,inter-ucfe,0,0,0,0,0,0,0,0,0,0,1,1,1,1,FALSE,1,2022,2022-2023
SD,2022-08-31,inter-ucx,0,0,0,0,0,0,0,0,0,0,0,0,0,0,FALSE,0,2022,2022-2023
SD,2022-08-31,inter-ui,3,0,0,0,1,0,0,0,0,0,3,7,6,6,FALSE,0.857142857142857,2022,2022-2023
SD,2022-08-31,intra-total,110,17,9,0,0,0,2,0,0,7,60,205,170,187,FALSE,0.91219512195122,2022,2022-2023
SD,2022-08-31,intra-ucfe,38,9,7,0,0,0,0,0,0,0,25,79,63,72,FALSE,0.911392405063291,2022,2022-2023
SD,2022-08-31,intra-ucx,0,0,0,0,0,0,0,0,0,0,0,0,0,0,FALSE,0,2022,2022-2023
SD,2022-08-31,intra-ui,72,8,2,0,0,0,2,0,0,7,35,126,107,115,FALSE,0.912698412698413,2022,2022-2023
SD,2022-09-30,inter-total,3,1,1,1,0,0,0,0,0,3,5,14,8,9,FALSE,0.642857142857143,2022,2022-2023
SD,2022-09-30,inter-ucfe,0,0,0,0,0,0,0,0,0,0,0,0,0,0,FALSE,0,2022,2022-2023
SD,2022-09-30,inter-ucx,0,0,0,0,0,0,0,0,0,0,0,0,0,0,FALSE,0,2022,2022-2023
SD,2022-09-30,inter-ui,3,1,1,1,0,0,0,0,0,3,5,14,8,9,FALSE,0.642857142857143,2022,2022-2023
SD,2022-09-30,intra-total,48,8,1,0,1,0,1,0,0,2,29,90,77,85,FALSE,0.944444444444444,2022,2022-2023
SD,2022-09-30,intra-ucfe,0,1,0,0,0,0,0,0,0,0,0,1,0,1,FALSE,1,2022,2022-2023
SD,2022-09-30,intra-ucx,0,0,0,0,0,0,0,0,0,0,0,0,0,0,FALSE,0,2022,2022-2023
SD,2022-09-30,intra-ui,48,7,1,0,1,0,1,0,0,2,29,89,77,84,FALSE,0.943820224719101,2022,2022-2023
SD,2022-10-31,inter-total,3,3,0,0,0,0,0,0,0,0,2,8,5,8,FALSE,1,2022,2022-2023
SD,2022-10-31,inter-ucfe,0,0,0,0,0,0,0,0,0,0,0,0,0,0,FALSE,0,2022,2022-2023
SD,2022-10-31,inter-ucx,0,0,0,0,0,0,0,0,0,0,0,0,0,0,FALSE,0,2022,2022-2023
SD,2022-10-31,inter-ui,3,3,0,0,0,0,0,0,0,0,2,8,5,8,FALSE,1,2022,2022-2023
SD,2022-10-31,intra-total,88,5,0,0,0,0,1,1,0,5,42,142,130,135,FALSE,0.950704225352113,2022,2022-2023
SD,2022-10-31,intra-ucfe,1,0,0,0,0,0,0,0,0,0,1,2,2,2,FALSE,1,2022,2022-2023
SD,2022-10-31,intra-ucx,0,0,0,0,0,0,0,0,0,0,0,0,0,0,FALSE,0,2022,2022-2023
SD,2022-10-31,intra-ui,87,5,0,0,0,0,1,1,0,5,41,140,128,133,FALSE,0.95,2022,2022-2023
SD,2022-11-30,inter-total,11,0,0,0,0,0,0,0,0,0,10,21,21,21,FALSE,1,2022,2022-2023
SD,2022-11-30,inter-ucfe,1,0,0,0,0,0,0,0,0,0,1,2,2,2,FALSE,1,2022,2022-2023
SD,2022-11-30,inter-ucx,0,0,0,0,0,0,0,0,0,0,0,0,0,0,FALSE,0,2022,2022-2023
SD,2022-11-30,inter-ui,10,0,0,0,0,0,0,0,0,0,9,19,19,19,FALSE,1,2022,2022-2023
SD,2022-11-30,intra-total,108,7,2,2,0,0,1,2,1,4,80,207,188,195,FALSE,0.942028985507246,2022,2022-2023
SD,2022-11-30,intra-ucfe,3,0,0,0,0,0,0,0,0,0,0,3,3,3,FALSE,1,2022,2022-2023
SD,2022-11-30,intra-ucx,0,0,0,0,0,0,0,0,0,0,0,0,0,0,FALSE,0,2022,2022-2023
SD,2022-11-30,intra-ui,105,7,2,2,0,0,1,2,1,4,80,204,185,192,FALSE,0.941176470588235,2022,2022-2023
SD,2022-12-31,inter-total,41,3,1,1,0,1,0,0,0,0,14,61,55,58,FALSE,0.950819672131147,2022,2022-2023
SD,2022-12-31,inter-ucfe,2,1,0,0,0,0,0,0,0,0,0,3,2,3,FALSE,1,2022,2022-2023
SD,2022-12-31,inter-ucx,0,0,0,0,0,0,0,0,0,0,0,0,0,0,FALSE,0,2022,2022-2023
SD,2022-12-31,inter-ui,39,2,1,1,0,1,0,0,0,0,14,58,53,55,FALSE,0.948275862068965,2022,2022-2023
SD,2022-12-31,intra-total,466,15,5,3,0,0,0,0,1,1,155,646,621,636,FALSE,0.984520123839009,2022,2022-2023
SD,2022-12-31,intra-ucfe,5,0,1,0,0,0,0,0,0,0,0,6,5,5,FALSE,0.833333333333333,2022,2022-2023
SD,2022-12-31,intra-ucx,1,0,0,0,0,0,0,0,0,0,0,1,1,1,FALSE,1,2022,2022-2023
SD,2022-12-31,intra-ui,460,15,4,3,0,0,0,0,1,1,155,639,615,630,FALSE,0.985915492957746,2022,2022-2023
SD,2023-01-31,inter-total,45,4,1,2,0,1,0,0,0,0,35,88,80,84,FALSE,0.954545454545455,2022,2022-2023
SD,2023-01-31,inter-ucfe,1,0,0,0,0,0,0,0,0,0,1,2,2,2,FALSE,1,2022,2022-2023
SD,2023-01-31,inter-ucx,0,0,0,0,0,0,0,0,0,0,0,0,0,0,FALSE,0,2022,2022-2023
SD,2023-01-31,inter-ui,44,4,1,2,0,1,0,0,0,0,34,86,78,82,FALSE,0.953488372093023,2022,2022-2023
SD,2023-01-31,intra-total,638,43,21,3,3,2,0,1,0,2,362,1075,1000,1043,FALSE,0.970232558139535,2022,2022-2023
SD,2023-01-31,intra-ucfe,7,1,0,0,1,0,0,0,0,0,6,15,13,14,FALSE,0.933333333333333,2022,2022-2023
SD,2023-01-31,intra-ucx,0,0,0,0,0,0,0,0,0,0,1,1,1,1,FALSE,1,2022,2022-2023
SD,2023-01-31,intra-ui,631,42,21,3,2,2,0,1,0,2,355,1059,986,1028,FALSE,0.970727101038716,2022,2022-2023
SD,2023-02-28,inter-total,29,3,2,1,0,1,1,0,0,0,11,48,40,43,FALSE,0.895833333333333,2022,2022-2023
SD,2023-02-28,inter-ucfe,0,0,0,0,0,0,0,0,0,0,0,0,0,0,FALSE,0,2022,2022-2023
SD,2023-02-28,inter-ucx,0,0,0,0,0,0,0,0,0,0,0,0,0,0,FALSE,0,2022,2022-2023
SD,2023-02-28,inter-ui,29,3,2,1,0,1,1,0,0,0,11,48,40,43,FALSE,0.895833333333333,2022,2022-2023
SD,2023-02-28,intra-total,355,18,6,1,1,0,0,0,1,2,166,550,521,539,FALSE,0.98,2022,2022-2023
SD,2023-02-28,intra-ucfe,3,0,0,0,0,0,0,0,0,0,1,4,4,4,FALSE,1,2022,2022-2023
SD,2023-02-28,intra-ucx,0,0,0,0,0,0,0,0,0,0,0,0,0,0,FALSE,0,2022,2022-2023
SD,2023-02-28,intra-ui,352,18,6,1,1,0,0,0,1,2,165,546,517,535,FALSE,0.97985347985348,2022,2022-2023
SD,2023-03-31,inter-total,18,2,1,1,1,0,0,0,0,0,5,28,23,25,FALSE,0.892857142857143,2022,2022-2023
SD,2023-03-31,inter-ucfe,0,0,0,0,0,0,0,0,0,0,0,0,0,0,FALSE,0,2022,2022-2023
SD,2023-03-31,inter-ucx,0,0,0,0,0,0,0,0,0,0,0,0,0,0,FALSE,0,2022,2022-2023
SD,2023-03-31,inter-ui,18,2,1,1,1,0,0,0,0,0,5,28,23,25,FALSE,0.892857142857143,2022,2022-2023
SD,2023-03-31,intra-total,235,11,2,3,2,2,0,0,0,1,124,380,359,370,FALSE,0.973684210526316,2022,2022-2023
SD,2023-03-31,intra-ucfe,0,0,0,0,0,0,0,0,0,0,2,2,2,2,FALSE,1,2022,2022-2023
SD,2023-03-31,intra-ucx,0,0,0,0,0,0,0,0,0,0,0,0,0,0,FALSE,0,2022,2022-2023
SD,2023-03-31,intra-ui,235,11,2,3,2,2,0,0,0,1,122,378,357,368,FALSE,0.973544973544973,2022,2022-2023
SD,2023-04-30,inter-total,3,1,0,0,0,0,0,0,0,0,3,7,6,7,FALSE,1,2022,2022-2023
SD,2023-04-30,inter-ucfe,0,0,0,0,0,0,0,0,0,0,0,0,0,0,FALSE,0,2022,2022-2023
SD,2023-04-30,inter-ucx,0,0,0,0,0,0,0,0,0,0,0,0,0,0,FALSE,0,2022,2022-2023
SD,2023-04-30,inter-ui,3,1,0,0,0,0,0,0,0,0,3,7,6,7,FALSE,1,2022,2022-2023
SD,2023-04-30,intra-total,78,10,8,5,0,0,0,0,0,1,63,165,141,151,FALSE,0.915151515151515,2022,2022-2023
SD,2023-04-30,intra-ucfe,6,0,0,0,0,0,0,0,0,0,3,9,9,9,FALSE,1,2022,2022-2023
SD,2023-04-30,intra-ucx,0,0,0,0,0,0,0,0,0,1,0,1,0,0,FALSE,0,2022,2022-2023
SD,2023-04-30,intra-ui,72,10,8,5,0,0,0,0,0,0,60,155,132,142,FALSE,0.916129032258065,2022,2022-2023
SD,2023-05-31,inter-total,2,1,1,0,0,0,0,0,0,1,2,7,4,5,FALSE,0.714285714285714,2022,2022-2023
SD,2023-05-31,inter-ucfe,0,0,0,0,0,0,0,0,0,0,0,0,0,0,FALSE,0,2022,2022-2023
SD,2023-05-31,inter-ucx,0,0,0,0,0,0,0,0,0,0,0,0,0,0,FALSE,0,2022,2022-2023
SD,2023-05-31,inter-ui,2,1,1,0,0,0,0,0,0,1,2,7,4,5,FALSE,0.714285714285714,2022,2022-2023
SD,2023-05-31,intra-total,105,5,1,1,0,0,0,0,0,0,58,170,163,168,FALSE,0.988235294117647,2022,2022-2023
SD,2023-05-31,intra-ucfe,5,0,0,0,0,0,0,0,0,0,0,5,5,5,FALSE,1,2022,2022-2023
SD,2023-05-31,intra-ucx,1,0,0,0,0,0,0,0,0,0,1,2,2,2,FALSE,1,2022,2022-2023
SD,2023-05-31,intra-ui,99,5,1,1,0,0,0,0,0,0,57,163,156,161,FALSE,0.987730061349693,2022,2022-2023
SD,2023-06-30,inter-total,4,2,1,0,0,0,0,0,0,0,7,14,11,13,FALSE,0.928571428571429,2022,2022-2023
SD,2023-06-30,inter-ucfe,1,0,0,0,0,0,0,0,0,0,0,1,1,1,FALSE,1,2022,2022-2023
SD,2023-06-30,inter-ucx,0,0,0,0,0,0,0,0,0,0,0,0,0,0,FALSE,0,2022,2022-2023
SD,2023-06-30,inter-ui,3,2,1,0,0,0,0,0,0,0,7,13,10,12,FALSE,0.923076923076923,2022,2022-2023
SD,2023-06-30,intra-total,162,9,1,1,1,0,0,0,0,0,70,244,232,241,FALSE,0.987704918032787,2022,2022-2023
SD,2023-06-30,intra-ucfe,15,0,0,0,0,0,0,0,0,0,6,21,21,21,FALSE,1,2022,2022-2023
SD,2023-06-30,intra-ucx,0,0,0,0,0,0,0,0,0,0,1,1,1,1,FALSE,1,2022,2022-2023
SD,2023-06-30,intra-ui,147,9,1,1,1,0,0,0,0,0,63,222,210,219,FALSE,0.986486486486486,2022,2022-2023
SD,2023-07-31,inter-total,12,1,0,0,0,0,0,0,0,0,8,21,20,21,FALSE,1,2023,2023-2024
SD,2023-07-31,inter-ucfe,1,0,0,0,0,0,0,0,0,0,2,3,3,3,FALSE,1,2023,2023-2024
SD,2023-07-31,inter-ucx,0,0,0,0,0,0,0,0,0,0,1,1,1,1,FALSE,1,2023,2023-2024
SD,2023-07-31,inter-ui,11,1,0,0,0,0,0,0,0,0,5,17,16,17,FALSE,1,2023,2023-2024
SD,2023-07-31,intra-total,150,19,4,1,4,1,0,0,0,1,118,298,268,287,FALSE,0.963087248322148,2023,2023-2024
SD,2023-07-31,intra-ucfe,49,4,0,1,0,0,0,0,0,0,32,86,81,85,FALSE,0.988372093023256,2023,2023-2024
SD,2023-07-31,intra-ucx,0,1,0,0,0,0,0,0,0,0,0,1,0,1,FALSE,1,2023,2023-2024
SD,2023-07-31,intra-ui,101,14,4,0,4,1,0,0,0,1,86,211,187,201,FALSE,0.95260663507109,2023,2023-2024
SD,2023-08-31,inter-total,9,1,1,0,1,0,0,0,1,0,6,19,15,16,FALSE,0.842105263157895,2023,2023-2024
SD,2023-08-31,inter-ucfe,3,1,0,0,0,0,0,0,0,0,0,4,3,4,FALSE,1,2023,2023-2024
SD,2023-08-31,inter-ucx,0,0,0,0,0,0,0,0,0,0,0,0,0,0,FALSE,0,2023,2023-2024
SD,2023-08-31,inter-ui,6,0,1,0,1,0,0,0,1,0,6,15,12,12,FALSE,0.8,2023,2023-2024
SD,2023-08-31,intra-total,178,16,5,1,1,0,0,1,0,1,77,280,255,271,FALSE,0.967857142857143,2023,2023-2024
SD,2023-08-31,intra-ucfe,19,6,2,1,0,0,0,0,0,0,5,33,24,30,FALSE,0.909090909090909,2023,2023-2024
SD,2023-08-31,intra-ucx,0,0,0,0,0,0,0,0,0,0,0,0,0,0,FALSE,0,2023,2023-2024
SD,2023-08-31,intra-ui,159,10,3,0,1,0,0,1,0,1,72,247,231,241,FALSE,0.975708502024291,2023,2023-2024
SD,2023-09-30,inter-total,5,2,0,0,0,0,0,0,0,0,5,12,10,12,FALSE,1,2023,2023-2024
SD,2023-09-30,inter-ucfe,0,0,0,0,0,0,0,0,0,0,0,0,0,0,FALSE,0,2023,2023-2024
SD,2023-09-30,inter-ucx,0,0,0,0,0,0,0,0,0,0,0,0,0,0,FALSE,0,2023,2023-2024
SD,2023-09-30,inter-ui,5,2,0,0,0,0,0,0,0,0,5,12,10,12,FALSE,1,2023,2023-2024
SD,2023-09-30,intra-total,54,9,3,1,1,1,0,0,0,2,53,124,107,116,FALSE,0.935483870967742,2023,2023-2024
SD,2023-09-30,intra-ucfe,2,0,0,0,0,0,0,0,0,0,0,2,2,2,FALSE,1,2023,2023-2024
SD,2023-09-30,intra-ucx,0,0,0,0,0,0,0,0,0,0,0,0,0,0,FALSE,0,2023,2023-2024
SD,2023-09-30,intra-ui,52,9,3,1,1,1,0,0,0,2,53,122,105,114,FALSE,0.934426229508197,2023,2023-2024
SD,2023-10-31,inter-total,9,2,0,0,0,0,0,0,0,0,1,12,10,12,FALSE,1,2023,2023-2024
SD,2023-10-31,inter-ucfe,0,0,0,0,0,0,0,0,0,0,0,0,0,0,FALSE,0,2023,2023-2024
SD,2023-10-31,inter-ucx,0,0,0,0,0,0,0,0,0,0,0,0,0,0,FALSE,0,2023,2023-2024
SD,2023-10-31,inter-ui,9,2,0,0,0,0,0,0,0,0,1,12,10,12,FALSE,1,2023,2023-2024
SD,2023-10-31,intra-total,62,7,1,1,1,0,0,0,0,1,61,134,123,130,FALSE,0.970149253731343,2023,2023-2024
SD,2023-10-31,intra-ucfe,0,2,0,0,0,0,0,0,0,0,0,2,0,2,FALSE,1,2023,2023-2024
SD,2023-10-31,intra-ucx,0,0,0,0,0,0,0,0,0,0,0,0,0,0,FALSE,0,2023,2023-2024
SD,2023-10-31,intra-ui,62,5,1,1,1,0,0,0,0,1,61,132,123,128,FALSE,0.96969696969697,2023,2023-2024
SD,2023-11-30,inter-total,27,0,1,1,0,0,0,0,0,0,13,42,40,40,FALSE,0.952380952380952,2023,2023-2024
SD,2023-11-30,inter-ucfe,2,0,0,1,0,0,0,0,0,0,2,5,4,4,FALSE,0.8,2023,2023-2024
SD,2023-11-30,inter-ucx,0,0,0,0,0,0,0,0,0,0,0,0,0,0,FALSE,0,2023,2023-2024
SD,2023-11-30,inter-ui,25,0,1,0,0,0,0,0,0,0,11,37,36,36,FALSE,0.972972972972973,2023,2023-2024
SD,2023-11-30,intra-total,149,13,4,0,2,1,0,0,0,0,88,257,237,250,FALSE,0.972762645914397,2023,2023-2024
SD,2023-11-30,intra-ucfe,6,0,0,0,0,1,0,0,0,0,5,12,11,11,FALSE,0.916666666666667,2023,2023-2024
SD,2023-11-30,intra-ucx,0,0,0,0,0,0,0,0,0,0,1,1,1,1,FALSE,1,2023,2023-2024
SD,2023-11-30,intra-ui,143,13,4,0,2,0,0,0,0,0,82,244,225,238,FALSE,0.975409836065574,2023,2023-2024
SD,2023-12-31,inter-total,65,1,1,0,1,0,1,0,0,0,32,101,97,98,FALSE,0.97029702970297,2023,2023-2024
SD,2023-12-31,inter-ucfe,0,0,0,0,0,0,0,0,0,0,1,1,1,1,FALSE,1,2023,2023-2024
SD,2023-12-31,inter-ucx,0,0,0,0,0,0,0,0,0,0,0,0,0,0,FALSE,0,2023,2023-2024
SD,2023-12-31,inter-ui,65,1,1,0,1,0,1,0,0,0,31,100,96,97,FALSE,0.97,2023,2023-2024
SD,2023-12-31,intra-total,427,20,3,2,1,2,1,2,0,0,169,627,596,616,FALSE,0.982456140350877,2023,2023-2024
SD,2023-12-31,intra-ucfe,5,1,0,0,0,0,0,0,0,0,3,9,8,9,FALSE,1,2023,2023-2024
SD,2023-12-31,intra-ucx,0,0,0,0,0,0,0,0,0,0,0,0,0,0,FALSE,0,2023,2023-2024
SD,2023-12-31,intra-ui,422,19,3,2,1,2,1,2,0,0,166,618,588,607,FALSE,0.982200647249191,2023,2023-2024
SD,2024-01-31,inter-total,59,8,3,3,0,0,0,0,0,0,29,102,88,96,FALSE,0.941176470588235,2023,2023-2024
SD,2024-01-31,inter-ucfe,2,0,0,0,0,0,0,0,0,0,1,3,3,3,FALSE,1,2023,2023-2024
SD,2024-01-31,inter-ucx,0,0,0,0,0,0,0,0,0,0,0,0,0,0,FALSE,0,2023,2023-2024
SD,2024-01-31,inter-ui,57,8,3,3,0,0,0,0,0,0,28,99,85,93,FALSE,0.939393939393939,2023,2023-2024
SD,2024-01-31,intra-total,669,36,8,4,8,0,0,0,0,1,329,1055,998,1034,FALSE,0.980094786729858,2023,2023-2024
SD,2024-01-31,intra-ucfe,6,0,1,0,0,0,0,0,0,0,2,9,8,8,FALSE,0.888888888888889,2023,2023-2024
SD,2024-01-31,intra-ucx,0,0,0,0,0,0,0,0,0,0,0,0,0,0,FALSE,0,2023,2023-2024
SD,2024-01-31,intra-ui,663,36,7,4,8,0,0,0,0,1,327,1046,990,1026,FALSE,0.980879541108987,2023,2023-2024
SD,2024-02-29,inter-total,51,1,2,0,0,0,0,0,0,1,30,85,81,82,FALSE,0.964705882352941,2023,2023-2024
SD,2024-02-29,inter-ucfe,0,0,0,0,0,0,0,0,0,0,0,0,0,0,FALSE,0,2023,2023-2024
SD,2024-02-29,inter-ucx,0,0,0,0,0,0,0,0,0,0,0,0,0,0,FALSE,0,2023,2023-2024
SD,2024-02-29,inter-ui,51,1,2,0,0,0,0,0,0,1,30,85,81,82,FALSE,0.964705882352941,2023,2023-2024
SD,2024-02-29,intra-total,445,20,5,2,2,0,0,0,0,0,185,659,630,650,FALSE,0.986342943854325,2023,2023-2024
SD,2024-02-29,intra-ucfe,2,0,1,0,0,0,0,0,0,0,3,6,5,5,FALSE,0.833333333333333,2023,2023-2024
SD,2024-02-29,intra-ucx,0,0,0,0,0,0,0,0,0,0,0,0,0,0,FALSE,0,2023,2023-2024
SD,2024-02-29,intra-ui,443,20,4,2,2,0,0,0,0,0,182,653,625,645,FALSE,0.987748851454824,2023,2023-2024
SD,2024-03-31,inter-total,15,2,0,0,0,0,0,0,1,1,11,30,26,28,FALSE,0.933333333333333,2023,2023-2024
SD,2024-03-31,inter-ucfe,0,0,0,0,0,0,0,0,0,0,0,0,0,0,FALSE,0,2023,2023-2024
SD,2024-03-31,inter-ucx,0,0,0,0,0,0,0,0,0,0,0,0,0,0,FALSE,0,2023,2023-2024
SD,2024-03-31,inter-ui,15,2,0,0,0,0,0,0,1,1,11,30,26,28,FALSE,0.933333333333333,2023,2023-2024
SD,2024-03-31,intra-total,141,11,2,1,1,1,0,0,0,1,79,237,220,231,FALSE,0.974683544303798,2023,2023-2024
SD,2024-03-31,intra-ucfe,1,0,0,0,0,0,0,0,0,0,0,1,1,1,FALSE,1,2023,2023-2024
SD,2024-03-31,intra-ucx,0,0,0,0,0,0,0,0,0,0,0,0,0,0,FALSE,0,2023,2023-2024
SD,2024-03-31,intra-ui,140,11,2,1,1,1,0,0,0,1,79,236,219,230,FALSE,0.974576271186441,2023,2023-2024
SD,2024-04-30,inter-total,13,5,0,0,0,0,1,0,0,1,6,26,19,24,FALSE,0.923076923076923,2023,2023-2024
SD,2024-04-30,inter-ucfe,0,0,0,0,0,0,0,0,0,0,0,0,0,0,FALSE,0,2023,2023-2024
SD,2024-04-30,inter-ucx,0,0,0,0,0,0,0,0,0,0,0,0,0,0,FALSE,0,2023,2023-2024
SD,2024-04-30,inter-ui,13,5,0,0,0,0,1,0,0,1,6,26,19,24,FALSE,0.923076923076923,2023,2023-2024
SD,2024-04-30,intra-total,124,17,1,1,1,3,0,0,0,2,91,240,215,232,FALSE,0.966666666666667,2023,2023-2024
SD,2024-04-30,intra-ucfe,8,0,0,0,0,0,0,0,0,0,0,8,8,8,FALSE,1,2023,2023-2024
SD,2024-04-30,intra-ucx,0,0,0,0,0,0,0,0,0,0,0,0,0,0,FALSE,0,2023,2023-2024
SD,2024-04-30,intra-ui,116,17,1,1,1,3,0,0,0,2,91,232,207,224,FALSE,0.96551724137931,2023,2023-2024
SD,2024-05-31,inter-total,16,0,0,0,1,0,0,0,0,0,10,27,26,26,FALSE,0.962962962962963,2023,2023-2024
SD,2024-05-31,inter-ucfe,0,0,0,0,0,0,0,0,0,0,0,0,0,0,FALSE,0,2023,2023-2024
SD,2024-05-31,inter-ucx,0,0,0,0,0,0,0,0,0,0,0,0,0,0,FALSE,0,2023,2023-2024
SD,2024-05-31,inter-ui,16,0,0,0,1,0,0,0,0,0,10,27,26,26,FALSE,0.962962962962963,2023,2023-2024
SD,2024-05-31,intra-total,109,7,2,1,1,1,0,0,0,1,71,193,180,187,FALSE,0.968911917098446,2023,2023-2024
SD,2024-05-31,intra-ucfe,4,0,0,0,0,0,0,0,0,0,0,4,4,4,FALSE,1,2023,2023-2024
SD,2024-05-31,intra-ucx,0,0,0,0,0,0,0,0,0,0,0,0,0,0,FALSE,0,2023,2023-2024
SD,2024-05-31,intra-ui,105,7,2,1,1,1,0,0,0,1,71,189,176,183,FALSE,0.968253968253968,2023,2023-2024
SD,2024-06-30,inter-total,10,1,0,0,1,0,0,0,0,0,4,16,14,15,FALSE,0.9375,2023,2023-2024
SD,2024-06-30,inter-ucfe,2,0,0,0,0,0,0,0,0,0,0,2,2,2,FALSE,1,2023,2023-2024
SD,2024-06-30,inter-ucx,0,0,0,0,0,0,0,0,0,0,0,0,0,0,FALSE,0,2023,2023-2024
SD,2024-06-30,inter-ui,8,1,0,0,1,0,0,0,0,0,4,14,12,13,FALSE,0.928571428571429,2023,2023-2024
SD,2024-06-30,intra-total,235,18,1,1,1,0,0,0,0,1,85,342,320,338,FALSE,0.988304093567251,2023,2023-2024
SD,2024-06-30,intra-ucfe,31,0,0,0,0,0,0,0,0,0,4,35,35,35,FALSE,1,2023,2023-2024
SD,2024-06-30,intra-ucx,0,0,0,0,0,0,0,0,0,0,0,0,0,0,FALSE,0,2023,2023-2024
SD,2024-06-30,intra-ui,204,18,1,1,1,0,0,0,0,1,81,307,285,303,FALSE,0.986970684039088,2023,2023-2024
SD,2024-07-31,inter-total,20,1,0,0,1,0,1,0,0,0,15,38,35,36,FALSE,0.947368421052632,2024,2024-2025
SD,2024-07-31,inter-ucfe,1,0,0,0,0,0,0,0,0,0,1,2,2,2,FALSE,1,2024,2024-2025
SD,2024-07-31,inter-ucx,0,0,0,0,0,0,0,0,0,0,0,0,0,0,FALSE,0,2024,2024-2025
SD,2024-07-31,inter-ui,19,1,0,0,1,0,1,0,0,0,14,36,33,34,FALSE,0.944444444444444,2024,2024-2025
SD,2024-07-31,intra-total,185,12,4,1,0,1,0,0,0,0,120,323,305,317,FALSE,0.981424148606811,2024,2024-2025
SD,2024-07-31,intra-ucfe,64,1,0,0,0,0,0,0,0,0,19,84,83,84,FALSE,1,2024,2024-2025
SD,2024-07-31,intra-ucx,1,0,0,0,0,0,0,0,0,0,0,1,1,1,FALSE,1,2024,2024-2025
SD,2024-07-31,intra-ui,120,11,4,1,0,1,0,0,0,0,101,238,221,232,FALSE,0.974789915966386,2024,2024-2025
SD,2024-08-31,inter-total,10,3,0,0,0,0,1,0,0,0,13,27,23,26,FALSE,0.962962962962963,2024,2024-2025
SD,2024-08-31,inter-ucfe,2,0,0,0,0,0,0,0,0,0,1,3,3,3,FALSE,1,2024,2024-2025
SD,2024-08-31,inter-ucx,0,0,0,0,0,0,0,0,0,0,0,0,0,0,FALSE,0,2024,2024-2025
SD,2024-08-31,inter-ui,8,3,0,0,0,0,1,0,0,0,12,24,20,23,FALSE,0.958333333333333,2024,2024-2025
SD,2024-08-31,intra-total,122,9,2,2,1,2,0,0,0,0,72,210,194,203,FALSE,0.966666666666667,2024,2024-2025
SD,2024-08-31,intra-ucfe,21,0,0,1,0,0,0,0,0,0,8,30,29,29,FALSE,0.966666666666667,2024,2024-2025
SD,2024-08-31,intra-ucx,0,0,0,0,0,0,0,0,0,0,0,0,0,0,FALSE,0,2024,2024-2025
SD,2024-08-31,intra-ui,101,9,2,1,1,2,0,0,0,0,64,180,165,174,FALSE,0.966666666666667,2024,2024-2025
SD,2024-09-30,inter-total,7,3,0,0,0,0,0,0,0,2,12,24,19,22,FALSE,0.916666666666667,2024,2024-2025
SD,2024-09-30,inter-ucfe,0,0,0,0,0,0,0,0,0,0,0,0,0,0,FALSE,0,2024,2024-2025
SD,2024-09-30,inter-ucx,0,0,0,0,0,0,0,0,0,0,0,0,0,0,FALSE,0,2024,2024-2025
SD,2024-09-30,inter-ui,7,3,0,0,0,0,0,0,0,2,12,24,19,22,FALSE,0.916666666666667,2024,2024-2025
SD,2024-09-30,intra-total,99,10,2,3,0,1,0,0,0,2,58,175,157,167,FALSE,0.954285714285714,2024,2024-2025
SD,2024-09-30,intra-ucfe,1,0,1,0,0,0,0,0,0,0,1,3,2,2,FALSE,0.666666666666667,2024,2024-2025
SD,2024-09-30,intra-ucx,0,0,0,0,0,0,0,0,0,0,1,1,1,1,FALSE,1,2024,2024-2025
SD,2024-09-30,intra-ui,98,10,1,3,0,1,0,0,0,2,56,171,154,164,FALSE,0.95906432748538,2024,2024-2025
SD,2024-10-31,inter-total,14,2,0,0,0,0,1,0,0,0,15,32,29,31,FALSE,0.96875,2024,2024-2025
SD,2024-10-31,inter-ucfe,0,0,0,0,0,0,0,0,0,0,0,0,0,0,FALSE,0,2024,2024-2025
SD,2024-10-31,inter-ucx,0,0,0,0,0,0,0,0,0,0,0,0,0,0,FALSE,0,2024,2024-2025
SD,2024-10-31,inter-ui,14,2,0,0,0,0,1,0,0,0,15,32,29,31,FALSE,0.96875,2024,2024-2025
SD,2024-10-31,intra-total,131,6,4,2,0,1,0,0,0,0,66,210,197,203,FALSE,0.966666666666667,2024,2024-2025
SD,2024-10-31,intra-ucfe,2,0,0,0,0,0,0,0,0,0,1,3,3,3,FALSE,1,2024,2024-2025
SD,2024-10-31,intra-ucx,0,0,0,0,0,0,0,0,0,0,0,0,0,0,FALSE,0,2024,2024-2025
SD,2024-10-31,intra-ui,129,6,4,2,0,1,0,0,0,0,65,207,194,200,FALSE,0.966183574879227,2024,2024-2025
SD,2024-11-30,inter-total,13,1,3,0,0,0,0,0,0,0,4,21,17,18,FALSE,0.857142857142857,2024,2024-2025
SD,2024-11-30,inter-ucfe,3,1,0,0,0,0,0,0,0,0,0,4,3,4,FALSE,1,2024,2024-2025
SD,2024-11-30,inter-ucx,0,0,0,0,0,0,0,0,0,0,0,0,0,0,FALSE,0,2024,2024-2025
SD,2024-11-30,inter-ui,10,0,3,0,0,0,0,0,0,0,4,17,14,14,FALSE,0.823529411764706,2024,2024-2025
SD,2024-11-30,intra-total,155,15,2,0,0,0,1,0,0,0,77,250,232,247,FALSE,0.988,2024,2024-2025
SD,2024-11-30,intra-ucfe,2,0,0,0,0,0,0,0,0,0,0,2,2,2,FALSE,1,2024,2024-2025
SD,2024-11-30,intra-ucx,0,0,0,0,0,0,0,0,0,0,0,0,0,0,FALSE,0,2024,2024-2025
SD,2024-11-30,intra-ui,153,15,2,0,0,0,1,0,0,0,77,248,230,245,FALSE,0.987903225806452,2024,2024-2025
SD,2024-12-31,inter-total,79,4,1,0,0,1,0,0,0,0,24,109,103,107,FALSE,0.981651376146789,2024,2024-2025
SD,2024-12-31,inter-ucfe,2,0,0,0,0,0,0,0,0,0,0,2,2,2,FALSE,1,2024,2024-2025
SD,2024-12-31,inter-ucx,0,0,0,0,0,0,0,0,0,0,0,0,0,0,FALSE,0,2024,2024-2025
SD,2024-12-31,inter-ui,77,4,1,0,0,1,0,0,0,0,24,107,101,105,FALSE,0.981308411214953,2024,2024-2025
SD,2024-12-31,intra-total,580,29,5,1,0,2,1,0,0,0,228,846,808,837,FALSE,0.98936170212766,2024,2024-2025
SD,2024-12-31,intra-ucfe,10,0,0,0,0,1,0,0,0,0,1,12,11,11,FALSE,0.916666666666667,2024,2024-2025
SD,2024-12-31,intra-ucx,0,0,0,0,0,0,0,0,0,0,0,0,0,0,FALSE,0,2024,2024-2025
SD,2024-12-31,intra-ui,570,29,5,1,0,1,1,0,0,0,227,834,797,826,FALSE,0.990407673860911,2024,2024-2025
TN,2019-01-31,inter-total,212,47,9,3,1,2,2,0,0,1,187,464,399,446,TRUE,0.859913793103448,2018,2018-2019
TN,2019-01-31,inter-ucfe,24,0,0,0,0,0,0,0,0,0,4,28,28,28,TRUE,1,2018,2018-2019
TN,2019-01-31,inter-ucx,0,0,0,0,0,0,0,0,0,0,0,0,0,0,TRUE,0,2018,2018-2019
TN,2019-01-31,inter-ui,188,47,9,3,1,2,2,0,0,1,183,436,371,418,TRUE,0.850917431192661,2018,2018-2019
TN,2019-01-31,intra-total,3278,583,96,44,27,14,6,9,3,30,3275,7365,6553,7136,TRUE,0.889748811948405,2018,2018-2019
TN,2019-01-31,intra-ucfe,218,7,0,0,0,0,0,0,0,1,52,278,270,277,TRUE,0.971223021582734,2018,2018-2019
TN,2019-01-31,intra-ucx,14,1,1,0,0,0,0,0,0,0,1,17,15,16,TRUE,0.882352941176471,2018,2018-2019
TN,2019-01-31,intra-ui,3046,575,95,44,27,14,6,9,3,29,3222,7070,6268,6843,TRUE,0.886562942008487,2018,2018-2019
TN,2019-02-28,inter-total,58,33,9,5,2,1,0,0,1,2,107,218,165,198,TRUE,0.756880733944954,2018,2018-2019
TN,2019-02-28,inter-ucfe,0,0,1,0,0,0,0,0,0,0,1,2,1,1,TRUE,0.5,2018,2018-2019
TN,2019-02-28,inter-ucx,0,0,0,0,0,0,0,0,0,0,0,0,0,0,TRUE,0,2018,2018-2019
TN,2019-02-28,inter-ui,58,33,8,5,2,1,0,0,1,2,106,216,164,197,TRUE,0.759259259259259,2018,2018-2019
TN,2019-02-28,intra-total,1171,525,104,55,36,21,13,6,6,22,1803,3762,2974,3499,TRUE,0.790536948431685,2018,2018-2019
TN,2019-02-28,intra-ucfe,3,4,1,0,1,0,0,0,0,0,1,10,4,8,TRUE,0.4,2018,2018-2019
TN,2019-02-28,intra-ucx,4,0,0,0,0,0,0,0,0,1,2,7,6,6,TRUE,0.857142857142857,2018,2018-2019
TN,2019-02-28,intra-ui,1164,521,103,55,35,21,13,6,6,21,1800,3745,2964,3485,TRUE,0.791455273698264,2018,2018-2019
TN,2019-03-31,inter-total,101,42,10,4,3,0,0,2,1,1,76,240,177,219,TRUE,0.7375,2018,2018-2019
TN,2019-03-31,inter-ucfe,0,0,0,0,0,0,0,1,0,0,0,1,0,0,TRUE,0,2018,2018-2019
TN,2019-03-31,inter-ucx,0,0,0,0,0,0,0,0,0,0,0,0,0,0,TRUE,0,2018,2018-2019
TN,2019-03-31,inter-ui,101,42,10,4,3,0,0,1,1,1,76,239,177,219,TRUE,0.740585774058577,2018,2018-2019
TN,2019-03-31,intra-total,1238,680,169,57,40,23,13,14,5,14,1331,3584,2569,3249,TRUE,0.716796875,2018,2018-2019
TN,2019-03-31,intra-ucfe,10,1,2,0,2,2,0,1,0,0,3,21,13,14,TRUE,0.619047619047619,2018,2018-2019
TN,2019-03-31,intra-ucx,6,0,0,1,0,0,0,0,0,0,0,7,6,6,TRUE,0.857142857142857,2018,2018-2019
TN,2019-03-31,intra-ui,1222,679,167,56,38,21,13,13,5,14,1328,3556,2550,3229,TRUE,0.717097862767154,2018,2018-2019
TN,2019-04-30,inter-total,138,8,4,2,3,2,0,0,0,3,50,210,188,196,TRUE,0.895238095238095,2018,2018-2019
TN,2019-04-30,inter-ucfe,1,0,0,0,0,0,0,0,0,1,1,3,2,2,TRUE,0.666666666666667,2018,2018-2019
TN,2019-04-30,inter-ucx,0,0,0,0,0,0,0,0,0,0,0,0,0,0,TRUE,0,2018,2018-2019
TN,2019-04-30,inter-ui,137,8,4,2,3,2,0,0,0,2,49,207,186,194,TRUE,0.898550724637681,2018,2018-2019
TN,2019-04-30,intra-total,3196,151,64,29,37,19,14,4,8,36,830,4388,4026,4177,TRUE,0.917502278942571,2018,2018-2019
TN,2019-04-30,intra-ucfe,10,0,1,0,0,0,1,0,0,0,4,16,14,14,TRUE,0.875,2018,2018-2019
TN,2019-04-30,intra-ucx,8,1,0,0,0,0,0,0,0,0,5,14,13,14,TRUE,0.928571428571429,2018,2018-2019
TN,2019-04-30,intra-ui,3178,150,63,29,37,19,13,4,8,36,821,4358,3999,4149,TRUE,0.9176227627352,2018,2018-2019
TN,2019-05-31,inter-total,160,1,2,1,0,2,0,0,0,1,27,194,187,188,TRUE,0.963917525773196,2018,2018-2019
TN,2019-05-31,inter-ucfe,0,0,0,0,0,0,0,0,0,0,0,0,0,0,TRUE,0,2018,2018-2019
TN,2019-05-31,inter-ucx,1,0,0,0,0,0,0,0,0,0,0,1,1,1,TRUE,1,2018,2018-2019
TN,2019-05-31,inter-ui,159,1,2,1,0,2,0,0,0,1,27,193,186,187,TRUE,0.963730569948187,2018,2018-2019
TN,2019-05-31,intra-total,2782,57,41,39,18,15,8,14,4,19,546,3543,3328,3385,TRUE,0.939316963025684,2018,2018-2019
TN,2019-05-31,intra-ucfe,11,1,0,0,0,1,0,0,0,0,4,17,15,16,TRUE,0.882352941176471,2018,2018-2019
TN,2019-05-31,intra-ucx,6,0,2,0,0,0,0,0,0,0,1,9,7,7,TRUE,0.777777777777778,2018,2018-2019
TN,2019-05-31,intra-ui,2765,56,39,39,18,14,8,14,4,19,541,3517,3306,3362,TRUE,0.940005686664771,2018,2018-2019
TN,2019-06-30,inter-total,199,9,2,5,2,1,1,0,1,0,76,296,275,284,TRUE,0.929054054054054,2018,2018-2019
TN,2019-06-30,inter-ucfe,2,0,0,0,0,0,0,0,0,0,0,2,2,2,TRUE,1,2018,2018-2019
TN,2019-06-30,inter-ucx,1,0,0,0,0,0,0,0,0,0,0,1,1,1,TRUE,1,2018,2018-2019
TN,2019-06-30,inter-ui,196,9,2,5,2,1,1,0,1,0,76,293,272,281,TRUE,0.928327645051194,2018,2018-2019
TN,2019-06-30,intra-total,4046,130,32,30,22,21,4,4,3,11,1071,5374,5117,5247,TRUE,0.952177149237067,2018,2018-2019
TN,2019-06-30,intra-ucfe,5,2,1,0,0,0,0,0,0,0,0,8,5,7,TRUE,0.625,2018,2018-2019
TN,2019-06-30,intra-ucx,10,0,0,0,0,0,0,0,0,0,4,14,14,14,TRUE,1,2018,2018-2019
TN,2019-06-30,intra-ui,4031,128,31,30,22,21,4,4,3,11,1067,5352,5098,5226,TRUE,0.95254110612855,2018,2018-2019
TN,2019-07-31,inter-total,197,8,5,5,0,2,1,0,0,1,79,298,276,284,TRUE,0.926174496644295,2019,2019-2020
TN,2019-07-31,inter-ucfe,1,0,0,0,0,0,0,0,0,0,0,1,1,1,TRUE,1,2019,2019-2020
TN,2019-07-31,inter-ucx,0,0,0,0,0,0,0,0,0,0,0,0,0,0,TRUE,0,2019,2019-2020
TN,2019-07-31,inter-ui,196,8,5,5,0,2,1,0,0,1,79,297,275,283,TRUE,0.925925925925926,2019,2019-2020
TN,2019-07-31,intra-total,3193,171,49,40,31,17,9,7,3,8,1311,4839,4504,4675,TRUE,0.930770820417442,2019,2019-2020
TN,2019-07-31,intra-ucfe,5,2,0,1,0,0,0,0,0,0,2,10,7,9,TRUE,0.7,2019,2019-2020
TN,2019-07-31,intra-ucx,6,0,0,0,0,0,0,0,1,0,1,8,7,7,TRUE,0.875,2019,2019-2020
TN,2019-07-31,intra-ui,3182,169,49,39,31,17,9,7,2,8,1308,4821,4490,4659,TRUE,0.931342045218834,2019,2019-2020
TN,2019-08-31,inter-total,153,8,4,1,2,0,0,0,0,2,67,237,220,228,TRUE,0.928270042194093,2019,2019-2020
TN,2019-08-31,inter-ucfe,0,0,0,0,0,0,0,0,0,0,0,0,0,0,TRUE,0,2019,2019-2020
TN,2019-08-31,inter-ucx,0,0,0,0,0,0,0,0,0,0,0,0,0,0,TRUE,0,2019,2019-2020
TN,2019-08-31,inter-ui,153,8,4,1,2,0,0,0,0,2,67,237,220,228,TRUE,0.928270042194093,2019,2019-2020
TN,2019-08-31,intra-total,2313,135,45,42,21,13,9,4,9,20,925,3536,3238,3373,TRUE,0.915723981900453,2019,2019-2020
TN,2019-08-31,intra-ucfe,7,1,1,0,0,0,0,0,0,0,4,13,11,12,TRUE,0.846153846153846,2019,2019-2020
TN,2019-08-31,intra-ucx,9,1,0,0,1,0,0,0,0,0,1,12,10,11,TRUE,0.833333333333333,2019,2019-2020
TN,2019-08-31,intra-ui,2297,133,44,42,20,13,9,4,9,20,920,3511,3217,3350,TRUE,0.916263172885218,2019,2019-2020
TN,2019-09-30,inter-total,173,4,0,2,2,2,1,0,0,3,56,243,229,233,TRUE,0.94238683127572,2019,2019-2020
TN,2019-09-30,inter-ucfe,0,0,0,1,0,0,0,0,0,0,0,1,0,0,TRUE,0,2019,2019-2020
TN,2019-09-30,inter-ucx,3,0,0,0,0,0,0,0,0,0,0,3,3,3,TRUE,1,2019,2019-2020
TN,2019-09-30,inter-ui,170,4,0,1,2,2,1,0,0,3,56,239,226,230,TRUE,0.94560669456067,2019,2019-2020
TN,2019-09-30,intra-total,2765,95,39,44,33,18,29,13,3,35,771,3845,3536,3631,TRUE,0.91963589076723,2019,2019-2020
TN,2019-09-30,intra-ucfe,2,2,1,0,0,0,0,0,0,0,1,6,3,5,TRUE,0.5,2019,2019-2020
TN,2019-09-30,intra-ucx,12,0,0,0,0,0,0,0,0,0,0,12,12,12,TRUE,1,2019,2019-2020
TN,2019-09-30,intra-ui,2751,93,38,44,33,18,29,13,3,35,770,3827,3521,3614,TRUE,0.92004180820486,2019,2019-2020
TN,2019-10-31,inter-total,170,7,3,7,2,0,1,0,0,3,57,250,227,234,TRUE,0.908,2019,2019-2020
TN,2019-10-31,inter-ucfe,1,0,0,0,0,0,0,0,0,0,2,3,3,3,TRUE,1,2019,2019-2020
TN,2019-10-31,inter-ucx,0,0,0,0,0,0,0,0,0,0,0,0,0,0,TRUE,0,2019,2019-2020
TN,2019-10-31,inter-ui,169,7,3,7,2,0,1,0,0,3,55,247,224,231,TRUE,0.906882591093117,2019,2019-2020
TN,2019-10-31,intra-total,3635,175,64,47,18,14,4,10,8,13,1070,5058,4705,4880,TRUE,0.930209568999605,2019,2019-2020
TN,2019-10-31,intra-ucfe,3,1,1,0,0,0,0,0,1,0,2,8,5,6,TRUE,0.625,2019,2019-2020
TN,2019-10-31,intra-ucx,9,0,0,0,0,0,0,0,0,0,2,11,11,11,TRUE,1,2019,2019-2020
TN,2019-10-31,intra-ui,3623,174,63,47,18,14,4,10,7,13,1066,5039,4689,4863,TRUE,0.93054177416154,2019,2019-2020
TN,2019-11-30,inter-total,120,15,2,0,0,2,0,1,0,3,53,196,173,188,TRUE,0.88265306122449,2019,2019-2020
TN,2019-11-30,inter-ucfe,1,0,0,0,0,0,0,0,0,0,0,1,1,1,TRUE,1,2019,2019-2020
TN,2019-11-30,inter-ucx,0,0,0,0,0,0,0,0,0,0,0,0,0,0,TRUE,0,2019,2019-2020
TN,2019-11-30,inter-ui,119,15,2,0,0,2,0,1,0,3,53,195,172,187,TRUE,0.882051282051282,2019,2019-2020
TN,2019-11-30,intra-total,2027,130,45,38,17,8,11,6,6,14,761,3063,2788,2918,TRUE,0.910218739797584,2019,2019-2020
TN,2019-11-30,intra-ucfe,9,0,1,0,0,0,0,0,0,0,4,14,13,13,TRUE,0.928571428571429,2019,2019-2020
TN,2019-11-30,intra-ucx,7,0,0,0,0,0,0,0,0,0,0,7,7,7,TRUE,1,2019,2019-2020
TN,2019-11-30,intra-ui,2011,130,44,38,17,8,11,6,6,14,757,3042,2768,2898,TRUE,0.909927679158448,2019,2019-2020
TN,2019-12-31,inter-total,252,8,4,5,2,0,1,1,0,0,85,358,337,345,TRUE,0.941340782122905,2019,2019-2020
TN,2019-12-31,inter-ucfe,6,0,0,0,0,0,0,0,0,0,0,6,6,6,TRUE,1,2019,2019-2020
TN,2019-12-31,inter-ucx,0,0,0,0,0,0,0,0,0,0,0,0,0,0,TRUE,0,2019,2019-2020
TN,2019-12-31,inter-ui,246,8,4,5,2,0,1,1,0,0,85,352,331,339,TRUE,0.940340909090909,2019,2019-2020
TN,2019-12-31,intra-total,2934,168,40,34,22,12,8,2,4,6,1043,4273,3977,4145,TRUE,0.930727825883454,2019,2019-2020
TN,2019-12-31,intra-ucfe,12,1,1,0,0,0,0,0,0,0,1,15,13,14,TRUE,0.866666666666667,2019,2019-2020
TN,2019-12-31,intra-ucx,13,1,0,0,0,0,0,0,0,0,1,15,14,15,TRUE,0.933333333333333,2019,2019-2020
TN,2019-12-31,intra-ui,2909,166,39,34,22,12,8,2,4,6,1041,4243,3950,4116,TRUE,0.93094508602404,2019,2019-2020
TN,2020-01-31,inter-total,191,32,8,6,1,2,1,0,0,4,146,391,337,369,TRUE,0.861892583120205,2019,2019-2020
TN,2020-01-31,inter-ucfe,1,0,0,0,0,0,0,0,0,0,0,1,1,1,TRUE,1,2019,2019-2020
TN,2020-01-31,inter-ucx,0,0,0,0,0,0,0,0,0,0,0,0,0,0,TRUE,0,2019,2019-2020
TN,2020-01-31,inter-ui,190,32,8,6,1,2,1,0,0,4,146,390,336,368,TRUE,0.861538461538462,2019,2019-2020
TN,2020-01-31,intra-total,3798,511,124,33,30,20,11,2,3,42,2288,6862,6086,6597,TRUE,0.886913436315943,2019,2019-2020
TN,2020-01-31,intra-ucfe,16,1,0,0,0,0,0,0,0,1,5,23,21,22,TRUE,0.91304347826087,2019,2019-2020
TN,2020-01-31,intra-ucx,8,1,0,0,0,0,0,0,0,1,0,10,8,9,TRUE,0.8,2019,2019-2020
TN,2020-01-31,intra-ui,3774,509,124,33,30,20,11,2,3,40,2283,6829,6057,6566,TRUE,0.886952701713282,2019,2019-2020
TN,2020-02-29,inter-total,119,41,9,4,4,2,2,2,0,2,94,279,213,254,TRUE,0.763440860215054,2019,2019-2020
TN,2020-02-29,inter-ucfe,3,0,0,0,0,0,0,0,0,0,0,3,3,3,TRUE,1,2019,2019-2020
TN,2020-02-29,inter-ucx,0,0,0,0,0,0,0,0,0,0,1,1,1,1,TRUE,1,2019,2019-2020
TN,2020-02-29,inter-ui,116,41,9,4,4,2,2,2,0,2,93,275,209,250,TRUE,0.76,2019,2019-2020
TN,2020-02-29,intra-total,1944,459,96,68,27,13,13,9,5,14,1629,4277,3573,4032,TRUE,0.835398643909282,2019,2019-2020
TN,2020-02-29,intra-ucfe,9,0,1,1,0,1,0,0,0,0,2,14,11,11,TRUE,0.785714285714286,2019,2019-2020
TN,2020-02-29,intra-ucx,12,1,0,1,0,0,0,0,0,0,1,15,13,14,TRUE,0.866666666666667,2019,2019-2020
TN,2020-02-29,intra-ui,1923,458,95,66,27,12,13,9,5,14,1626,4248,3549,4007,TRUE,0.83545197740113,2019,2019-2020
TN,2020-03-31,inter-total,670,23,7,2,5,0,1,1,0,1,113,823,783,806,TRUE,0.951397326852977,2019,2019-2020
TN,2020-03-31,inter-ucfe,0,0,0,0,1,0,0,0,0,0,0,1,0,0,TRUE,0,2019,2019-2020
TN,2020-03-31,inter-ucx,0,0,0,0,0,0,0,0,0,0,0,0,0,0,TRUE,0,2019,2019-2020
TN,2020-03-31,inter-ui,670,23,7,2,4,0,1,1,0,1,113,822,783,806,TRUE,0.952554744525547,2019,2019-2020
TN,2020-03-31,intra-total,20324,364,74,32,29,18,10,10,22,30,2710,23623,23034,23398,TRUE,0.975066672310884,2019,2019-2020
TN,2020-03-31,intra-ucfe,7,0,1,0,0,0,0,0,0,0,5,13,12,12,TRUE,0.923076923076923,2019,2019-2020
TN,2020-03-31,intra-ucx,21,0,0,0,1,0,0,0,0,0,5,27,26,26,TRUE,0.962962962962963,2019,2019-2020
TN,2020-03-31,intra-ui,20296,364,73,32,28,18,10,10,22,30,2700,23583,22996,23360,TRUE,0.975109188822457,2019,2019-2020
TN,2020-04-30,inter-total,6366,396,110,29,4,4,1,0,0,2,1501,8413,7867,8263,TRUE,0.935100439795555,2019,2019-2020
TN,2020-04-30,inter-ucfe,2,0,0,0,0,0,0,0,0,0,1,3,3,3,TRUE,1,2019,2019-2020
TN,2020-04-30,inter-ucx,0,0,0,0,0,0,0,0,0,0,0,0,0,0,TRUE,0,2019,2019-2020
TN,2020-04-30,inter-ui,6364,396,110,29,4,4,1,0,0,2,1500,8410,7864,8260,TRUE,0.935077288941736,2019,2019-2020
TN,2020-04-30,intra-total,175318,11928,3630,759,57,23,12,10,8,93,43993,235831,219311,231239,TRUE,0.929949836959518,2019,2019-2020
TN,2020-04-30,intra-ucfe,14,5,4,0,0,0,0,0,1,0,14,38,28,33,TRUE,0.736842105263158,2019,2019-2020
TN,2020-04-30,intra-ucx,25,5,2,1,0,0,0,0,0,0,19,52,44,49,TRUE,0.846153846153846,2019,2019-2020
TN,2020-04-30,intra-ui,175279,11918,3624,758,57,23,12,10,7,93,43960,235741,219239,231157,TRUE,0.929999448547346,2019,2019-2020
TN,2020-05-31,inter-total,2390,396,331,345,296,203,24,5,2,5,639,4636,3029,3425,TRUE,0.653364969801553,2019,2019-2020
TN,2020-05-31,inter-ucfe,0,0,1,0,2,1,0,0,0,0,2,6,2,2,TRUE,0.333333333333333,2019,2019-2020
TN,2020-05-31,inter-ucx,0,0,0,0,0,0,0,0,0,0,0,0,0,0,TRUE,0,2019,2019-2020
TN,2020-05-31,inter-ui,2390,396,330,345,294,202,24,5,2,5,637,4630,3027,3423,TRUE,0.65377969762419,2019,2019-2020
TN,2020-05-31,intra-total,50760,8637,8399,8634,8200,4446,803,122,26,31,12939,102997,63699,72336,TRUE,0.618454906453586,2019,2019-2020
TN,2020-05-31,intra-ucfe,4,4,5,8,6,0,2,0,1,0,0,30,4,8,TRUE,0.133333333333333,2019,2019-2020
TN,2020-05-31,intra-ucx,9,3,2,9,8,3,0,0,0,0,6,40,15,18,TRUE,0.375,2019,2019-2020
TN,2020-05-31,intra-ui,50747,8630,8392,8617,8186,4443,801,122,25,31,12933,102927,63680,72310,TRUE,0.618690916863408,2019,2019-2020
TN,2020-06-30,inter-total,828,79,57,38,44,46,62,59,43,47,170,1473,998,1077,TRUE,0.677528852681602,2019,2019-2020
TN,2020-06-30,inter-ucfe,0,0,1,0,1,1,2,0,1,0,0,6,0,0,TRUE,0,2019,2019-2020
TN,2020-06-30,inter-ucx,0,0,0,0,0,0,1,0,0,0,0,1,0,0,TRUE,0,2019,2019-2020
TN,2020-06-30,inter-ui,828,79,56,38,43,45,59,59,42,47,170,1466,998,1077,TRUE,0.680763983628922,2019,2019-2020
TN,2020-06-30,intra-total,19773,1860,1365,871,867,1120,1804,1506,1224,1286,4295,35971,24068,25928,TRUE,0.6690945483862,2019,2019-2020
TN,2020-06-30,intra-ucfe,0,1,5,1,4,1,9,2,8,3,1,35,1,2,TRUE,0.0285714285714286,2019,2019-2020
TN,2020-06-30,intra-ucx,9,1,5,1,2,3,4,4,4,0,4,37,13,14,TRUE,0.351351351351351,2019,2019-2020
TN,2020-06-30,intra-ui,19764,1858,1355,869,861,1116,1791,1500,1212,1283,4290,35899,24054,25912,TRUE,0.670046519401655,2019,2019-2020
TN,2020-07-31,inter-total,42,24,28,12,11,20,16,9,17,100,18,297,60,84,TRUE,0.202020202020202,2020,2020-2021
TN,2020-07-31,inter-ucfe,0,0,0,0,0,0,0,0,0,0,0,0,0,0,TRUE,0,2020,2020-2021
TN,2020-07-31,inter-ucx,0,0,0,0,0,0,0,0,0,0,0,0,0,0,TRUE,0,2020,2020-2021
TN,2020-07-31,inter-ui,42,24,28,12,11,20,16,9,17,100,18,297,60,84,TRUE,0.202020202020202,2020,2020-2021
TN,2020-07-31,intra-total,1438,2146,2123,1673,814,1036,543,413,432,3056,884,14558,2322,4468,TRUE,0.159499931309246,2020,2020-2021
TN,2020-07-31,intra-ucfe,0,2,0,4,1,0,0,0,1,21,1,30,1,3,TRUE,0.0333333333333333,2020,2020-2021
TN,2020-07-31,intra-ucx,10,1,1,4,0,1,0,1,0,9,2,29,12,13,TRUE,0.413793103448276,2020,2020-2021
TN,2020-07-31,intra-ui,1428,2143,2122,1665,813,1035,543,412,431,3026,881,14499,2309,4452,TRUE,0.159252362231878,2020,2020-2021
TN,2020-08-31,inter-total,57,150,97,78,86,82,49,12,7,118,102,838,159,309,TRUE,0.189737470167064,2020,2020-2021
TN,2020-08-31,inter-ucfe,0,0,0,0,0,0,0,0,0,0,0,0,0,0,TRUE,0,2020,2020-2021
TN,2020-08-31,inter-ucx,1,0,0,0,0,0,0,0,0,0,0,1,1,1,TRUE,1,2020,2020-2021
TN,2020-08-31,inter-ui,56,150,97,78,86,82,49,12,7,118,102,837,158,308,TRUE,0.188769414575866,2020,2020-2021
TN,2020-08-31,intra-total,4100,9061,6825,5563,4507,4487,2664,474,378,3319,6258,47636,10358,19419,TRUE,0.217440591149551,2020,2020-2021
TN,2020-08-31,intra-ucfe,0,0,0,0,1,1,0,3,2,14,1,22,1,1,TRUE,0.0454545454545455,2020,2020-2021
TN,2020-08-31,intra-ucx,4,4,0,0,1,0,0,1,1,20,3,34,7,11,TRUE,0.205882352941176,2020,2020-2021
TN,2020-08-31,intra-ui,4096,9057,6825,5563,4505,4486,2664,470,375,3285,6254,47580,10350,19407,TRUE,0.217528373266078,2020,2020-2021
TN,2020-09-30,inter-total,59,8,7,2,9,14,2,7,3,83,61,255,120,128,TRUE,0.470588235294118,2020,2020-2021
TN,2020-09-30,inter-ucfe,0,0,0,0,0,0,0,0,0,0,0,0,0,0,TRUE,0,2020,2020-2021
TN,2020-09-30,inter-ucx,0,0,0,0,0,0,0,0,0,0,0,0,0,0,TRUE,0,2020,2020-2021
TN,2020-09-30,inter-ui,59,8,7,2,9,14,2,7,3,83,61,255,120,128,TRUE,0.470588235294118,2020,2020-2021
TN,2020-09-30,intra-total,4015,543,258,211,192,221,218,268,258,2736,2893,11813,6908,7451,TRUE,0.584779480233641,2020,2020-2021
TN,2020-09-30,intra-ucfe,0,0,0,1,0,0,0,2,1,26,0,30,0,0,TRUE,0,2020,2020-2021
TN,2020-09-30,intra-ucx,10,3,1,1,0,1,0,1,1,14,2,34,12,15,TRUE,0.352941176470588,2020,2020-2021
TN,2020-09-30,intra-ui,4005,540,257,209,192,220,218,265,256,2696,2891,11749,6896,7436,TRUE,0.586943569665503,2020,2020-2021
TN,2020-10-31,inter-total,34,2,1,5,0,3,4,4,4,61,24,142,58,60,TRUE,0.408450704225352,2020,2020-2021
TN,2020-10-31,inter-ucfe,0,0,0,0,0,0,0,0,0,0,0,0,0,0,TRUE,0,2020,2020-2021
TN,2020-10-31,inter-ucx,1,0,0,0,0,0,0,0,0,0,0,1,1,1,TRUE,1,2020,2020-2021
TN,2020-10-31,inter-ui,33,2,1,5,0,3,4,4,4,61,24,141,57,59,TRUE,0.404255319148936,2020,2020-2021
TN,2020-10-31,intra-total,2697,334,101,121,119,138,124,104,129,1949,1209,7025,3906,4240,TRUE,0.556014234875445,2020,2020-2021
TN,2020-10-31,intra-ucfe,0,0,0,0,1,0,2,0,1,12,0,16,0,0,TRUE,0,2020,2020-2021
TN,2020-10-31,intra-ucx,4,1,0,1,0,0,0,0,1,19,0,26,4,5,TRUE,0.153846153846154,2020,2020-2021
TN,2020-10-31,intra-ui,2693,333,101,120,118,138,122,104,127,1918,1209,6983,3902,4235,TRUE,0.558785622225405,2020,2020-2021
TN,2020-11-30,inter-total,27,5,4,4,1,5,0,1,3,53,37,140,64,69,TRUE,0.457142857142857,2020,2020-2021
TN,2020-11-30,inter-ucfe,0,0,0,0,0,0,0,0,0,0,0,0,0,0,TRUE,0,2020,2020-2021
TN,2020-11-30,inter-ucx,0,0,0,0,0,0,0,0,0,0,0,0,0,0,TRUE,0,2020,2020-2021
TN,2020-11-30,inter-ui,27,5,4,4,1,5,0,1,3,53,37,140,64,69,TRUE,0.457142857142857,2020,2020-2021
TN,2020-11-30,intra-total,1294,235,156,114,73,75,66,68,65,1611,1193,4950,2487,2722,TRUE,0.502424242424242,2020,2020-2021
TN,2020-11-30,intra-ucfe,0,1,1,1,0,1,0,0,0,9,0,13,0,1,TRUE,0,2020,2020-2021
TN,2020-11-30,intra-ucx,7,2,2,0,0,1,0,0,0,9,1,22,8,10,TRUE,0.363636363636364,2020,2020-2021
TN,2020-11-30,intra-ui,1287,232,153,113,73,73,66,68,65,1593,1192,4915,2479,2711,TRUE,0.504374364191251,2020,2020-2021
TN,2020-12-31,inter-total,40,13,4,9,3,7,5,6,6,75,36,204,76,89,TRUE,0.372549019607843,2020,2020-2021
TN,2020-12-31,inter-ucfe,0,0,0,0,0,0,0,0,0,0,0,0,0,0,TRUE,0,2020,2020-2021
TN,2020-12-31,inter-ucx,0,0,0,0,0,0,0,0,0,0,0,0,0,0,TRUE,0,2020,2020-2021
TN,2020-12-31,inter-ui,40,13,4,9,3,7,5,6,6,75,36,204,76,89,TRUE,0.372549019607843,2020,2020-2021
TN,2020-12-31,intra-total,2255,310,163,180,233,233,210,221,211,3168,1261,8445,3516,3826,TRUE,0.416341030195382,2020,2020-2021
TN,2020-12-31,intra-ucfe,0,0,0,1,0,1,0,0,1,6,0,9,0,0,TRUE,0,2020,2020-2021
TN,2020-12-31,intra-ucx,0,0,1,0,0,1,1,0,1,20,0,24,0,0,TRUE,0,2020,2020-2021
TN,2020-12-31,intra-ui,2255,310,162,179,233,231,209,221,209,3142,1261,8412,3516,3826,TRUE,0.417974322396576,2020,2020-2021
TN,2021-01-31,inter-total,40,12,4,6,8,4,0,2,7,49,38,170,78,90,TRUE,0.458823529411765,2020,2020-2021
TN,2021-01-31,inter-ucfe,0,0,0,0,0,0,0,0,0,0,0,0,0,0,TRUE,0,2020,2020-2021
TN,2021-01-31,inter-ucx,0,0,0,0,0,0,0,0,0,0,0,0,0,0,TRUE,0,2020,2020-2021
TN,2021-01-31,inter-ui,40,12,4,6,8,4,0,2,7,49,38,170,78,90,TRUE,0.458823529411765,2020,2020-2021
TN,2021-01-31,intra-total,3961,883,321,276,161,147,171,166,160,2696,2750,11692,6711,7594,TRUE,0.573982210058159,2020,2020-2021
TN,2021-01-31,intra-ucfe,0,0,0,0,0,0,2,0,0,12,0,14,0,0,TRUE,0,2020,2020-2021
TN,2021-01-31,intra-ucx,0,1,0,0,0,1,0,0,0,3,0,5,0,1,TRUE,0,2020,2020-2021
TN,2021-01-31,intra-ui,3961,882,321,276,161,146,169,166,160,2681,2750,11673,6711,7593,TRUE,0.574916473914161,2020,2020-2021
TN,2021-02-28,inter-total,78,13,6,6,10,11,5,7,2,122,34,294,112,125,TRUE,0.380952380952381,2020,2020-2021
TN,2021-02-28,inter-ucfe,0,0,0,0,0,0,0,0,0,1,0,1,0,0,TRUE,0,2020,2020-2021
TN,2021-02-28,inter-ucx,0,0,0,0,0,0,0,0,0,0,0,0,0,0,TRUE,0,2020,2020-2021
TN,2021-02-28,inter-ui,78,13,6,6,10,11,5,7,2,121,34,293,112,125,TRUE,0.382252559726962,2020,2020-2021
TN,2021-02-28,intra-total,3029,588,541,538,518,470,315,261,199,3790,1570,11819,4599,5187,TRUE,0.389119214823589,2020,2020-2021
TN,2021-02-28,intra-ucfe,0,2,0,2,1,1,1,0,0,14,0,21,0,2,TRUE,0,2020,2020-2021
TN,2021-02-28,intra-ucx,0,0,2,0,0,0,0,0,0,2,0,4,0,0,TRUE,0,2020,2020-2021
TN,2021-02-28,intra-ui,3029,586,539,536,517,469,314,261,199,3774,1570,11794,4599,5185,TRUE,0.389944039342038,2020,2020-2021
TN,2021-03-31,inter-total,35,16,6,11,3,13,8,8,6,68,46,220,81,97,TRUE,0.368181818181818,2020,2020-2021
TN,2021-03-31,inter-ucfe,0,0,0,0,0,0,0,0,0,0,0,0,0,0,TRUE,0,2020,2020-2021
TN,2021-03-31,inter-ucx,0,0,0,0,0,0,0,0,0,0,0,0,0,0,TRUE,0,2020,2020-2021
TN,2021-03-31,inter-ui,35,16,6,11,3,13,8,8,6,68,46,220,81,97,TRUE,0.368181818181818,2020,2020-2021
TN,2021-03-31,intra-total,2639,501,562,461,357,384,369,405,343,2806,1802,10629,4441,4942,TRUE,0.417819173958039,2020,2020-2021
TN,2021-03-31,intra-ucfe,0,0,1,0,0,0,3,1,2,27,0,34,0,0,TRUE,0,2020,2020-2021
TN,2021-03-31,intra-ucx,1,1,1,0,1,1,0,1,0,8,0,14,1,2,TRUE,0.0714285714285714,2020,2020-2021
TN,2021-03-31,intra-ui,2638,500,560,461,356,383,366,403,341,2771,1802,10581,4440,4940,TRUE,0.41962007371704,2020,2020-2021
TN,2021-04-30,inter-total,92,7,5,3,4,3,0,0,1,56,56,227,148,155,TRUE,0.651982378854626,2020,2020-2021
TN,2021-04-30,inter-ucfe,0,0,0,0,0,0,0,0,0,1,0,1,0,0,TRUE,0,2020,2020-2021
TN,2021-04-30,inter-ucx,0,0,0,0,0,0,0,0,0,0,0,0,0,0,TRUE,0,2020,2020-2021
TN,2021-04-30,inter-ui,92,7,5,3,4,3,0,0,1,55,56,226,148,155,TRUE,0.654867256637168,2020,2020-2021
TN,2021-04-30,intra-total,7803,600,384,364,242,131,124,125,100,2202,2617,14692,10420,11020,TRUE,0.709229512659951,2020,2020-2021
TN,2021-04-30,intra-ucfe,7,3,0,0,1,0,1,0,1,22,5,40,12,15,TRUE,0.3,2020,2020-2021
TN,2021-04-30,intra-ucx,0,0,0,0,0,0,0,0,0,5,0,5,0,0,TRUE,0,2020,2020-2021
TN,2021-04-30,intra-ui,7796,597,384,364,241,131,123,125,99,2175,2612,14647,10408,11005,TRUE,0.71058919915341,2020,2020-2021
TN,2021-05-31,inter-total,32,12,11,5,7,1,1,2,1,53,30,155,62,74,TRUE,0.4,2020,2020-2021
TN,2021-05-31,inter-ucfe,0,0,0,0,0,0,0,0,0,1,0,1,0,0,TRUE,0,2020,2020-2021
TN,2021-05-31,inter-ucx,0,0,0,0,0,0,0,0,0,1,0,1,0,0,TRUE,0,2020,2020-2021
TN,2021-05-31,inter-ui,32,12,11,5,7,1,1,2,1,51,30,153,62,74,TRUE,0.405228758169935,2020,2020-2021
TN,2021-05-31,intra-total,3207,1187,743,334,191,180,126,116,128,2548,2599,11359,5806,6993,TRUE,0.511136543709834,2020,2020-2021
TN,2021-05-31,intra-ucfe,0,0,2,2,1,1,0,1,1,13,2,23,2,2,TRUE,0.0869565217391304,2020,2020-2021
TN,2021-05-31,intra-ucx,1,0,0,1,1,1,0,0,0,3,0,7,1,1,TRUE,0.142857142857143,2020,2020-2021
TN,2021-05-31,intra-ui,3206,1187,741,331,189,178,126,115,127,2532,2597,11329,5803,6990,TRUE,0.512225262600406,2020,2020-2021
TN,2021-06-30,inter-total,69,12,5,1,6,0,3,4,6,46,36,188,105,117,TRUE,0.558510638297872,2020,2020-2021
TN,2021-06-30,inter-ucfe,0,1,0,0,0,0,0,0,0,1,0,2,0,1,TRUE,0,2020,2020-2021
TN,2021-06-30,inter-ucx,0,0,0,0,0,0,0,0,0,0,0,0,0,0,TRUE,0,2020,2020-2021
TN,2021-06-30,inter-ui,69,11,5,1,6,0,3,4,6,45,36,186,105,116,TRUE,0.564516129032258,2020,2020-2021
TN,2021-06-30,intra-total,3781,759,548,428,376,311,174,151,147,2222,2553,11450,6334,7093,TRUE,0.553187772925764,2020,2020-2021
TN,2021-06-30,intra-ucfe,1,0,1,0,1,0,2,2,0,14,2,23,3,3,TRUE,0.130434782608696,2020,2020-2021
TN,2021-06-30,intra-ucx,0,0,0,0,0,0,0,0,1,8,1,10,1,1,TRUE,0.1,2020,2020-2021
TN,2021-06-30,intra-ui,3780,759,547,428,375,311,172,149,146,2200,2550,11417,6330,7089,TRUE,0.554436366821407,2020,2020-2021
TN,2021-07-31,inter-total,15,4,3,4,1,5,3,3,1,21,15,75,30,34,TRUE,0.4,2021,2021-2022
TN,2021-07-31,inter-ucfe,0,0,0,0,0,0,0,0,0,0,0,0,0,0,TRUE,0,2021,2021-2022
TN,2021-07-31,inter-ucx,0,0,0,0,0,0,0,0,0,0,0,0,0,0,TRUE,0,2021,2021-2022
TN,2021-07-31,inter-ui,15,4,3,4,1,5,3,3,1,21,15,75,30,34,TRUE,0.4,2021,2021-2022
TN,2021-07-31,intra-total,2125,516,339,220,178,147,179,145,98,1258,1221,6426,3346,3862,TRUE,0.520697167755991,2021,2021-2022
TN,2021-07-31,intra-ucfe,4,0,0,2,0,1,0,1,0,11,0,19,4,4,TRUE,0.210526315789474,2021,2021-2022
TN,2021-07-31,intra-ucx,0,0,1,0,0,0,0,1,0,5,0,7,0,0,TRUE,0,2021,2021-2022
TN,2021-07-31,intra-ui,2121,516,338,218,178,146,179,143,98,1242,1221,6400,3342,3858,TRUE,0.5221875,2021,2021-2022
TN,2021-08-31,inter-total,27,9,1,1,1,2,1,2,2,22,11,79,38,47,TRUE,0.481012658227848,2021,2021-2022
TN,2021-08-31,inter-ucfe,0,0,0,0,0,0,0,0,0,0,0,0,0,0,TRUE,0,2021,2021-2022
TN,2021-08-31,inter-ucx,0,0,0,0,0,0,0,0,0,0,0,0,0,0,TRUE,0,2021,2021-2022
TN,2021-08-31,inter-ui,27,9,1,1,1,2,1,2,2,22,11,79,38,47,TRUE,0.481012658227848,2021,2021-2022
TN,2021-08-31,intra-total,2442,508,133,226,128,120,120,87,69,1403,387,5623,2829,3337,TRUE,0.503112217677396,2021,2021-2022
TN,2021-08-31,intra-ucfe,0,2,2,2,2,1,1,0,0,18,1,29,1,3,TRUE,0.0344827586206897,2021,2021-2022
TN,2021-08-31,intra-ucx,1,0,0,0,0,0,1,0,1,8,0,11,1,1,TRUE,0.0909090909090909,2021,2021-2022
TN,2021-08-31,intra-ui,2441,506,131,224,126,119,118,87,68,1377,386,5583,2827,3333,TRUE,0.506358588572452,2021,2021-2022
TN,2021-09-30,inter-total,10,3,0,2,0,1,1,1,1,21,1,41,11,14,TRUE,0.268292682926829,2021,2021-2022
TN,2021-09-30,inter-ucfe,0,0,0,0,0,0,0,0,0,0,0,0,0,0,TRUE,0,2021,2021-2022
TN,2021-09-30,inter-ucx,0,0,0,0,0,0,0,0,1,0,0,1,0,0,TRUE,0,2021,2021-2022
TN,2021-09-30,inter-ui,10,3,0,2,0,1,1,1,0,21,1,40,11,14,TRUE,0.275,2021,2021-2022
TN,2021-09-30,intra-total,1102,347,139,63,78,45,38,49,43,1199,225,3328,1327,1674,TRUE,0.398737980769231,2021,2021-2022
TN,2021-09-30,intra-ucfe,0,1,0,3,1,2,3,0,1,15,1,27,1,2,TRUE,0.037037037037037,2021,2021-2022
TN,2021-09-30,intra-ucx,0,0,0,0,0,1,0,1,0,5,1,8,1,1,TRUE,0.125,2021,2021-2022
TN,2021-09-30,intra-ui,1102,346,139,60,77,42,35,48,42,1179,223,3293,1325,1671,TRUE,0.402368660795627,2021,2021-2022
TN,2021-10-31,inter-total,1,1,1,0,1,0,1,0,0,26,0,31,1,2,TRUE,0.032258064516129,2021,2021-2022
TN,2021-10-31,inter-ucfe,0,0,0,0,0,0,0,0,0,0,0,0,0,0,TRUE,0,2021,2021-2022
TN,2021-10-31,inter-ucx,0,0,0,0,0,0,0,0,0,0,0,0,0,0,TRUE,0,2021,2021-2022
TN,2021-10-31,inter-ui,1,1,1,0,1,0,1,0,0,26,0,31,1,2,TRUE,0.032258064516129,2021,2021-2022
TN,2021-10-31,intra-total,265,217,80,70,66,52,43,35,37,1132,91,2088,356,573,TRUE,0.170498084291188,2021,2021-2022
TN,2021-10-31,intra-ucfe,2,1,0,0,0,1,0,0,0,9,1,14,3,4,TRUE,0.214285714285714,2021,2021-2022
TN,2021-10-31,intra-ucx,1,0,2,0,2,0,0,0,0,4,0,9,1,1,TRUE,0.111111111111111,2021,2021-2022
TN,2021-10-31,intra-ui,262,216,78,70,64,51,43,35,37,1119,90,2065,352,568,TRUE,0.17046004842615,2021,2021-2022
TN,2021-11-30,inter-total,4,9,0,3,1,1,1,1,1,14,1,36,5,14,TRUE,0.138888888888889,2021,2021-2022
TN,2021-11-30,inter-ucfe,0,0,0,0,0,0,0,0,0,0,0,0,0,0,TRUE,0,2021,2021-2022
TN,2021-11-30,inter-ucx,0,0,0,0,0,0,0,0,0,0,0,0,0,0,TRUE,0,2021,2021-2022
TN,2021-11-30,inter-ui,4,9,0,3,1,1,1,1,1,14,1,36,5,14,TRUE,0.138888888888889,2021,2021-2022
TN,2021-11-30,intra-total,445,279,82,65,61,44,37,47,35,879,139,2113,584,863,TRUE,0.276384287742546,2021,2021-2022
TN,2021-11-30,intra-ucfe,1,0,1,0,0,0,0,0,1,8,0,11,1,1,TRUE,0.0909090909090909,2021,2021-2022
TN,2021-11-30,intra-ucx,1,0,0,0,1,0,0,0,1,5,0,8,1,1,TRUE,0.125,2021,2021-2022
TN,2021-11-30,intra-ui,443,279,81,65,60,44,37,47,33,866,139,2094,582,861,TRUE,0.277936962750716,2021,2021-2022
TN,2021-12-31,inter-total,1,8,1,1,0,0,0,1,0,35,1,48,2,10,TRUE,0.0416666666666667,2021,2021-2022
TN,2021-12-31,inter-ucfe,0,0,0,0,0,0,0,0,0,1,0,1,0,0,TRUE,0,2021,2021-2022
TN,2021-12-31,inter-ucx,0,0,0,0,0,0,0,0,0,0,0,0,0,0,TRUE,0,2021,2021-2022
TN,2021-12-31,inter-ui,1,8,1,1,0,0,0,1,0,34,1,47,2,10,TRUE,0.0425531914893617,2021,2021-2022
TN,2021-12-31,intra-total,294,272,65,54,30,28,27,21,23,2329,61,3204,355,627,TRUE,0.110799001248439,2021,2021-2022
TN,2021-12-31,intra-ucfe,1,0,0,2,0,0,1,0,0,12,0,16,1,1,TRUE,0.0625,2021,2021-2022
TN,2021-12-31,intra-ucx,1,0,0,0,0,0,0,0,0,3,0,4,1,1,TRUE,0.25,2021,2021-2022
TN,2021-12-31,intra-ui,292,272,65,52,30,28,26,21,23,2314,61,3184,353,625,TRUE,0.110866834170854,2021,2021-2022
TN,2022-01-31,inter-total,176,18,2,2,3,0,0,0,0,16,13,230,189,207,TRUE,0.821739130434783,2021,2021-2022
TN,2022-01-31,inter-ucfe,0,0,0,0,0,0,0,0,0,0,0,0,0,0,TRUE,0,2021,2021-2022
TN,2022-01-31,inter-ucx,0,0,0,0,0,0,0,0,0,0,0,0,0,0,TRUE,0,2021,2021-2022
TN,2022-01-31,inter-ui,176,18,2,2,3,0,0,0,0,16,13,230,189,207,TRUE,0.821739130434783,2021,2021-2022
TN,2022-01-31,intra-total,1753,241,116,86,47,44,39,22,37,731,282,3398,2035,2276,TRUE,0.598881695114773,2021,2021-2022
TN,2022-01-31,intra-ucfe,0,2,0,0,2,0,0,0,0,10,0,14,0,2,TRUE,0,2021,2021-2022
TN,2022-01-31,intra-ucx,0,0,1,0,0,0,0,0,0,3,0,4,0,0,TRUE,0,2021,2021-2022
TN,2022-01-31,intra-ui,1753,239,115,86,45,44,39,22,37,718,282,3380,2035,2274,TRUE,0.60207100591716,2021,2021-2022
TN,2022-02-28,inter-total,20,5,4,1,1,2,0,3,0,26,2,64,22,27,TRUE,0.34375,2021,2021-2022
TN,2022-02-28,inter-ucfe,0,0,0,0,0,0,0,0,0,0,0,0,0,0,TRUE,0,2021,2021-2022
TN,2022-02-28,inter-ucx,0,0,0,0,0,0,0,0,0,0,0,0,0,0,TRUE,0,2021,2021-2022
TN,2022-02-28,inter-ui,20,5,4,1,1,2,0,3,0,26,2,64,22,27,TRUE,0.34375,2021,2021-2022
TN,2022-02-28,intra-total,251,165,152,178,127,118,90,82,65,1754,72,3054,323,488,TRUE,0.105762933857236,2021,2021-2022
TN,2022-02-28,intra-ucfe,0,0,0,1,2,0,0,0,0,7,0,10,0,0,TRUE,0,2021,2021-2022
TN,2022-02-28,intra-ucx,0,2,1,1,0,0,0,0,0,8,0,12,0,2,TRUE,0,2021,2021-2022
TN,2022-02-28,intra-ui,251,163,151,176,125,118,90,82,65,1739,72,3032,323,486,TRUE,0.106530343007916,2021,2021-2022
TN,2022-03-31,inter-total,14,3,1,4,1,2,1,1,0,30,2,59,16,19,TRUE,0.271186440677966,2021,2021-2022
TN,2022-03-31,inter-ucfe,0,0,0,0,0,1,0,0,0,3,0,4,0,0,TRUE,0,2021,2021-2022
TN,2022-03-31,inter-ucx,0,0,0,0,0,0,0,0,0,0,0,0,0,0,TRUE,0,2021,2021-2022
TN,2022-03-31,inter-ui,14,3,1,4,1,1,1,1,0,27,2,55,16,19,TRUE,0.290909090909091,2021,2021-2022
TN,2022-03-31,intra-total,442,204,145,128,102,114,102,54,67,1378,216,2952,658,862,TRUE,0.22289972899729,2021,2021-2022
TN,2022-03-31,intra-ucfe,0,0,0,0,0,2,5,0,2,17,0,26,0,0,TRUE,0,2021,2021-2022
TN,2022-03-31,intra-ucx,2,0,0,0,0,0,0,0,0,16,3,21,5,5,TRUE,0.238095238095238,2021,2021-2022
TN,2022-03-31,intra-ui,440,204,145,128,102,112,97,54,65,1345,213,2905,653,857,TRUE,0.224784853700516,2021,2021-2022
TN,2022-04-30,inter-total,3,1,1,4,0,4,3,1,1,26,3,47,6,7,TRUE,0.127659574468085,2021,2021-2022
TN,2022-04-30,inter-ucfe,0,0,0,0,0,0,0,0,0,0,0,0,0,0,TRUE,0,2021,2021-2022
TN,2022-04-30,inter-ucx,0,0,0,0,0,0,0,0,0,1,0,1,0,0,TRUE,0,2021,2021-2022
TN,2022-04-30,inter-ui,3,1,1,4,0,4,3,1,1,25,3,46,6,7,TRUE,0.130434782608696,2021,2021-2022
TN,2022-04-30,intra-total,357,154,76,61,48,44,53,56,41,1179,200,2269,557,711,TRUE,0.245482591449978,2021,2021-2022
TN,2022-04-30,intra-ucfe,0,1,2,1,0,1,0,0,0,10,0,15,0,1,TRUE,0,2021,2021-2022
TN,2022-04-30,intra-ucx,2,0,0,0,1,0,0,0,0,15,1,19,3,3,TRUE,0.157894736842105,2021,2021-2022
TN,2022-04-30,intra-ui,355,153,74,60,47,43,53,56,41,1154,199,2235,554,707,TRUE,0.247874720357942,2021,2021-2022
TN,2022-05-31,inter-total,11,3,3,1,0,6,1,1,1,36,6,69,17,20,TRUE,0.246376811594203,2021,2021-2022
TN,2022-05-31,inter-ucfe,0,0,0,0,0,0,0,0,0,0,0,0,0,0,TRUE,0,2021,2021-2022
TN,2022-05-31,inter-ucx,0,0,0,0,0,0,0,0,0,0,0,0,0,0,TRUE,0,2021,2021-2022
TN,2022-05-31,inter-ui,11,3,3,1,0,6,1,1,1,36,6,69,17,20,TRUE,0.246376811594203,2021,2021-2022
TN,2022-05-31,intra-total,601,182,151,74,78,45,35,51,43,1368,321,2949,922,1104,TRUE,0.312648355374703,2021,2021-2022
TN,2022-05-31,intra-ucfe,0,0,0,2,0,0,0,3,0,6,3,14,3,3,TRUE,0.214285714285714,2021,2021-2022
TN,2022-05-31,intra-ucx,3,0,1,1,0,0,0,1,0,17,0,23,3,3,TRUE,0.130434782608696,2021,2021-2022
TN,2022-05-31,intra-ui,598,182,150,71,78,45,35,47,43,1345,318,2912,916,1098,TRUE,0.31456043956044,2021,2021-2022
TN,2022-06-30,inter-total,23,2,6,5,1,1,2,0,1,20,11,72,34,36,TRUE,0.472222222222222,2021,2021-2022
TN,2022-06-30,inter-ucfe,0,0,0,0,0,0,0,0,0,0,0,0,0,0,TRUE,0,2021,2021-2022
TN,2022-06-30,inter-ucx,0,0,0,0,0,0,0,0,0,1,0,1,0,0,TRUE,0,2021,2021-2022
TN,2022-06-30,inter-ui,23,2,6,5,1,1,2,0,1,19,11,71,34,36,TRUE,0.47887323943662,2021,2021-2022
TN,2022-06-30,intra-total,1241,183,167,101,90,79,60,39,45,1193,386,3584,1627,1810,TRUE,0.453962053571429,2021,2021-2022
TN,2022-06-30,intra-ucfe,0,1,0,0,1,0,0,0,0,7,1,10,1,2,TRUE,0.1,2021,2021-2022
TN,2022-06-30,intra-ucx,3,0,0,0,0,0,0,0,0,6,1,10,4,4,TRUE,0.4,2021,2021-2022
TN,2022-06-30,intra-ui,1238,182,167,101,89,79,60,39,45,1180,384,3564,1622,1804,TRUE,0.455106621773289,2021,2021-2022
TN,2022-07-31,inter-total,16,4,4,3,3,2,4,2,4,20,8,70,24,28,TRUE,0.342857142857143,2022,2022-2023
TN,2022-07-31,inter-ucfe,0,0,0,0,0,0,0,0,0,0,0,0,0,0,TRUE,0,2022,2022-2023
TN,2022-07-31,inter-ucx,0,0,0,0,0,0,0,0,0,0,0,0,0,0,TRUE,0,2022,2022-2023
TN,2022-07-31,inter-ui,16,4,4,3,3,2,4,2,4,20,8,70,24,28,TRUE,0.342857142857143,2022,2022-2023
TN,2022-07-31,intra-total,1015,338,332,240,161,125,108,78,48,1052,576,4073,1591,1929,TRUE,0.390621163761355,2022,2022-2023
TN,2022-07-31,intra-ucfe,4,0,1,1,0,2,0,0,0,5,0,13,4,4,TRUE,0.307692307692308,2022,2022-2023
TN,2022-07-31,intra-ucx,5,0,2,1,1,0,0,0,0,3,0,12,5,5,TRUE,0.416666666666667,2022,2022-2023
TN,2022-07-31,intra-ui,1006,338,329,238,160,123,108,78,48,1044,576,4048,1582,1920,TRUE,0.390810276679842,2022,2022-2023
TN,2022-08-31,inter-total,23,10,7,8,1,1,1,1,0,29,9,90,32,42,TRUE,0.355555555555556,2022,2022-2023
TN,2022-08-31,inter-ucfe,0,0,0,0,0,0,0,0,0,1,0,1,0,0,TRUE,0,2022,2022-2023
TN,2022-08-31,inter-ucx,0,0,0,0,0,0,0,0,0,0,0,0,0,0,TRUE,0,2022,2022-2023
TN,2022-08-31,inter-ui,23,10,7,8,1,1,1,1,0,28,9,89,32,42,TRUE,0.359550561797753,2022,2022-2023
TN,2022-08-31,intra-total,1349,418,280,172,134,133,105,95,77,1006,531,4300,1880,2298,TRUE,0.437209302325581,2022,2022-2023
TN,2022-08-31,intra-ucfe,1,1,2,0,1,0,0,2,0,7,0,14,1,2,TRUE,0.0714285714285714,2022,2022-2023
TN,2022-08-31,intra-ucx,3,2,2,0,0,1,0,0,0,4,3,15,6,8,TRUE,0.4,2022,2022-2023
TN,2022-08-31,intra-ui,1345,415,276,172,133,132,105,93,77,995,528,4271,1873,2288,TRUE,0.438538983844533,2022,2022-2023
TN,2022-09-30,inter-total,18,4,6,3,5,3,1,2,3,22,7,74,25,29,TRUE,0.337837837837838,2022,2022-2023
TN,2022-09-30,inter-ucfe,0,0,0,0,0,0,0,0,0,0,0,0,0,0,TRUE,0,2022,2022-2023
TN,2022-09-30,inter-ucx,1,0,0,0,0,0,0,0,0,0,0,1,1,1,TRUE,1,2022,2022-2023
TN,2022-09-30,inter-ui,17,4,6,3,5,3,1,2,3,22,7,73,24,28,TRUE,0.328767123287671,2022,2022-2023
TN,2022-09-30,intra-total,824,220,228,161,111,105,63,61,39,767,286,2865,1110,1330,TRUE,0.387434554973822,2022,2022-2023
TN,2022-09-30,intra-ucfe,0,0,1,0,2,1,0,0,0,6,0,10,0,0,TRUE,0,2022,2022-2023
TN,2022-09-30,intra-ucx,1,0,0,0,1,0,0,0,0,4,3,9,4,4,TRUE,0.444444444444444,2022,2022-2023
TN,2022-09-30,intra-ui,823,220,227,161,108,104,63,61,39,757,283,2846,1106,1326,TRUE,0.388615600843289,2022,2022-2023
TN,2022-10-31,inter-total,12,7,5,2,1,1,0,0,4,12,5,49,17,24,TRUE,0.346938775510204,2022,2022-2023
TN,2022-10-31,inter-ucfe,0,0,0,0,0,0,0,0,0,0,0,0,0,0,TRUE,0,2022,2022-2023
TN,2022-10-31,inter-ucx,0,0,0,0,0,0,0,0,0,0,0,0,0,0,TRUE,0,2022,2022-2023
TN,2022-10-31,inter-ui,12,7,5,2,1,1,0,0,4,12,5,49,17,24,TRUE,0.346938775510204,2022,2022-2023
TN,2022-10-31,intra-total,799,220,164,128,74,61,60,60,35,512,370,2483,1169,1389,TRUE,0.470801449859042,2022,2022-2023
TN,2022-10-31,intra-ucfe,2,1,0,0,0,1,0,0,1,4,1,10,3,4,TRUE,0.3,2022,2022-2023
TN,2022-10-31,intra-ucx,8,1,1,0,0,1,0,0,0,1,2,14,10,11,TRUE,0.714285714285714,2022,2022-2023
TN,2022-10-31,intra-ui,789,218,163,128,74,59,60,60,34,507,367,2459,1156,1374,TRUE,0.470109800732005,2022,2022-2023
TN,2022-11-30,inter-total,15,7,6,4,3,4,3,4,0,9,11,66,26,33,TRUE,0.393939393939394,2022,2022-2023
TN,2022-11-30,inter-ucfe,0,0,0,0,0,0,0,0,0,0,0,0,0,0,TRUE,0,2022,2022-2023
TN,2022-11-30,inter-ucx,0,0,0,0,0,0,0,0,0,0,0,0,0,0,TRUE,0,2022,2022-2023
TN,2022-11-30,inter-ui,15,7,6,4,3,4,3,4,0,9,11,66,26,33,TRUE,0.393939393939394,2022,2022-2023
TN,2022-11-30,intra-total,670,265,192,130,93,71,50,31,35,359,285,2181,955,1220,TRUE,0.437872535534159,2022,2022-2023
TN,2022-11-30,intra-ucfe,2,3,1,1,0,0,0,0,0,3,3,13,5,8,TRUE,0.384615384615385,2022,2022-2023
TN,2022-11-30,intra-ucx,3,0,0,1,0,0,0,0,0,1,1,6,4,4,TRUE,0.666666666666667,2022,2022-2023
TN,2022-11-30,intra-ui,665,262,191,128,93,71,50,31,35,355,281,2162,946,1208,TRUE,0.437557816836263,2022,2022-2023
TN,2022-12-31,inter-total,32,14,14,6,7,5,3,4,3,25,17,130,49,63,TRUE,0.376923076923077,2022,2022-2023
TN,2022-12-31,inter-ucfe,0,0,0,0,0,0,0,0,0,0,0,0,0,0,TRUE,0,2022,2022-2023
TN,2022-12-31,inter-ucx,0,0,0,0,0,0,0,0,0,0,0,0,0,0,TRUE,0,2022,2022-2023
TN,2022-12-31,inter-ui,32,14,14,6,7,5,3,4,3,25,17,130,49,63,TRUE,0.376923076923077,2022,2022-2023
TN,2022-12-31,intra-total,1460,526,357,238,155,134,103,86,72,1454,609,5194,2069,2595,TRUE,0.39834424335772,2022,2022-2023
TN,2022-12-31,intra-ucfe,2,1,0,0,0,0,0,0,0,4,2,9,4,5,TRUE,0.444444444444444,2022,2022-2023
TN,2022-12-31,intra-ucx,6,1,0,1,0,0,1,1,0,1,2,13,8,9,TRUE,0.615384615384615,2022,2022-2023
TN,2022-12-31,intra-ui,1452,524,357,237,155,134,102,85,72,1449,605,5172,2057,2581,TRUE,0.397718484145398,2022,2022-2023
TN,2023-01-31,inter-total,75,18,8,6,8,9,0,2,2,12,21,161,96,114,TRUE,0.596273291925466,2022,2022-2023
TN,2023-01-31,inter-ucfe,0,0,0,1,0,0,0,0,0,0,0,1,0,0,TRUE,0,2022,2022-2023
TN,2023-01-31,inter-ucx,0,0,0,0,0,0,0,0,0,0,0,0,0,0,TRUE,0,2022,2022-2023
TN,2023-01-31,inter-ui,75,18,8,5,8,9,0,2,2,12,21,160,96,114,TRUE,0.6,2022,2022-2023
TN,2023-01-31,intra-total,3221,357,176,157,104,72,67,53,42,391,706,5346,3927,4284,TRUE,0.734567901234568,2022,2022-2023
TN,2023-01-31,intra-ucfe,1,1,4,0,1,0,0,2,2,2,1,14,2,3,TRUE,0.142857142857143,2022,2022-2023
TN,2023-01-31,intra-ucx,3,3,0,0,0,0,0,0,0,0,2,8,5,8,TRUE,0.625,2022,2022-2023
TN,2023-01-31,intra-ui,3217,353,172,157,103,72,67,51,40,389,703,5324,3920,4273,TRUE,0.736288504883546,2022,2022-2023
TN,2023-02-28,inter-total,33,12,10,5,3,8,0,2,2,17,11,103,44,56,TRUE,0.427184466019417,2022,2022-2023
TN,2023-02-28,inter-ucfe,0,0,0,0,0,0,0,0,0,0,0,0,0,0,TRUE,0,2022,2022-2023
TN,2023-02-28,inter-ucx,0,0,0,0,0,0,0,0,0,0,0,0,0,0,TRUE,0,2022,2022-2023
TN,2023-02-28,inter-ui,33,12,10,5,3,8,0,2,2,17,11,103,44,56,TRUE,0.427184466019417,2022,2022-2023
TN,2023-02-28,intra-total,1153,337,285,158,120,87,70,58,42,496,458,3264,1611,1948,TRUE,0.493566176470588,2022,2022-2023
TN,2023-02-28,intra-ucfe,2,3,5,1,1,0,0,0,0,0,0,12,2,5,TRUE,0.166666666666667,2022,2022-2023
TN,2023-02-28,intra-ucx,2,4,0,0,0,0,0,0,0,0,3,9,5,9,TRUE,0.555555555555556,2022,2022-2023
TN,2023-02-28,intra-ui,1149,330,280,157,119,87,70,58,42,496,455,3243,1604,1934,TRUE,0.494603761948813,2022,2022-2023
TN,2023-03-31,inter-total,33,5,10,4,4,5,1,6,3,17,14,102,47,52,TRUE,0.46078431372549,2022,2022-2023
TN,2023-03-31,inter-ucfe,0,0,0,0,0,0,0,0,0,0,0,0,0,0,TRUE,0,2022,2022-2023
TN,2023-03-31,inter-ucx,0,0,0,0,0,0,0,0,0,0,0,0,0,0,TRUE,0,2022,2022-2023
TN,2023-03-31,inter-ui,33,5,10,4,4,5,1,6,3,17,14,102,47,52,TRUE,0.46078431372549,2022,2022-2023
TN,2023-03-31,intra-total,1105,342,241,179,145,116,79,86,63,451,494,3301,1599,1941,TRUE,0.484398667070585,2022,2022-2023
TN,2023-03-31,intra-ucfe,1,4,1,0,1,0,0,0,1,0,2,10,3,7,TRUE,0.3,2022,2022-2023
TN,2023-03-31,intra-ucx,6,1,1,0,0,0,0,0,0,0,0,8,6,7,TRUE,0.75,2022,2022-2023
TN,2023-03-31,intra-ui,1098,337,239,179,144,116,79,86,62,451,492,3283,1590,1927,TRUE,0.484313128236369,2022,2022-2023
TN,2023-04-30,inter-total,31,14,7,9,2,1,0,3,2,24,9,102,40,54,TRUE,0.392156862745098,2022,2022-2023
TN,2023-04-30,inter-ucfe,0,0,0,0,0,0,0,0,0,0,0,0,0,0,TRUE,0,2022,2022-2023
TN,2023-04-30,inter-ucx,0,0,0,0,0,0,0,0,0,0,0,0,0,0,TRUE,0,2022,2022-2023
TN,2023-04-30,inter-ui,31,14,7,9,2,1,0,3,2,24,9,102,40,54,TRUE,0.392156862745098,2022,2022-2023
TN,2023-04-30,intra-total,900,321,256,170,149,127,92,70,104,654,447,3290,1347,1668,TRUE,0.409422492401216,2022,2022-2023
TN,2023-04-30,intra-ucfe,2,1,1,0,0,0,0,0,0,1,3,8,5,6,TRUE,0.625,2022,2022-2023
TN,2023-04-30,intra-ucx,6,1,0,0,1,0,0,0,0,1,1,10,7,8,TRUE,0.7,2022,2022-2023
TN,2023-04-30,intra-ui,892,319,255,170,148,127,92,70,104,652,443,3272,1335,1654,TRUE,0.408007334963325,2022,2022-2023
TN,2023-05-31,inter-total,43,16,3,5,3,4,0,5,3,20,20,122,63,79,TRUE,0.516393442622951,2022,2022-2023
TN,2023-05-31,inter-ucfe,0,0,0,0,0,0,0,0,0,0,0,0,0,0,TRUE,0,2022,2022-2023
TN,2023-05-31,inter-ucx,0,0,0,0,0,0,0,0,0,0,0,0,0,0,TRUE,0,2022,2022-2023
TN,2023-05-31,inter-ui,43,16,3,5,3,4,0,5,3,20,20,122,63,79,TRUE,0.516393442622951,2022,2022-2023
TN,2023-05-31,intra-total,1964,265,200,166,126,95,84,67,60,616,568,4211,2532,2797,TRUE,0.60128235573498,2022,2022-2023
TN,2023-05-31,intra-ucfe,2,2,0,0,0,0,0,0,0,0,0,4,2,4,TRUE,0.5,2022,2022-2023
TN,2023-05-31,intra-ucx,7,0,0,0,0,0,0,0,0,0,1,8,8,8,TRUE,1,2022,2022-2023
TN,2023-05-31,intra-ui,1955,263,200,166,126,95,84,67,60,616,567,4199,2522,2785,TRUE,0.60061919504644,2022,2022-2023
TN,2023-06-30,inter-total,43,8,3,6,2,1,1,2,3,7,10,86,53,61,TRUE,0.616279069767442,2022,2022-2023
TN,2023-06-30,inter-ucfe,0,0,0,0,0,0,0,0,0,0,0,0,0,0,TRUE,0,2022,2022-2023
TN,2023-06-30,inter-ucx,0,0,0,0,0,0,0,0,0,0,0,0,0,0,TRUE,0,2022,2022-2023
TN,2023-06-30,inter-ui,43,8,3,6,2,1,1,2,3,7,10,86,53,61,TRUE,0.616279069767442,2022,2022-2023
TN,2023-06-30,intra-total,2257,356,230,100,102,50,55,52,44,271,624,4141,2881,3237,TRUE,0.695725670127988,2022,2022-2023
TN,2023-06-30,intra-ucfe,4,0,1,0,0,0,0,0,0,0,5,10,9,9,TRUE,0.9,2022,2022-2023
TN,2023-06-30,intra-ucx,5,0,0,1,0,0,0,0,0,0,0,6,5,5,TRUE,0.833333333333333,2022,2022-2023
TN,2023-06-30,intra-ui,2248,356,229,99,102,50,55,52,44,271,619,4125,2867,3223,TRUE,0.695030303030303,2022,2022-2023
TN,2023-07-31,inter-total,56,6,5,2,3,5,1,1,1,4,22,106,78,84,TRUE,0.735849056603774,2023,2023-2024
TN,2023-07-31,inter-ucfe,0,0,0,0,0,0,0,0,0,0,0,0,0,0,TRUE,0,2023,2023-2024
TN,2023-07-31,inter-ucx,0,0,0,0,0,0,0,0,0,0,0,0,0,0,TRUE,0,2023,2023-2024
TN,2023-07-31,inter-ui,56,6,5,2,3,5,1,1,1,4,22,106,78,84,TRUE,0.735849056603774,2023,2023-2024
TN,2023-07-31,intra-total,2189,277,222,155,161,121,73,41,25,259,573,4096,2762,3039,TRUE,0.67431640625,2023,2023-2024
TN,2023-07-31,intra-ucfe,4,2,0,0,0,1,0,0,0,0,5,12,9,11,TRUE,0.75,2023,2023-2024
TN,2023-07-31,intra-ucx,4,1,0,0,0,0,0,0,0,0,0,5,4,5,TRUE,0.8,2023,2023-2024
TN,2023-07-31,intra-ui,2181,274,222,155,161,120,73,41,25,259,568,4079,2749,3023,TRUE,0.67393969110076,2023,2023-2024
TN,2023-08-31,inter-total,46,8,7,4,4,3,1,1,5,9,12,100,58,66,TRUE,0.58,2023,2023-2024
TN,2023-08-31,inter-ucfe,0,0,0,0,0,0,0,0,0,0,0,0,0,0,TRUE,0,2023,2023-2024
TN,2023-08-31,inter-ucx,0,0,0,0,0,0,0,0,0,0,0,0,0,0,TRUE,0,2023,2023-2024
TN,2023-08-31,inter-ui,46,8,7,4,4,3,1,1,5,9,12,100,58,66,TRUE,0.58,2023,2023-2024
TN,2023-08-31,intra-total,2044,301,275,200,173,155,121,111,121,322,547,4370,2591,2892,TRUE,0.592906178489703,2023,2023-2024
TN,2023-08-31,intra-ucfe,3,2,1,1,0,0,1,0,0,0,4,12,7,9,TRUE,0.583333333333333,2023,2023-2024
TN,2023-08-31,intra-ucx,6,0,0,0,0,0,1,0,0,0,2,9,8,8,TRUE,0.888888888888889,2023,2023-2024
TN,2023-08-31,intra-ui,2035,299,274,199,173,155,119,111,121,322,541,4349,2576,2875,TRUE,0.592320073580133,2023,2023-2024
TN,2023-09-30,inter-total,36,2,3,4,4,2,2,1,5,11,16,86,52,54,TRUE,0.604651162790698,2023,2023-2024
TN,2023-09-30,inter-ucfe,1,0,0,0,0,0,0,0,0,0,0,1,1,1,TRUE,1,2023,2023-2024
TN,2023-09-30,inter-ucx,0,0,0,0,0,0,0,0,0,0,0,0,0,0,TRUE,0,2023,2023-2024
TN,2023-09-30,inter-ui,35,2,3,4,4,2,2,1,5,11,16,85,51,53,TRUE,0.6,2023,2023-2024
TN,2023-09-30,intra-total,1657,196,134,100,73,77,97,99,93,288,372,3186,2029,2225,TRUE,0.6368487131199,2023,2023-2024
TN,2023-09-30,intra-ucfe,2,2,0,0,0,0,0,0,0,1,2,7,4,6,TRUE,0.571428571428571,2023,2023-2024
TN,2023-09-30,intra-ucx,10,1,0,0,0,0,0,0,0,0,0,11,10,11,TRUE,0.909090909090909,2023,2023-2024
TN,2023-09-30,intra-ui,1645,193,134,100,73,77,97,99,93,287,370,3168,2015,2208,TRUE,0.63604797979798,2023,2023-2024
TN,2023-10-31,inter-total,39,5,5,3,0,6,8,3,3,6,17,95,56,61,TRUE,0.589473684210526,2023,2023-2024
TN,2023-10-31,inter-ucfe,0,0,0,0,0,0,0,0,0,0,0,0,0,0,TRUE,0,2023,2023-2024
TN,2023-10-31,inter-ucx,0,0,0,0,0,0,0,0,0,0,0,0,0,0,TRUE,0,2023,2023-2024
TN,2023-10-31,inter-ui,39,5,5,3,0,6,8,3,3,6,17,95,56,61,TRUE,0.589473684210526,2023,2023-2024
TN,2023-10-31,intra-total,2120,214,155,131,117,121,123,119,82,254,545,3981,2665,2879,TRUE,0.669429791509671,2023,2023-2024
TN,2023-10-31,intra-ucfe,1,3,0,1,0,0,0,0,0,0,1,6,2,5,TRUE,0.333333333333333,2023,2023-2024
TN,2023-10-31,intra-ucx,2,0,0,0,0,0,0,0,0,0,4,6,6,6,TRUE,1,2023,2023-2024
TN,2023-10-31,intra-ui,2117,211,155,130,117,121,123,119,82,254,540,3969,2657,2868,TRUE,0.669438145628622,2023,2023-2024
TN,2023-11-30,inter-total,43,3,4,5,9,1,4,0,3,6,17,95,60,63,TRUE,0.631578947368421,2023,2023-2024
TN,2023-11-30,inter-ucfe,0,0,0,0,0,0,0,0,0,0,0,0,0,0,TRUE,0,2023,2023-2024
TN,2023-11-30,inter-ucx,0,0,0,0,0,0,0,0,0,0,0,0,0,0,TRUE,0,2023,2023-2024
TN,2023-11-30,inter-ui,43,3,4,5,9,1,4,0,3,6,17,95,60,63,TRUE,0.631578947368421,2023,2023-2024
TN,2023-11-30,intra-total,1478,165,137,131,162,150,118,101,64,127,493,3126,1971,2136,TRUE,0.630518234165067,2023,2023-2024
TN,2023-11-30,intra-ucfe,2,1,0,0,0,0,0,0,0,1,3,7,5,6,TRUE,0.714285714285714,2023,2023-2024
TN,2023-11-30,intra-ucx,5,0,0,0,0,0,1,0,0,0,0,6,5,5,TRUE,0.833333333333333,2023,2023-2024
TN,2023-11-30,intra-ui,1471,164,137,131,162,150,117,101,64,126,490,3113,1961,2125,TRUE,0.629938965628012,2023,2023-2024
TN,2023-12-31,inter-total,54,10,9,6,3,1,3,3,0,2,14,105,68,78,TRUE,0.647619047619048,2023,2023-2024
TN,2023-12-31,inter-ucfe,0,0,0,0,0,0,0,0,0,0,0,0,0,0,TRUE,0,2023,2023-2024
TN,2023-12-31,inter-ucx,0,0,0,0,0,0,0,0,0,0,0,0,0,0,TRUE,0,2023,2023-2024
TN,2023-12-31,inter-ui,54,10,9,6,3,1,3,3,0,2,14,105,68,78,TRUE,0.647619047619048,2023,2023-2024
TN,2023-12-31,intra-total,2798,303,225,221,164,146,117,76,53,117,635,4855,3433,3736,TRUE,0.707106076210093,2023,2023-2024
TN,2023-12-31,intra-ucfe,2,1,0,0,0,0,1,0,0,0,2,6,4,5,TRUE,0.666666666666667,2023,2023-2024
TN,2023-12-31,intra-ucx,6,1,0,0,0,0,0,0,0,0,1,8,7,8,TRUE,0.875,2023,2023-2024
TN,2023-12-31,intra-ui,2790,301,225,221,164,146,116,76,53,117,632,4841,3422,3723,TRUE,0.706878744061144,2023,2023-2024
TN,2024-01-31,inter-total,79,12,13,6,7,7,4,3,4,4,20,159,99,111,TRUE,0.622641509433962,2023,2023-2024
TN,2024-01-31,inter-ucfe,0,0,0,0,0,0,0,0,0,0,0,0,0,0,TRUE,0,2023,2023-2024
TN,2024-01-31,inter-ucx,0,0,0,0,0,0,0,0,0,0,0,0,0,0,TRUE,0,2023,2023-2024
TN,2024-01-31,inter-ui,79,12,13,6,7,7,4,3,4,4,20,159,99,111,TRUE,0.622641509433962,2023,2023-2024
TN,2024-01-31,intra-total,3964,428,363,269,259,178,117,62,34,95,972,6741,4936,5364,TRUE,0.732235573357069,2023,2023-2024
TN,2024-01-31,intra-ucfe,1,1,1,0,0,0,0,0,0,0,5,8,6,7,TRUE,0.75,2023,2023-2024
TN,2024-01-31,intra-ucx,7,0,0,0,0,0,0,0,0,0,4,11,11,11,TRUE,1,2023,2023-2024
TN,2024-01-31,intra-ui,3956,427,362,269,259,178,117,62,34,95,963,6722,4919,5346,TRUE,0.731776257066349,2023,2023-2024
TN,2024-02-29,inter-total,37,5,6,4,6,4,1,0,0,1,10,74,47,52,TRUE,0.635135135135135,2023,2023-2024
TN,2024-02-29,inter-ucfe,0,0,0,0,0,0,0,0,0,0,0,0,0,0,TRUE,0,2023,2023-2024
TN,2024-02-29,inter-ucx,0,0,0,0,0,0,0,0,0,0,0,0,0,0,TRUE,0,2023,2023-2024
TN,2024-02-29,inter-ui,37,5,6,4,6,4,1,0,0,1,10,74,47,52,TRUE,0.635135135135135,2023,2023-2024
TN,2024-02-29,intra-total,1334,267,213,183,153,121,72,32,18,97,573,3063,1907,2174,TRUE,0.622592229840026,2023,2023-2024
TN,2024-02-29,intra-ucfe,1,2,2,0,1,0,0,0,0,1,2,9,3,5,TRUE,0.333333333333333,2023,2023-2024
TN,2024-02-29,intra-ucx,7,1,1,0,0,0,0,0,0,0,3,12,10,11,TRUE,0.833333333333333,2023,2023-2024
TN,2024-02-29,intra-ui,1326,264,210,183,152,121,72,32,18,96,568,3042,1894,2158,TRUE,0.622616699539777,2023,2023-2024
TN,2024-03-31,inter-total,43,28,4,7,5,6,2,2,2,4,13,116,56,84,TRUE,0.482758620689655,2023,2023-2024
TN,2024-03-31,inter-ucfe,0,0,0,0,0,0,0,0,0,0,0,0,0,0,TRUE,0,2023,2023-2024
TN,2024-03-31,inter-ucx,0,0,0,0,0,0,0,0,0,0,0,0,0,0,TRUE,0,2023,2023-2024
TN,2024-03-31,inter-ui,43,28,4,7,5,6,2,2,2,4,13,116,56,84,TRUE,0.482758620689655,2023,2023-2024
TN,2024-03-31,intra-total,1688,829,431,300,233,172,109,57,34,72,564,4489,2252,3081,TRUE,0.501670750723992,2023,2023-2024
TN,2024-03-31,intra-ucfe,4,1,1,0,0,0,0,0,0,0,3,9,7,8,TRUE,0.777777777777778,2023,2023-2024
TN,2024-03-31,intra-ucx,9,1,0,0,0,0,0,0,0,0,1,11,10,11,TRUE,0.909090909090909,2023,2023-2024
TN,2024-03-31,intra-ui,1675,827,430,300,233,172,109,57,34,72,560,4469,2235,3062,TRUE,0.500111881852764,2023,2023-2024
TN,2024-04-30,inter-total,55,14,11,7,0,3,1,3,1,6,19,120,74,88,TRUE,0.616666666666667,2023,2023-2024
TN,2024-04-30,inter-ucfe,0,0,0,0,0,0,0,0,0,0,0,0,0,0,TRUE,0,2023,2023-2024
TN,2024-04-30,inter-ucx,0,0,0,0,0,0,0,0,0,0,0,0,0,0,TRUE,0,2023,2023-2024
TN,2024-04-30,inter-ui,55,14,11,7,0,3,1,3,1,6,19,120,74,88,TRUE,0.616666666666667,2023,2023-2024
TN,2024-04-30,intra-total,2001,727,399,244,148,104,81,59,48,191,957,4959,2958,3685,TRUE,0.596491228070175,2023,2023-2024
TN,2024-04-30,intra-ucfe,5,4,0,0,0,0,0,0,0,1,3,13,8,12,TRUE,0.615384615384615,2023,2023-2024
TN,2024-04-30,intra-ucx,13,1,0,0,0,0,1,0,0,0,2,17,15,16,TRUE,0.882352941176471,2023,2023-2024
TN,2024-04-30,intra-ui,1983,722,399,244,148,104,80,59,48,190,952,4929,2935,3657,TRUE,0.595455467640495,2023,2023-2024
TN,2024-05-31,inter-total,68,7,4,0,0,0,0,1,0,4,19,103,87,94,TRUE,0.844660194174757,2023,2023-2024
TN,2024-05-31,inter-ucfe,1,0,0,0,0,0,0,0,0,0,0,1,1,1,TRUE,1,2023,2023-2024
TN,2024-05-31,inter-ucx,0,0,0,0,0,0,0,0,0,0,0,0,0,0,TRUE,0,2023,2023-2024
TN,2024-05-31,inter-ui,67,7,4,0,0,0,0,1,0,4,19,102,86,93,TRUE,0.843137254901961,2023,2023-2024
TN,2024-05-31,intra-total,2962,206,79,65,43,44,26,23,17,92,1039,4596,4001,4207,TRUE,0.870539599651871,2023,2023-2024
TN,2024-05-31,intra-ucfe,3,0,0,0,0,0,0,0,0,0,0,3,3,3,TRUE,1,2023,2023-2024
TN,2024-05-31,intra-ucx,8,0,0,0,0,1,0,0,0,0,2,11,10,10,TRUE,0.909090909090909,2023,2023-2024
TN,2024-05-31,intra-ui,2951,206,79,65,43,43,26,23,17,92,1037,4582,3988,4194,TRUE,0.870362287210825,2023,2023-2024
TN,2024-06-30,inter-total,59,6,5,5,4,2,2,0,1,4,35,123,94,100,TRUE,0.764227642276423,2023,2023-2024
TN,2024-06-30,inter-ucfe,0,0,0,0,0,0,0,0,0,0,0,0,0,0,TRUE,0,2023,2023-2024
TN,2024-06-30,inter-ucx,0,0,0,0,0,0,0,0,0,0,0,0,0,0,TRUE,0,2023,2023-2024
TN,2024-06-30,inter-ui,59,6,5,5,4,2,2,0,1,4,35,123,94,100,TRUE,0.764227642276423,2023,2023-2024
TN,2024-06-30,intra-total,3851,253,131,67,49,26,23,14,13,96,1103,5626,4954,5207,TRUE,0.880554568076786,2023,2023-2024
TN,2024-06-30,intra-ucfe,1,0,0,0,1,0,0,0,0,0,1,3,2,2,TRUE,0.666666666666667,2023,2023-2024
TN,2024-06-30,intra-ucx,9,0,0,0,1,0,0,0,0,0,1,11,10,10,TRUE,0.909090909090909,2023,2023-2024
TN,2024-06-30,intra-ui,3841,253,131,67,47,26,23,14,13,96,1101,5612,4942,5195,TRUE,0.880612972202423,2023,2023-2024
TN,2024-07-31,inter-total,62,6,7,2,4,0,0,1,0,6,40,128,102,108,TRUE,0.796875,2024,2024-2025
TN,2024-07-31,inter-ucfe,0,0,0,0,0,0,0,0,0,0,0,0,0,0,TRUE,0,2024,2024-2025
TN,2024-07-31,inter-ucx,0,0,0,0,0,0,0,0,0,0,1,1,1,1,TRUE,1,2024,2024-2025
TN,2024-07-31,inter-ui,62,6,7,2,4,0,0,1,0,6,39,127,101,107,TRUE,0.795275590551181,2024,2024-2025
TN,2024-07-31,intra-total,2666,292,112,50,36,42,28,20,21,105,2062,5434,4728,5020,TRUE,0.870077291129923,2024,2024-2025
TN,2024-07-31,intra-ucfe,6,0,0,0,0,0,0,0,0,1,1,8,7,7,TRUE,0.875,2024,2024-2025
TN,2024-07-31,intra-ucx,12,0,0,0,0,0,0,0,1,0,4,17,16,16,TRUE,0.941176470588235,2024,2024-2025
TN,2024-07-31,intra-ui,2648,292,112,50,36,42,28,20,20,104,2057,5409,4705,4997,TRUE,0.869846552042892,2024,2024-2025
TN,2024-08-31,inter-total,50,6,4,0,0,0,2,0,1,4,29,96,79,85,TRUE,0.822916666666667,2024,2024-2025
TN,2024-08-31,inter-ucfe,0,0,0,0,0,0,0,0,0,0,0,0,0,0,TRUE,0,2024,2024-2025
TN,2024-08-31,inter-ucx,0,0,0,0,0,0,0,0,0,0,0,0,0,0,TRUE,0,2024,2024-2025
TN,2024-08-31,inter-ui,50,6,4,0,0,0,2,0,1,4,29,96,79,85,TRUE,0.822916666666667,2024,2024-2025
TN,2024-08-31,intra-total,2325,223,121,63,51,20,16,22,17,115,1303,4276,3628,3851,TRUE,0.848456501403181,2024,2024-2025
TN,2024-08-31,intra-ucfe,6,1,0,0,0,0,0,0,0,0,1,8,7,8,TRUE,0.875,2024,2024-2025
TN,2024-08-31,intra-ucx,7,0,0,0,0,0,0,0,0,0,0,7,7,7,TRUE,1,2024,2024-2025
TN,2024-08-31,intra-ui,2312,222,121,63,51,20,16,22,17,115,1302,4261,3614,3836,TRUE,0.848157709457874,2024,2024-2025
TN,2024-09-30,inter-total,84,9,1,0,0,0,1,2,0,6,32,135,116,125,TRUE,0.859259259259259,2024,2024-2025
TN,2024-09-30,inter-ucfe,0,0,0,0,0,0,0,0,0,0,0,0,0,0,TRUE,0,2024,2024-2025
TN,2024-09-30,inter-ucx,0,0,0,0,0,0,0,0,0,0,0,0,0,0,TRUE,0,2024,2024-2025
TN,2024-09-30,inter-ui,84,9,1,0,0,0,1,2,0,6,32,135,116,125,TRUE,0.859259259259259,2024,2024-2025
TN,2024-09-30,intra-total,2722,233,102,26,21,16,11,13,10,116,1258,4528,3980,4213,TRUE,0.878975265017668,2024,2024-2025
TN,2024-09-30,intra-ucfe,2,1,0,0,0,0,0,0,0,0,0,3,2,3,TRUE,0.666666666666667,2024,2024-2025
TN,2024-09-30,intra-ucx,15,0,0,0,0,0,0,0,0,0,3,18,18,18,TRUE,1,2024,2024-2025
TN,2024-09-30,intra-ui,2705,232,102,26,21,16,11,13,10,116,1255,4507,3960,4192,TRUE,0.878633237186599,2024,2024-2025
TN,2024-10-31,inter-total,135,5,2,2,2,2,0,0,0,5,28,181,163,168,TRUE,0.900552486187845,2024,2024-2025
TN,2024-10-31,inter-ucfe,1,0,0,0,0,0,0,0,0,0,0,1,1,1,TRUE,1,2024,2024-2025
TN,2024-10-31,inter-ucx,0,0,0,0,0,0,0,0,0,0,0,0,0,0,TRUE,0,2024,2024-2025
TN,2024-10-31,inter-ui,134,5,2,2,2,2,0,0,0,5,28,180,162,167,TRUE,0.9,2024,2024-2025
TN,2024-10-31,intra-total,3596,115,66,21,22,9,20,11,14,133,920,4927,4516,4631,TRUE,0.916582098640146,2024,2024-2025
TN,2024-10-31,intra-ucfe,3,0,0,0,0,0,0,0,0,0,0,3,3,3,TRUE,1,2024,2024-2025
TN,2024-10-31,intra-ucx,8,0,0,0,0,0,0,0,0,0,1,9,9,9,TRUE,1,2024,2024-2025
TN,2024-10-31,intra-ui,3585,115,66,21,22,9,20,11,14,133,919,4915,4504,4619,TRUE,0.916378433367243,2024,2024-2025
TN,2024-11-30,inter-total,64,7,2,2,2,0,0,1,0,4,22,104,86,93,TRUE,0.826923076923077,2024,2024-2025
TN,2024-11-30,inter-ucfe,0,0,0,0,0,0,0,0,0,0,0,0,0,0,TRUE,0,2024,2024-2025
TN,2024-11-30,inter-ucx,0,0,0,0,0,0,0,0,0,0,0,0,0,0,TRUE,0,2024,2024-2025
TN,2024-11-30,inter-ui,64,7,2,2,2,0,0,1,0,4,22,104,86,93,TRUE,0.826923076923077,2024,2024-2025
TN,2024-11-30,intra-total,2544,129,54,36,21,30,9,3,4,109,746,3685,3290,3419,TRUE,0.89280868385346,2024,2024-2025
TN,2024-11-30,intra-ucfe,4,1,0,0,0,0,0,0,0,1,2,8,6,7,TRUE,0.75,2024,2024-2025
TN,2024-11-30,intra-ucx,9,0,0,0,0,0,0,0,0,0,1,10,10,10,TRUE,1,2024,2024-2025
TN,2024-11-30,intra-ui,2531,128,54,36,21,30,9,3,4,108,743,3667,3274,3402,TRUE,0.892827924734115,2024,2024-2025
TX,2019-01-31,inter-total,482,93,41,14,5,6,1,1,3,6,506,1158,988,1081,TRUE,0.853195164075993,2018,2018-2019
TX,2019-01-31,inter-ucfe,3,1,1,1,1,0,0,0,0,1,4,12,7,8,TRUE,0.583333333333333,2018,2018-2019
TX,2019-01-31,inter-ucx,0,0,0,0,0,0,0,0,0,0,0,0,0,0,TRUE,0,2018,2018-2019
TX,2019-01-31,inter-ui,479,92,40,13,4,6,1,1,3,5,502,1146,981,1073,TRUE,0.856020942408377,2018,2018-2019
TX,2019-01-31,intra-total,14025,3182,1044,337,150,141,133,73,45,140,16586,35856,30611,33793,TRUE,0.853720437304775,2018,2018-2019
TX,2019-01-31,intra-ucfe,1507,67,13,2,3,1,0,1,1,1,632,2228,2139,2206,TRUE,0.960053859964093,2018,2018-2019
TX,2019-01-31,intra-ucx,51,20,8,2,2,0,1,0,0,0,110,194,161,181,TRUE,0.829896907216495,2018,2018-2019
TX,2019-01-31,intra-ui,12467,3095,1023,333,145,140,132,72,44,139,15844,33434,28311,31406,TRUE,0.846772746306155,2018,2018-2019
TX,2019-02-28,inter-total,383,83,28,18,8,3,3,3,2,5,395,931,778,861,TRUE,0.835660580021482,2018,2018-2019
TX,2019-02-28,inter-ucfe,0,1,0,0,0,0,0,0,0,1,0,2,0,1,TRUE,0,2018,2018-2019
TX,2019-02-28,inter-ucx,1,0,0,0,0,0,0,0,0,0,0,1,1,1,TRUE,1,2018,2018-2019
TX,2019-02-28,inter-ui,382,82,28,18,8,3,3,3,2,4,395,928,777,859,TRUE,0.837284482758621,2018,2018-2019
TX,2019-02-28,intra-total,9309,2221,607,199,138,107,100,75,50,111,11755,24672,21064,23285,TRUE,0.853761348897536,2018,2018-2019
TX,2019-02-28,intra-ucfe,42,13,10,3,0,0,1,0,1,1,36,107,78,91,TRUE,0.728971962616822,2018,2018-2019
TX,2019-02-28,intra-ucx,70,16,11,3,2,0,1,1,1,1,109,215,179,195,TRUE,0.832558139534884,2018,2018-2019
TX,2019-02-28,intra-ui,9197,2192,586,193,136,107,98,74,48,109,11610,24350,20807,22999,TRUE,0.854496919917865,2018,2018-2019
TX,2019-03-31,inter-total,323,41,26,7,1,5,3,0,1,5,348,760,671,712,TRUE,0.882894736842105,2018,2018-2019
TX,2019-03-31,inter-ucfe,3,0,0,0,0,0,0,0,0,0,0,3,3,3,TRUE,1,2018,2018-2019
TX,2019-03-31,inter-ucx,1,0,0,0,0,0,0,0,0,0,0,1,1,1,TRUE,1,2018,2018-2019
TX,2019-03-31,inter-ui,319,41,26,7,1,5,3,0,1,5,348,756,667,708,TRUE,0.882275132275132,2018,2018-2019
TX,2019-03-31,intra-total,8606,1787,618,267,209,172,94,46,32,111,10649,22591,19255,21042,TRUE,0.852330574122438,2018,2018-2019
TX,2019-03-31,intra-ucfe,76,8,0,3,1,1,1,1,0,0,28,119,104,112,TRUE,0.873949579831933,2018,2018-2019
TX,2019-03-31,intra-ucx,56,11,1,2,2,0,0,0,0,2,108,182,164,175,TRUE,0.901098901098901,2018,2018-2019
TX,2019-03-31,intra-ui,8474,1768,617,262,206,171,93,45,32,109,10513,22290,18987,20755,TRUE,0.851816958277254,2018,2018-2019
TX,2019-04-30,inter-total,373,56,21,6,2,5,5,1,1,2,341,813,714,770,TRUE,0.878228782287823,2018,2018-2019
TX,2019-04-30,inter-ucfe,3,0,0,1,0,0,0,0,0,0,1,5,4,4,TRUE,0.8,2018,2018-2019
TX,2019-04-30,inter-ucx,0,0,0,0,0,0,0,0,0,0,0,0,0,0,TRUE,0,2018,2018-2019
TX,2019-04-30,inter-ui,370,56,21,5,2,5,5,1,1,2,340,808,710,766,TRUE,0.878712871287129,2018,2018-2019
TX,2019-04-30,intra-total,10369,1564,451,219,185,144,88,39,37,116,11412,24624,21781,23345,TRUE,0.884543534762833,2018,2018-2019
TX,2019-04-30,intra-ucfe,133,16,2,1,2,1,3,0,0,0,28,186,161,177,TRUE,0.865591397849462,2018,2018-2019
TX,2019-04-30,intra-ucx,54,11,3,3,2,1,0,0,0,0,113,187,167,178,TRUE,0.893048128342246,2018,2018-2019
TX,2019-04-30,intra-ui,10182,1537,446,215,181,142,85,39,37,116,11271,24251,21453,22990,TRUE,0.884623314502495,2018,2018-2019
TX,2019-05-31,inter-total,428,37,21,7,4,5,3,1,1,3,376,886,804,841,TRUE,0.90744920993228,2018,2018-2019
TX,2019-05-31,inter-ucfe,3,2,0,0,0,0,0,0,0,0,1,6,4,6,TRUE,0.666666666666667,2018,2018-2019
TX,2019-05-31,inter-ucx,0,0,0,0,0,0,0,0,0,0,0,0,0,0,TRUE,0,2018,2018-2019
TX,2019-05-31,inter-ui,425,35,21,7,4,5,3,1,1,3,375,880,800,835,TRUE,0.909090909090909,2018,2018-2019
TX,2019-05-31,intra-total,11557,1560,391,181,181,150,94,50,24,88,10946,25222,22503,24063,TRUE,0.892197288081833,2018,2018-2019
TX,2019-05-31,intra-ucfe,99,10,4,0,1,1,1,1,0,2,37,156,136,146,TRUE,0.871794871794872,2018,2018-2019
TX,2019-05-31,intra-ucx,89,13,2,1,2,0,1,0,0,1,121,230,210,223,TRUE,0.91304347826087,2018,2018-2019
TX,2019-05-31,intra-ui,11369,1537,385,180,178,149,92,49,24,85,10788,24836,22157,23694,TRUE,0.892132388468352,2018,2018-2019
TX,2019-06-30,inter-total,451,52,22,11,3,5,4,0,3,3,449,1003,900,952,TRUE,0.897308075772682,2018,2018-2019
TX,2019-06-30,inter-ucfe,2,0,0,1,0,0,0,0,0,0,3,6,5,5,TRUE,0.833333333333333,2018,2018-2019
TX,2019-06-30,inter-ucx,0,0,0,0,0,1,0,0,0,0,1,2,1,1,TRUE,0.5,2018,2018-2019
TX,2019-06-30,inter-ui,449,52,22,10,3,4,4,0,3,3,445,995,894,946,TRUE,0.898492462311558,2018,2018-2019
TX,2019-06-30,intra-total,11935,1892,510,171,145,141,95,52,37,83,12822,27883,24757,26649,TRUE,0.887888677688915,2018,2018-2019
TX,2019-06-30,intra-ucfe,76,9,2,2,0,0,2,0,0,1,40,132,116,125,TRUE,0.878787878787879,2018,2018-2019
TX,2019-06-30,intra-ucx,54,3,2,1,1,2,0,0,0,0,96,159,150,153,TRUE,0.943396226415094,2018,2018-2019
TX,2019-06-30,intra-ui,11805,1880,506,168,144,139,93,52,37,82,12686,27592,24491,26371,TRUE,0.887612351406205,2018,2018-2019
TX,2019-07-31,inter-total,548,80,36,6,4,4,5,1,1,1,486,1172,1034,1114,TRUE,0.882252559726963,2019,2019-2020
TX,2019-07-31,inter-ucfe,3,1,1,0,0,0,0,0,0,0,5,10,8,9,TRUE,0.8,2019,2019-2020
TX,2019-07-31,inter-ucx,2,0,0,0,0,0,0,0,0,0,3,5,5,5,TRUE,1,2019,2019-2020
TX,2019-07-31,inter-ui,543,79,35,6,4,4,5,1,1,1,478,1157,1021,1100,TRUE,0.882454624027658,2019,2019-2020
TX,2019-07-31,intra-total,12408,2422,683,251,170,165,124,62,36,101,13839,30261,26247,28669,TRUE,0.867354020025776,2019,2019-2020
TX,2019-07-31,intra-ucfe,59,8,4,0,0,1,1,0,0,2,41,116,100,108,TRUE,0.862068965517241,2019,2019-2020
TX,2019-07-31,intra-ucx,78,12,3,3,1,0,0,1,1,0,110,209,188,200,TRUE,0.899521531100479,2019,2019-2020
TX,2019-07-31,intra-ui,12271,2402,676,248,169,164,123,61,35,99,13688,29936,25959,28361,TRUE,0.867149919828968,2019,2019-2020
TX,2019-08-31,inter-total,451,63,27,10,4,8,3,2,2,1,451,1022,902,965,TRUE,0.882583170254403,2019,2019-2020
TX,2019-08-31,inter-ucfe,4,1,0,0,0,1,0,0,0,0,4,10,8,9,TRUE,0.8,2019,2019-2020
TX,2019-08-31,inter-ucx,0,0,0,0,0,0,0,0,0,0,0,0,0,0,TRUE,0,2019,2019-2020
TX,2019-08-31,inter-ui,447,62,27,10,4,7,3,2,2,1,447,1012,894,956,TRUE,0.883399209486166,2019,2019-2020
TX,2019-08-31,intra-total,10255,1902,587,244,173,161,131,65,31,124,12251,25924,22506,24408,TRUE,0.868153062798951,2019,2019-2020
TX,2019-08-31,intra-ucfe,107,8,3,1,1,1,1,0,1,2,43,168,150,158,TRUE,0.892857142857143,2019,2019-2020
TX,2019-08-31,intra-ucx,73,11,4,2,0,1,0,0,0,0,120,211,193,204,TRUE,0.914691943127962,2019,2019-2020
TX,2019-08-31,intra-ui,10075,1883,580,241,172,159,130,65,30,122,12088,25545,22163,24046,TRUE,0.867606185163437,2019,2019-2020
TX,2019-09-30,inter-total,317,64,25,7,12,4,5,4,1,3,396,838,713,777,TRUE,0.850835322195704,2019,2019-2020
TX,2019-09-30,inter-ucfe,2,2,0,0,1,0,0,0,0,0,5,10,7,9,TRUE,0.7,2019,2019-2020
TX,2019-09-30,inter-ucx,1,0,0,0,0,0,0,0,0,0,1,2,2,2,TRUE,1,2019,2019-2020
TX,2019-09-30,inter-ui,314,62,25,7,11,4,5,4,1,3,390,826,704,766,TRUE,0.852300242130751,2019,2019-2020
TX,2019-09-30,intra-total,8488,2039,596,200,141,143,109,57,33,89,12168,24063,20656,22695,TRUE,0.85841333167103,2019,2019-2020
TX,2019-09-30,intra-ucfe,148,13,1,1,1,1,1,0,0,1,60,227,208,221,TRUE,0.916299559471366,2019,2019-2020
TX,2019-09-30,intra-ucx,50,7,5,1,1,0,0,0,0,0,140,204,190,197,TRUE,0.931372549019608,2019,2019-2020
TX,2019-09-30,intra-ui,8290,2019,590,198,139,142,108,57,33,88,11968,23632,20258,22277,TRUE,0.857227488151659,2019,2019-2020
TX,2019-10-31,inter-total,305,41,19,14,7,6,4,3,2,3,361,765,666,707,TRUE,0.870588235294118,2019,2019-2020
TX,2019-10-31,inter-ucfe,2,0,0,0,0,1,0,0,0,0,2,5,4,4,TRUE,0.8,2019,2019-2020
TX,2019-10-31,inter-ucx,0,0,0,0,0,0,0,0,0,0,1,1,1,1,TRUE,1,2019,2019-2020
TX,2019-10-31,inter-ui,303,41,19,14,7,5,4,3,2,3,358,759,661,702,TRUE,0.870882740447958,2019,2019-2020
TX,2019-10-31,intra-total,10992,1825,499,165,133,143,119,86,51,123,12559,26695,23551,25376,TRUE,0.88222513579322,2019,2019-2020
TX,2019-10-31,intra-ucfe,68,6,5,3,1,0,0,0,0,1,32,116,100,106,TRUE,0.862068965517241,2019,2019-2020
TX,2019-10-31,intra-ucx,90,11,6,2,1,0,0,0,1,2,130,243,220,231,TRUE,0.905349794238683,2019,2019-2020
TX,2019-10-31,intra-ui,10834,1808,488,160,131,143,119,86,50,120,12397,26336,23231,25039,TRUE,0.882100546780073,2019,2019-2020
TX,2019-11-30,inter-total,448,59,19,5,3,5,1,2,0,6,431,979,879,938,TRUE,0.897854954034729,2019,2019-2020
TX,2019-11-30,inter-ucfe,5,3,0,0,0,0,0,0,0,0,2,10,7,10,TRUE,0.7,2019,2019-2020
TX,2019-11-30,inter-ucx,0,0,0,0,0,0,0,0,0,0,0,0,0,0,TRUE,0,2019,2019-2020
TX,2019-11-30,inter-ui,443,56,19,5,3,5,1,2,0,6,429,969,872,928,TRUE,0.899896800825593,2019,2019-2020
TX,2019-11-30,intra-total,10000,1728,471,189,139,119,89,52,36,108,11469,24400,21469,23197,TRUE,0.879877049180328,2019,2019-2020
TX,2019-11-30,intra-ucfe,108,4,2,2,1,0,3,0,0,1,35,156,143,147,TRUE,0.916666666666667,2019,2019-2020
TX,2019-11-30,intra-ucx,33,12,7,1,0,0,0,0,1,0,100,154,133,145,TRUE,0.863636363636364,2019,2019-2020
TX,2019-11-30,intra-ui,9859,1712,462,186,138,119,86,52,35,107,11334,24090,21193,22905,TRUE,0.879742631797426,2019,2019-2020
TX,2019-12-31,inter-total,608,94,32,15,5,5,2,1,5,3,697,1467,1305,1399,TRUE,0.889570552147239,2019,2019-2020
TX,2019-12-31,inter-ucfe,0,1,0,1,0,0,0,0,0,0,0,2,0,1,TRUE,0,2019,2019-2020
TX,2019-12-31,inter-ucx,0,0,0,0,0,0,0,0,0,0,1,1,1,1,TRUE,1,2019,2019-2020
TX,2019-12-31,inter-ui,608,93,32,14,5,5,2,1,5,3,696,1464,1304,1397,TRUE,0.890710382513661,2019,2019-2020
TX,2019-12-31,intra-total,12166,2681,663,202,117,123,103,67,59,101,15471,31753,27637,30318,TRUE,0.870374452807609,2019,2019-2020
TX,2019-12-31,intra-ucfe,103,7,1,0,2,0,0,0,0,2,38,153,141,148,TRUE,0.92156862745098,2019,2019-2020
TX,2019-12-31,intra-ucx,53,27,7,2,2,1,0,0,0,0,109,201,162,189,TRUE,0.805970149253731,2019,2019-2020
TX,2019-12-31,intra-ui,12010,2647,655,200,113,122,103,67,59,99,15324,31399,27334,29981,TRUE,0.870537278257269,2019,2019-2020
TX,2020-01-31,inter-total,616,93,33,8,5,9,3,2,1,7,609,1386,1225,1318,TRUE,0.883838383838384,2019,2019-2020
TX,2020-01-31,inter-ucfe,1,0,0,0,0,0,0,0,0,0,1,2,2,2,TRUE,1,2019,2019-2020
TX,2020-01-31,inter-ucx,0,1,0,0,0,0,0,0,0,0,0,1,0,1,TRUE,0,2019,2019-2020
TX,2020-01-31,inter-ui,615,92,33,8,5,9,3,2,1,7,608,1383,1223,1315,TRUE,0.884309472161967,2019,2019-2020
TX,2020-01-31,intra-total,13211,2775,948,300,127,99,81,73,66,143,15430,33253,28641,31416,TRUE,0.861305746849908,2019,2019-2020
TX,2020-01-31,intra-ucfe,38,9,4,1,0,0,0,0,1,2,26,81,64,73,TRUE,0.790123456790123,2019,2019-2020
TX,2020-01-31,intra-ucx,60,17,5,2,1,0,0,1,1,0,100,187,160,177,TRUE,0.855614973262032,2019,2019-2020
TX,2020-01-31,intra-ui,13113,2749,939,297,126,99,81,72,64,141,15304,32985,28417,31166,TRUE,0.861512808852509,2019,2019-2020
TX,2020-02-29,inter-total,440,53,17,3,6,2,1,4,1,3,475,1005,915,968,TRUE,0.91044776119403,2019,2019-2020
TX,2020-02-29,inter-ucfe,1,0,0,0,0,0,0,0,0,0,3,4,4,4,TRUE,1,2019,2019-2020
TX,2020-02-29,inter-ucx,0,0,0,0,0,0,0,0,0,0,0,0,0,0,TRUE,0,2019,2019-2020
TX,2020-02-29,inter-ui,439,53,17,3,6,2,1,4,1,3,472,1001,911,964,TRUE,0.91008991008991,2019,2019-2020
TX,2020-02-29,intra-total,9616,1940,502,168,91,79,73,72,45,162,13221,25969,22837,24777,TRUE,0.879394662867265,2019,2019-2020
TX,2020-02-29,intra-ucfe,14,13,3,0,1,0,0,1,0,1,21,54,35,48,TRUE,0.648148148148148,2019,2019-2020
TX,2020-02-29,intra-ucx,45,14,3,4,2,0,0,0,0,0,108,176,153,167,TRUE,0.869318181818182,2019,2019-2020
TX,2020-02-29,intra-ui,9557,1913,496,164,88,79,73,71,45,161,13092,25739,22649,24562,TRUE,0.879948715956331,2019,2019-2020
TX,2020-03-31,inter-total,508,65,24,13,11,2,4,3,0,5,473,1108,981,1046,TRUE,0.885379061371841,2019,2019-2020
TX,2020-03-31,inter-ucfe,0,0,0,0,0,0,0,0,0,0,0,0,0,0,TRUE,0,2019,2019-2020
TX,2020-03-31,inter-ucx,0,0,0,0,0,0,0,0,0,0,1,1,1,1,TRUE,1,2019,2019-2020
TX,2020-03-31,inter-ui,508,65,24,13,11,2,4,3,0,5,472,1107,980,1045,TRUE,0.885275519421861,2019,2019-2020
TX,2020-03-31,intra-total,41146,2231,643,254,130,144,110,88,44,161,14419,59370,55565,57796,TRUE,0.935910392454101,2019,2019-2020
TX,2020-03-31,intra-ucfe,31,13,2,1,1,1,1,0,0,2,26,78,57,70,TRUE,0.730769230769231,2019,2019-2020
TX,2020-03-31,intra-ucx,50,19,4,3,0,0,1,3,0,1,98,179,148,167,TRUE,0.826815642458101,2019,2019-2020
TX,2020-03-31,intra-ui,41065,2199,637,250,129,143,108,85,44,158,14295,59113,55360,57559,TRUE,0.936511427266422,2019,2019-2020
TX,2020-04-30,inter-total,2571,519,177,59,14,4,1,0,1,9,2732,6087,5303,5822,TRUE,0.871200919993429,2019,2019-2020
TX,2020-04-30,inter-ucfe,1,1,1,0,0,0,0,0,0,0,2,5,3,4,TRUE,0.6,2019,2019-2020
TX,2020-04-30,inter-ucx,0,0,0,0,0,0,0,0,0,0,0,0,0,0,TRUE,0,2019,2019-2020
TX,2020-04-30,inter-ui,2570,518,176,59,14,4,1,0,1,9,2730,6082,5300,5818,TRUE,0.871423873725748,2019,2019-2020
TX,2020-04-30,intra-total,285541,74410,24738,6668,554,271,148,114,72,175,271302,663993,556843,631253,TRUE,0.838627816859515,2019,2019-2020
TX,2020-04-30,intra-ucfe,55,30,12,3,1,1,0,0,0,2,59,163,114,144,TRUE,0.699386503067485,2019,2019-2020
TX,2020-04-30,intra-ucx,49,48,20,6,4,0,0,0,1,1,190,319,239,287,TRUE,0.749216300940439,2019,2019-2020
TX,2020-04-30,intra-ui,285437,74332,24706,6659,549,270,148,114,71,172,271053,663511,556490,630822,TRUE,0.838705010165619,2019,2019-2020
TX,2020-05-31,inter-total,2130,960,528,363,222,140,123,81,23,22,3176,7768,5306,6266,TRUE,0.683058702368692,2019,2019-2020
TX,2020-05-31,inter-ucfe,0,0,0,0,1,1,0,0,0,0,0,2,0,0,TRUE,0,2019,2019-2020
TX,2020-05-31,inter-ucx,0,0,0,0,0,0,0,0,0,0,1,1,1,1,TRUE,1,2019,2019-2020
TX,2020-05-31,inter-ui,2130,960,528,363,221,139,123,81,23,22,3175,7765,5305,6265,TRUE,0.683193818415969,2019,2019-2020
TX,2020-05-31,intra-total,141883,46798,25088,20376,17156,11755,10473,8382,1090,704,158832,442537,300715,347513,TRUE,0.67952510185589,2019,2019-2020
TX,2020-05-31,intra-ucfe,22,31,20,14,15,7,2,9,2,4,35,161,57,88,TRUE,0.354037267080745,2019,2019-2020
TX,2020-05-31,intra-ucx,56,53,51,29,24,25,21,11,4,11,196,481,252,305,TRUE,0.523908523908524,2019,2019-2020
TX,2020-05-31,intra-ui,141805,46714,25017,20333,17117,11723,10450,8362,1084,689,158601,441895,300406,347120,TRUE,0.679813077767343,2019,2019-2020
TX,2020-06-30,inter-total,1137,303,211,187,151,126,97,86,102,142,1832,4374,2969,3272,TRUE,0.678783721993599,2019,2019-2020
TX,2020-06-30,inter-ucfe,0,1,1,0,0,1,2,0,3,1,1,10,1,2,TRUE,0.1,2019,2019-2020
TX,2020-06-30,inter-ucx,0,1,2,0,0,0,2,0,0,3,2,10,2,3,TRUE,0.2,2019,2019-2020
TX,2020-06-30,inter-ui,1137,301,208,187,151,125,93,86,99,138,1829,4354,2966,3267,TRUE,0.681212677997244,2019,2019-2020
TX,2020-06-30,intra-total,61815,15605,10905,7319,5925,5349,4692,4997,5456,9549,79172,210784,140987,156592,TRUE,0.668869553666312,2019,2019-2020
TX,2020-06-30,intra-ucfe,19,17,9,13,16,23,18,22,14,19,23,193,42,59,TRUE,0.217616580310881,2019,2019-2020
TX,2020-06-30,intra-ucx,38,73,54,31,17,27,22,25,12,42,233,574,271,344,TRUE,0.47212543554007,2019,2019-2020
TX,2020-06-30,intra-ui,61758,15515,10842,7275,5892,5299,4652,4950,5430,9488,78916,210017,140674,156189,TRUE,0.669821966793164,2019,2019-2020
TX,2020-07-31,inter-total,798,195,111,93,78,69,51,46,48,274,1260,3023,2058,2253,TRUE,0.680780681442276,2020,2020-2021
TX,2020-07-31,inter-ucfe,0,1,2,3,1,0,0,0,0,1,0,8,0,1,TRUE,0,2020,2020-2021
TX,2020-07-31,inter-ucx,0,1,1,1,0,0,1,1,0,1,1,7,1,2,TRUE,0.142857142857143,2020,2020-2021
TX,2020-07-31,inter-ui,798,193,108,89,77,69,50,45,48,272,1259,3008,2057,2250,TRUE,0.683843085106383,2020,2020-2021
TX,2020-07-31,intra-total,37321,13287,7387,5194,3887,3079,2485,1863,1605,13644,68763,158515,106084,119371,TRUE,0.669236349872252,2020,2020-2021
TX,2020-07-31,intra-ucfe,16,13,24,19,12,12,3,8,7,37,12,163,28,41,TRUE,0.171779141104294,2020,2020-2021
TX,2020-07-31,intra-ucx,56,60,37,35,19,16,12,11,5,62,235,548,291,351,TRUE,0.531021897810219,2020,2020-2021
TX,2020-07-31,intra-ui,37249,13214,7326,5140,3856,3051,2470,1844,1593,13545,68516,157804,105765,118979,TRUE,0.670230158931333,2020,2020-2021
TX,2020-08-31,inter-total,546,177,110,88,96,79,55,43,30,250,867,2341,1413,1590,TRUE,0.603588210166596,2020,2020-2021
TX,2020-08-31,inter-ucfe,1,2,2,1,0,1,0,0,0,1,1,9,2,4,TRUE,0.222222222222222,2020,2020-2021
TX,2020-08-31,inter-ucx,3,0,0,1,2,0,0,2,0,0,1,9,4,4,TRUE,0.444444444444444,2020,2020-2021
TX,2020-08-31,inter-ui,542,175,108,86,94,78,55,41,30,249,865,2323,1407,1582,TRUE,0.605682307361171,2020,2020-2021
TX,2020-08-31,intra-total,18540,8911,6680,6145,5644,4403,3335,2494,1693,9890,38636,106371,57176,66087,TRUE,0.537514924180463,2020,2020-2021
TX,2020-08-31,intra-ucfe,22,35,15,6,13,18,5,6,7,40,34,201,56,91,TRUE,0.278606965174129,2020,2020-2021
TX,2020-08-31,intra-ucx,80,59,34,19,21,7,7,6,7,65,239,544,319,378,TRUE,0.586397058823529,2020,2020-2021
TX,2020-08-31,intra-ui,18438,8817,6631,6120,5610,4378,3323,2482,1679,9785,38363,105626,56801,65618,TRUE,0.537755855565865,2020,2020-2021
TX,2020-09-30,inter-total,511,144,74,94,80,45,56,31,28,184,667,1914,1178,1322,TRUE,0.61546499477534,2020,2020-2021
TX,2020-09-30,inter-ucfe,1,2,1,2,1,1,0,0,0,0,1,9,2,4,TRUE,0.222222222222222,2020,2020-2021
TX,2020-09-30,inter-ucx,1,1,0,0,0,0,1,0,0,1,1,5,2,3,TRUE,0.4,2020,2020-2021
TX,2020-09-30,inter-ui,509,141,73,92,79,44,55,31,28,183,665,1900,1174,1315,TRUE,0.617894736842105,2020,2020-2021
TX,2020-09-30,intra-total,20202,7894,5524,4858,6409,3826,2841,2085,1325,6067,29353,90384,49555,57449,TRUE,0.548271818020889,2020,2020-2021
TX,2020-09-30,intra-ucfe,38,13,13,4,11,7,8,3,6,44,32,179,70,83,TRUE,0.391061452513966,2020,2020-2021
TX,2020-09-30,intra-ucx,71,50,26,15,11,5,4,6,1,47,247,483,318,368,TRUE,0.658385093167702,2020,2020-2021
TX,2020-09-30,intra-ui,20093,7831,5485,4839,6387,3814,2829,2076,1318,5976,29074,89722,49167,56998,TRUE,0.547992688526783,2020,2020-2021
TX,2020-10-31,inter-total,551,125,63,39,21,18,19,21,17,154,878,1906,1429,1554,TRUE,0.749737670514166,2020,2020-2021
TX,2020-10-31,inter-ucfe,3,3,0,1,1,0,0,0,0,3,2,13,5,8,TRUE,0.384615384615385,2020,2020-2021
TX,2020-10-31,inter-ucx,0,0,0,0,0,0,0,0,0,0,1,1,1,1,TRUE,1,2020,2020-2021
TX,2020-10-31,inter-ui,548,122,63,38,20,18,19,21,17,151,875,1892,1423,1545,TRUE,0.752114164904863,2020,2020-2021
TX,2020-10-31,intra-total,16872,4601,1941,1209,977,738,666,610,492,3921,26516,58543,43388,47989,TRUE,0.741130451121398,2020,2020-2021
TX,2020-10-31,intra-ucfe,44,16,12,3,6,7,6,4,3,52,31,184,75,91,TRUE,0.407608695652174,2020,2020-2021
TX,2020-10-31,intra-ucx,78,33,25,10,6,5,5,3,4,28,221,418,299,332,TRUE,0.715311004784689,2020,2020-2021
TX,2020-10-31,intra-ui,16750,4552,1904,1196,965,726,655,603,485,3841,26264,57941,43014,47566,TRUE,0.742375865104158,2020,2020-2021
TX,2020-11-30,inter-total,427,152,41,35,27,12,8,8,6,112,863,1691,1290,1442,TRUE,0.762862211709048,2020,2020-2021
TX,2020-11-30,inter-ucfe,1,0,0,0,0,0,1,0,1,0,1,4,2,2,TRUE,0.5,2020,2020-2021
TX,2020-11-30,inter-ucx,0,0,0,1,0,0,0,0,0,0,1,2,1,1,TRUE,0.5,2020,2020-2021
TX,2020-11-30,inter-ui,426,152,41,34,27,12,7,8,5,112,861,1685,1287,1439,TRUE,0.76379821958457,2020,2020-2021
TX,2020-11-30,intra-total,10877,4705,1570,739,415,275,230,178,176,2805,20998,42968,31875,36580,TRUE,0.741831130143363,2020,2020-2021
TX,2020-11-30,intra-ucfe,27,35,22,17,6,5,1,1,1,19,61,195,88,123,TRUE,0.451282051282051,2020,2020-2021
TX,2020-11-30,intra-ucx,60,33,11,8,3,5,2,1,3,8,146,280,206,239,TRUE,0.735714285714286,2020,2020-2021
TX,2020-11-30,intra-ui,10790,4637,1537,714,406,265,227,176,172,2778,20791,42493,31581,36218,TRUE,0.743204763137458,2020,2020-2021
TX,2020-12-31,inter-total,432,154,61,35,26,10,9,14,5,113,814,1673,1246,1400,TRUE,0.744769874476987,2020,2020-2021
TX,2020-12-31,inter-ucfe,2,1,0,0,0,0,0,1,0,2,0,6,2,3,TRUE,0.333333333333333,2020,2020-2021
TX,2020-12-31,inter-ucx,0,0,1,0,0,0,0,0,0,0,2,3,2,2,TRUE,0.666666666666667,2020,2020-2021
TX,2020-12-31,inter-ui,430,153,60,35,26,10,9,13,5,111,812,1664,1242,1395,TRUE,0.746394230769231,2020,2020-2021
TX,2020-12-31,intra-total,10104,5465,1852,854,480,283,231,171,140,2520,19624,41724,29728,35193,TRUE,0.712491611542518,2020,2020-2021
TX,2020-12-31,intra-ucfe,85,56,32,26,14,12,6,4,3,14,90,342,175,231,TRUE,0.511695906432749,2020,2020-2021
TX,2020-12-31,intra-ucx,42,51,39,18,6,4,7,5,2,18,167,359,209,260,TRUE,0.582172701949861,2020,2020-2021
TX,2020-12-31,intra-ui,9977,5358,1781,810,460,267,218,162,135,2488,19367,41023,29344,34702,TRUE,0.715306047826829,2020,2020-2021
TX,2021-01-31,inter-total,443,145,64,36,19,15,23,13,8,107,723,1596,1166,1311,TRUE,0.730576441102757,2020,2020-2021
TX,2021-01-31,inter-ucfe,2,0,0,0,0,0,0,0,0,2,0,4,2,2,TRUE,0.5,2020,2020-2021
TX,2021-01-31,inter-ucx,1,0,0,2,0,0,0,0,0,0,2,5,3,3,TRUE,0.6,2020,2020-2021
TX,2021-01-31,inter-ui,440,145,64,34,19,15,23,13,8,105,721,1587,1161,1306,TRUE,0.731568998109641,2020,2020-2021
TX,2021-01-31,intra-total,14223,6117,2307,1099,726,392,292,207,150,1981,19853,47347,34076,40193,TRUE,0.71970769003316,2020,2020-2021
TX,2021-01-31,intra-ucfe,95,22,6,10,11,6,6,4,2,10,54,226,149,171,TRUE,0.65929203539823,2020,2020-2021
TX,2021-01-31,intra-ucx,75,26,16,15,7,3,5,6,3,17,167,340,242,268,TRUE,0.711764705882353,2020,2020-2021
TX,2021-01-31,intra-ui,14053,6069,2285,1074,708,383,281,197,145,1954,19632,46781,33685,39754,TRUE,0.720057288215301,2020,2020-2021
TX,2021-02-28,inter-total,397,95,56,31,24,17,13,8,4,71,874,1590,1271,1366,TRUE,0.79937106918239,2020,2020-2021
TX,2021-02-28,inter-ucfe,2,1,0,0,0,0,0,0,1,1,0,5,2,3,TRUE,0.4,2020,2020-2021
TX,2021-02-28,inter-ucx,0,1,0,0,0,0,0,0,1,0,0,2,0,1,TRUE,0,2020,2020-2021
TX,2021-02-28,inter-ui,395,93,56,31,24,17,13,8,2,70,874,1583,1269,1362,TRUE,0.801642451042325,2020,2020-2021
TX,2021-02-28,intra-total,10570,4259,3168,1359,814,512,300,194,164,1479,20045,42864,30615,34874,TRUE,0.714235722284434,2020,2020-2021
TX,2021-02-28,intra-ucfe,30,23,12,9,11,1,2,2,2,16,27,135,57,80,TRUE,0.422222222222222,2020,2020-2021
TX,2021-02-28,intra-ucx,74,30,10,7,6,8,1,4,2,12,167,321,241,271,TRUE,0.750778816199377,2020,2020-2021
TX,2021-02-28,intra-ui,10466,4206,3146,1343,797,503,297,188,160,1451,19851,42408,30317,34523,TRUE,0.714888700245237,2020,2020-2021
TX,2021-03-31,inter-total,361,95,68,47,26,20,19,16,14,89,970,1725,1331,1426,TRUE,0.771594202898551,2020,2020-2021
TX,2021-03-31,inter-ucfe,1,0,0,0,0,0,0,1,0,1,0,3,1,1,TRUE,0.333333333333333,2020,2020-2021
TX,2021-03-31,inter-ucx,1,0,0,0,0,0,0,0,0,1,1,3,2,2,TRUE,0.666666666666667,2020,2020-2021
TX,2021-03-31,inter-ui,359,95,68,47,26,20,19,15,14,87,969,1719,1328,1423,TRUE,0.772542175683537,2020,2020-2021
TX,2021-03-31,intra-total,8887,3718,3514,2632,1173,924,501,376,305,2220,17929,42179,26816,30534,TRUE,0.635766613717727,2020,2020-2021
TX,2021-03-31,intra-ucfe,32,14,8,4,0,7,4,0,0,27,27,123,59,73,TRUE,0.479674796747968,2020,2020-2021
TX,2021-03-31,intra-ucx,41,32,15,13,3,3,1,5,2,18,162,295,203,235,TRUE,0.688135593220339,2020,2020-2021
TX,2021-03-31,intra-ui,8814,3672,3491,2615,1170,914,496,371,303,2175,17740,41761,26554,30226,TRUE,0.635856421062714,2020,2020-2021
TX,2021-04-30,inter-total,174,85,57,37,17,11,6,8,11,84,284,774,458,543,TRUE,0.591731266149871,2020,2020-2021
TX,2021-04-30,inter-ucfe,0,0,0,0,0,0,0,0,1,0,0,1,0,0,TRUE,0,2020,2020-2021
TX,2021-04-30,inter-ucx,0,2,0,0,0,0,0,0,0,1,1,4,1,3,TRUE,0.25,2020,2020-2021
TX,2021-04-30,inter-ui,174,83,57,37,17,11,6,8,10,83,283,769,457,540,TRUE,0.594278283485046,2020,2020-2021
TX,2021-04-30,intra-total,9277,3861,2367,1515,885,712,510,371,301,2210,13273,35282,22550,26411,TRUE,0.639136103395499,2020,2020-2021
TX,2021-04-30,intra-ucfe,26,13,4,3,1,3,2,1,4,17,18,92,44,57,TRUE,0.478260869565217,2020,2020-2021
TX,2021-04-30,intra-ucx,50,33,11,9,6,4,4,2,0,13,113,245,163,196,TRUE,0.66530612244898,2020,2020-2021
TX,2021-04-30,intra-ui,9201,3815,2352,1503,878,705,504,368,297,2180,13142,34945,22343,26158,TRUE,0.639376162541136,2020,2020-2021
TX,2021-05-31,inter-total,151,102,78,59,25,15,8,7,11,70,233,759,384,486,TRUE,0.505928853754941,2020,2020-2021
TX,2021-05-31,inter-ucfe,2,0,0,0,0,0,0,0,0,1,2,5,4,4,TRUE,0.8,2020,2020-2021
TX,2021-05-31,inter-ucx,0,0,0,0,0,0,0,0,0,2,0,2,0,0,TRUE,0,2020,2020-2021
TX,2021-05-31,inter-ui,149,102,78,59,25,15,8,7,11,67,231,752,380,482,TRUE,0.50531914893617,2020,2020-2021
TX,2021-05-31,intra-total,8738,3918,2030,1676,1249,899,619,537,403,2103,13062,35234,21800,25718,TRUE,0.618720554010331,2020,2020-2021
TX,2021-05-31,intra-ucfe,28,17,13,4,2,3,2,2,1,17,16,105,44,61,TRUE,0.419047619047619,2020,2020-2021
TX,2021-05-31,intra-ucx,46,26,6,8,5,3,4,1,3,11,101,214,147,173,TRUE,0.686915887850467,2020,2020-2021
TX,2021-05-31,intra-ui,8664,3875,2011,1664,1242,893,613,534,399,2075,12945,34915,21609,25484,TRUE,0.618903050264929,2020,2020-2021
TX,2021-06-30,inter-total,136,146,90,68,39,31,23,18,9,95,240,895,376,522,TRUE,0.420111731843575,2020,2020-2021
TX,2021-06-30,inter-ucfe,1,1,0,1,0,0,0,0,0,0,2,5,3,4,TRUE,0.6,2020,2020-2021
TX,2021-06-30,inter-ucx,0,0,0,0,0,0,0,0,0,1,1,2,1,1,TRUE,0.5,2020,2020-2021
TX,2021-06-30,inter-ui,135,145,90,67,39,31,23,18,9,94,237,888,372,517,TRUE,0.418918918918919,2020,2020-2021
TX,2021-06-30,intra-total,7110,5359,3972,2075,990,751,579,479,335,2207,9526,33383,16636,21995,TRUE,0.498337477159033,2020,2020-2021
TX,2021-06-30,intra-ucfe,19,16,9,6,6,3,8,2,2,19,31,121,50,66,TRUE,0.413223140495868,2020,2020-2021
TX,2021-06-30,intra-ucx,27,30,19,11,3,6,3,6,1,13,119,238,146,176,TRUE,0.613445378151261,2020,2020-2021
TX,2021-06-30,intra-ui,7064,5313,3944,2058,981,742,568,471,332,2175,9376,33024,16440,21753,TRUE,0.49781976744186,2020,2020-2021
TX,2021-07-31,inter-total,208,136,71,47,33,20,8,17,15,76,289,920,497,633,TRUE,0.540217391304348,2021,2021-2022
TX,2021-07-31,inter-ucfe,0,1,0,0,0,1,0,0,1,1,1,5,1,2,TRUE,0.2,2021,2021-2022
TX,2021-07-31,inter-ucx,1,0,0,0,0,0,0,0,0,0,1,2,2,2,TRUE,1,2021,2021-2022
TX,2021-07-31,inter-ui,207,135,71,47,33,19,8,17,14,75,287,913,494,629,TRUE,0.541073384446879,2021,2021-2022
TX,2021-07-31,intra-total,10628,4939,2869,1741,972,767,422,339,241,1846,13193,37957,23821,28760,TRUE,0.627578575756778,2021,2021-2022
TX,2021-07-31,intra-ucfe,61,16,12,9,3,7,1,2,0,16,36,163,97,113,TRUE,0.595092024539877,2021,2021-2022
TX,2021-07-31,intra-ucx,33,23,12,8,3,6,1,1,1,13,109,210,142,165,TRUE,0.676190476190476,2021,2021-2022
TX,2021-07-31,intra-ui,10534,4900,2845,1724,966,754,420,336,240,1817,13048,37584,23582,28482,TRUE,0.627447850149,2021,2021-2022
TX,2021-08-31,inter-total,116,125,72,47,32,25,23,11,8,105,243,807,359,484,TRUE,0.444857496902107,2021,2021-2022
TX,2021-08-31,inter-ucfe,1,1,0,0,0,0,0,0,0,0,2,4,3,4,TRUE,0.75,2021,2021-2022
TX,2021-08-31,inter-ucx,0,1,1,0,0,0,0,0,0,1,1,4,1,2,TRUE,0.25,2021,2021-2022
TX,2021-08-31,inter-ui,115,123,71,47,32,25,23,11,8,104,240,799,355,478,TRUE,0.444305381727159,2021,2021-2022
TX,2021-08-31,intra-total,5893,5222,2649,1572,972,772,510,356,246,1874,12122,32188,18015,23237,TRUE,0.559680626320368,2021,2021-2022
TX,2021-08-31,intra-ucfe,22,25,14,5,3,5,1,1,1,14,30,121,52,77,TRUE,0.429752066115702,2021,2021-2022
TX,2021-08-31,intra-ucx,40,28,16,5,3,4,2,0,1,9,121,229,161,189,TRUE,0.703056768558952,2021,2021-2022
TX,2021-08-31,intra-ui,5831,5169,2619,1562,966,763,507,355,244,1851,11971,31838,17802,22971,TRUE,0.559143162258936,2021,2021-2022
TX,2021-09-30,inter-total,86,75,43,28,12,21,20,17,10,56,146,514,232,307,TRUE,0.45136186770428,2021,2021-2022
TX,2021-09-30,inter-ucfe,3,1,0,2,0,0,0,0,0,0,0,6,3,4,TRUE,0.5,2021,2021-2022
TX,2021-09-30,inter-ucx,0,0,0,0,0,0,0,0,0,0,1,1,1,1,TRUE,1,2021,2021-2022
TX,2021-09-30,inter-ui,83,74,43,26,12,21,20,17,10,56,145,507,228,302,TRUE,0.449704142011834,2021,2021-2022
TX,2021-09-30,intra-total,4956,2835,1602,1046,781,692,620,394,269,1460,8186,22841,13142,15977,TRUE,0.575368854253316,2021,2021-2022
TX,2021-09-30,intra-ucfe,29,12,3,4,6,5,4,1,4,19,21,108,50,62,TRUE,0.462962962962963,2021,2021-2022
TX,2021-09-30,intra-ucx,48,24,18,9,7,5,0,5,1,9,104,230,152,176,TRUE,0.660869565217391,2021,2021-2022
TX,2021-09-30,intra-ui,4879,2799,1581,1033,768,682,616,388,264,1432,8061,22503,12940,15739,TRUE,0.575034439852464,2021,2021-2022
TX,2021-10-31,inter-total,128,59,25,23,29,17,15,13,12,96,139,556,267,326,TRUE,0.48021582733813,2021,2021-2022
TX,2021-10-31,inter-ucfe,0,1,0,0,0,1,1,0,0,1,0,4,0,1,TRUE,0,2021,2021-2022
TX,2021-10-31,inter-ucx,1,0,0,0,0,0,0,0,0,0,1,2,2,2,TRUE,1,2021,2021-2022
TX,2021-10-31,inter-ui,127,58,25,23,29,16,14,13,12,95,138,550,265,323,TRUE,0.481818181818182,2021,2021-2022
TX,2021-10-31,intra-total,5740,2454,1510,1042,741,572,425,379,370,2676,8110,24019,13850,16304,TRUE,0.576626837087306,2021,2021-2022
TX,2021-10-31,intra-ucfe,39,19,6,7,4,4,4,3,1,13,40,140,79,98,TRUE,0.564285714285714,2021,2021-2022
TX,2021-10-31,intra-ucx,38,27,16,9,3,5,5,4,2,15,93,217,131,158,TRUE,0.603686635944701,2021,2021-2022
TX,2021-10-31,intra-ui,5663,2408,1488,1026,734,563,416,372,367,2648,7977,23662,13640,16048,TRUE,0.576451694700364,2021,2021-2022
TX,2021-11-30,inter-total,176,69,26,21,20,16,9,9,5,76,246,673,422,491,TRUE,0.62704309063893,2021,2021-2022
TX,2021-11-30,inter-ucfe,1,1,0,1,0,0,0,0,0,0,2,5,3,4,TRUE,0.6,2021,2021-2022
TX,2021-11-30,inter-ucx,0,0,0,0,0,0,0,0,0,0,1,1,1,1,TRUE,1,2021,2021-2022
TX,2021-11-30,inter-ui,175,68,26,20,20,16,9,9,5,76,243,667,418,486,TRUE,0.626686656671664,2021,2021-2022
TX,2021-11-30,intra-total,5923,2663,1052,911,728,653,429,296,190,2015,10153,25013,16076,18739,TRUE,0.642705792987646,2021,2021-2022
TX,2021-11-30,intra-ucfe,52,14,13,8,1,11,7,0,0,14,32,152,84,98,TRUE,0.552631578947369,2021,2021-2022
TX,2021-11-30,intra-ucx,59,29,13,11,6,8,4,4,5,13,94,246,153,182,TRUE,0.621951219512195,2021,2021-2022
TX,2021-11-30,intra-ui,5812,2620,1026,892,721,634,418,292,185,1988,10027,24615,15839,18459,TRUE,0.643469429209831,2021,2021-2022
TX,2021-12-31,inter-total,259,75,43,22,24,7,8,4,6,70,327,845,586,661,TRUE,0.693491124260355,2021,2021-2022
TX,2021-12-31,inter-ucfe,0,1,1,2,0,0,0,0,0,0,2,6,2,3,TRUE,0.333333333333333,2021,2021-2022
TX,2021-12-31,inter-ucx,1,0,1,0,0,0,0,0,0,0,0,2,1,1,TRUE,0.5,2021,2021-2022
TX,2021-12-31,inter-ui,258,74,41,20,24,7,8,4,6,70,325,837,583,657,TRUE,0.696535244922342,2021,2021-2022
TX,2021-12-31,intra-total,7167,2246,865,463,303,273,184,166,127,1362,10408,23564,17575,19821,TRUE,0.745841113563062,2021,2021-2022
TX,2021-12-31,intra-ucfe,21,22,7,7,2,0,3,2,2,18,33,117,54,76,TRUE,0.461538461538462,2021,2021-2022
TX,2021-12-31,intra-ucx,50,20,11,8,7,2,0,1,2,4,97,202,147,167,TRUE,0.727722772277228,2021,2021-2022
TX,2021-12-31,intra-ui,7096,2204,847,448,294,271,181,163,123,1340,10278,23245,17374,19578,TRUE,0.747429554742956,2021,2021-2022
TX,2022-01-31,inter-total,209,72,37,26,10,9,16,11,5,38,312,745,521,593,TRUE,0.699328859060403,2021,2021-2022
TX,2022-01-31,inter-ucfe,1,1,1,0,0,0,0,0,0,0,0,3,1,2,TRUE,0.333333333333333,2021,2021-2022
TX,2022-01-31,inter-ucx,0,0,0,0,0,0,0,0,0,0,0,0,0,0,TRUE,0,2021,2021-2022
TX,2022-01-31,inter-ui,208,71,36,26,10,9,16,11,5,38,312,742,520,591,TRUE,0.700808625336927,2021,2021-2022
TX,2022-01-31,intra-total,7746,2509,929,458,311,192,114,115,86,932,11757,25149,19503,22012,TRUE,0.775498031730884,2021,2021-2022
TX,2022-01-31,intra-ucfe,40,13,8,4,2,2,0,2,1,6,22,100,62,75,TRUE,0.62,2021,2021-2022
TX,2022-01-31,intra-ucx,30,11,10,7,7,1,1,0,1,2,98,168,128,139,TRUE,0.761904761904762,2021,2021-2022
TX,2022-01-31,intra-ui,7676,2485,911,447,302,189,113,113,84,924,11637,24881,19313,21798,TRUE,0.776214782364053,2021,2021-2022
TX,2022-02-28,inter-total,178,52,23,17,11,7,5,3,5,52,228,581,406,458,TRUE,0.698795180722892,2021,2021-2022
TX,2022-02-28,inter-ucfe,1,0,0,0,0,0,0,0,0,1,2,4,3,3,TRUE,0.75,2021,2021-2022
TX,2022-02-28,inter-ucx,0,0,0,0,0,0,0,0,0,0,0,0,0,0,TRUE,0,2021,2021-2022
TX,2022-02-28,inter-ui,177,52,23,17,11,7,5,3,5,51,226,577,403,455,TRUE,0.69844020797227,2021,2021-2022
TX,2022-02-28,intra-total,4998,2356,1035,530,306,194,112,125,105,868,8574,19203,13572,15928,TRUE,0.706764568036244,2021,2021-2022
TX,2022-02-28,intra-ucfe,26,11,3,6,1,4,2,1,1,6,24,85,50,61,TRUE,0.588235294117647,2021,2021-2022
TX,2022-02-28,intra-ucx,47,15,6,5,2,0,1,1,3,13,86,179,133,148,TRUE,0.743016759776536,2021,2021-2022
TX,2022-02-28,intra-ui,4925,2330,1026,519,303,190,109,123,101,849,8464,18939,13389,15719,TRUE,0.706953904641217,2021,2021-2022
TX,2022-03-31,inter-total,184,39,37,19,10,7,8,5,5,40,215,569,399,438,TRUE,0.701230228471002,2021,2021-2022
TX,2022-03-31,inter-ucfe,1,0,0,1,0,0,1,0,0,0,3,6,4,4,TRUE,0.666666666666667,2021,2021-2022
TX,2022-03-31,inter-ucx,1,0,0,0,0,0,0,0,0,0,1,2,2,2,TRUE,1,2021,2021-2022
TX,2022-03-31,inter-ui,182,39,37,18,10,7,7,5,5,40,211,561,393,432,TRUE,0.700534759358289,2021,2021-2022
TX,2022-03-31,intra-total,5575,2502,1255,768,454,295,242,186,160,1121,8853,21411,14428,16930,TRUE,0.673859231236281,2021,2021-2022
TX,2022-03-31,intra-ucfe,36,14,8,5,2,7,0,1,1,14,23,111,59,73,TRUE,0.531531531531532,2021,2021-2022
TX,2022-03-31,intra-ucx,35,20,7,6,8,4,3,4,3,3,106,199,141,161,TRUE,0.708542713567839,2021,2021-2022
TX,2022-03-31,intra-ui,5504,2468,1240,757,444,284,239,181,156,1104,8724,21101,14228,16696,TRUE,0.674280839770627,2021,2021-2022
TX,2022-04-30,inter-total,209,44,22,12,8,3,1,2,2,27,215,545,424,468,TRUE,0.777981651376147,2021,2021-2022
TX,2022-04-30,inter-ucfe,1,2,1,0,0,0,0,0,0,0,3,7,4,6,TRUE,0.571428571428571,2021,2021-2022
TX,2022-04-30,inter-ucx,1,0,0,1,0,0,0,0,0,0,0,2,1,1,TRUE,0.5,2021,2021-2022
TX,2022-04-30,inter-ui,207,42,21,11,8,3,1,2,2,27,212,536,419,461,TRUE,0.781716417910448,2021,2021-2022
TX,2022-04-30,intra-total,6042,2085,1015,528,282,164,87,83,62,798,8332,19478,14374,16459,TRUE,0.737960776260396,2021,2021-2022
TX,2022-04-30,intra-ucfe,53,8,6,0,1,0,1,0,1,4,53,127,106,114,TRUE,0.834645669291339,2021,2021-2022
TX,2022-04-30,intra-ucx,35,22,8,1,3,2,0,1,1,4,80,157,115,137,TRUE,0.732484076433121,2021,2021-2022
TX,2022-04-30,intra-ui,5954,2055,1001,527,278,162,86,82,60,790,8199,19194,14153,16208,TRUE,0.737365843492758,2021,2021-2022
TX,2022-05-31,inter-total,158,46,26,10,8,7,1,1,0,17,225,499,383,429,TRUE,0.767535070140281,2021,2021-2022
TX,2022-05-31,inter-ucfe,0,0,0,0,0,0,0,0,0,0,0,0,0,0,TRUE,0,2021,2021-2022
TX,2022-05-31,inter-ucx,0,0,0,0,0,0,0,0,0,0,1,1,1,1,TRUE,1,2021,2021-2022
TX,2022-05-31,inter-ui,158,46,26,10,8,7,1,1,0,17,224,498,382,428,TRUE,0.767068273092369,2021,2021-2022
TX,2022-05-31,intra-total,5588,2479,1199,702,318,151,85,49,51,671,8903,20196,14491,16970,TRUE,0.717518320459497,2021,2021-2022
TX,2022-05-31,intra-ucfe,25,14,6,2,1,2,0,3,0,3,39,95,64,78,TRUE,0.673684210526316,2021,2021-2022
TX,2022-05-31,intra-ucx,40,23,7,1,3,0,2,1,0,4,93,174,133,156,TRUE,0.764367816091954,2021,2021-2022
TX,2022-05-31,intra-ui,5523,2442,1186,699,314,149,83,45,51,664,8771,19927,14294,16736,TRUE,0.717318211471872,2021,2021-2022
TX,2022-06-30,inter-total,208,50,21,14,6,5,3,6,2,24,272,611,480,530,TRUE,0.785597381342062,2021,2021-2022
TX,2022-06-30,inter-ucfe,1,1,0,0,0,0,0,0,0,0,5,7,6,7,TRUE,0.857142857142857,2021,2021-2022
TX,2022-06-30,inter-ucx,0,0,0,0,0,0,0,0,0,0,1,1,1,1,TRUE,1,2021,2021-2022
TX,2022-06-30,inter-ui,207,49,21,14,6,5,3,6,2,24,266,603,473,522,TRUE,0.78441127694859,2021,2021-2022
TX,2022-06-30,intra-total,8150,2937,1320,753,412,245,165,97,78,655,11529,26341,19679,22616,TRUE,0.747086291332903,2021,2021-2022
TX,2022-06-30,intra-ucfe,244,20,4,3,1,0,0,0,1,5,124,402,368,388,TRUE,0.915422885572139,2021,2021-2022
TX,2022-06-30,intra-ucx,37,19,9,2,3,1,1,0,0,3,101,176,138,157,TRUE,0.784090909090909,2021,2021-2022
TX,2022-06-30,intra-ui,7869,2898,1307,748,408,244,164,97,77,647,11304,25763,19173,22071,TRUE,0.744206808213329,2021,2021-2022
TX,2022-07-31,inter-total,213,44,24,16,4,6,3,2,1,11,259,583,472,516,TRUE,0.809605488850772,2022,2022-2023
TX,2022-07-31,inter-ucfe,2,0,2,2,0,1,0,0,0,0,1,8,3,3,TRUE,0.375,2022,2022-2023
TX,2022-07-31,inter-ucx,0,0,0,0,0,0,0,0,0,0,2,2,2,2,TRUE,1,2022,2022-2023
TX,2022-07-31,inter-ui,211,44,22,14,4,5,3,2,1,11,256,573,467,511,TRUE,0.815008726003491,2022,2022-2023
TX,2022-07-31,intra-total,7712,2447,918,392,238,159,131,83,69,531,11155,23835,18867,21314,TRUE,0.791567023285085,2022,2022-2023
TX,2022-07-31,intra-ucfe,45,23,9,2,3,2,1,2,1,3,62,153,107,130,TRUE,0.699346405228758,2022,2022-2023
TX,2022-07-31,intra-ucx,57,24,5,4,2,1,0,4,0,0,120,217,177,201,TRUE,0.815668202764977,2022,2022-2023
TX,2022-07-31,intra-ui,7610,2400,904,386,233,156,130,77,68,528,10973,23465,18583,20983,TRUE,0.791945450671213,2022,2022-2023
TX,2022-08-31,inter-total,167,75,28,19,13,2,2,4,2,15,240,567,407,482,TRUE,0.717813051146385,2022,2022-2023
TX,2022-08-31,inter-ucfe,2,0,1,0,0,0,0,0,0,0,5,8,7,7,TRUE,0.875,2022,2022-2023
TX,2022-08-31,inter-ucx,1,0,0,0,0,0,0,0,0,0,0,1,1,1,TRUE,1,2022,2022-2023
TX,2022-08-31,inter-ui,164,75,27,19,13,2,2,4,2,15,235,558,399,474,TRUE,0.71505376344086,2022,2022-2023
TX,2022-08-31,intra-total,6019,3169,1411,655,333,223,155,103,72,589,11614,24343,17633,20802,TRUE,0.724356077722549,2022,2022-2023
TX,2022-08-31,intra-ucfe,30,19,12,6,5,3,1,0,4,7,46,133,76,95,TRUE,0.571428571428571,2022,2022-2023
TX,2022-08-31,intra-ucx,49,20,14,5,5,1,4,1,0,5,133,237,182,202,TRUE,0.767932489451477,2022,2022-2023
TX,2022-08-31,intra-ui,5940,3130,1385,644,323,219,150,102,68,577,11435,23973,17375,20505,TRUE,0.724773703750052,2022,2022-2023
TX,2022-09-30,inter-total,104,62,23,9,7,3,4,2,0,22,200,436,304,366,TRUE,0.697247706422018,2022,2022-2023
TX,2022-09-30,inter-ucfe,1,0,0,0,0,0,0,0,0,0,2,3,3,3,TRUE,1,2022,2022-2023
TX,2022-09-30,inter-ucx,0,0,1,0,0,0,0,0,0,0,0,1,0,0,TRUE,0,2022,2022-2023
TX,2022-09-30,inter-ui,103,62,22,9,7,3,4,2,0,22,198,432,301,363,TRUE,0.696759259259259,2022,2022-2023
TX,2022-09-30,intra-total,4840,2915,1437,752,409,263,165,110,69,544,9490,20994,14330,17245,TRUE,0.682575974087835,2022,2022-2023
TX,2022-09-30,intra-ucfe,25,10,3,2,3,2,0,0,1,5,24,75,49,59,TRUE,0.653333333333333,2022,2022-2023
TX,2022-09-30,intra-ucx,47,25,5,5,2,0,2,0,0,4,109,199,156,181,TRUE,0.78391959798995,2022,2022-2023
TX,2022-09-30,intra-ui,4768,2880,1429,745,404,261,163,110,68,535,9357,20720,14125,17005,TRUE,0.681708494208494,2022,2022-2023
TX,2022-10-31,inter-total,123,45,28,10,6,9,4,4,0,8,221,458,344,389,TRUE,0.751091703056769,2022,2022-2023
TX,2022-10-31,inter-ucfe,0,1,1,0,0,0,0,0,0,1,0,3,0,1,TRUE,0,2022,2022-2023
TX,2022-10-31,inter-ucx,0,0,0,0,0,0,0,0,0,0,0,0,0,0,TRUE,0,2022,2022-2023
TX,2022-10-31,inter-ui,123,44,27,10,6,9,4,4,0,7,221,455,344,388,TRUE,0.756043956043956,2022,2022-2023
TX,2022-10-31,intra-total,4676,2593,1275,734,462,287,226,134,107,592,9190,20276,13866,16459,TRUE,0.6838626948116,2022,2022-2023
TX,2022-10-31,intra-ucfe,26,14,5,3,1,0,0,0,1,4,26,80,52,66,TRUE,0.65,2022,2022-2023
TX,2022-10-31,intra-ucx,42,12,8,4,2,3,1,1,2,3,98,176,140,152,TRUE,0.795454545454545,2022,2022-2023
TX,2022-10-31,intra-ui,4608,2567,1262,727,459,284,225,133,104,585,9066,20020,13674,16241,TRUE,0.683016983016983,2022,2022-2023
TX,2022-11-30,inter-total,145,82,30,15,17,5,2,1,5,18,251,571,396,478,TRUE,0.693520140105079,2022,2022-2023
TX,2022-11-30,inter-ucfe,1,1,1,0,0,0,0,0,0,0,1,4,2,3,TRUE,0.5,2022,2022-2023
TX,2022-11-30,inter-ucx,0,0,0,0,0,0,0,0,0,0,0,0,0,0,TRUE,0,2022,2022-2023
TX,2022-11-30,inter-ui,144,81,29,15,17,5,2,1,5,18,250,567,394,475,TRUE,0.694885361552028,2022,2022-2023
TX,2022-11-30,intra-total,4664,3263,1457,828,517,371,226,143,119,606,10532,22726,15196,18459,TRUE,0.668661445040922,2022,2022-2023
TX,2022-11-30,intra-ucfe,10,10,2,4,0,1,3,0,0,2,21,53,31,41,TRUE,0.584905660377359,2022,2022-2023
TX,2022-11-30,intra-ucx,21,35,13,2,4,0,0,1,0,2,99,177,120,155,TRUE,0.677966101694915,2022,2022-2023
TX,2022-11-30,intra-ui,4633,3218,1442,822,513,370,223,142,119,602,10412,22496,15045,18263,TRUE,0.668785561877667,2022,2022-2023
TX,2022-12-31,inter-total,257,61,31,30,16,15,2,9,1,14,288,724,545,606,TRUE,0.752762430939227,2022,2022-2023
TX,2022-12-31,inter-ucfe,0,0,0,0,0,0,0,0,0,0,1,1,1,1,TRUE,1,2022,2022-2023
TX,2022-12-31,inter-ucx,0,0,0,0,0,0,0,0,0,0,1,1,1,1,TRUE,1,2022,2022-2023
TX,2022-12-31,inter-ui,257,61,31,30,16,15,2,9,1,14,286,722,543,604,TRUE,0.75207756232687,2022,2022-2023
TX,2022-12-31,intra-total,7941,2889,1513,873,599,441,347,242,169,548,11496,27058,19437,22326,TRUE,0.718345775741001,2022,2022-2023
TX,2022-12-31,intra-ucfe,18,11,5,1,3,0,0,1,1,5,23,68,41,52,TRUE,0.602941176470588,2022,2022-2023
TX,2022-12-31,intra-ucx,56,16,6,2,1,1,0,1,0,5,101,189,157,173,TRUE,0.830687830687831,2022,2022-2023
TX,2022-12-31,intra-ui,7867,2862,1502,870,595,440,347,240,168,538,11372,26801,19239,22101,TRUE,0.717846349016828,2022,2022-2023
TX,2023-01-31,inter-total,205,79,35,27,5,10,8,5,10,19,307,710,512,591,TRUE,0.72112676056338,2022,2022-2023
TX,2023-01-31,inter-ucfe,2,1,0,0,0,0,0,0,0,1,2,6,4,5,TRUE,0.666666666666667,2022,2022-2023
TX,2023-01-31,inter-ucx,1,1,0,0,0,0,0,0,0,0,0,2,1,2,TRUE,0.5,2022,2022-2023
TX,2023-01-31,inter-ui,202,77,35,27,5,10,8,5,10,18,305,702,507,584,TRUE,0.722222222222222,2022,2022-2023
TX,2023-01-31,intra-total,8239,3478,1736,989,577,375,212,196,144,580,15058,31584,23297,26775,TRUE,0.73762031408308,2022,2022-2023
TX,2023-01-31,intra-ucfe,22,11,6,7,1,2,0,1,0,2,26,78,48,59,TRUE,0.615384615384615,2022,2022-2023
TX,2023-01-31,intra-ucx,31,24,11,7,4,5,2,0,1,3,96,184,127,151,TRUE,0.690217391304348,2022,2022-2023
TX,2023-01-31,intra-ui,8186,3443,1719,975,572,368,210,195,143,575,14936,31322,23122,26565,TRUE,0.738203179873571,2022,2022-2023
TX,2023-02-28,inter-total,182,64,18,13,1,2,2,2,2,15,272,573,454,518,TRUE,0.792321116928447,2022,2022-2023
TX,2023-02-28,inter-ucfe,0,0,0,0,0,0,0,0,0,0,0,0,0,0,TRUE,0,2022,2022-2023
TX,2023-02-28,inter-ucx,0,0,0,0,0,0,0,0,0,0,0,0,0,0,TRUE,0,2022,2022-2023
TX,2023-02-28,inter-ui,182,64,18,13,1,2,2,2,2,15,272,573,454,518,TRUE,0.792321116928447,2022,2022-2023
TX,2023-02-28,intra-total,6790,3138,1286,584,310,227,130,116,86,551,12619,25837,19409,22547,TRUE,0.751209505747571,2022,2022-2023
TX,2023-02-28,intra-ucfe,17,9,3,4,0,0,0,3,0,4,17,57,34,43,TRUE,0.596491228070175,2022,2022-2023
TX,2023-02-28,intra-ucx,38,20,10,3,0,1,0,1,0,1,91,165,129,149,TRUE,0.781818181818182,2022,2022-2023
TX,2023-02-28,intra-ui,6735,3109,1273,577,310,226,130,112,86,546,12511,25615,19246,22355,TRUE,0.751356626976381,2022,2022-2023
TX,2023-03-31,inter-total,147,71,27,15,13,4,1,6,5,19,251,559,398,469,TRUE,0.711985688729875,2022,2022-2023
TX,2023-03-31,inter-ucfe,0,1,0,0,1,0,0,0,0,0,0,2,0,1,TRUE,0,2022,2022-2023
TX,2023-03-31,inter-ucx,0,0,0,0,0,0,0,0,0,0,0,0,0,0,TRUE,0,2022,2022-2023
TX,2023-03-31,inter-ui,147,70,27,15,12,4,1,6,5,19,251,557,398,468,TRUE,0.714542190305207,2022,2022-2023
TX,2023-03-31,intra-total,6963,3088,1456,754,410,239,148,117,77,607,12910,26769,19873,22961,TRUE,0.742388583809631,2022,2022-2023
TX,2023-03-31,intra-ucfe,19,12,9,4,0,0,0,1,3,4,22,74,41,53,TRUE,0.554054054054054,2022,2022-2023
TX,2023-03-31,intra-ucx,28,13,8,4,3,1,1,2,1,2,78,141,106,119,TRUE,0.75177304964539,2022,2022-2023
TX,2023-03-31,intra-ui,6916,3063,1439,746,407,238,147,114,73,601,12810,26554,19726,22789,TRUE,0.742863598704527,2022,2022-2023
TX,2023-04-30,inter-total,192,35,18,6,5,5,9,6,4,14,273,567,465,500,TRUE,0.82010582010582,2022,2022-2023
TX,2023-04-30,inter-ucfe,0,0,0,0,0,0,1,0,0,0,0,1,0,0,TRUE,0,2022,2022-2023
TX,2023-04-30,inter-ucx,0,0,0,1,0,0,0,0,0,0,0,1,0,0,TRUE,0,2022,2022-2023
TX,2023-04-30,inter-ui,192,35,18,5,5,5,8,6,4,14,273,565,465,500,TRUE,0.823008849557522,2022,2022-2023
TX,2023-04-30,intra-total,7168,2666,1147,595,338,218,126,108,79,484,12228,25157,19396,22062,TRUE,0.770998131732719,2022,2022-2023
TX,2023-04-30,intra-ucfe,22,8,6,3,2,3,1,0,0,3,16,64,38,46,TRUE,0.59375,2022,2022-2023
TX,2023-04-30,intra-ucx,44,7,2,1,1,0,0,3,2,3,81,144,125,132,TRUE,0.868055555555556,2022,2022-2023
TX,2023-04-30,intra-ui,7102,2651,1139,591,335,215,125,105,77,478,12131,24949,19233,21884,TRUE,0.770892620946731,2022,2022-2023
TX,2023-05-31,inter-total,190,56,30,21,6,11,2,2,3,24,244,589,434,490,TRUE,0.736842105263158,2022,2022-2023
TX,2023-05-31,inter-ucfe,0,0,0,0,0,0,0,0,0,0,0,0,0,0,TRUE,0,2022,2022-2023
TX,2023-05-31,inter-ucx,1,0,0,0,0,0,0,0,0,0,0,1,1,1,TRUE,1,2022,2022-2023
TX,2023-05-31,inter-ui,189,56,30,21,6,11,2,2,3,24,244,588,433,489,TRUE,0.736394557823129,2022,2022-2023
TX,2023-05-31,intra-total,8129,3466,1614,770,423,275,214,127,122,804,13576,29520,21705,25171,TRUE,0.735264227642276,2022,2022-2023
TX,2023-05-31,intra-ucfe,18,20,5,5,1,2,1,2,0,4,29,87,47,67,TRUE,0.540229885057471,2022,2022-2023
TX,2023-05-31,intra-ucx,45,10,5,6,0,1,0,0,4,2,99,172,144,154,TRUE,0.837209302325582,2022,2022-2023
TX,2023-05-31,intra-ui,8066,3436,1604,759,422,272,213,125,118,798,13448,29261,21514,24950,TRUE,0.735244865178907,2022,2022-2023
TX,2023-06-30,inter-total,240,60,28,12,10,4,8,5,3,19,275,664,515,575,TRUE,0.775602409638554,2022,2022-2023
TX,2023-06-30,inter-ucfe,1,0,0,0,0,0,0,0,0,0,1,2,2,2,TRUE,1,2022,2022-2023
TX,2023-06-30,inter-ucx,0,1,0,0,0,0,0,0,0,0,0,1,0,1,TRUE,0,2022,2022-2023
TX,2023-06-30,inter-ui,239,59,28,12,10,4,8,5,3,19,274,661,513,572,TRUE,0.776096822995462,2022,2022-2023
TX,2023-06-30,intra-total,9486,3761,1789,891,449,332,203,147,97,490,14504,32149,23990,27751,TRUE,0.746212945970326,2022,2022-2023
TX,2023-06-30,intra-ucfe,31,11,8,3,1,2,1,0,1,3,33,94,64,75,TRUE,0.680851063829787,2022,2022-2023
TX,2023-06-30,intra-ucx,44,15,10,2,0,0,0,1,0,1,109,182,153,168,TRUE,0.840659340659341,2022,2022-2023
TX,2023-06-30,intra-ui,9411,3735,1771,886,448,330,202,146,96,486,14362,31873,23773,27508,TRUE,0.745866407303988,2022,2022-2023
TX,2023-07-31,inter-total,209,77,42,23,7,5,7,5,1,4,318,698,527,604,TRUE,0.755014326647565,2023,2023-2024
TX,2023-07-31,inter-ucfe,0,2,0,0,0,0,0,0,0,0,0,2,0,2,TRUE,0,2023,2023-2024
TX,2023-07-31,inter-ucx,0,1,0,0,0,0,0,0,0,0,0,1,0,1,TRUE,0,2023,2023-2024
TX,2023-07-31,inter-ui,209,74,42,23,7,5,7,5,1,4,318,695,527,601,TRUE,0.758273381294964,2023,2023-2024
TX,2023-07-31,intra-total,7270,3774,1818,1079,590,373,229,137,96,355,13717,29438,20987,24761,TRUE,0.712922073510429,2023,2023-2024
TX,2023-07-31,intra-ucfe,20,11,9,6,4,1,0,2,0,1,26,80,46,57,TRUE,0.575,2023,2023-2024
TX,2023-07-31,intra-ucx,30,7,8,5,3,1,0,1,0,1,125,181,155,162,TRUE,0.856353591160221,2023,2023-2024
TX,2023-07-31,intra-ui,7220,3756,1801,1068,583,371,229,134,96,353,13566,29177,20786,24542,TRUE,0.712410460294067,2023,2023-2024
TX,2023-08-31,inter-total,208,76,36,17,15,10,5,5,2,13,286,673,494,570,TRUE,0.734026745913819,2023,2023-2024
TX,2023-08-31,inter-ucfe,0,1,0,0,0,0,0,0,0,0,3,4,3,4,TRUE,0.75,2023,2023-2024
TX,2023-08-31,inter-ucx,1,1,0,0,0,0,0,0,0,0,1,3,2,3,TRUE,0.666666666666667,2023,2023-2024
TX,2023-08-31,inter-ui,207,74,36,17,15,10,5,5,2,13,282,666,489,563,TRUE,0.734234234234234,2023,2023-2024
TX,2023-08-31,intra-total,8210,3968,1917,1118,695,466,326,186,118,466,12564,30034,20774,24742,TRUE,0.691682759539189,2023,2023-2024
TX,2023-08-31,intra-ucfe,28,13,8,3,0,3,2,0,2,4,29,92,57,70,TRUE,0.619565217391304,2023,2023-2024
TX,2023-08-31,intra-ucx,49,12,7,2,3,2,1,2,1,2,113,194,162,174,TRUE,0.835051546391753,2023,2023-2024
TX,2023-08-31,intra-ui,8133,3943,1902,1113,692,461,323,184,115,460,12422,29748,20555,24498,TRUE,0.690970821567837,2023,2023-2024
TX,2023-09-30,inter-total,128,58,39,25,15,10,11,3,4,12,190,495,318,376,TRUE,0.642424242424243,2023,2023-2024
TX,2023-09-30,inter-ucfe,0,1,1,0,0,0,0,0,1,0,2,5,2,3,TRUE,0.4,2023,2023-2024
TX,2023-09-30,inter-ucx,0,0,0,0,0,0,0,0,0,0,0,0,0,0,TRUE,0,2023,2023-2024
TX,2023-09-30,inter-ui,128,57,38,25,15,10,11,3,3,12,188,490,316,373,TRUE,0.644897959183673,2023,2023-2024
TX,2023-09-30,intra-total,5705,3444,1929,1129,687,475,327,260,162,632,10122,24872,15827,19271,TRUE,0.6363380508202,2023,2023-2024
TX,2023-09-30,intra-ucfe,17,13,8,9,4,4,0,1,2,1,19,78,36,49,TRUE,0.461538461538462,2023,2023-2024
TX,2023-09-30,intra-ucx,43,12,8,5,4,0,0,1,0,5,88,166,131,143,TRUE,0.789156626506024,2023,2023-2024
TX,2023-09-30,intra-ui,5645,3419,1913,1115,679,471,327,258,160,626,10015,24628,15660,19079,TRUE,0.635861620919279,2023,2023-2024
TX,2023-10-31,inter-total,169,61,21,11,9,9,6,2,3,19,224,534,393,454,TRUE,0.735955056179775,2023,2023-2024
TX,2023-10-31,inter-ucfe,2,1,0,0,0,0,0,0,0,1,0,4,2,3,TRUE,0.5,2023,2023-2024
TX,2023-10-31,inter-ucx,0,0,0,0,0,0,0,0,0,0,0,0,0,0,TRUE,0,2023,2023-2024
TX,2023-10-31,inter-ui,167,60,21,11,9,9,6,2,3,18,224,530,391,451,TRUE,0.737735849056604,2023,2023-2024
TX,2023-10-31,intra-total,6458,3514,1608,910,632,410,293,192,151,555,11559,26282,18017,21531,TRUE,0.685526215660909,2023,2023-2024
TX,2023-10-31,intra-ucfe,16,15,6,3,1,1,0,1,1,3,31,78,47,62,TRUE,0.602564102564103,2023,2023-2024
TX,2023-10-31,intra-ucx,45,15,7,3,0,0,1,1,1,1,77,151,122,137,TRUE,0.80794701986755,2023,2023-2024
TX,2023-10-31,intra-ui,6397,3484,1595,904,631,409,292,190,149,551,11451,26053,17848,21332,TRUE,0.685065059686025,2023,2023-2024
TX,2023-11-30,inter-total,174,89,32,22,13,7,2,2,3,15,310,669,484,573,TRUE,0.723467862481316,2023,2023-2024
TX,2023-11-30,inter-ucfe,1,0,0,1,0,0,0,0,0,0,0,2,1,1,TRUE,0.5,2023,2023-2024
TX,2023-11-30,inter-ucx,0,0,0,0,0,0,0,0,0,1,2,3,2,2,TRUE,0.666666666666667,2023,2023-2024
TX,2023-11-30,inter-ui,173,89,32,21,13,7,2,2,3,14,308,664,481,570,TRUE,0.724397590361446,2023,2023-2024
TX,2023-11-30,intra-total,6015,3890,1861,1058,582,369,219,162,139,698,12290,27283,18305,22195,TRUE,0.670930616134589,2023,2023-2024
TX,2023-11-30,intra-ucfe,9,9,7,7,3,1,0,0,0,4,17,57,26,35,TRUE,0.456140350877193,2023,2023-2024
TX,2023-11-30,intra-ucx,33,15,5,3,0,1,0,0,0,1,86,144,119,134,TRUE,0.826388888888889,2023,2023-2024
TX,2023-11-30,intra-ui,5973,3866,1849,1048,579,367,219,162,139,693,12187,27082,18160,22026,TRUE,0.670556088915147,2023,2023-2024
TX,2023-12-31,inter-total,183,85,38,17,13,3,3,5,3,10,282,642,465,550,TRUE,0.724299065420561,2023,2023-2024
TX,2023-12-31,inter-ucfe,0,1,1,0,0,0,0,0,0,0,0,2,0,1,TRUE,0,2023,2023-2024
TX,2023-12-31,inter-ucx,0,0,0,0,0,0,0,0,0,0,0,0,0,0,TRUE,0,2023,2023-2024
TX,2023-12-31,inter-ui,183,84,37,17,13,3,3,5,3,10,282,640,465,549,TRUE,0.7265625,2023,2023-2024
TX,2023-12-31,intra-total,6970,3501,1691,878,527,307,237,197,130,442,11040,25920,18010,21511,TRUE,0.69483024691358,2023,2023-2024
TX,2023-12-31,intra-ucfe,16,7,4,4,4,0,0,1,0,0,20,56,36,43,TRUE,0.642857142857143,2023,2023-2024
TX,2023-12-31,intra-ucx,50,17,10,1,3,2,1,0,0,0,71,155,121,138,TRUE,0.780645161290323,2023,2023-2024
TX,2023-12-31,intra-ui,6904,3477,1677,873,520,305,236,196,130,442,10949,25709,17853,21330,TRUE,0.694426076471275,2023,2023-2024
TX,2024-01-31,inter-total,186,105,50,36,15,6,3,2,4,15,314,736,500,605,TRUE,0.679347826086957,2023,2023-2024
TX,2024-01-31,inter-ucfe,1,2,0,0,0,0,0,0,0,0,2,5,3,5,TRUE,0.6,2023,2023-2024
TX,2024-01-31,inter-ucx,2,0,0,0,0,0,0,0,0,0,0,2,2,2,TRUE,1,2023,2023-2024
TX,2024-01-31,inter-ui,183,103,50,36,15,6,3,2,4,15,312,729,495,598,TRUE,0.679012345679012,2023,2023-2024
TX,2024-01-31,intra-total,7464,4521,2185,1056,542,282,183,145,107,518,14621,31624,22085,26606,TRUE,0.698362003541614,2023,2023-2024
TX,2024-01-31,intra-ucfe,16,9,4,2,2,4,0,1,0,0,17,55,33,42,TRUE,0.6,2023,2023-2024
TX,2024-01-31,intra-ucx,26,16,19,0,2,3,1,1,0,2,75,145,101,117,TRUE,0.696551724137931,2023,2023-2024
TX,2024-01-31,intra-ui,7422,4496,2162,1054,538,275,182,143,107,516,14529,31424,21951,26447,TRUE,0.698542515274949,2023,2023-2024
TX,2024-02-29,inter-total,177,66,30,10,7,5,3,1,4,14,253,570,430,496,TRUE,0.754385964912281,2023,2023-2024
TX,2024-02-29,inter-ucfe,0,1,0,1,0,0,0,0,0,1,0,3,0,1,TRUE,0,2023,2023-2024
TX,2024-02-29,inter-ucx,1,0,0,0,0,0,0,0,0,0,0,1,1,1,TRUE,1,2023,2023-2024
TX,2024-02-29,inter-ui,176,65,30,9,7,5,3,1,4,13,253,566,429,494,TRUE,0.757950530035336,2023,2023-2024
TX,2024-02-29,intra-total,7286,3840,1493,553,301,177,129,100,69,479,13086,27513,20372,24212,TRUE,0.740449969105514,2023,2023-2024
TX,2024-02-29,intra-ucfe,22,13,3,3,1,0,0,1,1,2,22,68,44,57,TRUE,0.647058823529412,2023,2023-2024
TX,2024-02-29,intra-ucx,37,15,4,1,1,1,1,1,0,2,89,152,126,141,TRUE,0.828947368421053,2023,2023-2024
TX,2024-02-29,intra-ui,7227,3812,1486,549,299,176,128,98,68,475,12975,27293,20202,24014,TRUE,0.740189792254424,2023,2023-2024
TX,2024-03-31,inter-total,159,48,35,11,9,6,5,4,2,15,207,501,366,414,TRUE,0.730538922155689,2023,2023-2024
TX,2024-03-31,inter-ucfe,0,0,0,1,0,0,0,0,0,1,1,3,1,1,TRUE,0.333333333333333,2023,2023-2024
TX,2024-03-31,inter-ucx,0,0,0,0,0,0,0,0,0,0,0,0,0,0,TRUE,0,2023,2023-2024
TX,2024-03-31,inter-ui,159,48,35,10,9,6,5,4,2,14,206,498,365,413,TRUE,0.732931726907631,2023,2023-2024
TX,2024-03-31,intra-total,7093,3642,1903,909,420,235,138,76,68,466,11648,26598,18741,22383,TRUE,0.70460184976314,2023,2023-2024
TX,2024-03-31,intra-ucfe,36,9,5,6,1,0,3,0,0,0,18,78,54,63,TRUE,0.692307692307692,2023,2023-2024
TX,2024-03-31,intra-ucx,51,10,4,1,0,1,1,0,0,3,92,163,143,153,TRUE,0.877300613496933,2023,2023-2024
TX,2024-03-31,intra-ui,7006,3623,1894,902,419,234,134,76,68,463,11538,26357,18544,22167,TRUE,0.703570209052624,2023,2023-2024
TX,2024-04-30,inter-total,188,76,27,14,10,7,1,1,1,15,243,583,431,507,TRUE,0.739279588336192,2023,2023-2024
TX,2024-04-30,inter-ucfe,0,0,0,0,0,0,0,0,0,0,1,1,1,1,TRUE,1,2023,2023-2024
TX,2024-04-30,inter-ucx,0,0,0,0,0,0,0,0,0,0,0,0,0,0,TRUE,0,2023,2023-2024
TX,2024-04-30,inter-ui,188,76,27,14,10,7,1,1,1,15,242,582,430,506,TRUE,0.738831615120275,2023,2023-2024
TX,2024-04-30,intra-total,7891,3826,1889,975,486,242,167,127,110,536,12571,28820,20462,24288,TRUE,0.70999306037474,2023,2023-2024
TX,2024-04-30,intra-ucfe,32,22,5,4,0,1,1,1,0,1,37,104,69,91,TRUE,0.663461538461538,2023,2023-2024
TX,2024-04-30,intra-ucx,52,8,6,4,1,0,0,1,1,1,103,177,155,163,TRUE,0.875706214689266,2023,2023-2024
TX,2024-04-30,intra-ui,7807,3796,1878,967,485,241,166,125,109,534,12431,28539,20238,24034,TRUE,0.709134868075265,2023,2023-2024
TX,2024-05-31,inter-total,210,65,26,20,5,5,6,2,1,15,245,600,455,520,TRUE,0.758333333333333,2023,2023-2024
TX,2024-05-31,inter-ucfe,0,0,0,0,0,0,0,0,0,0,1,1,1,1,TRUE,1,2023,2023-2024
TX,2024-05-31,inter-ucx,1,1,0,0,0,0,0,0,0,0,3,5,4,5,TRUE,0.8,2023,2023-2024
TX,2024-05-31,inter-ui,209,64,26,20,5,5,6,2,1,15,241,594,450,514,TRUE,0.757575757575758,2023,2023-2024
TX,2024-05-31,intra-total,8701,4003,1838,851,357,223,115,125,74,464,13635,30386,22336,26339,TRUE,0.735075363654315,2023,2023-2024
TX,2024-05-31,intra-ucfe,9,9,4,1,2,1,1,0,0,2,19,48,28,37,TRUE,0.583333333333333,2023,2023-2024
TX,2024-05-31,intra-ucx,62,22,6,0,1,1,0,2,0,2,100,196,162,184,TRUE,0.826530612244898,2023,2023-2024
TX,2024-05-31,intra-ui,8630,3972,1828,850,354,221,114,123,74,460,13516,30142,22146,26118,TRUE,0.734722314378608,2023,2023-2024
TX,2024-06-30,inter-total,166,62,33,15,9,5,3,5,2,7,217,524,383,445,TRUE,0.730916030534351,2023,2023-2024
TX,2024-06-30,inter-ucfe,1,0,0,1,0,0,0,0,0,0,0,2,1,1,TRUE,0.5,2023,2023-2024
TX,2024-06-30,inter-ucx,1,0,0,0,0,0,0,0,0,0,0,1,1,1,TRUE,1,2023,2023-2024
TX,2024-06-30,inter-ui,164,62,33,14,9,5,3,5,2,7,217,521,381,443,TRUE,0.731285988483685,2023,2023-2024
TX,2024-06-30,intra-total,8405,3756,1673,899,470,280,151,98,61,447,14060,30300,22465,26221,TRUE,0.741419141914192,2023,2023-2024
TX,2024-06-30,intra-ucfe,7,9,4,5,3,1,0,0,0,6,19,54,26,35,TRUE,0.481481481481482,2023,2023-2024
TX,2024-06-30,intra-ucx,53,15,7,0,2,2,0,1,0,1,93,174,146,161,TRUE,0.839080459770115,2023,2023-2024
TX,2024-06-30,intra-ui,8345,3732,1662,894,465,277,151,97,61,440,13948,30072,22293,26025,TRUE,0.741320830007981,2023,2023-2024
TX,2024-07-31,inter-total,179,64,29,14,8,5,3,3,3,12,284,604,463,527,TRUE,0.766556291390729,2024,2024-2025
TX,2024-07-31,inter-ucfe,1,1,1,0,0,0,0,0,0,0,1,4,2,3,TRUE,0.5,2024,2024-2025
TX,2024-07-31,inter-ucx,1,0,0,0,0,0,0,0,0,0,0,1,1,1,TRUE,1,2024,2024-2025
TX,2024-07-31,inter-ui,177,63,28,14,8,5,3,3,3,12,283,599,460,523,TRUE,0.767946577629382,2024,2024-2025
TX,2024-07-31,intra-total,7870,4308,2003,1037,669,395,324,256,173,582,14916,32533,22786,27094,TRUE,0.700396520456152,2024,2024-2025
TX,2024-07-31,intra-ucfe,13,18,10,4,2,1,2,1,0,6,17,74,30,48,TRUE,0.405405405405405,2024,2024-2025
TX,2024-07-31,intra-ucx,41,18,8,7,1,0,2,0,0,2,84,163,125,143,TRUE,0.766871165644172,2024,2024-2025
TX,2024-07-31,intra-ui,7816,4272,1985,1026,666,394,320,255,173,574,14815,32296,22631,26903,TRUE,0.700736933366361,2024,2024-2025
TX,2024-08-31,inter-total,168,57,39,29,8,5,6,4,4,8,235,563,403,460,TRUE,0.715808170515098,2024,2024-2025
TX,2024-08-31,inter-ucfe,2,0,0,0,1,0,0,0,1,0,2,6,4,4,TRUE,0.666666666666667,2024,2024-2025
TX,2024-08-31,inter-ucx,0,0,0,0,0,0,0,0,0,0,1,1,1,1,TRUE,1,2024,2024-2025
TX,2024-08-31,inter-ui,166,57,39,29,7,5,6,4,3,8,232,556,398,455,TRUE,0.715827338129496,2024,2024-2025
TX,2024-08-31,intra-total,7435,4907,2629,1466,865,277,196,160,127,693,13349,32104,20784,25691,TRUE,0.647395963119861,2024,2024-2025
TX,2024-08-31,intra-ucfe,21,26,14,3,4,2,1,1,0,2,21,95,42,68,TRUE,0.442105263157895,2024,2024-2025
TX,2024-08-31,intra-ucx,46,12,4,3,3,3,2,0,0,1,98,172,144,156,TRUE,0.837209302325582,2024,2024-2025
TX,2024-08-31,intra-ui,7368,4869,2611,1460,858,272,193,159,127,690,13230,31837,20598,25467,TRUE,0.646983070012878,2024,2024-2025
TX,2024-09-30,inter-total,116,58,32,24,7,8,6,1,8,11,190,461,306,364,TRUE,0.663774403470716,2024,2024-2025
TX,2024-09-30,inter-ucfe,0,0,0,0,0,0,0,0,0,0,1,1,1,1,TRUE,1,2024,2024-2025
TX,2024-09-30,inter-ucx,0,0,0,0,0,0,0,0,0,0,1,1,1,1,TRUE,1,2024,2024-2025
TX,2024-09-30,inter-ui,116,58,32,24,7,8,6,1,8,11,188,459,304,362,TRUE,0.662309368191721,2024,2024-2025
TX,2024-09-30,intra-total,5320,3101,1492,884,722,598,326,184,104,551,11045,24327,16365,19466,TRUE,0.67270933530645,2024,2024-2025
TX,2024-09-30,intra-ucfe,12,7,5,3,3,2,1,1,0,3,16,53,28,35,TRUE,0.528301886792453,2024,2024-2025
TX,2024-09-30,intra-ucx,34,14,8,1,1,4,1,1,0,2,91,157,125,139,TRUE,0.796178343949045,2024,2024-2025
TX,2024-09-30,intra-ui,5274,3080,1479,880,718,592,324,182,104,546,10938,24117,16212,19292,TRUE,0.672222913297674,2024,2024-2025
TX,2024-10-31,inter-total,145,66,33,25,19,10,7,6,3,9,197,520,342,408,TRUE,0.657692307692308,2024,2024-2025
TX,2024-10-31,inter-ucfe,1,0,0,0,0,0,0,0,0,0,2,3,3,3,TRUE,1,2024,2024-2025
TX,2024-10-31,inter-ucx,1,0,0,0,0,0,0,0,0,0,1,2,2,2,TRUE,1,2024,2024-2025
TX,2024-10-31,inter-ui,143,66,33,25,19,10,7,6,3,9,194,515,337,403,TRUE,0.654368932038835,2024,2024-2025
TX,2024-10-31,intra-total,7101,3429,1815,972,648,469,363,269,199,661,11614,27540,18715,22144,TRUE,0.679557007988381,2024,2024-2025
TX,2024-10-31,intra-ucfe,18,13,10,6,3,4,2,0,0,3,23,82,41,54,TRUE,0.5,2024,2024-2025
TX,2024-10-31,intra-ucx,45,18,7,2,1,3,0,1,1,3,106,187,151,169,TRUE,0.807486631016043,2024,2024-2025
TX,2024-10-31,intra-ui,7038,3398,1798,964,644,462,361,268,198,655,11485,27271,18523,21921,TRUE,0.679219683913315,2024,2024-2025
TX,2024-11-30,inter-total,147,65,22,28,12,5,2,4,1,12,180,478,327,392,TRUE,0.684100418410042,2024,2024-2025
TX,2024-11-30,inter-ucfe,1,0,0,0,0,0,0,0,0,0,0,1,1,1,TRUE,1,2024,2024-2025
TX,2024-11-30,inter-ucx,1,0,0,0,0,0,0,0,0,0,0,1,1,1,TRUE,1,2024,2024-2025
TX,2024-11-30,inter-ui,145,65,22,28,12,5,2,4,1,12,180,476,325,390,TRUE,0.682773109243698,2024,2024-2025
TX,2024-11-30,intra-total,6312,3248,1665,1067,669,417,292,245,161,501,10515,25092,16827,20075,TRUE,0.670612147297944,2024,2024-2025
TX,2024-11-30,intra-ucfe,11,9,4,2,1,1,0,0,0,2,16,46,27,36,TRUE,0.586956521739131,2024,2024-2025
TX,2024-11-30,intra-ucx,41,13,6,6,1,1,3,0,1,3,75,150,116,129,TRUE,0.773333333333333,2024,2024-2025
TX,2024-11-30,intra-ui,6260,3226,1655,1059,667,415,289,245,160,496,10424,24896,16684,19910,TRUE,0.670147814910026,2024,2024-2025
UT,2019-01-31,inter-total,53,4,4,3,0,0,0,0,0,0,15,79,68,72,FALSE,0.911392405063291,2018,2018-2019
UT,2019-01-31,inter-ucfe,4,0,1,0,0,0,0,0,0,0,1,6,5,5,FALSE,0.833333333333333,2018,2018-2019
UT,2019-01-31,inter-ucx,0,0,0,0,0,0,0,0,0,0,0,0,0,0,FALSE,0,2018,2018-2019
UT,2019-01-31,inter-ui,49,4,3,3,0,0,0,0,0,0,14,73,63,67,FALSE,0.917808219178082,2018,2018-2019
UT,2019-01-31,intra-total,3016,133,45,21,12,7,6,1,0,4,588,3833,3604,3737,FALSE,0.974954343855987,2018,2018-2019
UT,2019-01-31,intra-ucfe,36,2,1,0,0,2,0,0,0,0,10,51,46,48,FALSE,0.941176470588235,2018,2018-2019
UT,2019-01-31,intra-ucx,1,1,0,0,0,0,0,0,0,0,0,2,1,2,FALSE,1,2018,2018-2019
UT,2019-01-31,intra-ui,2979,130,44,21,12,5,6,1,0,4,578,3780,3557,3687,FALSE,0.975396825396825,2018,2018-2019
UT,2019-02-28,inter-total,38,3,2,1,2,1,0,0,0,1,8,56,46,49,FALSE,0.875,2018,2018-2019
UT,2019-02-28,inter-ucfe,1,1,0,0,0,0,0,0,0,1,0,3,1,2,FALSE,0.666666666666667,2018,2018-2019
UT,2019-02-28,inter-ucx,0,0,0,0,0,0,0,0,0,0,0,0,0,0,FALSE,0,2018,2018-2019
UT,2019-02-28,inter-ui,37,2,2,1,2,1,0,0,0,0,8,53,45,47,FALSE,0.886792452830189,2018,2018-2019
UT,2019-02-28,intra-total,1636,118,38,17,8,2,2,2,1,7,472,2303,2108,2226,FALSE,0.966565349544073,2018,2018-2019
UT,2019-02-28,intra-ucfe,23,5,3,2,1,0,0,0,0,0,8,42,31,36,FALSE,0.857142857142857,2018,2018-2019
UT,2019-02-28,intra-ucx,4,2,0,0,0,0,0,0,0,0,2,8,6,8,FALSE,1,2018,2018-2019
UT,2019-02-28,intra-ui,1609,111,35,15,7,2,2,2,1,7,462,2253,2071,2182,FALSE,0.968486462494452,2018,2018-2019
UT,2019-03-31,inter-total,28,3,0,1,2,1,1,0,0,0,13,49,41,44,FALSE,0.897959183673469,2018,2018-2019
UT,2019-03-31,inter-ucfe,1,0,0,0,0,0,0,0,0,0,0,1,1,1,FALSE,1,2018,2018-2019
UT,2019-03-31,inter-ucx,0,0,0,0,0,0,0,0,0,0,0,0,0,0,FALSE,0,2018,2018-2019
UT,2019-03-31,inter-ui,27,3,0,1,2,1,1,0,0,0,13,48,40,43,FALSE,0.895833333333333,2018,2018-2019
UT,2019-03-31,intra-total,1088,77,26,19,12,5,6,0,1,4,373,1611,1461,1538,FALSE,0.954686530105525,2018,2018-2019
UT,2019-03-31,intra-ucfe,10,0,0,0,0,1,0,0,0,1,2,14,12,12,FALSE,0.857142857142857,2018,2018-2019
UT,2019-03-31,intra-ucx,4,0,0,0,0,0,0,0,0,0,1,5,5,5,FALSE,1,2018,2018-2019
UT,2019-03-31,intra-ui,1074,77,26,19,12,4,6,0,1,3,370,1592,1444,1521,FALSE,0.955402010050251,2018,2018-2019
UT,2019-04-30,inter-total,27,1,4,0,0,0,1,0,0,0,8,41,35,36,FALSE,0.878048780487805,2018,2018-2019
UT,2019-04-30,inter-ucfe,0,0,1,0,0,0,0,0,0,0,0,1,0,0,FALSE,0,2018,2018-2019
UT,2019-04-30,inter-ucx,0,0,0,0,0,0,0,0,0,0,0,0,0,0,FALSE,0,2018,2018-2019
UT,2019-04-30,inter-ui,27,1,3,0,0,0,1,0,0,0,8,40,35,36,FALSE,0.9,2018,2018-2019
UT,2019-04-30,intra-total,1144,89,19,10,4,5,3,2,2,3,313,1594,1457,1546,FALSE,0.969887076537014,2018,2018-2019
UT,2019-04-30,intra-ucfe,4,1,0,0,0,1,0,1,0,0,2,9,6,7,FALSE,0.777777777777778,2018,2018-2019
UT,2019-04-30,intra-ucx,4,0,1,0,0,0,0,0,0,0,0,5,4,4,FALSE,0.8,2018,2018-2019
UT,2019-04-30,intra-ui,1136,88,18,10,4,4,3,1,2,3,311,1580,1447,1535,FALSE,0.971518987341772,2018,2018-2019
UT,2019-05-31,inter-total,30,7,1,0,0,1,0,1,0,0,14,54,44,51,FALSE,0.944444444444444,2018,2018-2019
UT,2019-05-31,inter-ucfe,0,0,0,0,0,0,0,0,0,0,0,0,0,0,FALSE,0,2018,2018-2019
UT,2019-05-31,inter-ucx,0,0,0,0,0,0,0,0,0,0,0,0,0,0,FALSE,0,2018,2018-2019
UT,2019-05-31,inter-ui,30,7,1,0,0,1,0,1,0,0,14,54,44,51,FALSE,0.944444444444444,2018,2018-2019
UT,2019-05-31,intra-total,955,98,30,13,8,3,2,2,1,5,334,1451,1289,1387,FALSE,0.955892487939352,2018,2018-2019
UT,2019-05-31,intra-ucfe,4,1,0,0,0,0,0,0,0,0,3,8,7,8,FALSE,1,2018,2018-2019
UT,2019-05-31,intra-ucx,0,0,0,0,0,0,0,1,0,0,0,1,0,0,FALSE,0,2018,2018-2019
UT,2019-05-31,intra-ui,951,97,30,13,8,3,2,1,1,5,331,1442,1282,1379,FALSE,0.956310679611651,2018,2018-2019
UT,2019-06-30,inter-total,37,3,2,1,3,0,1,0,1,1,7,56,44,47,FALSE,0.839285714285714,2018,2018-2019
UT,2019-06-30,inter-ucfe,1,0,0,0,0,0,0,0,0,0,0,1,1,1,FALSE,1,2018,2018-2019
UT,2019-06-30,inter-ucx,0,0,0,0,0,0,0,0,0,0,0,0,0,0,FALSE,0,2018,2018-2019
UT,2019-06-30,inter-ui,36,3,2,1,3,0,1,0,1,1,7,55,43,46,FALSE,0.836363636363636,2018,2018-2019
UT,2019-06-30,intra-total,954,79,19,15,8,4,2,3,1,2,339,1426,1293,1372,FALSE,0.962131837307153,2018,2018-2019
UT,2019-06-30,intra-ucfe,6,6,0,0,0,0,0,0,0,0,8,20,14,20,FALSE,1,2018,2018-2019
UT,2019-06-30,intra-ucx,1,0,0,0,0,0,0,0,0,0,0,1,1,1,FALSE,1,2018,2018-2019
UT,2019-06-30,intra-ui,947,73,19,15,8,4,2,3,1,2,331,1405,1278,1351,FALSE,0.961565836298932,2018,2018-2019
UT,2019-07-31,inter-total,38,4,2,0,1,0,1,0,0,0,6,52,44,48,FALSE,0.923076923076923,2019,2019-2020
UT,2019-07-31,inter-ucfe,0,0,0,0,0,0,0,0,0,0,0,0,0,0,FALSE,0,2019,2019-2020
UT,2019-07-31,inter-ucx,0,0,0,0,0,0,0,0,0,0,0,0,0,0,FALSE,0,2019,2019-2020
UT,2019-07-31,inter-ui,38,4,2,0,1,0,1,0,0,0,6,52,44,48,FALSE,0.923076923076923,2019,2019-2020
UT,2019-07-31,intra-total,1069,78,34,8,9,4,3,1,1,5,367,1579,1436,1514,FALSE,0.958834705509816,2019,2019-2020
UT,2019-07-31,intra-ucfe,30,1,3,0,1,0,0,0,0,0,2,37,32,33,FALSE,0.891891891891892,2019,2019-2020
UT,2019-07-31,intra-ucx,4,0,1,0,0,0,0,0,0,0,1,6,5,5,FALSE,0.833333333333333,2019,2019-2020
UT,2019-07-31,intra-ui,1035,77,30,8,8,4,3,1,1,5,364,1536,1399,1476,FALSE,0.9609375,2019,2019-2020
UT,2019-08-31,inter-total,34,3,2,1,1,0,0,0,0,1,16,58,50,53,FALSE,0.913793103448276,2019,2019-2020
UT,2019-08-31,inter-ucfe,0,0,0,0,0,0,0,0,0,0,0,0,0,0,FALSE,0,2019,2019-2020
UT,2019-08-31,inter-ucx,0,0,0,0,0,0,0,0,0,0,0,0,0,0,FALSE,0,2019,2019-2020
UT,2019-08-31,inter-ui,34,3,2,1,1,0,0,0,0,1,16,58,50,53,FALSE,0.913793103448276,2019,2019-2020
UT,2019-08-31,intra-total,783,73,23,11,5,1,2,0,1,6,303,1208,1086,1159,FALSE,0.959437086092715,2019,2019-2020
UT,2019-08-31,intra-ucfe,11,2,0,0,0,0,0,0,0,0,2,15,13,15,FALSE,1,2019,2019-2020
UT,2019-08-31,intra-ucx,2,0,0,0,0,0,0,0,0,0,0,2,2,2,FALSE,1,2019,2019-2020
UT,2019-08-31,intra-ui,770,71,23,11,5,1,2,0,1,6,301,1191,1071,1142,FALSE,0.958858102434929,2019,2019-2020
UT,2019-09-30,inter-total,27,5,1,1,0,1,0,0,0,0,13,48,40,45,FALSE,0.9375,2019,2019-2020
UT,2019-09-30,inter-ucfe,0,0,0,0,0,0,0,0,0,0,0,0,0,0,FALSE,0,2019,2019-2020
UT,2019-09-30,inter-ucx,0,0,0,0,0,0,0,0,0,0,0,0,0,0,FALSE,0,2019,2019-2020
UT,2019-09-30,inter-ui,27,5,1,1,0,1,0,0,0,0,13,48,40,45,FALSE,0.9375,2019,2019-2020
UT,2019-09-30,intra-total,794,79,29,13,5,1,1,1,0,5,308,1236,1102,1181,FALSE,0.955501618122977,2019,2019-2020
UT,2019-09-30,intra-ucfe,6,0,1,1,1,0,0,0,0,0,4,13,10,10,FALSE,0.769230769230769,2019,2019-2020
UT,2019-09-30,intra-ucx,2,0,0,0,0,0,0,0,0,0,1,3,3,3,FALSE,1,2019,2019-2020
UT,2019-09-30,intra-ui,786,79,28,12,4,1,1,1,0,5,303,1220,1089,1168,FALSE,0.957377049180328,2019,2019-2020
UT,2019-10-31,inter-total,32,8,1,1,0,0,0,0,0,0,12,54,44,52,FALSE,0.962962962962963,2019,2019-2020
UT,2019-10-31,inter-ucfe,0,0,1,0,0,0,0,0,0,0,0,1,0,0,FALSE,0,2019,2019-2020
UT,2019-10-31,inter-ucx,0,0,0,0,0,0,0,0,0,0,0,0,0,0,FALSE,0,2019,2019-2020
UT,2019-10-31,inter-ui,32,8,0,1,0,0,0,0,0,0,12,53,44,52,FALSE,0.981132075471698,2019,2019-2020
UT,2019-10-31,intra-total,940,71,24,13,3,6,1,0,1,1,280,1340,1220,1291,FALSE,0.963432835820896,2019,2019-2020
UT,2019-10-31,intra-ucfe,6,0,0,0,1,0,0,0,0,0,2,9,8,8,FALSE,0.888888888888889,2019,2019-2020
UT,2019-10-31,intra-ucx,3,1,0,0,0,0,0,0,0,0,0,4,3,4,FALSE,1,2019,2019-2020
UT,2019-10-31,intra-ui,931,70,24,13,2,6,1,0,1,1,278,1327,1209,1279,FALSE,0.963828183873399,2019,2019-2020
UT,2019-11-30,inter-total,44,8,1,0,0,0,1,0,1,0,20,75,64,72,FALSE,0.96,2019,2019-2020
UT,2019-11-30,inter-ucfe,3,0,0,0,0,0,0,0,0,0,5,8,8,8,FALSE,1,2019,2019-2020
UT,2019-11-30,inter-ucx,0,0,0,0,0,0,0,0,0,0,0,0,0,0,FALSE,0,2019,2019-2020
UT,2019-11-30,inter-ui,41,8,1,0,0,0,1,0,1,0,15,67,56,64,FALSE,0.955223880597015,2019,2019-2020
UT,2019-11-30,intra-total,1442,77,27,13,4,2,1,0,2,8,324,1900,1766,1843,FALSE,0.97,2019,2019-2020
UT,2019-11-30,intra-ucfe,23,2,1,0,0,0,0,0,0,0,4,30,27,29,FALSE,0.966666666666667,2019,2019-2020
UT,2019-11-30,intra-ucx,4,0,0,0,0,0,0,0,0,0,2,6,6,6,FALSE,1,2019,2019-2020
UT,2019-11-30,intra-ui,1415,75,26,13,4,2,1,0,2,8,318,1864,1733,1808,FALSE,0.969957081545064,2019,2019-2020
UT,2019-12-31,inter-total,71,4,5,2,1,2,0,0,0,0,22,107,93,97,FALSE,0.906542056074766,2019,2019-2020
UT,2019-12-31,inter-ucfe,4,0,1,0,0,1,0,0,0,0,6,12,10,10,FALSE,0.833333333333333,2019,2019-2020
UT,2019-12-31,inter-ucx,0,0,0,0,0,0,0,0,0,0,0,0,0,0,FALSE,0,2019,2019-2020
UT,2019-12-31,inter-ui,67,4,4,2,1,1,0,0,0,0,16,95,83,87,FALSE,0.91578947368421,2019,2019-2020
UT,2019-12-31,intra-total,3103,102,27,18,9,2,2,1,2,1,520,3787,3623,3725,FALSE,0.983628201742804,2019,2019-2020
UT,2019-12-31,intra-ucfe,69,3,0,1,0,0,0,0,0,0,15,88,84,87,FALSE,0.988636363636364,2019,2019-2020
UT,2019-12-31,intra-ucx,5,2,0,0,0,0,0,0,0,0,0,7,5,7,FALSE,1,2019,2019-2020
UT,2019-12-31,intra-ui,3029,97,27,17,9,2,2,1,2,1,505,3692,3534,3631,FALSE,0.983477789815818,2019,2019-2020
UT,2020-01-31,inter-total,76,4,4,3,0,0,0,0,2,0,19,108,95,99,FALSE,0.916666666666667,2019,2019-2020
UT,2020-01-31,inter-ucfe,5,0,0,0,0,0,0,0,0,0,2,7,7,7,FALSE,1,2019,2019-2020
UT,2020-01-31,inter-ucx,0,0,0,0,0,0,0,0,0,0,0,0,0,0,FALSE,0,2019,2019-2020
UT,2020-01-31,inter-ui,71,4,4,3,0,0,0,0,2,0,17,101,88,92,FALSE,0.910891089108911,2019,2019-2020
UT,2020-01-31,intra-total,3169,98,36,16,7,5,4,1,1,1,586,3924,3755,3853,FALSE,0.98190621814475,2019,2019-2020
UT,2020-01-31,intra-ucfe,104,3,3,2,0,0,0,0,0,1,19,132,123,126,FALSE,0.954545454545455,2019,2019-2020
UT,2020-01-31,intra-ucx,3,0,0,0,0,0,0,0,0,0,0,3,3,3,FALSE,1,2019,2019-2020
UT,2020-01-31,intra-ui,3062,95,33,14,7,5,4,1,1,0,567,3789,3629,3724,FALSE,0.982845077856954,2019,2019-2020
UT,2020-02-29,inter-total,49,6,4,1,2,1,1,0,0,0,24,88,73,79,FALSE,0.897727272727273,2019,2019-2020
UT,2020-02-29,inter-ucfe,0,0,0,0,0,0,0,0,0,0,4,4,4,4,FALSE,1,2019,2019-2020
UT,2020-02-29,inter-ucx,0,0,0,0,0,0,0,0,0,0,0,0,0,0,FALSE,0,2019,2019-2020
UT,2020-02-29,inter-ui,49,6,4,1,2,1,1,0,0,0,20,84,69,75,FALSE,0.892857142857143,2019,2019-2020
UT,2020-02-29,intra-total,1536,124,43,13,8,6,2,5,0,8,470,2215,2006,2130,FALSE,0.961625282167043,2019,2019-2020
UT,2020-02-29,intra-ucfe,37,3,1,2,0,0,0,0,0,0,8,51,45,48,FALSE,0.941176470588235,2019,2019-2020
UT,2020-02-29,intra-ucx,1,0,0,0,0,0,0,0,0,0,0,1,1,1,FALSE,1,2019,2019-2020
UT,2020-02-29,intra-ui,1498,121,42,11,8,6,2,5,0,8,462,2163,1960,2081,FALSE,0.96208969024503,2019,2019-2020
UT,2020-03-31,inter-total,70,3,1,1,0,1,0,1,0,0,11,88,81,84,FALSE,0.954545454545455,2019,2019-2020
UT,2020-03-31,inter-ucfe,0,0,0,0,0,0,0,0,0,0,0,0,0,0,FALSE,0,2019,2019-2020
UT,2020-03-31,inter-ucx,0,0,0,0,0,0,0,0,0,0,0,0,0,0,FALSE,0,2019,2019-2020
UT,2020-03-31,inter-ui,70,3,1,1,0,1,0,1,0,0,11,88,81,84,FALSE,0.954545454545455,2019,2019-2020
UT,2020-03-31,intra-total,5945,121,33,12,10,2,1,3,1,2,449,6579,6394,6515,FALSE,0.990272077823377,2019,2019-2020
UT,2020-03-31,intra-ucfe,13,1,0,0,1,0,0,0,0,0,7,22,20,21,FALSE,0.954545454545455,2019,2019-2020
UT,2020-03-31,intra-ucx,5,0,0,0,0,0,0,0,0,0,0,5,5,5,FALSE,1,2019,2019-2020
UT,2020-03-31,intra-ui,5927,120,33,12,9,2,1,3,1,2,442,6552,6369,6489,FALSE,0.990384615384615,2019,2019-2020
UT,2020-04-30,inter-total,490,54,28,4,0,0,0,0,0,1,140,717,630,684,FALSE,0.95397489539749,2019,2019-2020
UT,2020-04-30,inter-ucfe,1,0,1,0,0,0,0,0,0,1,1,4,2,2,FALSE,0.5,2019,2019-2020
UT,2020-04-30,inter-ucx,0,0,0,0,0,0,0,0,0,0,0,0,0,0,FALSE,0,2019,2019-2020
UT,2020-04-30,inter-ui,489,54,27,4,0,0,0,0,0,0,139,713,628,682,FALSE,0.956521739130435,2019,2019-2020
UT,2020-04-30,intra-total,45791,3039,768,139,7,8,2,0,2,7,9855,59618,55646,58685,FALSE,0.984350363984032,2019,2019-2020
UT,2020-04-30,intra-ucfe,18,3,2,0,0,0,0,0,0,0,4,27,22,25,FALSE,0.925925925925926,2019,2019-2020
UT,2020-04-30,intra-ucx,0,5,4,0,0,0,0,0,0,0,5,14,5,10,FALSE,0.714285714285714,2019,2019-2020
UT,2020-04-30,intra-ui,45773,3031,762,139,7,8,2,0,2,7,9846,59577,55619,58650,FALSE,0.984440304144217,2019,2019-2020
UT,2020-05-31,inter-total,282,79,72,40,17,8,3,1,0,0,97,599,379,458,FALSE,0.764607679465776,2019,2019-2020
UT,2020-05-31,inter-ucfe,0,0,0,0,0,0,0,0,0,0,0,0,0,0,FALSE,0,2019,2019-2020
UT,2020-05-31,inter-ucx,0,0,0,0,0,0,0,0,0,0,0,0,0,0,FALSE,0,2019,2019-2020
UT,2020-05-31,inter-ui,282,79,72,40,17,8,3,1,0,0,97,599,379,458,FALSE,0.764607679465776,2019,2019-2020
UT,2020-05-31,intra-total,15304,3240,2353,1158,507,185,72,19,2,4,4840,27684,20144,23384,FALSE,0.844675624909695,2019,2019-2020
UT,2020-05-31,intra-ucfe,1,7,2,4,0,1,0,0,0,0,3,18,4,11,FALSE,0.611111111111111,2019,2019-2020
UT,2020-05-31,intra-ucx,1,3,1,3,0,0,0,0,0,0,4,12,5,8,FALSE,0.666666666666667,2019,2019-2020
UT,2020-05-31,intra-ui,15302,3230,2350,1151,507,184,72,19,2,4,4833,27654,20135,23365,FALSE,0.844904896217545,2019,2019-2020
UT,2020-06-30,inter-total,110,33,21,22,25,18,17,20,6,19,50,341,160,193,FALSE,0.565982404692082,2019,2019-2020
UT,2020-06-30,inter-ucfe,0,0,0,0,0,0,0,0,0,0,0,0,0,0,FALSE,0,2019,2019-2020
UT,2020-06-30,inter-ucx,0,0,0,0,0,0,0,0,0,0,0,0,0,0,FALSE,0,2019,2019-2020
UT,2020-06-30,inter-ui,110,33,21,22,25,18,17,20,6,19,50,341,160,193,FALSE,0.565982404692082,2019,2019-2020
UT,2020-06-30,intra-total,6480,988,650,783,551,455,393,219,167,153,1902,12741,8382,9370,FALSE,0.735421081547759,2019,2019-2020
UT,2020-06-30,intra-ucfe,0,0,0,0,2,3,0,0,0,0,1,6,1,1,FALSE,0.166666666666667,2019,2019-2020
UT,2020-06-30,intra-ucx,0,1,3,1,0,1,1,0,0,0,3,10,3,4,FALSE,0.4,2019,2019-2020
UT,2020-06-30,intra-ui,6480,987,647,782,549,451,392,219,167,153,1898,12725,8378,9365,FALSE,0.735952848722986,2019,2019-2020
UT,2020-07-31,inter-total,88,22,12,15,15,9,6,8,5,48,30,258,118,140,FALSE,0.542635658914729,2020,2020-2021
UT,2020-07-31,inter-ucfe,2,0,0,0,1,0,0,1,0,0,0,4,2,2,FALSE,0.5,2020,2020-2021
UT,2020-07-31,inter-ucx,1,0,0,0,0,0,0,0,0,0,0,1,1,1,FALSE,1,2020,2020-2021
UT,2020-07-31,inter-ui,85,22,12,15,14,9,6,7,5,48,30,253,115,137,FALSE,0.541501976284585,2020,2020-2021
UT,2020-07-31,intra-total,3836,660,374,260,225,193,97,86,77,474,1149,7431,4985,5645,FALSE,0.759655497241286,2020,2020-2021
UT,2020-07-31,intra-ucfe,0,2,0,2,2,1,1,1,2,2,2,15,2,4,FALSE,0.266666666666667,2020,2020-2021
UT,2020-07-31,intra-ucx,2,1,0,0,0,0,1,0,0,0,2,6,4,5,FALSE,0.833333333333333,2020,2020-2021
UT,2020-07-31,intra-ui,3834,657,374,258,223,192,95,85,75,472,1145,7410,4979,5636,FALSE,0.76059379217274,2020,2020-2021
UT,2020-08-31,inter-total,47,9,9,6,11,8,5,3,2,31,19,150,66,75,FALSE,0.5,2020,2020-2021
UT,2020-08-31,inter-ucfe,0,0,0,0,0,0,0,0,0,0,0,0,0,0,FALSE,0,2020,2020-2021
UT,2020-08-31,inter-ucx,0,0,0,0,0,0,0,0,0,0,0,0,0,0,FALSE,0,2020,2020-2021
UT,2020-08-31,inter-ui,47,9,9,6,11,8,5,3,2,31,19,150,66,75,FALSE,0.5,2020,2020-2021
UT,2020-08-31,intra-total,1530,367,232,211,253,211,183,125,61,413,564,4150,2094,2461,FALSE,0.593012048192771,2020,2020-2021
UT,2020-08-31,intra-ucfe,0,2,1,0,0,3,0,1,0,1,1,9,1,3,FALSE,0.333333333333333,2020,2020-2021
UT,2020-08-31,intra-ucx,1,0,1,0,0,0,0,0,0,1,0,3,1,1,FALSE,0.333333333333333,2020,2020-2021
UT,2020-08-31,intra-ui,1529,365,230,211,253,208,183,124,61,411,563,4138,2092,2457,FALSE,0.593765103914935,2020,2020-2021
UT,2020-09-30,inter-total,15,7,4,5,4,5,8,7,4,31,9,99,24,31,FALSE,0.313131313131313,2020,2020-2021
UT,2020-09-30,inter-ucfe,0,0,0,0,0,0,0,0,0,0,0,0,0,0,FALSE,0,2020,2020-2021
UT,2020-09-30,inter-ucx,0,0,0,0,0,0,0,0,0,0,0,0,0,0,FALSE,0,2020,2020-2021
UT,2020-09-30,inter-ui,15,7,4,5,4,5,8,7,4,31,9,99,24,31,FALSE,0.313131313131313,2020,2020-2021
UT,2020-09-30,intra-total,743,204,110,85,110,110,153,185,165,390,331,2586,1074,1278,FALSE,0.494199535962877,2020,2020-2021
UT,2020-09-30,intra-ucfe,0,0,1,0,0,0,0,1,0,2,0,4,0,0,FALSE,0,2020,2020-2021
UT,2020-09-30,intra-ucx,2,0,1,1,0,0,1,0,0,0,2,7,4,4,FALSE,0.571428571428571,2020,2020-2021
UT,2020-09-30,intra-ui,741,204,108,84,110,110,152,184,165,388,329,2575,1070,1274,FALSE,0.494757281553398,2020,2020-2021
UT,2020-10-31,inter-total,21,3,3,2,1,5,2,10,6,32,14,99,35,38,FALSE,0.383838383838384,2020,2020-2021
UT,2020-10-31,inter-ucfe,0,0,0,0,0,0,0,0,1,0,1,2,1,1,FALSE,0.5,2020,2020-2021
UT,2020-10-31,inter-ucx,0,0,0,0,0,0,0,0,0,0,0,0,0,0,FALSE,0,2020,2020-2021
UT,2020-10-31,inter-ui,21,3,3,2,1,5,2,10,5,32,13,97,34,37,FALSE,0.381443298969072,2020,2020-2021
UT,2020-10-31,intra-total,689,198,119,95,128,161,187,159,146,406,358,2646,1047,1245,FALSE,0.470521541950113,2020,2020-2021
UT,2020-10-31,intra-ucfe,1,0,0,2,0,1,2,1,0,6,3,16,4,4,FALSE,0.25,2020,2020-2021
UT,2020-10-31,intra-ucx,3,0,0,0,0,0,0,0,0,3,0,6,3,3,FALSE,0.5,2020,2020-2021
UT,2020-10-31,intra-ui,685,198,119,93,128,160,185,158,146,397,355,2624,1040,1238,FALSE,0.471798780487805,2020,2020-2021
UT,2020-11-30,inter-total,26,10,3,7,5,6,1,1,0,18,15,92,41,51,FALSE,0.554347826086957,2020,2020-2021
UT,2020-11-30,inter-ucfe,0,0,0,0,0,0,0,0,0,0,1,1,1,1,FALSE,1,2020,2020-2021
UT,2020-11-30,inter-ucx,0,0,0,0,0,0,0,0,0,0,0,0,0,0,FALSE,0,2020,2020-2021
UT,2020-11-30,inter-ui,26,10,3,7,5,6,1,1,0,18,14,91,40,50,FALSE,0.54945054945055,2020,2020-2021
UT,2020-11-30,intra-total,1175,216,116,96,98,127,130,101,49,213,415,2736,1590,1806,FALSE,0.660087719298246,2020,2020-2021
UT,2020-11-30,intra-ucfe,16,2,2,2,0,2,1,2,1,8,8,44,24,26,FALSE,0.590909090909091,2020,2020-2021
UT,2020-11-30,intra-ucx,2,0,0,0,0,0,0,1,0,1,0,4,2,2,FALSE,0.5,2020,2020-2021
UT,2020-11-30,intra-ui,1157,214,114,94,98,125,129,98,48,204,407,2688,1564,1778,FALSE,0.661458333333333,2020,2020-2021
UT,2020-12-31,inter-total,23,6,5,7,3,7,6,3,4,14,30,108,53,59,FALSE,0.546296296296296,2020,2020-2021
UT,2020-12-31,inter-ucfe,1,0,1,2,0,2,0,0,0,2,9,17,10,10,FALSE,0.588235294117647,2020,2020-2021
UT,2020-12-31,inter-ucx,0,0,0,0,0,0,0,0,0,0,0,0,0,0,FALSE,0,2020,2020-2021
UT,2020-12-31,inter-ui,22,6,4,5,3,5,6,3,4,12,21,91,43,49,FALSE,0.538461538461538,2020,2020-2021
UT,2020-12-31,intra-total,2310,302,149,155,148,137,99,51,44,122,753,4270,3063,3365,FALSE,0.788056206088993,2020,2020-2021
UT,2020-12-31,intra-ucfe,23,11,4,3,1,1,1,0,1,9,37,91,60,71,FALSE,0.78021978021978,2020,2020-2021
UT,2020-12-31,intra-ucx,2,0,0,0,1,0,0,0,0,0,0,3,2,2,FALSE,0.666666666666667,2020,2020-2021
UT,2020-12-31,intra-ui,2285,291,145,152,146,136,98,51,43,113,716,4176,3001,3292,FALSE,0.788314176245211,2020,2020-2021
UT,2021-01-31,inter-total,26,5,3,6,4,9,6,2,6,18,24,109,50,55,FALSE,0.504587155963303,2020,2020-2021
UT,2021-01-31,inter-ucfe,1,1,1,0,0,0,1,0,0,0,4,8,5,6,FALSE,0.75,2020,2020-2021
UT,2021-01-31,inter-ucx,0,0,0,0,0,0,0,0,0,0,0,0,0,0,FALSE,0,2020,2020-2021
UT,2021-01-31,inter-ui,25,4,2,6,4,9,5,2,6,18,20,101,45,49,FALSE,0.485148514851485,2020,2020-2021
UT,2021-01-31,intra-total,2023,382,159,122,106,133,146,122,62,143,1019,4417,3042,3424,FALSE,0.775186778356351,2020,2020-2021
UT,2021-01-31,intra-ucfe,33,9,3,2,5,2,2,2,3,5,55,121,88,97,FALSE,0.801652892561983,2020,2020-2021
UT,2021-01-31,intra-ucx,4,0,0,0,0,0,0,0,1,1,1,7,5,5,FALSE,0.714285714285714,2020,2020-2021
UT,2021-01-31,intra-ui,1986,373,156,120,101,131,144,120,58,137,963,4289,2949,3322,FALSE,0.774539519701562,2020,2020-2021
UT,2021-02-28,inter-total,25,14,7,5,2,5,4,1,2,17,21,103,46,60,FALSE,0.58252427184466,2020,2020-2021
UT,2021-02-28,inter-ucfe,1,1,0,1,0,0,0,0,0,0,0,3,1,2,FALSE,0.666666666666667,2020,2020-2021
UT,2021-02-28,inter-ucx,0,0,0,0,0,0,0,0,0,0,0,0,0,0,FALSE,0,2020,2020-2021
UT,2021-02-28,inter-ui,24,13,7,4,2,5,4,1,2,17,21,100,45,58,FALSE,0.58,2020,2020-2021
UT,2021-02-28,intra-total,1099,286,200,154,185,153,100,88,42,133,571,3011,1670,1956,FALSE,0.649618067087346,2020,2020-2021
UT,2021-02-28,intra-ucfe,5,6,2,6,4,1,2,2,2,9,18,57,23,29,FALSE,0.508771929824562,2020,2020-2021
UT,2021-02-28,intra-ucx,4,0,0,0,0,1,0,0,0,0,1,6,5,5,FALSE,0.833333333333333,2020,2020-2021
UT,2021-02-28,intra-ui,1090,280,198,148,181,151,98,86,40,124,552,2948,1642,1922,FALSE,0.651967435549525,2020,2020-2021
UT,2021-03-31,inter-total,30,11,5,2,8,2,3,4,3,13,12,93,42,53,FALSE,0.56989247311828,2020,2020-2021
UT,2021-03-31,inter-ucfe,0,0,0,1,0,0,0,0,0,2,0,3,0,0,FALSE,0,2020,2020-2021
UT,2021-03-31,inter-ucx,0,0,0,0,1,0,0,0,0,0,0,1,0,0,FALSE,0,2020,2020-2021
UT,2021-03-31,inter-ui,30,11,5,1,7,2,3,4,3,11,12,89,42,53,FALSE,0.595505617977528,2020,2020-2021
UT,2021-03-31,intra-total,1128,334,166,107,137,160,120,82,56,120,542,2952,1670,2004,FALSE,0.678861788617886,2020,2020-2021
UT,2021-03-31,intra-ucfe,6,1,3,1,1,2,2,1,1,5,8,31,14,15,FALSE,0.483870967741936,2020,2020-2021
UT,2021-03-31,intra-ucx,1,1,0,0,0,1,0,0,0,0,1,4,2,3,FALSE,0.75,2020,2020-2021
UT,2021-03-31,intra-ui,1121,332,163,106,136,157,118,81,55,115,533,2917,1654,1986,FALSE,0.680836475831334,2020,2020-2021
UT,2021-04-30,inter-total,32,14,4,2,1,1,3,7,1,10,31,106,63,77,FALSE,0.726415094339623,2020,2020-2021
UT,2021-04-30,inter-ucfe,1,1,0,0,0,0,0,0,0,0,0,2,1,2,FALSE,1,2020,2020-2021
UT,2021-04-30,inter-ucx,0,0,0,0,0,0,0,0,0,0,0,0,0,0,FALSE,0,2020,2020-2021
UT,2021-04-30,inter-ui,31,13,4,2,1,1,3,7,1,10,31,104,62,75,FALSE,0.721153846153846,2020,2020-2021
UT,2021-04-30,intra-total,1350,298,173,80,79,70,50,33,26,124,903,3186,2253,2551,FALSE,0.800690521029504,2020,2020-2021
UT,2021-04-30,intra-ucfe,1,2,1,0,2,0,0,0,0,3,10,19,11,13,FALSE,0.68421052631579,2020,2020-2021
UT,2021-04-30,intra-ucx,1,0,0,1,0,0,0,0,0,0,1,3,2,2,FALSE,0.666666666666667,2020,2020-2021
UT,2021-04-30,intra-ui,1348,296,172,79,77,70,50,33,26,121,892,3164,2240,2536,FALSE,0.801517067003793,2020,2020-2021
UT,2021-05-31,inter-total,34,10,3,1,5,3,2,2,0,10,11,81,45,55,FALSE,0.679012345679012,2020,2020-2021
UT,2021-05-31,inter-ucfe,0,0,0,0,0,1,0,0,0,0,0,1,0,0,FALSE,0,2020,2020-2021
UT,2021-05-31,inter-ucx,0,0,0,0,0,0,0,0,0,0,0,0,0,0,FALSE,0,2020,2020-2021
UT,2021-05-31,inter-ui,34,10,3,1,5,2,2,2,0,10,11,80,45,55,FALSE,0.6875,2020,2020-2021
UT,2021-05-31,intra-total,1014,357,226,146,104,54,40,35,18,94,608,2696,1622,1979,FALSE,0.734050445103858,2020,2020-2021
UT,2021-05-31,intra-ucfe,0,5,2,1,1,1,0,0,0,4,1,15,1,6,FALSE,0.4,2020,2020-2021
UT,2021-05-31,intra-ucx,2,1,0,0,1,0,0,0,0,1,1,6,3,4,FALSE,0.666666666666667,2020,2020-2021
UT,2021-05-31,intra-ui,1012,351,224,145,102,53,40,35,18,89,606,2675,1618,1969,FALSE,0.73607476635514,2020,2020-2021
UT,2021-06-30,inter-total,15,7,7,5,2,10,2,4,0,5,10,67,25,32,FALSE,0.477611940298507,2020,2020-2021
UT,2021-06-30,inter-ucfe,0,0,0,0,0,0,0,0,0,0,0,0,0,0,FALSE,0,2020,2020-2021
UT,2021-06-30,inter-ucx,0,0,0,0,0,0,0,0,0,0,0,0,0,0,FALSE,0,2020,2020-2021
UT,2021-06-30,inter-ui,15,7,7,5,2,10,2,4,0,5,10,67,25,32,FALSE,0.477611940298507,2020,2020-2021
UT,2021-06-30,intra-total,729,277,189,115,111,83,62,37,32,116,508,2259,1237,1514,FALSE,0.67020805666224,2020,2020-2021
UT,2021-06-30,intra-ucfe,1,5,1,0,1,0,2,1,1,3,3,18,4,9,FALSE,0.5,2020,2020-2021
UT,2021-06-30,intra-ucx,0,0,2,0,0,0,0,0,0,0,1,3,1,1,FALSE,0.333333333333333,2020,2020-2021
UT,2021-06-30,intra-ui,728,272,186,115,110,83,60,36,31,113,504,2238,1232,1504,FALSE,0.672028596961573,2020,2020-2021
UT,2021-07-31,inter-total,27,8,3,1,4,1,1,1,3,10,17,76,44,52,FALSE,0.68421052631579,2021,2021-2022
UT,2021-07-31,inter-ucfe,0,0,0,0,0,0,0,0,0,0,0,0,0,0,FALSE,0,2021,2021-2022
UT,2021-07-31,inter-ucx,0,0,0,0,0,0,0,0,0,0,0,0,0,0,FALSE,0,2021,2021-2022
UT,2021-07-31,inter-ui,27,8,3,1,4,1,1,1,3,10,17,76,44,52,FALSE,0.68421052631579,2021,2021-2022
UT,2021-07-31,intra-total,1143,262,128,88,70,67,69,40,28,158,426,2479,1569,1831,FALSE,0.738604275917709,2021,2021-2022
UT,2021-07-31,intra-ucfe,4,1,1,0,0,0,0,0,0,1,1,8,5,6,FALSE,0.75,2021,2021-2022
UT,2021-07-31,intra-ucx,1,1,1,0,0,0,0,0,0,1,0,4,1,2,FALSE,0.5,2021,2021-2022
UT,2021-07-31,intra-ui,1138,260,126,88,70,67,69,40,28,156,425,2467,1563,1823,FALSE,0.738954195379003,2021,2021-2022
UT,2021-08-31,inter-total,15,11,5,4,7,5,3,2,2,4,8,66,23,34,FALSE,0.515151515151515,2021,2021-2022
UT,2021-08-31,inter-ucfe,0,0,0,0,0,0,0,0,0,0,0,0,0,0,FALSE,0,2021,2021-2022
UT,2021-08-31,inter-ucx,0,0,0,0,0,0,0,0,0,0,0,0,0,0,FALSE,0,2021,2021-2022
UT,2021-08-31,inter-ui,15,11,5,4,7,5,3,2,2,4,8,66,23,34,FALSE,0.515151515151515,2021,2021-2022
UT,2021-08-31,intra-total,675,268,180,134,130,92,57,31,25,104,330,2026,1005,1273,FALSE,0.628331688055281,2021,2021-2022
UT,2021-08-31,intra-ucfe,1,0,0,1,2,1,0,2,0,2,2,11,3,3,FALSE,0.272727272727273,2021,2021-2022
UT,2021-08-31,intra-ucx,4,1,0,0,0,0,0,0,0,0,0,5,4,5,FALSE,1,2021,2021-2022
UT,2021-08-31,intra-ui,670,267,180,133,128,91,57,29,25,102,328,2010,998,1265,FALSE,0.629353233830846,2021,2021-2022
UT,2021-09-30,inter-total,17,6,5,8,3,0,1,0,0,10,8,58,25,31,FALSE,0.53448275862069,2021,2021-2022
UT,2021-09-30,inter-ucfe,0,0,1,1,0,0,0,0,0,0,0,2,0,0,FALSE,0,2021,2021-2022
UT,2021-09-30,inter-ucx,0,0,0,0,0,0,0,0,0,0,0,0,0,0,FALSE,0,2021,2021-2022
UT,2021-09-30,inter-ui,17,6,4,7,3,0,1,0,0,10,8,56,25,31,FALSE,0.553571428571429,2021,2021-2022
UT,2021-09-30,intra-total,399,227,210,120,71,41,33,18,7,55,241,1422,640,867,FALSE,0.609704641350211,2021,2021-2022
UT,2021-09-30,intra-ucfe,0,1,0,0,1,1,0,0,0,0,0,3,0,1,FALSE,0.333333333333333,2021,2021-2022
UT,2021-09-30,intra-ucx,2,0,0,0,0,0,0,0,0,0,0,2,2,2,FALSE,1,2021,2021-2022
UT,2021-09-30,intra-ui,397,226,210,120,70,40,33,18,7,55,241,1417,638,864,FALSE,0.609738884968243,2021,2021-2022
UT,2021-10-31,inter-total,18,7,3,3,2,0,2,0,0,6,6,47,24,31,FALSE,0.659574468085106,2021,2021-2022
UT,2021-10-31,inter-ucfe,1,1,0,0,0,0,0,0,0,0,0,2,1,2,FALSE,1,2021,2021-2022
UT,2021-10-31,inter-ucx,0,0,0,0,0,0,0,0,0,0,0,0,0,0,FALSE,0,2021,2021-2022
UT,2021-10-31,inter-ui,17,6,3,3,2,0,2,0,0,6,6,45,23,29,FALSE,0.644444444444445,2021,2021-2022
UT,2021-10-31,intra-total,591,155,54,39,20,12,11,8,6,33,298,1227,889,1044,FALSE,0.850855745721271,2021,2021-2022
UT,2021-10-31,intra-ucfe,6,3,1,1,1,0,1,1,0,0,5,19,11,14,FALSE,0.736842105263158,2021,2021-2022
UT,2021-10-31,intra-ucx,2,1,0,0,0,0,0,0,0,0,2,5,4,5,FALSE,1,2021,2021-2022
UT,2021-10-31,intra-ui,583,151,53,38,19,12,10,7,6,33,291,1203,874,1025,FALSE,0.852036575228595,2021,2021-2022
UT,2021-11-30,inter-total,62,4,1,2,3,0,2,0,1,2,21,98,83,87,FALSE,0.887755102040816,2021,2021-2022
UT,2021-11-30,inter-ucfe,4,0,0,0,0,0,0,0,0,0,3,7,7,7,FALSE,1,2021,2021-2022
UT,2021-11-30,inter-ucx,0,0,0,0,0,0,0,0,0,0,0,0,0,0,FALSE,0,2021,2021-2022
UT,2021-11-30,inter-ui,58,4,1,2,3,0,2,0,1,2,18,91,76,80,FALSE,0.879120879120879,2021,2021-2022
UT,2021-11-30,intra-total,1078,191,62,32,20,8,5,6,5,25,373,1805,1451,1642,FALSE,0.909695290858726,2021,2021-2022
UT,2021-11-30,intra-ucfe,31,3,4,0,0,0,0,0,1,3,7,49,38,41,FALSE,0.836734693877551,2021,2021-2022
UT,2021-11-30,intra-ucx,3,0,0,1,0,0,0,0,0,0,0,4,3,3,FALSE,0.75,2021,2021-2022
UT,2021-11-30,intra-ui,1044,188,58,31,20,8,5,6,4,22,366,1752,1410,1598,FALSE,0.912100456621005,2021,2021-2022
UT,2021-12-31,inter-total,52,7,5,1,1,1,1,0,1,3,15,87,67,74,FALSE,0.850574712643678,2021,2021-2022
UT,2021-12-31,inter-ucfe,5,0,0,0,0,0,0,0,0,0,2,7,7,7,FALSE,1,2021,2021-2022
UT,2021-12-31,inter-ucx,0,0,0,0,0,0,0,0,0,0,0,0,0,0,FALSE,0,2021,2021-2022
UT,2021-12-31,inter-ui,47,7,5,1,1,1,1,0,1,3,13,80,60,67,FALSE,0.8375,2021,2021-2022
UT,2021-12-31,intra-total,1936,113,45,44,17,6,4,4,5,27,403,2604,2339,2452,FALSE,0.941628264208909,2021,2021-2022
UT,2021-12-31,intra-ucfe,74,3,2,1,1,1,0,1,0,0,10,93,84,87,FALSE,0.935483870967742,2021,2021-2022
UT,2021-12-31,intra-ucx,2,1,0,0,0,0,0,0,0,0,2,5,4,5,FALSE,1,2021,2021-2022
UT,2021-12-31,intra-ui,1860,109,43,43,16,5,4,3,5,27,391,2506,2251,2360,FALSE,0.941739824421389,2021,2021-2022
UT,2022-01-31,inter-total,34,4,2,1,0,2,1,0,1,1,15,61,49,53,FALSE,0.868852459016394,2021,2021-2022
UT,2022-01-31,inter-ucfe,4,0,0,0,0,0,0,0,0,0,0,4,4,4,FALSE,1,2021,2021-2022
UT,2022-01-31,inter-ucx,0,0,0,0,0,0,0,0,0,0,0,0,0,0,FALSE,0,2021,2021-2022
UT,2022-01-31,inter-ui,30,4,2,1,0,2,1,0,1,1,15,57,45,49,FALSE,0.859649122807018,2021,2021-2022
UT,2022-01-31,intra-total,2661,115,35,31,17,7,4,3,1,12,501,3387,3162,3277,FALSE,0.967522881606141,2021,2021-2022
UT,2022-01-31,intra-ucfe,88,3,1,1,0,0,1,0,0,0,7,101,95,98,FALSE,0.97029702970297,2021,2021-2022
UT,2022-01-31,intra-ucx,2,0,0,0,0,0,0,0,0,0,0,2,2,2,FALSE,1,2021,2021-2022
UT,2022-01-31,intra-ui,2571,112,34,30,17,7,3,3,1,12,494,3284,3065,3177,FALSE,0.96741778319123,2021,2021-2022
UT,2022-02-28,inter-total,18,9,5,1,3,1,1,0,0,1,18,57,36,45,FALSE,0.789473684210526,2021,2021-2022
UT,2022-02-28,inter-ucfe,0,1,1,0,0,0,0,0,0,0,0,2,0,1,FALSE,0.5,2021,2021-2022
UT,2022-02-28,inter-ucx,0,0,0,0,0,0,0,0,0,0,0,0,0,0,FALSE,0,2021,2021-2022
UT,2022-02-28,inter-ui,18,8,4,1,3,1,1,0,0,1,18,55,36,44,FALSE,0.8,2021,2021-2022
UT,2022-02-28,intra-total,990,152,69,33,17,12,9,2,2,13,394,1693,1384,1536,FALSE,0.907265209686946,2021,2021-2022
UT,2022-02-28,intra-ucfe,21,5,1,0,0,1,1,0,0,3,11,43,32,37,FALSE,0.86046511627907,2021,2021-2022
UT,2022-02-28,intra-ucx,1,0,1,0,0,0,0,0,0,0,1,3,2,2,FALSE,0.666666666666667,2021,2021-2022
UT,2022-02-28,intra-ui,968,147,67,33,17,11,8,2,2,10,382,1647,1350,1497,FALSE,0.908925318761384,2021,2021-2022
UT,2022-03-31,inter-total,27,2,0,1,0,1,1,0,0,1,4,37,31,33,FALSE,0.891891891891892,2021,2021-2022
UT,2022-03-31,inter-ucfe,2,0,0,0,0,0,0,0,0,0,0,2,2,2,FALSE,1,2021,2021-2022
UT,2022-03-31,inter-ucx,0,0,0,0,0,0,0,0,0,0,0,0,0,0,FALSE,0,2021,2021-2022
UT,2022-03-31,inter-ui,25,2,0,1,0,1,1,0,0,1,4,35,29,31,FALSE,0.885714285714286,2021,2021-2022
UT,2022-03-31,intra-total,881,99,35,19,16,8,4,4,3,19,305,1393,1186,1285,FALSE,0.922469490308686,2021,2021-2022
UT,2022-03-31,intra-ucfe,14,2,1,1,0,1,0,1,0,1,3,24,17,19,FALSE,0.791666666666667,2021,2021-2022
UT,2022-03-31,intra-ucx,5,0,1,0,0,0,0,0,0,0,0,6,5,5,FALSE,0.833333333333333,2021,2021-2022
UT,2022-03-31,intra-ui,862,97,33,18,16,7,4,3,3,18,302,1363,1164,1261,FALSE,0.92516507703595,2021,2021-2022
UT,2022-04-30,inter-total,21,3,1,1,0,0,0,1,0,2,4,33,25,28,FALSE,0.848484848484848,2021,2021-2022
UT,2022-04-30,inter-ucfe,2,0,1,0,0,0,0,0,0,0,0,3,2,2,FALSE,0.666666666666667,2021,2021-2022
UT,2022-04-30,inter-ucx,0,0,0,0,0,0,0,0,0,0,0,0,0,0,FALSE,0,2021,2021-2022
UT,2022-04-30,inter-ui,19,3,0,1,0,0,0,1,0,2,4,30,23,26,FALSE,0.866666666666667,2021,2021-2022
UT,2022-04-30,intra-total,772,69,19,7,6,5,0,1,0,11,246,1136,1018,1087,FALSE,0.956866197183099,2021,2021-2022
UT,2022-04-30,intra-ucfe,7,0,0,0,0,0,0,0,0,0,2,9,9,9,FALSE,1,2021,2021-2022
UT,2022-04-30,intra-ucx,2,0,0,0,0,0,0,0,0,0,2,4,4,4,FALSE,1,2021,2021-2022
UT,2022-04-30,intra-ui,763,69,19,7,6,5,0,1,0,11,242,1123,1005,1074,FALSE,0.956366874443455,2021,2021-2022
UT,2022-05-31,inter-total,30,4,3,5,0,0,0,0,0,2,10,54,40,44,FALSE,0.814814814814815,2021,2021-2022
UT,2022-05-31,inter-ucfe,0,0,0,0,0,0,0,0,0,0,0,0,0,0,FALSE,0,2021,2021-2022
UT,2022-05-31,inter-ucx,0,0,0,0,0,0,0,0,0,0,0,0,0,0,FALSE,0,2021,2021-2022
UT,2022-05-31,inter-ui,30,4,3,5,0,0,0,0,0,2,10,54,40,44,FALSE,0.814814814814815,2021,2021-2022
UT,2022-05-31,intra-total,1016,100,34,13,7,0,2,2,1,3,331,1509,1347,1447,FALSE,0.958913187541418,2021,2021-2022
UT,2022-05-31,intra-ucfe,5,1,1,0,0,0,0,0,0,0,1,8,6,7,FALSE,0.875,2021,2021-2022
UT,2022-05-31,intra-ucx,1,0,1,0,0,0,0,0,0,0,0,2,1,1,FALSE,0.5,2021,2021-2022
UT,2022-05-31,intra-ui,1010,99,32,13,7,0,2,2,1,3,330,1499,1340,1439,FALSE,0.959973315543696,2021,2021-2022
UT,2022-06-30,inter-total,24,1,3,1,1,0,0,1,1,3,10,45,34,35,FALSE,0.777777777777778,2021,2021-2022
UT,2022-06-30,inter-ucfe,0,0,1,0,1,0,0,0,0,1,0,3,0,0,FALSE,0,2021,2021-2022
UT,2022-06-30,inter-ucx,0,0,0,0,0,0,0,0,0,0,0,0,0,0,FALSE,0,2021,2021-2022
UT,2022-06-30,inter-ui,24,1,2,1,0,0,0,1,1,2,10,42,34,35,FALSE,0.833333333333333,2021,2021-2022
UT,2022-06-30,intra-total,857,89,29,15,8,6,3,0,0,14,325,1346,1182,1271,FALSE,0.944279346210996,2021,2021-2022
UT,2022-06-30,intra-ucfe,4,1,1,1,0,0,0,0,0,1,1,9,5,6,FALSE,0.666666666666667,2021,2021-2022
UT,2022-06-30,intra-ucx,2,0,0,0,0,0,0,0,0,1,0,3,2,2,FALSE,0.666666666666667,2021,2021-2022
UT,2022-06-30,intra-ui,851,88,28,14,8,6,3,0,0,12,324,1334,1175,1263,FALSE,0.946776611694153,2021,2021-2022
UT,2022-07-31,inter-total,29,2,1,2,0,1,0,0,0,1,14,50,43,45,FALSE,0.9,2022,2022-2023
UT,2022-07-31,inter-ucfe,0,0,0,1,0,0,0,0,0,1,0,2,0,0,FALSE,0,2022,2022-2023
UT,2022-07-31,inter-ucx,0,0,0,0,0,0,0,0,0,0,0,0,0,0,FALSE,0,2022,2022-2023
UT,2022-07-31,inter-ui,29,2,1,1,0,1,0,0,0,0,14,48,43,45,FALSE,0.9375,2022,2022-2023
UT,2022-07-31,intra-total,911,111,38,14,10,8,0,3,0,3,323,1421,1234,1345,FALSE,0.946516537649543,2022,2022-2023
UT,2022-07-31,intra-ucfe,7,0,1,0,0,0,0,0,0,0,0,8,7,7,FALSE,0.875,2022,2022-2023
UT,2022-07-31,intra-ucx,1,0,0,0,0,0,0,0,0,0,0,1,1,1,FALSE,1,2022,2022-2023
UT,2022-07-31,intra-ui,903,111,37,14,10,8,0,3,0,3,323,1412,1226,1337,FALSE,0.946883852691218,2022,2022-2023
UT,2022-08-31,inter-total,27,9,2,1,0,0,0,0,0,0,12,51,39,48,FALSE,0.941176470588235,2022,2022-2023
UT,2022-08-31,inter-ucfe,0,0,0,0,0,0,0,0,0,0,0,0,0,0,FALSE,0,2022,2022-2023
UT,2022-08-31,inter-ucx,0,0,0,0,0,0,0,0,0,0,0,0,0,0,FALSE,0,2022,2022-2023
UT,2022-08-31,inter-ui,27,9,2,1,0,0,0,0,0,0,12,51,39,48,FALSE,0.941176470588235,2022,2022-2023
UT,2022-08-31,intra-total,829,127,44,29,15,4,5,3,0,7,398,1461,1227,1354,FALSE,0.926762491444216,2022,2022-2023
UT,2022-08-31,intra-ucfe,4,3,0,0,0,0,0,0,0,0,0,7,4,7,FALSE,1,2022,2022-2023
UT,2022-08-31,intra-ucx,3,1,0,0,0,0,0,0,0,0,2,6,5,6,FALSE,1,2022,2022-2023
UT,2022-08-31,intra-ui,822,123,44,29,15,4,5,3,0,7,396,1448,1218,1341,FALSE,0.92610497237569,2022,2022-2023
UT,2022-09-30,inter-total,28,3,2,4,0,0,1,0,0,0,10,48,38,41,FALSE,0.854166666666667,2022,2022-2023
UT,2022-09-30,inter-ucfe,0,0,0,1,0,0,0,0,0,0,0,1,0,0,FALSE,0,2022,2022-2023
UT,2022-09-30,inter-ucx,0,0,0,0,0,0,0,0,0,0,0,0,0,0,FALSE,0,2022,2022-2023
UT,2022-09-30,inter-ui,28,3,2,3,0,0,1,0,0,0,10,47,38,41,FALSE,0.872340425531915,2022,2022-2023
UT,2022-09-30,intra-total,711,109,32,17,10,3,3,1,1,5,339,1231,1050,1159,FALSE,0.941510966693745,2022,2022-2023
UT,2022-09-30,intra-ucfe,3,0,0,0,0,0,0,0,0,1,0,4,3,3,FALSE,0.75,2022,2022-2023
UT,2022-09-30,intra-ucx,0,0,0,0,0,0,0,0,0,0,0,0,0,0,FALSE,0,2022,2022-2023
UT,2022-09-30,intra-ui,708,109,32,17,10,3,3,1,1,4,339,1227,1047,1156,FALSE,0.942135289323553,2022,2022-2023
UT,2022-10-31,inter-total,30,3,3,1,0,1,0,0,0,1,11,50,41,44,FALSE,0.88,2022,2022-2023
UT,2022-10-31,inter-ucfe,0,0,0,0,0,0,0,0,0,0,0,0,0,0,FALSE,0,2022,2022-2023
UT,2022-10-31,inter-ucx,0,0,0,0,0,0,0,0,0,0,0,0,0,0,FALSE,0,2022,2022-2023
UT,2022-10-31,inter-ui,30,3,3,1,0,1,0,0,0,1,11,50,41,44,FALSE,0.88,2022,2022-2023
UT,2022-10-31,intra-total,909,110,31,17,4,9,2,2,1,5,362,1452,1271,1381,FALSE,0.951101928374656,2022,2022-2023
UT,2022-10-31,intra-ucfe,1,2,0,0,0,0,0,0,0,0,1,4,2,4,FALSE,1,2022,2022-2023
UT,2022-10-31,intra-ucx,1,0,0,0,0,0,0,0,0,0,0,1,1,1,FALSE,1,2022,2022-2023
UT,2022-10-31,intra-ui,907,108,31,17,4,9,2,2,1,5,361,1447,1268,1376,FALSE,0.950932964754665,2022,2022-2023
UT,2022-11-30,inter-total,59,6,3,2,0,1,0,0,0,1,14,86,73,79,FALSE,0.918604651162791,2022,2022-2023
UT,2022-11-30,inter-ucfe,7,1,0,0,0,0,0,0,0,0,0,8,7,8,FALSE,1,2022,2022-2023
UT,2022-11-30,inter-ucx,0,0,0,0,0,0,0,0,0,0,0,0,0,0,FALSE,0,2022,2022-2023
UT,2022-11-30,inter-ui,52,5,3,2,0,1,0,0,0,1,14,78,66,71,FALSE,0.91025641025641,2022,2022-2023
UT,2022-11-30,intra-total,1534,168,64,26,17,6,8,3,1,2,454,2283,1988,2156,FALSE,0.94437144108629,2022,2022-2023
UT,2022-11-30,intra-ucfe,26,1,2,1,0,0,0,0,0,0,5,35,31,32,FALSE,0.914285714285714,2022,2022-2023
UT,2022-11-30,intra-ucx,4,0,0,0,0,0,0,0,0,0,0,4,4,4,FALSE,1,2022,2022-2023
UT,2022-11-30,intra-ui,1504,167,62,25,17,6,8,3,1,2,449,2244,1953,2120,FALSE,0.944741532976827,2022,2022-2023
UT,2022-12-31,inter-total,68,8,8,4,1,0,0,0,0,0,12,101,80,88,FALSE,0.871287128712871,2022,2022-2023
UT,2022-12-31,inter-ucfe,1,1,2,0,0,0,0,0,0,0,1,5,2,3,FALSE,0.6,2022,2022-2023
UT,2022-12-31,inter-ucx,0,0,0,0,0,0,0,0,0,0,0,0,0,0,FALSE,0,2022,2022-2023
UT,2022-12-31,inter-ui,67,7,6,4,1,0,0,0,0,0,11,96,78,85,FALSE,0.885416666666667,2022,2022-2023
UT,2022-12-31,intra-total,2762,163,63,28,10,12,2,3,1,4,508,3556,3270,3433,FALSE,0.96541057367829,2022,2022-2023
UT,2022-12-31,intra-ucfe,58,2,3,0,0,0,0,0,0,0,9,72,67,69,FALSE,0.958333333333333,2022,2022-2023
UT,2022-12-31,intra-ucx,3,1,0,0,0,0,0,0,0,0,0,4,3,4,FALSE,1,2022,2022-2023
UT,2022-12-31,intra-ui,2701,160,60,28,10,12,2,3,1,4,499,3480,3200,3360,FALSE,0.96551724137931,2022,2022-2023
UT,2023-01-31,inter-total,63,7,4,1,1,2,0,1,1,1,22,103,85,92,FALSE,0.893203883495146,2022,2022-2023
UT,2023-01-31,inter-ucfe,1,0,0,0,0,1,0,0,0,0,2,4,3,3,FALSE,0.75,2022,2022-2023
UT,2023-01-31,inter-ucx,0,0,0,0,0,0,0,0,0,0,0,0,0,0,FALSE,0,2022,2022-2023
UT,2023-01-31,inter-ui,62,7,4,1,1,1,0,1,1,1,20,99,82,89,FALSE,0.898989898989899,2022,2022-2023
UT,2023-01-31,intra-total,3589,226,78,35,23,12,3,1,0,12,770,4749,4359,4585,FALSE,0.965466413981891,2022,2022-2023
UT,2023-01-31,intra-ucfe,68,1,0,1,0,0,0,0,0,0,22,92,90,91,FALSE,0.989130434782609,2022,2022-2023
UT,2023-01-31,intra-ucx,4,0,0,0,0,0,0,0,0,0,0,4,4,4,FALSE,1,2022,2022-2023
UT,2023-01-31,intra-ui,3517,225,78,34,23,12,3,1,0,12,748,4653,4265,4490,FALSE,0.964968837309263,2022,2022-2023
UT,2023-02-28,inter-total,39,6,2,1,1,3,0,0,0,0,14,66,53,59,FALSE,0.893939393939394,2022,2022-2023
UT,2023-02-28,inter-ucfe,1,0,0,0,0,0,0,0,0,0,1,2,2,2,FALSE,1,2022,2022-2023
UT,2023-02-28,inter-ucx,0,0,0,0,0,0,0,0,0,0,0,0,0,0,FALSE,0,2022,2022-2023
UT,2023-02-28,inter-ui,38,6,2,1,1,3,0,0,0,0,13,64,51,57,FALSE,0.890625,2022,2022-2023
UT,2023-02-28,intra-total,1689,190,77,32,17,12,2,0,5,6,623,2653,2312,2502,FALSE,0.943083301922352,2022,2022-2023
UT,2023-02-28,intra-ucfe,19,2,1,1,1,0,0,0,0,0,3,27,22,24,FALSE,0.888888888888889,2022,2022-2023
UT,2023-02-28,intra-ucx,1,0,0,0,0,0,0,0,0,0,0,1,1,1,FALSE,1,2022,2022-2023
UT,2023-02-28,intra-ui,1669,188,76,31,16,12,2,0,5,6,620,2625,2289,2477,FALSE,0.943619047619048,2022,2022-2023
UT,2023-03-31,inter-total,30,4,1,1,2,2,0,0,1,0,8,49,38,42,FALSE,0.857142857142857,2022,2022-2023
UT,2023-03-31,inter-ucfe,3,0,0,0,0,0,0,0,0,0,1,4,4,4,FALSE,1,2022,2022-2023
UT,2023-03-31,inter-ucx,0,0,0,0,0,0,0,0,0,0,0,0,0,0,FALSE,0,2022,2022-2023
UT,2023-03-31,inter-ui,27,4,1,1,2,2,0,0,1,0,7,45,34,38,FALSE,0.844444444444445,2022,2022-2023
UT,2023-03-31,intra-total,1420,165,83,39,26,18,2,4,3,11,549,2320,1969,2134,FALSE,0.919827586206896,2022,2022-2023
UT,2023-03-31,intra-ucfe,10,0,1,1,1,0,0,0,0,1,3,17,13,13,FALSE,0.764705882352941,2022,2022-2023
UT,2023-03-31,intra-ucx,5,0,0,0,0,0,0,0,0,0,0,5,5,5,FALSE,1,2022,2022-2023
UT,2023-03-31,intra-ui,1405,165,82,38,25,18,2,4,3,10,546,2298,1951,2116,FALSE,0.920800696257615,2022,2022-2023
UT,2023-04-30,inter-total,22,2,2,0,0,0,0,0,0,0,11,37,33,35,FALSE,0.945945945945946,2022,2022-2023
UT,2023-04-30,inter-ucfe,0,0,0,0,0,0,0,0,0,0,0,0,0,0,FALSE,0,2022,2022-2023
UT,2023-04-30,inter-ucx,0,0,0,0,0,0,0,0,0,0,0,0,0,0,FALSE,0,2022,2022-2023
UT,2023-04-30,inter-ui,22,2,2,0,0,0,0,0,0,0,11,37,33,35,FALSE,0.945945945945946,2022,2022-2023
UT,2023-04-30,intra-total,1380,98,37,23,20,11,4,4,0,6,439,2022,1819,1917,FALSE,0.948071216617211,2022,2022-2023
UT,2023-04-30,intra-ucfe,2,1,0,0,0,0,0,0,0,0,3,6,5,6,FALSE,1,2022,2022-2023
UT,2023-04-30,intra-ucx,0,0,0,0,0,0,0,0,0,0,1,1,1,1,FALSE,1,2022,2022-2023
UT,2023-04-30,intra-ui,1378,97,37,23,20,11,4,4,0,6,435,2015,1813,1910,FALSE,0.947890818858561,2022,2022-2023
UT,2023-05-31,inter-total,58,6,2,0,0,0,0,0,0,2,5,73,63,69,FALSE,0.945205479452055,2022,2022-2023
UT,2023-05-31,inter-ucfe,0,0,0,0,0,0,0,0,0,0,0,0,0,0,FALSE,0,2022,2022-2023
UT,2023-05-31,inter-ucx,0,0,0,0,0,0,0,0,0,0,0,0,0,0,FALSE,0,2022,2022-2023
UT,2023-05-31,inter-ui,58,6,2,0,0,0,0,0,0,2,5,73,63,69,FALSE,0.945205479452055,2022,2022-2023
UT,2023-05-31,intra-total,1665,136,36,20,9,11,4,3,1,2,554,2441,2219,2355,FALSE,0.964768537484637,2022,2022-2023
UT,2023-05-31,intra-ucfe,2,1,0,1,0,1,0,0,0,1,1,7,3,4,FALSE,0.571428571428571,2022,2022-2023
UT,2023-05-31,intra-ucx,4,0,0,0,0,0,0,0,0,0,0,4,4,4,FALSE,1,2022,2022-2023
UT,2023-05-31,intra-ui,1659,135,36,19,9,10,4,3,1,1,553,2430,2212,2347,FALSE,0.965843621399177,2022,2022-2023
UT,2023-06-30,inter-total,35,6,0,2,1,1,0,0,0,2,9,56,44,50,FALSE,0.892857142857143,2022,2022-2023
UT,2023-06-30,inter-ucfe,0,0,0,0,0,0,0,0,0,0,0,0,0,0,FALSE,0,2022,2022-2023
UT,2023-06-30,inter-ucx,0,0,0,0,0,0,0,0,0,0,0,0,0,0,FALSE,0,2022,2022-2023
UT,2023-06-30,inter-ui,35,6,0,2,1,1,0,0,0,2,9,56,44,50,FALSE,0.892857142857143,2022,2022-2023
UT,2023-06-30,intra-total,1212,133,52,25,13,7,8,2,1,5,444,1902,1656,1789,FALSE,0.940588853838065,2022,2022-2023
UT,2023-06-30,intra-ucfe,3,1,1,1,0,0,1,0,0,0,0,7,3,4,FALSE,0.571428571428571,2022,2022-2023
UT,2023-06-30,intra-ucx,3,1,0,0,0,0,0,0,0,0,0,4,3,4,FALSE,1,2022,2022-2023
UT,2023-06-30,intra-ui,1206,131,51,24,13,7,7,2,1,5,444,1891,1650,1781,FALSE,0.941829719725013,2022,2022-2023
UT,2023-07-31,inter-total,38,3,2,1,1,0,0,0,0,2,15,62,53,56,FALSE,0.903225806451613,2023,2023-2024
UT,2023-07-31,inter-ucfe,0,0,0,0,0,0,0,0,0,0,0,0,0,0,FALSE,0,2023,2023-2024
UT,2023-07-31,inter-ucx,0,0,0,0,0,0,0,0,0,0,0,0,0,0,FALSE,0,2023,2023-2024
UT,2023-07-31,inter-ui,38,3,2,1,1,0,0,0,0,2,15,62,53,56,FALSE,0.903225806451613,2023,2023-2024
UT,2023-07-31,intra-total,1207,122,46,19,7,7,2,0,0,1,418,1829,1625,1747,FALSE,0.955166757791143,2023,2023-2024
UT,2023-07-31,intra-ucfe,2,0,0,2,0,0,0,0,0,0,0,4,2,2,FALSE,0.5,2023,2023-2024
UT,2023-07-31,intra-ucx,3,0,0,0,0,0,0,0,0,0,0,3,3,3,FALSE,1,2023,2023-2024
UT,2023-07-31,intra-ui,1202,122,46,17,7,7,2,0,0,1,418,1822,1620,1742,FALSE,0.95609220636663,2023,2023-2024
UT,2023-08-31,inter-total,38,6,1,2,1,0,1,0,0,3,20,72,58,64,FALSE,0.888888888888889,2023,2023-2024
UT,2023-08-31,inter-ucfe,0,0,0,0,0,0,0,0,0,0,0,0,0,0,FALSE,0,2023,2023-2024
UT,2023-08-31,inter-ucx,0,0,0,0,0,0,0,0,0,0,0,0,0,0,FALSE,0,2023,2023-2024
UT,2023-08-31,inter-ui,38,6,1,2,1,0,1,0,0,3,20,72,58,64,FALSE,0.888888888888889,2023,2023-2024
UT,2023-08-31,intra-total,1468,137,52,35,24,12,1,5,2,8,474,2218,1942,2079,FALSE,0.937330928764653,2023,2023-2024
UT,2023-08-31,intra-ucfe,5,1,0,1,0,0,0,1,0,0,2,10,7,8,FALSE,0.8,2023,2023-2024
UT,2023-08-31,intra-ucx,3,0,0,0,0,0,0,0,0,0,1,4,4,4,FALSE,1,2023,2023-2024
UT,2023-08-31,intra-ui,1460,136,52,34,24,12,1,4,2,8,471,2204,1931,2067,FALSE,0.937840290381125,2023,2023-2024
UT,2023-09-30,inter-total,26,2,1,1,1,0,0,0,1,0,10,42,36,38,FALSE,0.904761904761905,2023,2023-2024
UT,2023-09-30,inter-ucfe,0,0,0,0,0,0,0,0,0,0,0,0,0,0,FALSE,0,2023,2023-2024
UT,2023-09-30,inter-ucx,0,0,0,0,0,0,0,0,0,0,0,0,0,0,FALSE,0,2023,2023-2024
UT,2023-09-30,inter-ui,26,2,1,1,1,0,0,0,1,0,10,42,36,38,FALSE,0.904761904761905,2023,2023-2024
UT,2023-09-30,intra-total,1007,120,52,30,11,2,4,2,2,8,428,1666,1435,1555,FALSE,0.933373349339736,2023,2023-2024
UT,2023-09-30,intra-ucfe,5,1,0,0,0,0,0,0,0,0,3,9,8,9,FALSE,1,2023,2023-2024
UT,2023-09-30,intra-ucx,2,0,0,0,0,0,0,0,0,0,0,2,2,2,FALSE,1,2023,2023-2024
UT,2023-09-30,intra-ui,1000,119,52,30,11,2,4,2,2,8,425,1655,1425,1544,FALSE,0.932930513595166,2023,2023-2024
UT,2023-10-31,inter-total,38,4,3,0,0,0,0,0,0,1,14,60,52,56,FALSE,0.933333333333333,2023,2023-2024
UT,2023-10-31,inter-ucfe,1,0,0,0,0,0,0,0,0,0,1,2,2,2,FALSE,1,2023,2023-2024
UT,2023-10-31,inter-ucx,0,0,0,0,0,0,0,0,0,0,0,0,0,0,FALSE,0,2023,2023-2024
UT,2023-10-31,inter-ui,37,4,3,0,0,0,0,0,0,1,13,58,50,54,FALSE,0.931034482758621,2023,2023-2024
UT,2023-10-31,intra-total,1439,148,56,21,16,2,7,3,2,3,524,2221,1963,2111,FALSE,0.95047276001801,2023,2023-2024
UT,2023-10-31,intra-ucfe,10,0,0,0,1,0,0,0,0,0,2,13,12,12,FALSE,0.923076923076923,2023,2023-2024
UT,2023-10-31,intra-ucx,2,0,0,0,0,0,0,0,0,0,0,2,2,2,FALSE,1,2023,2023-2024
UT,2023-10-31,intra-ui,1427,148,56,21,15,2,7,3,2,3,522,2206,1949,2097,FALSE,0.950589301903898,2023,2023-2024
UT,2023-11-30,inter-total,56,3,3,1,0,1,0,1,0,0,17,82,73,76,FALSE,0.926829268292683,2023,2023-2024
UT,2023-11-30,inter-ucfe,4,0,0,0,0,0,0,0,0,0,1,5,5,5,FALSE,1,2023,2023-2024
UT,2023-11-30,inter-ucx,0,0,0,0,0,0,0,0,0,0,0,0,0,0,FALSE,0,2023,2023-2024
UT,2023-11-30,inter-ui,52,3,3,1,0,1,0,1,0,0,16,77,68,71,FALSE,0.922077922077922,2023,2023-2024
UT,2023-11-30,intra-total,1578,143,48,23,15,10,5,1,2,5,499,2329,2077,2220,FALSE,0.953198797767282,2023,2023-2024
UT,2023-11-30,intra-ucfe,16,2,1,0,0,0,0,0,0,1,8,28,24,26,FALSE,0.928571428571429,2023,2023-2024
UT,2023-11-30,intra-ucx,3,0,0,0,0,0,0,0,0,0,0,3,3,3,FALSE,1,2023,2023-2024
UT,2023-11-30,intra-ui,1559,141,47,23,15,10,5,1,2,4,491,2298,2050,2191,FALSE,0.953437771975631,2023,2023-2024
UT,2023-12-31,inter-total,34,6,3,1,2,1,1,0,0,0,20,68,54,60,FALSE,0.882352941176471,2023,2023-2024
UT,2023-12-31,inter-ucfe,2,0,1,0,0,0,0,0,0,0,2,5,4,4,FALSE,0.8,2023,2023-2024
UT,2023-12-31,inter-ucx,0,0,0,0,0,0,0,0,0,0,0,0,0,0,FALSE,0,2023,2023-2024
UT,2023-12-31,inter-ui,32,6,2,1,2,1,1,0,0,0,18,63,50,56,FALSE,0.888888888888889,2023,2023-2024
UT,2023-12-31,intra-total,2311,206,67,41,21,12,3,5,5,7,595,3273,2906,3112,FALSE,0.950809654750993,2023,2023-2024
UT,2023-12-31,intra-ucfe,42,3,1,0,1,0,1,0,0,0,9,57,51,54,FALSE,0.947368421052632,2023,2023-2024
UT,2023-12-31,intra-ucx,3,0,0,0,0,0,0,0,0,0,3,6,6,6,FALSE,1,2023,2023-2024
UT,2023-12-31,intra-ui,2266,203,66,41,20,12,2,5,5,7,583,3210,2849,3052,FALSE,0.950778816199377,2023,2023-2024
UT,2024-01-31,inter-total,66,11,9,2,3,0,1,0,3,2,19,116,85,96,FALSE,0.827586206896552,2023,2023-2024
UT,2024-01-31,inter-ucfe,3,0,0,0,0,0,0,0,0,0,0,3,3,3,FALSE,1,2023,2023-2024
UT,2024-01-31,inter-ucx,0,0,0,0,0,0,0,0,0,0,0,0,0,0,FALSE,0,2023,2023-2024
UT,2024-01-31,inter-ui,63,11,9,2,3,0,1,0,3,2,19,113,82,93,FALSE,0.823008849557522,2023,2023-2024
UT,2024-01-31,intra-total,3243,350,116,69,46,33,15,6,3,7,871,4759,4114,4464,FALSE,0.938012187434335,2023,2023-2024
UT,2024-01-31,intra-ucfe,77,9,0,0,1,0,0,1,0,0,11,99,88,97,FALSE,0.97979797979798,2023,2023-2024
UT,2024-01-31,intra-ucx,1,0,0,0,0,0,0,0,0,0,0,1,1,1,FALSE,1,2023,2023-2024
UT,2024-01-31,intra-ui,3165,341,116,69,45,33,15,5,3,7,860,4659,4025,4366,FALSE,0.937110968018888,2023,2023-2024
UT,2024-02-29,inter-total,45,7,3,1,1,2,1,0,1,1,18,80,63,70,FALSE,0.875,2023,2023-2024
UT,2024-02-29,inter-ucfe,1,0,0,0,0,1,0,0,0,1,0,3,1,1,FALSE,0.333333333333333,2023,2023-2024
UT,2024-02-29,inter-ucx,0,0,0,0,0,0,0,0,0,0,0,0,0,0,FALSE,0,2023,2023-2024
UT,2024-02-29,inter-ui,44,7,3,1,1,1,1,0,1,0,18,77,62,69,FALSE,0.896103896103896,2023,2023-2024
UT,2024-02-29,intra-total,1954,234,110,64,31,23,8,10,5,15,633,3087,2587,2821,FALSE,0.913832199546485,2023,2023-2024
UT,2024-02-29,intra-ucfe,19,3,2,1,0,0,0,2,1,1,6,35,25,28,FALSE,0.8,2023,2023-2024
UT,2024-02-29,intra-ucx,3,0,0,0,0,0,0,0,0,0,0,3,3,3,FALSE,1,2023,2023-2024
UT,2024-02-29,intra-ui,1932,231,108,63,31,23,8,8,4,14,627,3049,2559,2790,FALSE,0.91505411610364,2023,2023-2024
UT,2024-03-31,inter-total,19,6,7,2,2,0,2,0,0,0,20,58,39,45,FALSE,0.775862068965517,2023,2023-2024
UT,2024-03-31,inter-ucfe,0,0,1,0,0,0,0,0,0,0,1,2,1,1,FALSE,0.5,2023,2023-2024
UT,2024-03-31,inter-ucx,0,0,0,0,0,0,0,0,0,0,0,0,0,0,FALSE,0,2023,2023-2024
UT,2024-03-31,inter-ui,19,6,6,2,2,0,2,0,0,0,19,56,38,44,FALSE,0.785714285714286,2023,2023-2024
UT,2024-03-31,intra-total,1338,175,72,46,18,16,9,10,5,15,465,2169,1803,1978,FALSE,0.911940986629783,2023,2023-2024
UT,2024-03-31,intra-ucfe,9,0,0,1,0,0,0,0,0,0,4,14,13,13,FALSE,0.928571428571429,2023,2023-2024
UT,2024-03-31,intra-ucx,1,0,1,0,0,0,0,0,0,0,1,3,2,2,FALSE,0.666666666666667,2023,2023-2024
UT,2024-03-31,intra-ui,1328,175,71,45,18,16,9,10,5,15,460,2152,1788,1963,FALSE,0.912174721189591,2023,2023-2024
UT,2024-04-30,inter-total,23,3,3,2,0,4,0,0,2,1,8,46,31,34,FALSE,0.739130434782609,2023,2023-2024
UT,2024-04-30,inter-ucfe,0,0,0,0,0,0,0,0,0,0,0,0,0,0,FALSE,0,2023,2023-2024
UT,2024-04-30,inter-ucx,0,0,0,0,0,0,0,0,0,0,0,0,0,0,FALSE,0,2023,2023-2024
UT,2024-04-30,inter-ui,23,3,3,2,0,4,0,0,2,1,8,46,31,34,FALSE,0.739130434782609,2023,2023-2024
UT,2024-04-30,intra-total,1496,155,74,40,21,20,5,6,6,10,522,2355,2018,2173,FALSE,0.922717622080679,2023,2023-2024
UT,2024-04-30,intra-ucfe,5,1,0,1,0,0,0,0,0,0,1,8,6,7,FALSE,0.875,2023,2023-2024
UT,2024-04-30,intra-ucx,4,1,1,0,0,0,0,0,0,0,0,6,4,5,FALSE,0.833333333333333,2023,2023-2024
UT,2024-04-30,intra-ui,1487,153,73,39,21,20,5,6,6,10,521,2341,2008,2161,FALSE,0.923109782144383,2023,2023-2024
UT,2024-05-31,inter-total,19,7,3,1,1,2,0,0,0,3,14,50,33,40,FALSE,0.8,2023,2023-2024
UT,2024-05-31,inter-ucfe,0,0,0,0,0,0,0,0,0,0,0,0,0,0,FALSE,0,2023,2023-2024
UT,2024-05-31,inter-ucx,0,0,0,0,0,0,0,0,0,0,0,0,0,0,FALSE,0,2023,2023-2024
UT,2024-05-31,inter-ui,19,7,3,1,1,2,0,0,0,3,14,50,33,40,FALSE,0.8,2023,2023-2024
UT,2024-05-31,intra-total,1559,195,76,29,27,19,9,3,0,14,558,2489,2117,2312,FALSE,0.928887103254319,2023,2023-2024
UT,2024-05-31,intra-ucfe,4,2,0,0,0,0,1,0,0,0,4,11,8,10,FALSE,0.909090909090909,2023,2023-2024
UT,2024-05-31,intra-ucx,6,0,0,0,0,0,0,0,0,1,1,8,7,7,FALSE,0.875,2023,2023-2024
UT,2024-05-31,intra-ui,1549,193,76,29,27,19,8,3,0,13,553,2470,2102,2295,FALSE,0.92914979757085,2023,2023-2024
UT,2024-06-30,inter-total,23,3,4,3,3,3,1,1,1,2,10,54,33,36,FALSE,0.666666666666667,2023,2023-2024
UT,2024-06-30,inter-ucfe,0,0,1,0,0,0,0,0,0,0,0,1,0,0,FALSE,0,2023,2023-2024
UT,2024-06-30,inter-ucx,0,0,0,0,0,0,0,0,0,0,0,0,0,0,FALSE,0,2023,2023-2024
UT,2024-06-30,inter-ui,23,3,3,3,3,3,1,1,1,2,10,53,33,36,FALSE,0.679245283018868,2023,2023-2024
UT,2024-06-30,intra-total,1126,172,90,46,25,15,7,7,2,12,443,1945,1569,1741,FALSE,0.895115681233933,2023,2023-2024
UT,2024-06-30,intra-ucfe,4,2,0,0,0,0,0,0,0,0,1,7,5,7,FALSE,1,2023,2023-2024
UT,2024-06-30,intra-ucx,4,0,0,0,0,0,0,0,0,0,0,4,4,4,FALSE,1,2023,2023-2024
UT,2024-06-30,intra-ui,1118,170,90,46,25,15,7,7,2,12,442,1934,1560,1730,FALSE,0.894519131334023,2023,2023-2024
UT,2024-07-31,inter-total,25,10,5,5,1,1,3,0,0,3,26,79,51,61,FALSE,0.772151898734177,2024,2024-2025
UT,2024-07-31,inter-ucfe,0,0,1,0,0,0,0,0,0,0,0,1,0,0,FALSE,0,2024,2024-2025
UT,2024-07-31,inter-ucx,0,0,0,0,0,0,0,0,0,0,0,0,0,0,FALSE,0,2024,2024-2025
UT,2024-07-31,inter-ui,25,10,4,5,1,1,3,0,0,3,26,78,51,61,FALSE,0.782051282051282,2024,2024-2025
UT,2024-07-31,intra-total,1421,206,67,25,25,17,9,6,2,14,591,2383,2012,2218,FALSE,0.930759546789761,2024,2024-2025
UT,2024-07-31,intra-ucfe,7,2,0,0,0,1,0,0,0,0,2,12,9,11,FALSE,0.916666666666667,2024,2024-2025
UT,2024-07-31,intra-ucx,1,1,0,0,1,0,0,0,0,0,2,5,3,4,FALSE,0.8,2024,2024-2025
UT,2024-07-31,intra-ui,1413,203,67,25,24,16,9,6,2,14,587,2366,2000,2203,FALSE,0.931107354184277,2024,2024-2025
UT,2024-08-31,inter-total,33,7,3,1,4,1,1,0,2,3,14,69,47,54,FALSE,0.782608695652174,2024,2024-2025
UT,2024-08-31,inter-ucfe,0,0,0,0,0,0,0,0,1,0,0,1,0,0,FALSE,0,2024,2024-2025
UT,2024-08-31,inter-ucx,0,0,0,0,0,0,0,0,0,0,0,0,0,0,FALSE,0,2024,2024-2025
UT,2024-08-31,inter-ui,33,7,3,1,4,1,1,0,1,3,14,68,47,54,FALSE,0.794117647058824,2024,2024-2025
UT,2024-08-31,intra-total,1209,184,80,50,25,18,7,3,3,11,431,2021,1640,1824,FALSE,0.90252350321623,2024,2024-2025
UT,2024-08-31,intra-ucfe,7,3,1,1,0,0,0,0,0,0,4,16,11,14,FALSE,0.875,2024,2024-2025
UT,2024-08-31,intra-ucx,2,0,1,1,0,0,0,0,0,0,2,6,4,4,FALSE,0.666666666666667,2024,2024-2025
UT,2024-08-31,intra-ui,1200,181,78,48,25,18,7,3,3,11,425,1999,1625,1806,FALSE,0.903451725862931,2024,2024-2025
UT,2024-09-30,inter-total,26,4,2,2,0,1,1,0,0,0,15,51,41,45,FALSE,0.882352941176471,2024,2024-2025
UT,2024-09-30,inter-ucfe,0,0,0,0,0,0,0,0,0,0,0,0,0,0,FALSE,0,2024,2024-2025
UT,2024-09-30,inter-ucx,0,0,0,0,0,0,0,0,0,0,0,0,0,0,FALSE,0,2024,2024-2025
UT,2024-09-30,inter-ui,26,4,2,2,0,1,1,0,0,0,15,51,41,45,FALSE,0.882352941176471,2024,2024-2025
UT,2024-09-30,intra-total,1155,131,42,33,16,8,5,4,3,7,496,1900,1651,1782,FALSE,0.937894736842105,2024,2024-2025
UT,2024-09-30,intra-ucfe,0,0,0,0,0,0,0,0,0,0,1,1,1,1,FALSE,1,2024,2024-2025
UT,2024-09-30,intra-ucx,0,0,0,0,0,0,0,0,0,0,0,0,0,0,FALSE,0,2024,2024-2025
UT,2024-09-30,intra-ui,1155,131,42,33,16,8,5,4,3,7,495,1899,1650,1781,FALSE,0.937862032648763,2024,2024-2025
UT,2024-10-31,inter-total,25,4,2,0,3,2,0,0,0,2,11,49,36,40,FALSE,0.816326530612245,2024,2024-2025
UT,2024-10-31,inter-ucfe,0,0,0,0,0,0,0,0,0,0,1,1,1,1,FALSE,1,2024,2024-2025
UT,2024-10-31,inter-ucx,0,0,0,0,0,0,0,0,0,0,0,0,0,0,FALSE,0,2024,2024-2025
UT,2024-10-31,inter-ui,25,4,2,0,3,2,0,0,0,2,10,48,35,39,FALSE,0.8125,2024,2024-2025
UT,2024-10-31,intra-total,1415,136,49,33,24,8,4,3,3,4,532,2211,1947,2083,FALSE,0.942107643600181,2024,2024-2025
UT,2024-10-31,intra-ucfe,2,0,1,0,1,0,0,0,0,0,0,4,2,2,FALSE,0.5,2024,2024-2025
UT,2024-10-31,intra-ucx,4,0,0,0,0,0,0,0,0,0,0,4,4,4,FALSE,1,2024,2024-2025
UT,2024-10-31,intra-ui,1409,136,48,33,23,8,4,3,3,4,532,2203,1941,2077,FALSE,0.942805265546981,2024,2024-2025
UT,2024-11-30,inter-total,51,13,3,0,0,1,0,1,0,0,16,85,67,80,FALSE,0.941176470588235,2024,2024-2025
UT,2024-11-30,inter-ucfe,0,0,0,0,0,0,0,0,0,0,1,1,1,1,FALSE,1,2024,2024-2025
UT,2024-11-30,inter-ucx,0,0,0,0,0,0,0,0,0,0,0,0,0,0,FALSE,0,2024,2024-2025
UT,2024-11-30,inter-ui,51,13,3,0,0,1,0,1,0,0,15,84,66,79,FALSE,0.940476190476191,2024,2024-2025
UT,2024-11-30,intra-total,1598,157,67,25,14,4,5,2,0,8,518,2398,2116,2273,FALSE,0.947873227689741,2024,2024-2025
UT,2024-11-30,intra-ucfe,16,2,2,0,0,1,0,0,0,1,7,29,23,25,FALSE,0.862068965517241,2024,2024-2025
UT,2024-11-30,intra-ucx,2,0,0,0,0,0,0,0,0,0,0,2,2,2,FALSE,1,2024,2024-2025
UT,2024-11-30,intra-ui,1580,155,65,25,14,3,5,2,0,7,511,2367,2091,2246,FALSE,0.948880439374736,2024,2024-2025
UT,2024-12-31,inter-total,43,18,6,5,2,0,0,0,0,2,18,94,61,79,FALSE,0.840425531914894,2024,2024-2025
UT,2024-12-31,inter-ucfe,3,4,0,0,0,0,0,0,0,0,4,11,7,11,FALSE,1,2024,2024-2025
UT,2024-12-31,inter-ucx,0,0,0,0,0,0,0,0,0,0,0,0,0,0,FALSE,0,2024,2024-2025
UT,2024-12-31,inter-ui,40,14,6,5,2,0,0,0,0,2,14,83,54,68,FALSE,0.819277108433735,2024,2024-2025
UT,2024-12-31,intra-total,3144,195,69,38,24,15,5,6,1,4,675,4176,3819,4014,FALSE,0.961206896551724,2024,2024-2025
UT,2024-12-31,intra-ucfe,71,2,4,0,0,0,0,0,0,0,20,97,91,93,FALSE,0.958762886597938,2024,2024-2025
UT,2024-12-31,intra-ucx,5,0,0,0,0,0,0,0,0,0,1,6,6,6,FALSE,1,2024,2024-2025
UT,2024-12-31,intra-ui,3068,193,65,38,24,15,5,6,1,4,654,4073,3722,3915,FALSE,0.961207954824454,2024,2024-2025
VA,2019-01-31,inter-total,318,49,18,7,5,4,0,1,1,6,138,547,456,505,FALSE,0.923217550274223,2018,2018-2019
VA,2019-01-31,inter-ucfe,9,1,0,0,0,0,0,1,0,0,8,19,17,18,FALSE,0.947368421052632,2018,2018-2019
VA,2019-01-31,inter-ucx,1,0,0,0,0,0,0,0,0,0,0,1,1,1,FALSE,1,2018,2018-2019
VA,2019-01-31,inter-ui,308,48,18,7,5,4,0,0,1,6,130,527,438,486,FALSE,0.922201138519924,2018,2018-2019
VA,2019-01-31,intra-total,5204,887,323,87,44,16,18,18,11,32,2090,8730,7294,8181,FALSE,0.937113402061856,2018,2018-2019
VA,2019-01-31,intra-ucfe,98,19,4,1,0,1,0,0,0,0,70,193,168,187,FALSE,0.968911917098446,2018,2018-2019
VA,2019-01-31,intra-ucx,13,4,1,0,0,0,0,0,0,0,8,26,21,25,FALSE,0.961538461538461,2018,2018-2019
VA,2019-01-31,intra-ui,5093,864,318,86,44,15,18,18,11,32,2012,8511,7105,7969,FALSE,0.936317706497474,2018,2018-2019
VA,2019-02-28,inter-total,204,38,16,11,6,4,0,1,1,2,76,359,280,318,FALSE,0.885793871866295,2018,2018-2019
VA,2019-02-28,inter-ucfe,1,0,0,2,1,0,0,0,0,0,0,4,1,1,FALSE,0.25,2018,2018-2019
VA,2019-02-28,inter-ucx,0,0,0,0,0,0,0,0,0,0,0,0,0,0,FALSE,0,2018,2018-2019
VA,2019-02-28,inter-ui,203,38,16,9,5,4,0,1,1,2,76,355,279,317,FALSE,0.892957746478873,2018,2018-2019
VA,2019-02-28,intra-total,3283,480,186,73,48,19,16,14,10,16,1440,5585,4723,5203,FALSE,0.931602506714414,2018,2018-2019
VA,2019-02-28,intra-ucfe,11,6,8,4,3,1,0,0,0,0,8,41,19,25,FALSE,0.609756097560976,2018,2018-2019
VA,2019-02-28,intra-ucx,8,4,1,1,0,0,0,0,0,0,8,22,16,20,FALSE,0.909090909090909,2018,2018-2019
VA,2019-02-28,intra-ui,3264,470,177,68,45,18,16,14,10,16,1424,5522,4688,5158,FALSE,0.934081854400579,2018,2018-2019
VA,2019-03-31,inter-total,143,17,5,8,4,4,2,2,3,3,63,254,206,223,FALSE,0.877952755905512,2018,2018-2019
VA,2019-03-31,inter-ucfe,1,1,0,0,0,1,0,0,0,0,0,3,1,2,FALSE,0.666666666666667,2018,2018-2019
VA,2019-03-31,inter-ucx,0,0,0,0,0,0,0,0,0,0,0,0,0,0,FALSE,0,2018,2018-2019
VA,2019-03-31,inter-ui,142,16,5,8,4,3,2,2,3,3,63,251,205,221,FALSE,0.880478087649402,2018,2018-2019
VA,2019-03-31,intra-total,2309,427,123,60,34,32,27,13,9,19,1315,4368,3624,4051,FALSE,0.92742673992674,2018,2018-2019
VA,2019-03-31,intra-ucfe,10,6,3,2,3,1,1,1,1,1,7,36,17,23,FALSE,0.638888888888889,2018,2018-2019
VA,2019-03-31,intra-ucx,25,3,1,3,1,0,0,0,0,1,12,46,37,40,FALSE,0.869565217391304,2018,2018-2019
VA,2019-03-31,intra-ui,2274,418,119,55,30,31,26,12,8,17,1296,4286,3570,3988,FALSE,0.930471301913206,2018,2018-2019
VA,2019-04-30,inter-total,169,19,8,4,6,2,2,0,0,10,40,260,209,228,FALSE,0.876923076923077,2018,2018-2019
VA,2019-04-30,inter-ucfe,0,0,0,1,0,0,0,0,0,1,0,2,0,0,FALSE,0,2018,2018-2019
VA,2019-04-30,inter-ucx,0,1,0,0,0,0,0,0,0,0,0,1,0,1,FALSE,1,2018,2018-2019
VA,2019-04-30,inter-ui,169,18,8,3,6,2,2,0,0,9,40,257,209,227,FALSE,0.883268482490272,2018,2018-2019
VA,2019-04-30,intra-total,2661,325,86,23,20,15,12,5,9,16,1003,4175,3664,3989,FALSE,0.955449101796407,2018,2018-2019
VA,2019-04-30,intra-ucfe,12,3,2,0,1,1,0,0,0,2,7,28,19,22,FALSE,0.785714285714286,2018,2018-2019
VA,2019-04-30,intra-ucx,26,6,0,0,0,0,0,0,0,0,6,38,32,38,FALSE,1,2018,2018-2019
VA,2019-04-30,intra-ui,2623,316,84,23,19,14,12,5,9,14,990,4109,3613,3929,FALSE,0.956193721100024,2018,2018-2019
VA,2019-05-31,inter-total,191,16,5,1,2,1,1,2,0,4,29,252,220,236,FALSE,0.936507936507937,2018,2018-2019
VA,2019-05-31,inter-ucfe,2,1,0,0,0,0,0,0,0,1,2,6,4,5,FALSE,0.833333333333333,2018,2018-2019
VA,2019-05-31,inter-ucx,0,0,0,0,0,0,0,0,0,0,1,1,1,1,FALSE,1,2018,2018-2019
VA,2019-05-31,inter-ui,189,15,5,1,2,1,1,2,0,3,26,245,215,230,FALSE,0.938775510204082,2018,2018-2019
VA,2019-05-31,intra-total,2805,290,65,27,15,21,11,9,8,15,933,4199,3738,4028,FALSE,0.959276018099547,2018,2018-2019
VA,2019-05-31,intra-ucfe,8,0,1,0,0,0,0,0,0,1,5,15,13,13,FALSE,0.866666666666667,2018,2018-2019
VA,2019-05-31,intra-ucx,18,6,1,1,0,1,0,0,0,0,11,38,29,35,FALSE,0.921052631578947,2018,2018-2019
VA,2019-05-31,intra-ui,2779,284,63,26,15,20,11,9,8,14,917,4146,3696,3980,FALSE,0.959961408586589,2018,2018-2019
VA,2019-06-30,inter-total,177,17,5,3,2,0,0,0,1,3,51,259,228,245,FALSE,0.945945945945946,2018,2018-2019
VA,2019-06-30,inter-ucfe,0,1,0,0,0,0,0,0,0,0,1,2,1,2,FALSE,1,2018,2018-2019
VA,2019-06-30,inter-ucx,0,0,0,0,0,0,0,0,0,0,0,0,0,0,FALSE,0,2018,2018-2019
VA,2019-06-30,inter-ui,177,16,5,3,2,0,0,0,1,3,50,257,227,243,FALSE,0.945525291828794,2018,2018-2019
VA,2019-06-30,intra-total,3105,306,72,22,9,13,13,7,7,9,1178,4741,4283,4589,FALSE,0.967939253322084,2018,2018-2019
VA,2019-06-30,intra-ucfe,6,5,1,0,0,1,0,1,0,0,10,24,16,21,FALSE,0.875,2018,2018-2019
VA,2019-06-30,intra-ucx,19,3,0,0,0,0,0,0,0,0,10,32,29,32,FALSE,1,2018,2018-2019
VA,2019-06-30,intra-ui,3080,298,71,22,9,12,13,6,7,9,1158,4685,4238,4536,FALSE,0.968196371398079,2018,2018-2019
VA,2019-07-31,inter-total,211,26,12,1,0,5,2,0,0,4,71,332,282,308,FALSE,0.927710843373494,2019,2019-2020
VA,2019-07-31,inter-ucfe,0,0,0,0,0,0,1,0,0,0,3,4,3,3,FALSE,0.75,2019,2019-2020
VA,2019-07-31,inter-ucx,0,0,0,0,0,0,0,0,0,0,0,0,0,0,FALSE,0,2019,2019-2020
VA,2019-07-31,inter-ui,211,26,12,1,0,5,1,0,0,4,68,328,279,305,FALSE,0.929878048780488,2019,2019-2020
VA,2019-07-31,intra-total,2767,550,155,40,17,13,13,14,4,19,1446,5038,4213,4763,FALSE,0.945414847161572,2019,2019-2020
VA,2019-07-31,intra-ucfe,12,6,2,0,0,0,0,0,0,0,3,23,15,21,FALSE,0.91304347826087,2019,2019-2020
VA,2019-07-31,intra-ucx,22,4,1,1,0,0,1,0,0,0,12,41,34,38,FALSE,0.926829268292683,2019,2019-2020
VA,2019-07-31,intra-ui,2733,540,152,39,17,13,12,14,4,19,1431,4974,4164,4704,FALSE,0.945717732207479,2019,2019-2020
VA,2019-08-31,inter-total,135,30,12,4,5,2,3,2,0,1,67,261,202,232,FALSE,0.888888888888889,2019,2019-2020
VA,2019-08-31,inter-ucfe,0,2,1,1,0,0,0,0,0,0,4,8,4,6,FALSE,0.75,2019,2019-2020
VA,2019-08-31,inter-ucx,0,0,0,0,0,0,0,0,0,0,0,0,0,0,FALSE,0,2019,2019-2020
VA,2019-08-31,inter-ui,135,28,11,3,5,2,3,2,0,1,63,253,198,226,FALSE,0.893280632411067,2019,2019-2020
VA,2019-08-31,intra-total,1969,538,167,64,26,16,7,10,6,20,1281,4104,3250,3788,FALSE,0.923001949317739,2019,2019-2020
VA,2019-08-31,intra-ucfe,5,8,1,3,0,0,0,0,0,2,9,28,14,22,FALSE,0.785714285714286,2019,2019-2020
VA,2019-08-31,intra-ucx,18,4,1,0,0,0,0,0,0,1,9,33,27,31,FALSE,0.939393939393939,2019,2019-2020
VA,2019-08-31,intra-ui,1946,526,165,61,26,16,7,10,6,17,1263,4043,3209,3735,FALSE,0.923818946326985,2019,2019-2020
VA,2019-09-30,inter-total,149,37,13,3,2,2,1,2,2,2,48,261,197,234,FALSE,0.896551724137931,2019,2019-2020
VA,2019-09-30,inter-ucfe,1,4,0,0,0,0,0,0,1,0,0,6,1,5,FALSE,0.833333333333333,2019,2019-2020
VA,2019-09-30,inter-ucx,1,0,0,0,0,0,0,0,0,0,0,1,1,1,FALSE,1,2019,2019-2020
VA,2019-09-30,inter-ui,147,33,13,3,2,2,1,2,1,2,48,254,195,228,FALSE,0.897637795275591,2019,2019-2020
VA,2019-09-30,intra-total,1833,617,221,69,38,11,10,10,7,24,1113,3953,2946,3563,FALSE,0.90134075385783,2019,2019-2020
VA,2019-09-30,intra-ucfe,5,10,2,3,1,0,0,0,1,0,2,24,7,17,FALSE,0.708333333333333,2019,2019-2020
VA,2019-09-30,intra-ucx,8,3,2,2,2,0,0,0,0,0,10,27,18,21,FALSE,0.777777777777778,2019,2019-2020
VA,2019-09-30,intra-ui,1820,604,217,64,35,11,10,10,6,24,1101,3902,2921,3525,FALSE,0.903382880574065,2019,2019-2020
VA,2019-10-31,inter-total,122,18,5,5,2,1,1,0,0,3,83,240,205,223,FALSE,0.929166666666667,2019,2019-2020
VA,2019-10-31,inter-ucfe,2,0,0,0,0,1,0,0,0,0,2,5,4,4,FALSE,0.8,2019,2019-2020
VA,2019-10-31,inter-ucx,0,0,0,0,0,0,0,0,0,0,1,1,1,1,FALSE,1,2019,2019-2020
VA,2019-10-31,inter-ui,120,18,5,5,2,0,1,0,0,3,80,234,200,218,FALSE,0.931623931623932,2019,2019-2020
VA,2019-10-31,intra-total,2062,482,155,49,24,14,13,12,11,24,1366,4212,3428,3910,FALSE,0.928300094966762,2019,2019-2020
VA,2019-10-31,intra-ucfe,2,4,5,2,0,0,1,1,0,0,10,25,12,16,FALSE,0.64,2019,2019-2020
VA,2019-10-31,intra-ucx,25,4,1,1,0,0,0,0,0,0,9,40,34,38,FALSE,0.95,2019,2019-2020
VA,2019-10-31,intra-ui,2035,474,149,46,24,14,12,11,11,24,1347,4147,3382,3856,FALSE,0.929828791897758,2019,2019-2020
VA,2019-11-30,inter-total,167,18,9,5,0,0,0,0,0,0,55,254,222,240,FALSE,0.944881889763779,2019,2019-2020
VA,2019-11-30,inter-ucfe,1,1,0,0,0,0,0,0,0,0,1,3,2,3,FALSE,1,2019,2019-2020
VA,2019-11-30,inter-ucx,0,0,1,0,0,0,0,0,0,0,0,1,0,0,FALSE,0,2019,2019-2020
VA,2019-11-30,inter-ui,166,17,8,5,0,0,0,0,0,0,54,250,220,237,FALSE,0.948,2019,2019-2020
VA,2019-11-30,intra-total,2166,365,141,47,26,8,7,9,5,26,1171,3971,3337,3702,FALSE,0.932258876857215,2019,2019-2020
VA,2019-11-30,intra-ucfe,11,5,3,0,0,1,0,0,0,0,7,27,18,23,FALSE,0.851851851851852,2019,2019-2020
VA,2019-11-30,intra-ucx,4,7,2,1,0,1,0,0,0,1,11,27,15,22,FALSE,0.814814814814815,2019,2019-2020
VA,2019-11-30,intra-ui,2151,353,136,46,26,6,7,9,5,25,1153,3917,3304,3657,FALSE,0.933622670411029,2019,2019-2020
VA,2019-12-31,inter-total,260,36,6,6,5,4,0,0,1,5,118,441,378,414,FALSE,0.938775510204082,2019,2019-2020
VA,2019-12-31,inter-ucfe,3,3,0,0,0,1,0,0,0,0,2,9,5,8,FALSE,0.888888888888889,2019,2019-2020
VA,2019-12-31,inter-ucx,0,0,0,0,0,0,0,0,0,0,0,0,0,0,FALSE,0,2019,2019-2020
VA,2019-12-31,inter-ui,257,33,6,6,5,3,0,0,1,5,116,432,373,406,FALSE,0.939814814814815,2019,2019-2020
VA,2019-12-31,intra-total,3792,462,164,62,29,13,16,10,6,29,1387,5970,5179,5641,FALSE,0.944891122278057,2019,2019-2020
VA,2019-12-31,intra-ucfe,23,8,3,1,0,0,0,0,0,3,13,51,36,44,FALSE,0.862745098039216,2019,2019-2020
VA,2019-12-31,intra-ucx,17,4,2,2,0,0,0,0,0,1,11,37,28,32,FALSE,0.864864864864865,2019,2019-2020
VA,2019-12-31,intra-ui,3752,450,159,59,29,13,16,10,6,25,1363,5882,5115,5565,FALSE,0.946106766405984,2019,2019-2020
VA,2020-01-31,inter-total,177,46,23,11,1,2,0,1,0,5,113,379,290,336,FALSE,0.886543535620053,2019,2019-2020
VA,2020-01-31,inter-ucfe,2,1,1,0,0,0,0,0,0,1,0,5,2,3,FALSE,0.6,2019,2019-2020
VA,2020-01-31,inter-ucx,0,0,0,0,0,0,0,0,0,0,0,0,0,0,FALSE,0,2019,2019-2020
VA,2020-01-31,inter-ui,175,45,22,11,1,2,0,1,0,4,113,374,288,333,FALSE,0.890374331550802,2019,2019-2020
VA,2020-01-31,intra-total,4209,508,233,85,36,15,15,16,6,24,1892,7039,6101,6609,FALSE,0.938911777241085,2019,2019-2020
VA,2020-01-31,intra-ucfe,14,3,3,0,0,0,1,0,0,0,9,30,23,26,FALSE,0.866666666666667,2019,2019-2020
VA,2020-01-31,intra-ucx,16,3,2,1,1,0,0,0,0,0,12,35,28,31,FALSE,0.885714285714286,2019,2019-2020
VA,2020-01-31,intra-ui,4179,502,228,84,35,15,14,16,6,24,1871,6974,6050,6552,FALSE,0.939489532549469,2019,2019-2020
VA,2020-02-29,inter-total,174,22,15,6,1,2,1,1,3,0,71,296,245,267,FALSE,0.902027027027027,2019,2019-2020
VA,2020-02-29,inter-ucfe,1,0,0,0,0,0,0,0,0,0,1,2,2,2,FALSE,1,2019,2019-2020
VA,2020-02-29,inter-ucx,0,0,0,0,0,0,0,0,0,0,0,0,0,0,FALSE,0,2019,2019-2020
VA,2020-02-29,inter-ui,173,22,15,6,1,2,1,1,3,0,70,294,243,265,FALSE,0.901360544217687,2019,2019-2020
VA,2020-02-29,intra-total,2985,523,227,88,39,20,9,11,5,29,1438,5374,4423,4946,FALSE,0.920357275772237,2019,2019-2020
VA,2020-02-29,intra-ucfe,15,1,4,2,2,1,0,0,0,0,6,31,21,22,FALSE,0.709677419354839,2019,2019-2020
VA,2020-02-29,intra-ucx,10,4,3,1,0,0,0,0,0,0,10,28,20,24,FALSE,0.857142857142857,2019,2019-2020
VA,2020-02-29,intra-ui,2960,518,220,85,37,19,9,11,5,29,1422,5315,4382,4900,FALSE,0.921919096895579,2019,2019-2020
VA,2020-03-31,inter-total,588,23,10,5,2,2,2,0,0,16,253,901,841,864,FALSE,0.958934517203108,2019,2019-2020
VA,2020-03-31,inter-ucfe,3,0,1,0,0,0,0,0,0,0,1,5,4,4,FALSE,0.8,2019,2019-2020
VA,2020-03-31,inter-ucx,0,0,0,0,0,0,0,0,0,0,0,0,0,0,FALSE,0,2019,2019-2020
VA,2020-03-31,inter-ui,585,23,9,5,2,2,2,0,0,16,252,896,837,860,FALSE,0.959821428571429,2019,2019-2020
VA,2020-03-31,intra-total,34384,519,195,64,34,32,20,15,5,158,18832,54258,53216,53735,FALSE,0.990360868443363,2019,2019-2020
VA,2020-03-31,intra-ucfe,17,5,0,2,1,0,0,0,0,2,12,39,29,34,FALSE,0.871794871794872,2019,2019-2020
VA,2020-03-31,intra-ucx,28,4,4,2,1,0,0,0,0,1,19,59,47,51,FALSE,0.864406779661017,2019,2019-2020
VA,2020-03-31,intra-ui,34339,510,191,60,32,32,20,15,5,155,18801,54160,53140,53650,FALSE,0.990583456425406,2019,2019-2020
VA,2020-04-30,inter-total,3727,239,99,28,91,81,3,0,0,6,937,5211,4664,4903,FALSE,0.940894262137786,2019,2019-2020
VA,2020-04-30,inter-ucfe,7,1,1,1,1,2,0,0,0,0,2,15,9,10,FALSE,0.666666666666667,2019,2019-2020
VA,2020-04-30,inter-ucx,0,0,0,0,0,0,0,0,0,0,0,0,0,0,FALSE,0,2019,2019-2020
VA,2020-04-30,inter-ui,3720,238,98,27,90,79,3,0,0,6,935,5196,4655,4893,FALSE,0.941685912240185,2019,2019-2020
VA,2020-04-30,intra-total,199006,17392,4981,893,1593,1320,17,8,9,87,70609,295915,269615,287007,FALSE,0.969896760894176,2019,2019-2020
VA,2020-04-30,intra-ucfe,33,36,13,7,8,3,1,0,0,1,43,145,76,112,FALSE,0.772413793103448,2019,2019-2020
VA,2020-04-30,intra-ucx,89,39,12,4,10,12,1,0,1,0,49,217,138,177,FALSE,0.815668202764977,2019,2019-2020
VA,2020-04-30,intra-ui,198884,17317,4956,882,1575,1305,15,8,8,86,70517,295553,269401,286718,FALSE,0.970106884382835,2019,2019-2020
VA,2020-05-31,inter-total,1630,121,104,38,32,38,22,9,2,5,390,2391,2020,2141,FALSE,0.895441237975742,2019,2019-2020
VA,2020-05-31,inter-ucfe,2,1,0,0,0,1,0,0,0,0,1,5,3,4,FALSE,0.8,2019,2019-2020
VA,2020-05-31,inter-ucx,5,1,0,0,0,0,0,0,0,0,1,7,6,7,FALSE,1,2019,2019-2020
VA,2020-05-31,inter-ui,1623,119,104,38,32,37,22,9,2,5,388,2379,2011,2130,FALSE,0.895334174022699,2019,2019-2020
VA,2020-05-31,intra-total,67838,5547,3268,1159,1289,904,519,159,38,58,17861,98640,85699,91246,FALSE,0.925040551500406,2019,2019-2020
VA,2020-05-31,intra-ucfe,17,13,14,10,16,5,7,2,1,1,12,98,29,42,FALSE,0.428571428571429,2019,2019-2020
VA,2020-05-31,intra-ucx,65,16,4,8,1,6,1,1,0,0,27,129,92,108,FALSE,0.837209302325582,2019,2019-2020
VA,2020-05-31,intra-ui,67756,5518,3250,1141,1272,893,511,156,37,57,17822,98413,85578,91096,FALSE,0.925650066556248,2019,2019-2020
VA,2020-06-30,inter-total,854,62,30,25,23,22,22,31,36,47,232,1384,1086,1148,FALSE,0.829479768786127,2019,2019-2020
VA,2020-06-30,inter-ucfe,3,0,0,0,0,0,0,0,2,0,1,6,4,4,FALSE,0.666666666666667,2019,2019-2020
VA,2020-06-30,inter-ucx,3,0,0,0,0,0,0,0,0,0,2,5,5,5,FALSE,1,2019,2019-2020
VA,2020-06-30,inter-ui,848,62,30,25,23,22,22,31,34,47,229,1373,1077,1139,FALSE,0.829570284049527,2019,2019-2020
VA,2020-06-30,intra-total,32437,2434,1016,407,411,429,490,749,666,1248,9881,50168,42318,44752,FALSE,0.892042736405677,2019,2019-2020
VA,2020-06-30,intra-ucfe,11,5,6,3,3,2,3,4,4,14,7,62,18,23,FALSE,0.370967741935484,2019,2019-2020
VA,2020-06-30,intra-ucx,49,22,3,6,1,1,2,2,2,8,33,129,82,104,FALSE,0.806201550387597,2019,2019-2020
VA,2020-06-30,intra-ui,32377,2407,1007,398,407,426,485,743,660,1226,9841,49977,42218,44625,FALSE,0.892910738939912,2019,2019-2020
VA,2020-07-31,inter-total,599,73,33,37,28,22,10,15,15,186,196,1214,795,868,FALSE,0.71499176276771,2020,2020-2021
VA,2020-07-31,inter-ucfe,0,0,0,0,0,0,0,0,0,3,1,4,1,1,FALSE,0.25,2020,2020-2021
VA,2020-07-31,inter-ucx,1,2,3,0,1,0,0,0,0,0,0,7,1,3,FALSE,0.428571428571429,2020,2020-2021
VA,2020-07-31,inter-ui,598,71,30,37,27,22,10,15,15,183,195,1203,793,864,FALSE,0.718204488778055,2020,2020-2021
VA,2020-07-31,intra-total,20145,2425,1247,937,820,675,404,379,492,4649,6556,38729,26701,29126,FALSE,0.752046270236774,2020,2020-2021
VA,2020-07-31,intra-ucfe,11,9,2,2,3,2,1,1,0,15,4,50,15,24,FALSE,0.48,2020,2020-2021
VA,2020-07-31,intra-ucx,17,24,8,4,2,2,0,0,1,8,15,81,32,56,FALSE,0.691358024691358,2020,2020-2021
VA,2020-07-31,intra-ui,20117,2392,1237,931,815,671,403,378,491,4626,6537,38598,26654,29046,FALSE,0.752526037618529,2020,2020-2021
VA,2020-08-31,inter-total,357,55,22,19,8,5,5,7,6,131,208,823,565,620,FALSE,0.753341433778858,2020,2020-2021
VA,2020-08-31,inter-ucfe,1,1,0,1,0,1,0,0,0,2,1,7,2,3,FALSE,0.428571428571429,2020,2020-2021
VA,2020-08-31,inter-ucx,0,0,1,2,0,0,0,0,0,0,2,5,2,2,FALSE,0.4,2020,2020-2021
VA,2020-08-31,inter-ui,356,54,21,16,8,4,5,7,6,129,205,811,561,615,FALSE,0.758323057953144,2020,2020-2021
VA,2020-08-31,intra-total,7967,1221,462,167,128,91,109,90,81,3160,4425,17901,12392,13613,FALSE,0.760460309479917,2020,2020-2021
VA,2020-08-31,intra-ucfe,8,8,3,2,6,2,1,2,0,33,6,71,14,22,FALSE,0.309859154929577,2020,2020-2021
VA,2020-08-31,intra-ucx,26,26,5,6,1,1,0,0,2,12,24,103,50,76,FALSE,0.737864077669903,2020,2020-2021
VA,2020-08-31,intra-ui,7933,1187,454,159,121,88,108,88,79,3115,4395,17727,12328,13515,FALSE,0.762396344559147,2020,2020-2021
VA,2020-09-30,inter-total,279,48,10,4,5,7,5,1,6,141,205,711,484,532,FALSE,0.748241912798875,2020,2020-2021
VA,2020-09-30,inter-ucfe,1,0,0,0,0,0,0,0,0,2,0,3,1,1,FALSE,0.333333333333333,2020,2020-2021
VA,2020-09-30,inter-ucx,0,1,0,0,0,0,1,0,1,1,2,6,2,3,FALSE,0.5,2020,2020-2021
VA,2020-09-30,inter-ui,278,47,10,4,5,7,4,1,5,138,203,702,481,528,FALSE,0.752136752136752,2020,2020-2021
VA,2020-09-30,intra-total,4758,632,209,81,66,64,58,59,62,2592,2593,11174,7351,7983,FALSE,0.714426346876678,2020,2020-2021
VA,2020-09-30,intra-ucfe,0,3,1,2,1,2,0,3,0,20,0,32,0,3,FALSE,0.09375,2020,2020-2021
VA,2020-09-30,intra-ucx,16,11,6,1,0,0,0,0,1,8,18,61,34,45,FALSE,0.737704918032787,2020,2020-2021
VA,2020-09-30,intra-ui,4742,618,202,78,65,62,58,56,61,2564,2575,11081,7317,7935,FALSE,0.716090605541016,2020,2020-2021
VA,2020-10-31,inter-total,292,58,20,6,4,2,3,2,5,114,283,789,575,633,FALSE,0.802281368821293,2020,2020-2021
VA,2020-10-31,inter-ucfe,0,0,0,0,0,0,0,0,0,2,1,3,1,1,FALSE,0.333333333333333,2020,2020-2021
VA,2020-10-31,inter-ucx,0,0,2,0,0,0,0,0,0,0,0,2,0,0,FALSE,0,2020,2020-2021
VA,2020-10-31,inter-ui,292,58,18,6,4,2,3,2,5,112,282,784,574,632,FALSE,0.806122448979592,2020,2020-2021
VA,2020-10-31,intra-total,3638,535,170,41,31,20,23,20,22,2299,2146,8945,5784,6319,FALSE,0.70642817216322,2020,2020-2021
VA,2020-10-31,intra-ucfe,5,5,4,1,2,0,0,0,2,15,3,37,8,13,FALSE,0.351351351351351,2020,2020-2021
VA,2020-10-31,intra-ucx,6,6,3,1,1,0,1,0,0,4,15,37,21,27,FALSE,0.72972972972973,2020,2020-2021
VA,2020-10-31,intra-ui,3627,524,163,39,28,20,22,20,20,2280,2128,8871,5755,6279,FALSE,0.707811971592831,2020,2020-2021
VA,2020-11-30,inter-total,296,120,27,10,4,1,5,0,1,95,440,999,736,856,FALSE,0.856856856856857,2020,2020-2021
VA,2020-11-30,inter-ucfe,1,0,0,0,1,0,0,0,0,0,0,2,1,1,FALSE,0.5,2020,2020-2021
VA,2020-11-30,inter-ucx,0,0,1,0,0,0,0,0,0,0,1,2,1,1,FALSE,0.5,2020,2020-2021
VA,2020-11-30,inter-ui,295,120,26,10,3,1,5,0,1,95,439,995,734,854,FALSE,0.858291457286432,2020,2020-2021
VA,2020-11-30,intra-total,3112,612,196,44,27,24,34,19,19,1688,2894,8669,6006,6618,FALSE,0.763409851193909,2020,2020-2021
VA,2020-11-30,intra-ucfe,10,10,4,3,1,0,1,0,0,6,8,43,18,28,FALSE,0.651162790697675,2020,2020-2021
VA,2020-11-30,intra-ucx,13,5,1,2,0,0,0,0,1,2,16,40,29,34,FALSE,0.85,2020,2020-2021
VA,2020-11-30,intra-ui,3089,597,191,39,26,24,33,19,18,1680,2870,8586,5959,6556,FALSE,0.763568600046587,2020,2020-2021
VA,2020-12-31,inter-total,396,209,32,1,5,0,7,1,2,110,538,1301,934,1143,FALSE,0.878554957724827,2020,2020-2021
VA,2020-12-31,inter-ucfe,1,0,1,0,0,0,0,0,0,5,0,7,1,1,FALSE,0.142857142857143,2020,2020-2021
VA,2020-12-31,inter-ucx,0,0,0,0,0,0,0,0,0,1,1,2,1,1,FALSE,0.5,2020,2020-2021
VA,2020-12-31,inter-ui,395,209,31,1,5,0,7,1,2,104,537,1292,932,1141,FALSE,0.88312693498452,2020,2020-2021
VA,2020-12-31,intra-total,3756,666,195,37,12,12,13,23,18,2108,2187,9027,5943,6609,FALSE,0.732136922565636,2020,2020-2021
VA,2020-12-31,intra-ucfe,16,10,4,3,1,0,1,4,0,15,10,64,26,36,FALSE,0.5625,2020,2020-2021
VA,2020-12-31,intra-ucx,3,6,0,0,0,1,1,0,1,3,11,26,14,20,FALSE,0.769230769230769,2020,2020-2021
VA,2020-12-31,intra-ui,3737,650,191,34,11,11,11,19,17,2090,2166,8937,5903,6553,FALSE,0.733243817835963,2020,2020-2021
VA,2021-01-31,inter-total,108,67,38,5,5,4,3,3,4,96,112,445,220,287,FALSE,0.644943820224719,2020,2020-2021
VA,2021-01-31,inter-ucfe,1,1,1,0,1,1,0,0,0,3,0,8,1,2,FALSE,0.25,2020,2020-2021
VA,2021-01-31,inter-ucx,1,0,0,0,0,0,0,0,0,0,0,1,1,1,FALSE,1,2020,2020-2021
VA,2021-01-31,inter-ui,106,66,37,5,4,3,3,3,4,93,112,436,218,284,FALSE,0.651376146788991,2020,2020-2021
VA,2021-01-31,intra-total,5257,1002,329,29,26,17,18,10,13,1483,3411,11595,8668,9670,FALSE,0.833980163863734,2020,2020-2021
VA,2021-01-31,intra-ucfe,10,12,1,3,1,1,2,0,1,26,9,66,19,31,FALSE,0.46969696969697,2020,2020-2021
VA,2021-01-31,intra-ucx,12,10,10,3,2,1,0,0,0,6,19,63,31,41,FALSE,0.650793650793651,2020,2020-2021
VA,2021-01-31,intra-ui,5235,980,318,23,23,15,16,10,12,1451,3383,11466,8618,9598,FALSE,0.837083551369266,2020,2020-2021
VA,2021-02-28,inter-total,191,44,21,13,7,4,4,4,1,194,182,665,373,417,FALSE,0.627067669172932,2020,2020-2021
VA,2021-02-28,inter-ucfe,0,0,1,0,0,0,0,0,0,10,0,11,0,0,FALSE,0,2020,2020-2021
VA,2021-02-28,inter-ucx,0,0,0,1,0,0,1,0,0,0,0,2,0,0,FALSE,0,2020,2020-2021
VA,2021-02-28,inter-ui,191,44,20,12,7,4,3,4,1,184,182,652,373,417,FALSE,0.639570552147239,2020,2020-2021
VA,2021-02-28,intra-total,3652,609,243,81,61,50,26,23,13,3578,2452,10788,6104,6713,FALSE,0.622265480163144,2020,2020-2021
VA,2021-02-28,intra-ucfe,8,12,1,3,0,1,0,0,0,30,12,67,20,32,FALSE,0.477611940298507,2020,2020-2021
VA,2021-02-28,intra-ucx,13,12,3,2,2,4,0,2,0,12,11,61,24,36,FALSE,0.59016393442623,2020,2020-2021
VA,2021-02-28,intra-ui,3631,585,239,76,59,45,26,21,13,3536,2429,10660,6060,6645,FALSE,0.623358348968105,2020,2020-2021
VA,2021-03-31,inter-total,987,286,61,8,3,6,8,8,12,148,1215,2742,2202,2488,FALSE,0.907366885485047,2020,2020-2021
VA,2021-03-31,inter-ucfe,1,0,0,0,0,0,0,0,0,2,1,4,2,2,FALSE,0.5,2020,2020-2021
VA,2021-03-31,inter-ucx,0,0,0,0,0,0,0,0,0,0,1,1,1,1,FALSE,1,2020,2020-2021
VA,2021-03-31,inter-ui,986,286,61,8,3,6,8,8,12,146,1213,2737,2199,2485,FALSE,0.907928388746803,2020,2020-2021
VA,2021-03-31,intra-total,6224,622,206,57,69,71,62,119,236,2595,2614,12875,8838,9460,FALSE,0.734757281553398,2020,2020-2021
VA,2021-03-31,intra-ucfe,2,4,6,3,2,2,2,0,0,9,1,31,3,7,FALSE,0.225806451612903,2020,2020-2021
VA,2021-03-31,intra-ucx,10,17,9,2,2,1,2,1,1,2,21,68,31,48,FALSE,0.705882352941177,2020,2020-2021
VA,2021-03-31,intra-ui,6212,601,191,52,65,68,58,118,235,2584,2592,12776,8804,9405,FALSE,0.7361458985598,2020,2020-2021
VA,2021-04-30,inter-total,1102,586,150,18,10,15,4,5,11,92,1989,3982,3091,3677,FALSE,0.92340532395781,2020,2020-2021
VA,2021-04-30,inter-ucfe,0,0,0,0,0,0,0,0,0,5,1,6,1,1,FALSE,0.166666666666667,2020,2020-2021
VA,2021-04-30,inter-ucx,0,0,0,0,0,0,0,0,0,0,0,0,0,0,FALSE,0,2020,2020-2021
VA,2021-04-30,inter-ui,1102,586,150,18,10,15,4,5,11,87,1988,3976,3090,3676,FALSE,0.924547283702213,2020,2020-2021
VA,2021-04-30,intra-total,7443,523,223,122,165,288,94,53,134,1125,1900,12070,9343,9866,FALSE,0.817398508699254,2020,2020-2021
VA,2021-04-30,intra-ucfe,6,1,2,2,1,1,1,0,0,10,4,28,10,11,FALSE,0.392857142857143,2020,2020-2021
VA,2021-04-30,intra-ucx,5,9,8,0,0,0,2,2,0,3,10,39,15,24,FALSE,0.615384615384615,2020,2020-2021
VA,2021-04-30,intra-ui,7432,513,213,120,164,287,91,51,134,1112,1886,12003,9318,9831,FALSE,0.819045238690327,2020,2020-2021
VA,2021-05-31,inter-total,191,253,53,24,16,10,5,10,5,175,410,1152,601,854,FALSE,0.741319444444445,2020,2020-2021
VA,2021-05-31,inter-ucfe,0,0,1,0,1,0,0,0,1,8,0,11,0,0,FALSE,0,2020,2020-2021
VA,2021-05-31,inter-ucx,0,1,0,0,0,0,0,0,0,0,0,1,0,1,FALSE,1,2020,2020-2021
VA,2021-05-31,inter-ui,191,252,52,24,15,10,5,10,4,167,410,1140,601,853,FALSE,0.748245614035088,2020,2020-2021
VA,2021-05-31,intra-total,4268,522,371,344,267,105,116,64,48,3213,1108,10426,5376,5898,FALSE,0.56570113178592,2020,2020-2021
VA,2021-05-31,intra-ucfe,4,2,3,0,2,0,1,0,1,29,2,44,6,8,FALSE,0.181818181818182,2020,2020-2021
VA,2021-05-31,intra-ucx,9,8,0,0,1,0,0,0,0,3,4,25,13,21,FALSE,0.84,2020,2020-2021
VA,2021-05-31,intra-ui,4255,512,368,344,264,105,115,64,47,3181,1102,10357,5357,5869,FALSE,0.566669885101863,2020,2020-2021
VA,2021-06-30,inter-total,118,10,9,8,6,16,22,17,22,388,70,686,188,198,FALSE,0.288629737609329,2020,2020-2021
VA,2021-06-30,inter-ucfe,0,0,0,0,0,0,0,0,0,13,0,13,0,0,FALSE,0,2020,2020-2021
VA,2021-06-30,inter-ucx,0,0,0,0,0,0,0,0,0,1,1,2,1,1,FALSE,0.5,2020,2020-2021
VA,2021-06-30,inter-ui,118,10,9,8,6,16,22,17,22,374,69,671,187,197,FALSE,0.293591654247392,2020,2020-2021
VA,2021-06-30,intra-total,2118,232,152,120,154,226,289,326,465,4560,671,9313,2789,3021,FALSE,0.324385267905079,2020,2020-2021
VA,2021-06-30,intra-ucfe,4,1,2,0,1,2,2,1,1,34,2,50,6,7,FALSE,0.14,2020,2020-2021
VA,2021-06-30,intra-ucx,4,2,1,1,1,0,1,3,2,8,7,30,11,13,FALSE,0.433333333333333,2020,2020-2021
VA,2021-06-30,intra-ui,2110,229,149,119,152,224,286,322,462,4518,662,9233,2772,3001,FALSE,0.325029784468753,2020,2020-2021
VA,2021-07-31,inter-total,87,31,36,31,29,21,27,22,22,550,62,918,149,180,FALSE,0.196078431372549,2021,2021-2022
VA,2021-07-31,inter-ucfe,0,0,0,0,0,0,0,0,0,3,0,3,0,0,FALSE,0,2021,2021-2022
VA,2021-07-31,inter-ucx,0,0,0,0,0,0,0,0,0,0,0,0,0,0,FALSE,0,2021,2021-2022
VA,2021-07-31,inter-ui,87,31,36,31,29,21,27,22,22,547,62,915,149,180,FALSE,0.19672131147541,2021,2021-2022
VA,2021-07-31,intra-total,1395,449,414,406,338,303,304,348,370,4318,634,9279,2029,2478,FALSE,0.267054639508568,2021,2021-2022
VA,2021-07-31,intra-ucfe,1,4,3,1,2,1,1,2,2,39,0,56,1,5,FALSE,0.0892857142857143,2021,2021-2022
VA,2021-07-31,intra-ucx,4,1,2,1,2,0,1,4,1,11,6,33,10,11,FALSE,0.333333333333333,2021,2021-2022
VA,2021-07-31,intra-ui,1390,444,409,404,334,302,302,342,367,4268,628,9190,2018,2462,FALSE,0.267899891186072,2021,2021-2022
VA,2021-08-31,inter-total,111,29,19,26,18,20,23,12,20,165,76,519,187,216,FALSE,0.416184971098266,2021,2021-2022
VA,2021-08-31,inter-ucfe,0,0,0,0,0,0,1,0,0,2,0,3,0,0,FALSE,0,2021,2021-2022
VA,2021-08-31,inter-ucx,0,0,0,0,0,0,0,0,0,0,0,0,0,0,FALSE,0,2021,2021-2022
VA,2021-08-31,inter-ui,111,29,19,26,18,20,22,12,20,163,76,516,187,216,FALSE,0.418604651162791,2021,2021-2022
VA,2021-08-31,intra-total,2216,467,369,278,258,203,187,195,207,1783,1040,7203,3256,3723,FALSE,0.516867971678467,2021,2021-2022
VA,2021-08-31,intra-ucfe,4,5,2,1,2,0,3,4,1,22,2,46,6,11,FALSE,0.239130434782609,2021,2021-2022
VA,2021-08-31,intra-ucx,5,7,5,2,1,3,2,0,0,7,4,36,9,16,FALSE,0.444444444444444,2021,2021-2022
VA,2021-08-31,intra-ui,2207,455,362,275,255,200,182,191,206,1754,1034,7121,3241,3696,FALSE,0.519028226372701,2021,2021-2022
VA,2021-09-30,inter-total,58,42,25,20,17,13,8,11,11,177,43,425,101,143,FALSE,0.336470588235294,2021,2021-2022
VA,2021-09-30,inter-ucfe,1,0,1,0,0,0,1,0,0,5,1,9,2,2,FALSE,0.222222222222222,2021,2021-2022
VA,2021-09-30,inter-ucx,0,0,0,0,0,1,0,0,0,0,0,1,0,0,FALSE,0,2021,2021-2022
VA,2021-09-30,inter-ui,57,42,24,20,17,12,7,11,11,172,42,415,99,141,FALSE,0.339759036144578,2021,2021-2022
VA,2021-09-30,intra-total,2072,384,304,284,270,202,153,143,141,1498,688,6139,2760,3144,FALSE,0.512135526958788,2021,2021-2022
VA,2021-09-30,intra-ucfe,0,0,6,2,0,2,0,1,0,25,1,37,1,1,FALSE,0.027027027027027,2021,2021-2022
VA,2021-09-30,intra-ucx,2,6,0,1,2,0,2,3,2,12,4,34,6,12,FALSE,0.352941176470588,2021,2021-2022
VA,2021-09-30,intra-ui,2070,378,298,281,268,200,151,139,139,1461,683,6068,2753,3131,FALSE,0.515985497692815,2021,2021-2022
VA,2021-10-31,inter-total,30,10,12,2,2,7,6,3,0,75,20,167,50,60,FALSE,0.359281437125749,2021,2021-2022
VA,2021-10-31,inter-ucfe,1,0,0,0,0,0,0,0,0,4,0,5,1,1,FALSE,0.2,2021,2021-2022
VA,2021-10-31,inter-ucx,0,0,0,0,0,0,0,0,0,1,0,1,0,0,FALSE,0,2021,2021-2022
VA,2021-10-31,inter-ui,29,10,12,2,2,7,6,3,0,70,20,161,49,59,FALSE,0.366459627329193,2021,2021-2022
VA,2021-10-31,intra-total,769,94,94,62,55,52,56,41,39,729,201,2192,970,1064,FALSE,0.485401459854015,2021,2021-2022
VA,2021-10-31,intra-ucfe,2,3,2,0,0,0,3,0,0,20,1,31,3,6,FALSE,0.193548387096774,2021,2021-2022
VA,2021-10-31,intra-ucx,4,3,1,0,1,1,0,0,0,6,2,18,6,9,FALSE,0.5,2021,2021-2022
VA,2021-10-31,intra-ui,763,88,91,62,54,51,53,41,39,703,198,2143,961,1049,FALSE,0.489500699953337,2021,2021-2022
VA,2021-11-30,inter-total,14,5,6,5,0,4,2,2,1,494,8,541,22,27,FALSE,0.0499075785582255,2021,2021-2022
VA,2021-11-30,inter-ucfe,0,0,0,1,0,0,0,0,0,1,0,2,0,0,FALSE,0,2021,2021-2022
VA,2021-11-30,inter-ucx,0,0,0,0,0,0,0,0,0,1,0,1,0,0,FALSE,0,2021,2021-2022
VA,2021-11-30,inter-ui,14,5,6,4,0,4,2,2,1,492,8,538,22,27,FALSE,0.050185873605948,2021,2021-2022
VA,2021-11-30,intra-total,127,63,61,68,54,33,10,17,13,6817,61,7324,188,251,FALSE,0.0342708902239214,2021,2021-2022
VA,2021-11-30,intra-ucfe,1,1,1,1,1,0,0,0,0,20,0,25,1,2,FALSE,0.08,2021,2021-2022
VA,2021-11-30,intra-ucx,0,1,1,0,0,0,0,0,0,5,2,9,2,3,FALSE,0.333333333333333,2021,2021-2022
VA,2021-11-30,intra-ui,126,61,59,67,53,33,10,17,13,6792,59,7290,185,246,FALSE,0.0337448559670782,2021,2021-2022
VA,2021-12-31,inter-total,155,30,4,0,2,1,0,0,0,8,79,279,234,264,FALSE,0.946236559139785,2021,2021-2022
VA,2021-12-31,inter-ucfe,0,0,1,0,0,0,0,0,0,0,0,1,0,0,FALSE,0,2021,2021-2022
VA,2021-12-31,inter-ucx,0,0,0,0,0,0,0,0,0,1,0,1,0,0,FALSE,0,2021,2021-2022
VA,2021-12-31,inter-ui,155,30,3,0,2,1,0,0,0,7,79,277,234,264,FALSE,0.953068592057762,2021,2021-2022
VA,2021-12-31,intra-total,14057,1029,35,10,2,2,1,6,11,102,15259,30514,29316,30345,FALSE,0.994461558628826,2021,2021-2022
VA,2021-12-31,intra-ucfe,0,0,0,0,0,0,0,0,0,0,0,0,0,0,FALSE,0,2021,2021-2022
VA,2021-12-31,intra-ucx,0,1,0,0,0,0,0,1,0,1,0,3,0,1,FALSE,0.333333333333333,2021,2021-2022
VA,2021-12-31,intra-ui,14057,1028,35,10,2,2,1,5,11,101,15259,30511,29316,30344,FALSE,0.994526564189964,2021,2021-2022
VA,2022-01-31,inter-total,21,6,1,3,7,3,4,8,2,77,11,143,32,38,FALSE,0.265734265734266,2021,2021-2022
VA,2022-01-31,inter-ucfe,1,0,0,0,0,0,0,0,0,0,0,1,1,1,FALSE,1,2021,2021-2022
VA,2022-01-31,inter-ucx,0,0,0,0,0,0,0,0,0,3,0,3,0,0,FALSE,0,2021,2021-2022
VA,2022-01-31,inter-ui,20,6,1,3,7,3,4,8,2,74,11,139,31,37,FALSE,0.266187050359712,2021,2021-2022
VA,2022-01-31,intra-total,182,96,55,23,20,28,36,31,30,603,78,1182,260,356,FALSE,0.301184433164129,2021,2021-2022
VA,2022-01-31,intra-ucfe,0,0,0,0,0,0,0,0,0,2,2,4,2,2,FALSE,0.5,2021,2021-2022
VA,2022-01-31,intra-ucx,2,0,0,0,0,0,0,0,0,3,1,6,3,3,FALSE,0.5,2021,2021-2022
VA,2022-01-31,intra-ui,180,96,55,23,20,28,36,31,30,598,75,1172,255,351,FALSE,0.299488054607509,2021,2021-2022
VA,2022-02-28,inter-total,49,15,24,24,16,18,14,5,10,94,23,292,72,87,FALSE,0.297945205479452,2021,2021-2022
VA,2022-02-28,inter-ucfe,0,0,1,0,0,0,0,0,0,0,0,1,0,0,FALSE,0,2021,2021-2022
VA,2022-02-28,inter-ucx,0,0,0,0,0,0,0,0,0,0,0,0,0,0,FALSE,0,2021,2021-2022
VA,2022-02-28,inter-ui,49,15,23,24,16,18,14,5,10,94,23,291,72,87,FALSE,0.298969072164948,2021,2021-2022
VA,2022-02-28,intra-total,320,184,253,249,226,137,118,55,55,1357,169,3123,489,673,FALSE,0.215497918667948,2021,2021-2022
VA,2022-02-28,intra-ucfe,2,0,1,2,2,0,2,1,1,4,1,16,3,3,FALSE,0.1875,2021,2021-2022
VA,2022-02-28,intra-ucx,1,0,1,2,1,1,0,0,0,2,1,9,2,2,FALSE,0.222222222222222,2021,2021-2022
VA,2022-02-28,intra-ui,317,184,251,245,223,136,116,54,54,1351,167,3098,484,668,FALSE,0.2156229825694,2021,2021-2022
VA,2022-03-31,inter-total,50,32,23,30,39,26,31,25,12,150,57,475,107,139,FALSE,0.292631578947368,2021,2021-2022
VA,2022-03-31,inter-ucfe,0,1,0,2,0,1,1,0,1,3,0,9,0,1,FALSE,0.111111111111111,2021,2021-2022
VA,2022-03-31,inter-ucx,0,0,0,0,0,0,0,0,0,0,0,0,0,0,FALSE,0,2021,2021-2022
VA,2022-03-31,inter-ui,50,31,23,28,39,25,30,25,11,147,57,466,107,138,FALSE,0.296137339055794,2021,2021-2022
VA,2022-03-31,intra-total,467,328,224,267,340,291,293,206,166,1231,533,4346,1000,1328,FALSE,0.305568338702255,2021,2021-2022
VA,2022-03-31,intra-ucfe,4,2,3,1,0,1,2,1,0,6,2,22,6,8,FALSE,0.363636363636364,2021,2021-2022
VA,2022-03-31,intra-ucx,5,1,1,1,1,2,1,2,3,5,8,30,13,14,FALSE,0.466666666666667,2021,2021-2022
VA,2022-03-31,intra-ui,458,325,220,265,339,288,290,203,163,1220,523,4294,981,1306,FALSE,0.304145319049837,2021,2021-2022
VA,2022-04-30,inter-total,75,19,12,6,3,5,6,5,6,206,50,393,125,144,FALSE,0.366412213740458,2021,2021-2022
VA,2022-04-30,inter-ucfe,0,0,0,0,0,0,1,0,1,4,0,6,0,0,FALSE,0,2021,2021-2022
VA,2022-04-30,inter-ucx,0,0,0,0,0,0,0,0,0,0,0,0,0,0,FALSE,0,2021,2021-2022
VA,2022-04-30,inter-ui,75,19,12,6,3,5,5,5,5,202,50,387,125,144,FALSE,0.372093023255814,2021,2021-2022
VA,2022-04-30,intra-total,773,174,109,80,51,58,36,56,37,953,488,2815,1261,1435,FALSE,0.509769094138544,2021,2021-2022
VA,2022-04-30,intra-ucfe,7,2,1,1,0,0,1,0,0,6,8,26,15,17,FALSE,0.653846153846154,2021,2021-2022
VA,2022-04-30,intra-ucx,5,1,0,1,0,0,0,0,2,2,3,14,8,9,FALSE,0.642857142857143,2021,2021-2022
VA,2022-04-30,intra-ui,761,171,108,78,51,58,35,56,35,945,477,2775,1238,1409,FALSE,0.507747747747748,2021,2021-2022
VA,2022-05-31,inter-total,87,12,7,4,3,7,4,2,0,117,51,294,138,150,FALSE,0.510204081632653,2021,2021-2022
VA,2022-05-31,inter-ucfe,0,1,0,0,0,0,0,0,0,0,0,1,0,1,FALSE,1,2021,2021-2022
VA,2022-05-31,inter-ucx,0,0,0,0,0,0,0,0,0,0,0,0,0,0,FALSE,0,2021,2021-2022
VA,2022-05-31,inter-ui,87,11,7,4,3,7,4,2,0,117,51,293,138,149,FALSE,0.508532423208191,2021,2021-2022
VA,2022-05-31,intra-total,1271,129,51,47,34,45,59,40,18,768,546,3008,1817,1946,FALSE,0.646941489361702,2021,2021-2022
VA,2022-05-31,intra-ucfe,3,5,0,1,2,0,0,0,1,6,2,20,5,10,FALSE,0.5,2021,2021-2022
VA,2022-05-31,intra-ucx,7,0,1,0,0,0,0,0,0,1,7,16,14,14,FALSE,0.875,2021,2021-2022
VA,2022-05-31,intra-ui,1261,124,50,46,32,45,59,40,17,761,537,2972,1798,1922,FALSE,0.646702557200538,2021,2021-2022
VA,2022-06-30,inter-total,70,16,9,1,1,3,7,1,6,106,48,268,118,134,FALSE,0.5,2021,2021-2022
VA,2022-06-30,inter-ucfe,2,0,0,0,0,0,0,0,0,0,0,2,2,2,FALSE,1,2021,2021-2022
VA,2022-06-30,inter-ucx,0,0,0,0,0,0,0,0,0,0,0,0,0,0,FALSE,0,2021,2021-2022
VA,2022-06-30,inter-ui,68,16,9,1,1,3,7,1,6,106,48,266,116,132,FALSE,0.496240601503759,2021,2021-2022
VA,2022-06-30,intra-total,1085,247,119,47,41,42,36,43,50,736,664,3110,1749,1996,FALSE,0.641800643086817,2021,2021-2022
VA,2022-06-30,intra-ucfe,9,3,1,2,0,0,2,1,1,4,12,35,21,24,FALSE,0.685714285714286,2021,2021-2022
VA,2022-06-30,intra-ucx,7,5,0,1,0,1,0,0,2,4,2,22,9,14,FALSE,0.636363636363636,2021,2021-2022
VA,2022-06-30,intra-ui,1069,239,118,44,41,41,34,42,47,728,650,3053,1719,1958,FALSE,0.641336390435637,2021,2021-2022
VA,2022-07-31,inter-total,58,18,14,12,6,5,10,7,5,241,36,412,94,112,FALSE,0.271844660194175,2022,2022-2023
VA,2022-07-31,inter-ucfe,2,0,2,0,0,0,0,0,0,3,1,8,3,3,FALSE,0.375,2022,2022-2023
VA,2022-07-31,inter-ucx,0,0,0,0,0,0,0,0,0,0,0,0,0,0,FALSE,0,2022,2022-2023
VA,2022-07-31,inter-ui,56,18,12,12,6,5,10,7,5,238,35,404,91,109,FALSE,0.26980198019802,2022,2022-2023
VA,2022-07-31,intra-total,1526,252,164,119,97,102,85,96,67,1869,595,4972,2121,2373,FALSE,0.477272727272727,2022,2022-2023
VA,2022-07-31,intra-ucfe,6,4,2,3,0,0,1,0,0,5,4,25,10,14,FALSE,0.56,2022,2022-2023
VA,2022-07-31,intra-ucx,10,3,1,0,1,0,1,1,2,9,4,32,14,17,FALSE,0.53125,2022,2022-2023
VA,2022-07-31,intra-ui,1510,245,161,116,96,102,83,95,65,1855,587,4915,2097,2342,FALSE,0.476500508646999,2022,2022-2023
VA,2022-08-31,inter-total,71,17,17,17,4,6,5,7,2,204,35,385,106,123,FALSE,0.31948051948052,2022,2022-2023
VA,2022-08-31,inter-ucfe,3,0,0,0,0,0,0,0,0,2,0,5,3,3,FALSE,0.6,2022,2022-2023
VA,2022-08-31,inter-ucx,0,0,0,0,0,0,0,0,0,0,0,0,0,0,FALSE,0,2022,2022-2023
VA,2022-08-31,inter-ui,68,17,17,17,4,6,5,7,2,202,35,380,103,120,FALSE,0.315789473684211,2022,2022-2023
VA,2022-08-31,intra-total,3352,274,195,154,81,66,63,51,56,849,765,5906,4117,4391,FALSE,0.743481205553674,2022,2022-2023
VA,2022-08-31,intra-ucfe,12,2,5,2,0,0,3,1,0,9,10,44,22,24,FALSE,0.545454545454545,2022,2022-2023
VA,2022-08-31,intra-ucx,16,0,1,1,0,0,0,0,0,4,7,29,23,23,FALSE,0.793103448275862,2022,2022-2023
VA,2022-08-31,intra-ui,3324,272,189,151,81,66,60,50,56,836,748,5833,4072,4344,FALSE,0.744728270186868,2022,2022-2023
VA,2022-09-30,inter-total,43,13,6,3,5,7,2,7,3,207,37,333,80,93,FALSE,0.279279279279279,2022,2022-2023
VA,2022-09-30,inter-ucfe,0,0,0,0,1,0,0,1,1,0,0,3,0,0,FALSE,0,2022,2022-2023
VA,2022-09-30,inter-ucx,0,0,0,0,0,0,0,0,0,0,0,0,0,0,FALSE,0,2022,2022-2023
VA,2022-09-30,inter-ui,43,13,6,3,4,7,2,6,2,207,37,330,80,93,FALSE,0.281818181818182,2022,2022-2023
VA,2022-09-30,intra-total,1063,204,133,96,117,111,90,52,52,1307,631,3856,1694,1898,FALSE,0.492219917012448,2022,2022-2023
VA,2022-09-30,intra-ucfe,3,1,1,2,1,1,1,0,0,14,5,29,8,9,FALSE,0.310344827586207,2022,2022-2023
VA,2022-09-30,intra-ucx,12,0,1,1,1,0,0,1,0,10,6,32,18,18,FALSE,0.5625,2022,2022-2023
VA,2022-09-30,intra-ui,1048,203,131,93,115,110,89,51,52,1283,620,3795,1668,1871,FALSE,0.493017127799737,2022,2022-2023
VA,2022-10-31,inter-total,30,10,7,7,3,11,3,1,1,115,33,221,63,73,FALSE,0.330316742081448,2022,2022-2023
VA,2022-10-31,inter-ucfe,1,0,0,0,0,0,0,0,0,0,0,1,1,1,FALSE,1,2022,2022-2023
VA,2022-10-31,inter-ucx,0,0,0,0,0,0,0,0,0,1,0,1,0,0,FALSE,0,2022,2022-2023
VA,2022-10-31,inter-ui,29,10,7,7,3,11,3,1,1,114,33,219,62,72,FALSE,0.328767123287671,2022,2022-2023
VA,2022-10-31,intra-total,586,168,127,75,58,48,30,36,30,558,448,2164,1034,1202,FALSE,0.555452865064695,2022,2022-2023
VA,2022-10-31,intra-ucfe,0,1,0,1,2,2,1,0,0,6,1,14,1,2,FALSE,0.142857142857143,2022,2022-2023
VA,2022-10-31,intra-ucx,2,1,0,2,0,1,0,0,0,3,4,13,6,7,FALSE,0.538461538461538,2022,2022-2023
VA,2022-10-31,intra-ui,584,166,127,72,56,45,29,36,30,549,443,2137,1027,1193,FALSE,0.558259241927936,2022,2022-2023
VA,2022-11-30,inter-total,36,25,14,5,3,3,1,4,2,40,32,165,68,93,FALSE,0.563636363636364,2022,2022-2023
VA,2022-11-30,inter-ucfe,1,0,0,0,0,0,0,0,0,0,0,1,1,1,FALSE,1,2022,2022-2023
VA,2022-11-30,inter-ucx,0,0,0,0,0,0,0,0,0,0,0,0,0,0,FALSE,0,2022,2022-2023
VA,2022-11-30,inter-ui,35,25,14,5,3,3,1,4,2,40,32,164,67,92,FALSE,0.560975609756098,2022,2022-2023
VA,2022-11-30,intra-total,717,388,247,120,68,37,24,17,16,273,492,2399,1209,1597,FALSE,0.665694039182993,2022,2022-2023
VA,2022-11-30,intra-ucfe,2,1,0,1,1,0,0,0,0,3,0,8,2,3,FALSE,0.375,2022,2022-2023
VA,2022-11-30,intra-ucx,4,1,0,0,0,1,0,0,0,1,4,11,8,9,FALSE,0.818181818181818,2022,2022-2023
VA,2022-11-30,intra-ui,711,386,247,119,67,36,24,17,16,269,488,2380,1199,1585,FALSE,0.665966386554622,2022,2022-2023
VA,2022-12-31,inter-total,52,26,23,23,13,7,5,5,5,58,48,265,100,126,FALSE,0.475471698113208,2022,2022-2023
VA,2022-12-31,inter-ucfe,0,0,0,0,0,0,0,0,2,3,1,6,1,1,FALSE,0.166666666666667,2022,2022-2023
VA,2022-12-31,inter-ucx,0,0,0,0,0,1,0,0,0,0,0,1,0,0,FALSE,0,2022,2022-2023
VA,2022-12-31,inter-ui,52,26,23,23,13,6,5,5,3,55,47,258,99,125,FALSE,0.484496124031008,2022,2022-2023
VA,2022-12-31,intra-total,729,395,317,228,176,73,65,31,30,652,661,3357,1390,1785,FALSE,0.531724754244861,2022,2022-2023
VA,2022-12-31,intra-ucfe,5,1,1,0,1,1,2,0,0,6,4,21,9,10,FALSE,0.476190476190476,2022,2022-2023
VA,2022-12-31,intra-ucx,8,2,0,1,2,2,0,0,0,1,4,20,12,14,FALSE,0.7,2022,2022-2023
VA,2022-12-31,intra-ui,716,392,316,227,173,70,63,31,30,645,653,3316,1369,1761,FALSE,0.531061519903498,2022,2022-2023
VA,2023-01-31,inter-total,41,22,27,33,21,15,8,4,3,87,24,285,65,87,FALSE,0.305263157894737,2022,2022-2023
VA,2023-01-31,inter-ucfe,1,0,0,1,0,0,0,0,0,1,0,3,1,1,FALSE,0.333333333333333,2022,2022-2023
VA,2023-01-31,inter-ucx,0,0,0,0,0,0,0,0,0,0,0,0,0,0,FALSE,0,2022,2022-2023
VA,2023-01-31,inter-ui,40,22,27,32,21,15,8,4,3,86,24,282,64,86,FALSE,0.304964539007092,2022,2022-2023
VA,2023-01-31,intra-total,703,481,429,464,412,218,156,96,52,696,527,4234,1230,1711,FALSE,0.404109589041096,2022,2022-2023
VA,2023-01-31,intra-ucfe,1,2,5,2,0,6,0,0,1,10,0,27,1,3,FALSE,0.111111111111111,2022,2022-2023
VA,2023-01-31,intra-ucx,3,2,1,2,3,1,0,1,0,8,2,23,5,7,FALSE,0.304347826086957,2022,2022-2023
VA,2023-01-31,intra-ui,699,477,423,460,409,211,156,95,51,678,525,4184,1224,1701,FALSE,0.406548757170172,2022,2022-2023
VA,2023-02-28,inter-total,40,67,60,45,28,20,22,17,2,80,45,426,85,152,FALSE,0.356807511737089,2022,2022-2023
VA,2023-02-28,inter-ucfe,1,0,0,0,0,3,1,0,0,1,0,6,1,1,FALSE,0.166666666666667,2022,2022-2023
VA,2023-02-28,inter-ucx,0,0,0,0,0,0,0,0,0,0,0,0,0,0,FALSE,0,2022,2022-2023
VA,2023-02-28,inter-ui,39,67,60,45,28,17,21,17,2,79,45,420,84,151,FALSE,0.35952380952381,2022,2022-2023
VA,2023-02-28,intra-total,540,928,774,477,316,283,182,117,64,1011,919,5611,1459,2387,FALSE,0.425414364640884,2022,2022-2023
VA,2023-02-28,intra-ucfe,1,0,4,1,0,2,0,1,0,11,1,21,2,2,FALSE,0.0952380952380952,2022,2022-2023
VA,2023-02-28,intra-ucx,3,0,5,2,1,1,0,0,0,3,4,19,7,7,FALSE,0.368421052631579,2022,2022-2023
VA,2023-02-28,intra-ui,536,928,765,474,315,280,182,116,64,997,914,5571,1450,2378,FALSE,0.426853347693412,2022,2022-2023
VA,2023-03-31,inter-total,50,53,61,36,21,17,14,11,8,98,86,455,136,189,FALSE,0.415384615384615,2022,2022-2023
VA,2023-03-31,inter-ucfe,0,0,1,1,0,2,0,0,0,6,0,10,0,0,FALSE,0,2022,2022-2023
VA,2023-03-31,inter-ucx,0,0,0,0,0,0,0,0,0,0,0,0,0,0,FALSE,0,2022,2022-2023
VA,2023-03-31,inter-ui,50,53,60,35,21,15,14,11,8,92,86,445,136,189,FALSE,0.424719101123596,2022,2022-2023
VA,2023-03-31,intra-total,791,874,621,388,235,167,152,110,90,996,1204,5628,1995,2869,FALSE,0.509772565742715,2022,2022-2023
VA,2023-03-31,intra-ucfe,0,1,3,3,0,0,1,1,2,14,2,27,2,3,FALSE,0.111111111111111,2022,2022-2023
VA,2023-03-31,intra-ucx,9,3,2,2,0,2,1,1,1,15,6,42,15,18,FALSE,0.428571428571429,2022,2022-2023
VA,2023-03-31,intra-ui,782,870,616,383,235,165,150,108,87,967,1196,5559,1978,2848,FALSE,0.512322360136715,2022,2022-2023
VA,2023-04-30,inter-total,77,42,35,19,13,10,14,7,10,88,106,421,183,225,FALSE,0.534441805225653,2022,2022-2023
VA,2023-04-30,inter-ucfe,0,2,1,0,1,0,0,1,0,0,0,5,0,2,FALSE,0.4,2022,2022-2023
VA,2023-04-30,inter-ucx,1,0,0,0,0,0,0,0,0,0,0,1,1,1,FALSE,1,2022,2022-2023
VA,2023-04-30,inter-ui,76,40,34,19,12,10,14,6,10,88,106,415,182,222,FALSE,0.534939759036145,2022,2022-2023
VA,2023-04-30,intra-total,1241,613,338,188,130,91,77,81,77,885,1212,4933,2453,3066,FALSE,0.621528481654166,2022,2022-2023
VA,2023-04-30,intra-ucfe,3,3,0,4,2,0,2,0,0,7,2,23,5,8,FALSE,0.347826086956522,2022,2022-2023
VA,2023-04-30,intra-ucx,5,0,4,2,1,0,0,0,0,2,2,16,7,7,FALSE,0.4375,2022,2022-2023
VA,2023-04-30,intra-ui,1233,610,334,182,127,91,75,81,77,876,1208,4894,2441,3051,FALSE,0.623416428279526,2022,2022-2023
VA,2023-05-31,inter-total,113,40,17,5,3,5,3,2,3,44,93,328,206,246,FALSE,0.75,2022,2022-2023
VA,2023-05-31,inter-ucfe,0,0,1,0,0,0,0,0,0,2,1,4,1,1,FALSE,0.25,2022,2022-2023
VA,2023-05-31,inter-ucx,0,0,0,0,0,0,0,0,0,0,0,0,0,0,FALSE,0,2022,2022-2023
VA,2023-05-31,inter-ui,113,40,16,5,3,5,3,2,3,42,92,324,205,245,FALSE,0.756172839506173,2022,2022-2023
VA,2023-05-31,intra-total,1666,561,216,70,63,45,26,20,25,408,1262,4362,2928,3489,FALSE,0.799862448418157,2022,2022-2023
VA,2023-05-31,intra-ucfe,6,4,3,1,1,2,2,0,1,4,3,27,9,13,FALSE,0.481481481481482,2022,2022-2023
VA,2023-05-31,intra-ucx,10,8,5,2,3,1,0,0,1,4,4,38,14,22,FALSE,0.578947368421053,2022,2022-2023
VA,2023-05-31,intra-ui,1650,549,208,67,59,42,24,20,23,400,1255,4297,2905,3454,FALSE,0.803816616243891,2022,2022-2023
VA,2023-06-30,inter-total,104,53,26,8,3,2,1,0,5,30,89,321,193,246,FALSE,0.766355140186916,2022,2022-2023
VA,2023-06-30,inter-ucfe,0,2,1,0,0,0,0,0,1,1,2,7,2,4,FALSE,0.571428571428571,2022,2022-2023
VA,2023-06-30,inter-ucx,0,0,0,0,0,0,0,0,0,0,0,0,0,0,FALSE,0,2022,2022-2023
VA,2023-06-30,inter-ui,104,51,25,8,3,2,1,0,4,29,87,314,191,242,FALSE,0.770700636942675,2022,2022-2023
VA,2023-06-30,intra-total,1414,681,314,137,69,48,34,15,10,244,1550,4516,2964,3645,FALSE,0.807130203720106,2022,2022-2023
VA,2023-06-30,intra-ucfe,0,2,3,2,1,1,3,0,0,3,5,20,5,7,FALSE,0.35,2022,2022-2023
VA,2023-06-30,intra-ucx,3,4,2,1,3,1,0,0,0,1,1,16,4,8,FALSE,0.5,2022,2022-2023
VA,2023-06-30,intra-ui,1411,675,309,134,65,46,31,15,10,240,1544,4480,2955,3630,FALSE,0.810267857142857,2022,2022-2023
VA,2023-07-31,inter-total,95,22,14,4,10,1,5,0,1,20,106,278,201,223,FALSE,0.802158273381295,2023,2023-2024
VA,2023-07-31,inter-ucfe,0,0,0,0,0,0,0,0,0,2,0,2,0,0,FALSE,0,2023,2023-2024
VA,2023-07-31,inter-ucx,0,0,0,0,0,0,0,0,0,0,0,0,0,0,FALSE,0,2023,2023-2024
VA,2023-07-31,inter-ui,95,22,14,4,10,1,5,0,1,18,106,276,201,223,FALSE,0.807971014492754,2023,2023-2024
VA,2023-07-31,intra-total,1492,459,220,111,77,33,24,17,14,184,1397,4028,2889,3348,FALSE,0.831181727904667,2023,2023-2024
VA,2023-07-31,intra-ucfe,2,4,3,0,1,0,0,0,0,6,3,19,5,9,FALSE,0.473684210526316,2023,2023-2024
VA,2023-07-31,intra-ucx,14,3,2,0,0,0,1,0,0,5,5,30,19,22,FALSE,0.733333333333333,2023,2023-2024
VA,2023-07-31,intra-ui,1476,452,215,111,76,33,23,17,14,173,1389,3979,2865,3317,FALSE,0.83362653933149,2023,2023-2024
VA,2023-08-31,inter-total,90,35,15,13,4,6,4,1,2,24,82,276,172,207,FALSE,0.75,2023,2023-2024
VA,2023-08-31,inter-ucfe,0,0,0,0,0,0,0,0,0,0,0,0,0,0,FALSE,0,2023,2023-2024
VA,2023-08-31,inter-ucx,2,1,0,0,0,0,0,0,0,0,0,3,2,3,FALSE,1,2023,2023-2024
VA,2023-08-31,inter-ui,88,34,15,13,4,6,4,1,2,24,82,273,170,204,FALSE,0.747252747252747,2023,2023-2024
VA,2023-08-31,intra-total,1377,453,266,127,87,49,23,21,22,240,1190,3855,2567,3020,FALSE,0.783398184176394,2023,2023-2024
VA,2023-08-31,intra-ucfe,3,4,7,3,1,1,0,0,0,2,6,27,9,13,FALSE,0.481481481481482,2023,2023-2024
VA,2023-08-31,intra-ucx,9,0,1,0,0,0,0,0,0,4,13,27,22,22,FALSE,0.814814814814815,2023,2023-2024
VA,2023-08-31,intra-ui,1365,449,258,124,86,48,23,21,22,234,1171,3801,2536,2985,FALSE,0.785319652722968,2023,2023-2024
VA,2023-09-30,inter-total,71,31,24,15,15,14,3,3,1,19,69,265,140,171,FALSE,0.645283018867925,2023,2023-2024
VA,2023-09-30,inter-ucfe,2,0,0,0,1,0,0,0,0,1,1,5,3,3,FALSE,0.6,2023,2023-2024
VA,2023-09-30,inter-ucx,0,0,0,0,0,0,0,0,0,0,0,0,0,0,FALSE,0,2023,2023-2024
VA,2023-09-30,inter-ui,69,31,24,15,14,14,3,3,1,18,68,260,137,168,FALSE,0.646153846153846,2023,2023-2024
VA,2023-09-30,intra-total,1383,432,311,241,220,147,56,31,21,220,1125,4187,2508,2940,FALSE,0.70217339383807,2023,2023-2024
VA,2023-09-30,intra-ucfe,3,0,0,1,2,0,0,3,0,4,3,16,6,6,FALSE,0.375,2023,2023-2024
VA,2023-09-30,intra-ucx,8,2,2,1,0,2,0,0,0,2,6,23,14,16,FALSE,0.695652173913044,2023,2023-2024
VA,2023-09-30,intra-ui,1372,430,309,239,218,145,56,28,21,214,1116,4148,2488,2918,FALSE,0.703471552555448,2023,2023-2024
VA,2023-10-31,inter-total,54,40,17,13,13,6,2,4,2,21,75,247,129,169,FALSE,0.68421052631579,2023,2023-2024
VA,2023-10-31,inter-ucfe,0,0,0,0,1,0,0,0,0,0,4,5,4,4,FALSE,0.8,2023,2023-2024
VA,2023-10-31,inter-ucx,0,0,0,0,0,0,0,0,0,0,0,0,0,0,FALSE,0,2023,2023-2024
VA,2023-10-31,inter-ui,54,40,17,13,12,6,2,4,2,21,71,242,125,165,FALSE,0.681818181818182,2023,2023-2024
VA,2023-10-31,intra-total,1098,570,254,175,140,89,77,50,44,269,1180,3946,2278,2848,FALSE,0.721743537759757,2023,2023-2024
VA,2023-10-31,intra-ucfe,2,7,5,3,2,1,0,2,1,2,3,28,5,12,FALSE,0.428571428571429,2023,2023-2024
VA,2023-10-31,intra-ucx,11,6,2,0,0,0,1,0,0,2,8,30,19,25,FALSE,0.833333333333333,2023,2023-2024
VA,2023-10-31,intra-ui,1085,557,247,172,138,88,76,48,43,265,1169,3888,2254,2811,FALSE,0.722993827160494,2023,2023-2024
VA,2023-11-30,inter-total,55,32,15,16,12,12,5,3,2,33,78,263,133,165,FALSE,0.627376425855513,2023,2023-2024
VA,2023-11-30,inter-ucfe,0,0,0,0,0,1,0,0,1,1,0,3,0,0,FALSE,0,2023,2023-2024
VA,2023-11-30,inter-ucx,0,0,0,0,0,0,0,0,0,0,0,0,0,0,FALSE,0,2023,2023-2024
VA,2023-11-30,inter-ui,55,32,15,16,12,11,5,3,1,32,78,260,133,165,FALSE,0.634615384615385,2023,2023-2024
VA,2023-11-30,intra-total,1132,478,246,144,95,83,37,44,34,209,1107,3609,2239,2717,FALSE,0.752840121917429,2023,2023-2024
VA,2023-11-30,intra-ucfe,4,5,2,1,0,0,0,0,0,2,5,19,9,14,FALSE,0.736842105263158,2023,2023-2024
VA,2023-11-30,intra-ucx,6,0,0,2,0,3,0,2,0,0,3,16,9,9,FALSE,0.5625,2023,2023-2024
VA,2023-11-30,intra-ui,1122,473,244,141,95,80,37,42,34,207,1099,3574,2221,2694,FALSE,0.753777280358142,2023,2023-2024
VA,2023-12-31,inter-total,92,18,13,5,5,7,4,4,2,47,62,259,154,172,FALSE,0.664092664092664,2023,2023-2024
VA,2023-12-31,inter-ucfe,1,1,0,0,0,0,0,0,0,0,1,3,2,3,FALSE,1,2023,2023-2024
VA,2023-12-31,inter-ucx,0,0,0,0,0,0,0,0,0,0,0,0,0,0,FALSE,0,2023,2023-2024
VA,2023-12-31,inter-ui,91,17,13,5,5,7,4,4,2,47,61,256,152,169,FALSE,0.66015625,2023,2023-2024
VA,2023-12-31,intra-total,1807,364,244,147,83,61,40,23,17,359,1021,4166,2828,3192,FALSE,0.766202592414786,2023,2023-2024
VA,2023-12-31,intra-ucfe,8,3,1,0,0,0,0,0,0,6,8,26,16,19,FALSE,0.730769230769231,2023,2023-2024
VA,2023-12-31,intra-ucx,5,0,2,0,0,0,1,0,0,3,5,16,10,10,FALSE,0.625,2023,2023-2024
VA,2023-12-31,intra-ui,1794,361,241,147,83,61,39,23,17,350,1008,4124,2802,3163,FALSE,0.766973811833172,2023,2023-2024
VA,2024-01-31,inter-total,145,17,11,8,0,5,2,4,2,73,117,384,262,279,FALSE,0.7265625,2023,2023-2024
VA,2024-01-31,inter-ucfe,3,1,0,0,0,0,0,1,0,0,0,5,3,4,FALSE,0.8,2023,2023-2024
VA,2024-01-31,inter-ucx,0,0,0,0,0,0,0,0,0,0,0,0,0,0,FALSE,0,2023,2023-2024
VA,2024-01-31,inter-ui,142,16,11,8,0,5,2,3,2,73,117,379,259,275,FALSE,0.725593667546174,2023,2023-2024
VA,2024-01-31,intra-total,3255,350,113,57,28,32,26,14,15,546,1794,6230,5049,5399,FALSE,0.86661316211878,2023,2023-2024
VA,2024-01-31,intra-ucfe,10,3,2,2,0,0,0,1,0,7,5,30,15,18,FALSE,0.6,2023,2023-2024
VA,2024-01-31,intra-ucx,14,1,1,0,0,0,0,0,0,6,13,35,27,28,FALSE,0.8,2023,2023-2024
VA,2024-01-31,intra-ui,3231,346,110,55,28,32,26,13,15,533,1776,6165,5007,5353,FALSE,0.868288726682887,2023,2023-2024
VA,2024-02-29,inter-total,167,16,9,4,2,1,0,3,3,19,95,319,262,278,FALSE,0.871473354231975,2023,2023-2024
VA,2024-02-29,inter-ucfe,0,0,0,0,0,0,0,0,0,1,1,2,1,1,FALSE,0.5,2023,2023-2024
VA,2024-02-29,inter-ucx,0,0,0,0,0,0,0,0,0,0,0,0,0,0,FALSE,0,2023,2023-2024
VA,2024-02-29,inter-ui,167,16,9,4,2,1,0,3,3,18,94,317,261,277,FALSE,0.873817034700316,2023,2023-2024
VA,2024-02-29,intra-total,2806,267,119,33,28,12,10,8,4,134,1255,4676,4061,4328,FALSE,0.925577416595381,2023,2023-2024
VA,2024-02-29,intra-ucfe,7,6,1,0,0,0,0,0,0,5,15,34,22,28,FALSE,0.823529411764706,2023,2023-2024
VA,2024-02-29,intra-ucx,11,0,0,0,1,0,0,0,0,0,7,19,18,18,FALSE,0.947368421052632,2023,2023-2024
VA,2024-02-29,intra-ui,2788,261,118,33,27,12,10,8,4,129,1233,4623,4021,4282,FALSE,0.926238373350638,2023,2023-2024
VA,2024-03-31,inter-total,141,23,6,8,6,4,2,3,0,26,93,312,234,257,FALSE,0.823717948717949,2023,2023-2024
VA,2024-03-31,inter-ucfe,0,0,0,0,0,0,0,0,0,1,1,2,1,1,FALSE,0.5,2023,2023-2024
VA,2024-03-31,inter-ucx,0,0,0,0,0,0,0,0,0,0,0,0,0,0,FALSE,0,2023,2023-2024
VA,2024-03-31,inter-ui,141,23,6,8,6,4,2,3,0,25,92,310,233,256,FALSE,0.825806451612903,2023,2023-2024
VA,2024-03-31,intra-total,2389,279,94,37,36,20,19,15,13,225,1194,4321,3583,3862,FALSE,0.893774589215459,2023,2023-2024
VA,2024-03-31,intra-ucfe,5,3,1,0,0,0,0,1,0,4,7,21,12,15,FALSE,0.714285714285714,2023,2023-2024
VA,2024-03-31,intra-ucx,11,1,0,0,0,0,0,0,0,3,7,22,18,19,FALSE,0.863636363636364,2023,2023-2024
VA,2024-03-31,intra-ui,2373,275,93,37,36,20,19,14,13,218,1180,4278,3553,3828,FALSE,0.894810659186536,2023,2023-2024
VA,2024-04-30,inter-total,188,15,9,2,5,4,3,2,2,35,99,364,287,302,FALSE,0.82967032967033,2023,2023-2024
VA,2024-04-30,inter-ucfe,0,0,1,0,0,0,0,0,0,1,1,3,1,1,FALSE,0.333333333333333,2023,2023-2024
VA,2024-04-30,inter-ucx,1,0,0,0,0,0,0,0,0,0,0,1,1,1,FALSE,1,2023,2023-2024
VA,2024-04-30,inter-ui,187,15,8,2,5,4,3,2,2,34,98,360,285,300,FALSE,0.833333333333333,2023,2023-2024
VA,2024-04-30,intra-total,2688,219,66,29,22,10,12,7,9,231,981,4274,3669,3888,FALSE,0.909686476368741,2023,2023-2024
VA,2024-04-30,intra-ucfe,4,4,2,1,0,0,0,0,0,5,4,20,8,12,FALSE,0.6,2023,2023-2024
VA,2024-04-30,intra-ucx,18,2,0,0,0,0,0,0,0,1,9,30,27,29,FALSE,0.966666666666667,2023,2023-2024
VA,2024-04-30,intra-ui,2666,213,64,28,22,10,12,7,9,225,968,4224,3634,3847,FALSE,0.910748106060606,2023,2023-2024
VA,2024-05-31,inter-total,158,20,7,4,4,2,2,3,3,25,91,319,249,269,FALSE,0.843260188087774,2023,2023-2024
VA,2024-05-31,inter-ucfe,0,0,0,0,0,0,0,0,0,0,3,3,3,3,FALSE,1,2023,2023-2024
VA,2024-05-31,inter-ucx,0,0,0,0,1,0,0,0,0,0,0,1,0,0,FALSE,0,2023,2023-2024
VA,2024-05-31,inter-ui,158,20,7,4,3,2,2,3,3,25,88,315,246,266,FALSE,0.844444444444445,2023,2023-2024
VA,2024-05-31,intra-total,2586,306,127,44,25,12,10,10,10,267,1221,4618,3807,4113,FALSE,0.890645300996102,2023,2023-2024
VA,2024-05-31,intra-ucfe,2,4,2,3,0,0,1,0,0,9,2,23,4,8,FALSE,0.347826086956522,2023,2023-2024
VA,2024-05-31,intra-ucx,7,3,0,2,0,0,0,0,0,2,8,22,15,18,FALSE,0.818181818181818,2023,2023-2024
VA,2024-05-31,intra-ui,2577,299,125,39,25,12,9,10,10,256,1211,4573,3788,4087,FALSE,0.893724032363875,2023,2023-2024
VA,2024-06-30,inter-total,141,21,10,1,4,2,2,2,0,14,78,275,219,240,FALSE,0.872727272727273,2023,2023-2024
VA,2024-06-30,inter-ucfe,1,0,0,0,0,0,0,0,0,0,0,1,1,1,FALSE,1,2023,2023-2024
VA,2024-06-30,inter-ucx,0,0,0,0,0,0,0,0,0,0,0,0,0,0,FALSE,0,2023,2023-2024
VA,2024-06-30,inter-ui,140,21,10,1,4,2,2,2,0,14,78,274,218,239,FALSE,0.872262773722628,2023,2023-2024
VA,2024-06-30,intra-total,2212,259,95,42,22,12,4,6,1,225,1124,4002,3336,3595,FALSE,0.898300849575212,2023,2023-2024
VA,2024-06-30,intra-ucfe,5,3,1,0,0,0,0,0,0,3,8,20,13,16,FALSE,0.8,2023,2023-2024
VA,2024-06-30,intra-ucx,10,0,1,0,0,0,0,0,0,0,7,18,17,17,FALSE,0.944444444444444,2023,2023-2024
VA,2024-06-30,intra-ui,2197,256,93,42,22,12,4,6,1,222,1109,3964,3306,3562,FALSE,0.898587285570131,2023,2023-2024
VA,2024-07-31,inter-total,207,15,8,2,4,3,0,0,1,48,90,378,297,312,FALSE,0.825396825396825,2024,2024-2025
VA,2024-07-31,inter-ucfe,1,0,1,0,0,0,0,0,0,1,1,4,2,2,FALSE,0.5,2024,2024-2025
VA,2024-07-31,inter-ucx,0,0,0,0,0,0,0,0,0,1,1,2,1,1,FALSE,0.5,2024,2024-2025
VA,2024-07-31,inter-ui,206,15,7,2,4,3,0,0,1,46,88,372,294,309,FALSE,0.830645161290323,2024,2024-2025
VA,2024-07-31,intra-total,2770,304,125,37,20,8,14,11,8,626,1259,5182,4029,4333,FALSE,0.836163643380934,2024,2024-2025
VA,2024-07-31,intra-ucfe,10,5,1,2,0,1,1,1,0,4,7,32,17,22,FALSE,0.6875,2024,2024-2025
VA,2024-07-31,intra-ucx,14,3,0,2,0,0,0,0,0,2,4,25,18,21,FALSE,0.84,2024,2024-2025
VA,2024-07-31,intra-ui,2746,296,124,33,20,7,13,10,8,620,1248,5125,3994,4290,FALSE,0.837073170731707,2024,2024-2025
VA,2024-08-31,inter-total,180,21,8,3,0,1,4,0,0,24,58,299,238,259,FALSE,0.866220735785953,2024,2024-2025
VA,2024-08-31,inter-ucfe,0,1,0,0,0,0,0,0,0,0,0,1,0,1,FALSE,1,2024,2024-2025
VA,2024-08-31,inter-ucx,0,0,0,0,0,0,0,0,0,0,0,0,0,0,FALSE,0,2024,2024-2025
VA,2024-08-31,inter-ui,180,20,8,3,0,1,4,0,0,24,58,298,238,258,FALSE,0.865771812080537,2024,2024-2025
VA,2024-08-31,intra-total,2548,276,111,31,13,13,16,12,9,302,929,4260,3477,3753,FALSE,0.880985915492958,2024,2024-2025
VA,2024-08-31,intra-ucfe,4,4,1,2,1,0,0,0,0,3,4,19,8,12,FALSE,0.631578947368421,2024,2024-2025
VA,2024-08-31,intra-ucx,12,2,1,1,0,0,0,0,0,4,4,24,16,18,FALSE,0.75,2024,2024-2025
VA,2024-08-31,intra-ui,2532,270,109,28,12,13,16,12,9,295,921,4217,3453,3723,FALSE,0.882855110267963,2024,2024-2025
VA,2024-09-30,inter-total,165,22,10,4,1,0,1,2,1,35,86,327,251,273,FALSE,0.834862385321101,2024,2024-2025
VA,2024-09-30,inter-ucfe,0,1,0,1,0,0,0,0,0,1,1,4,1,2,FALSE,0.5,2024,2024-2025
VA,2024-09-30,inter-ucx,0,0,0,0,0,0,0,0,0,0,1,1,1,1,FALSE,1,2024,2024-2025
VA,2024-09-30,inter-ui,165,21,10,3,1,0,1,2,1,34,84,322,249,270,FALSE,0.838509316770186,2024,2024-2025
VA,2024-09-30,intra-total,2179,271,149,47,16,16,7,9,5,207,1126,4032,3305,3576,FALSE,0.886904761904762,2024,2024-2025
VA,2024-09-30,intra-ucfe,6,6,1,1,4,0,0,0,1,3,3,25,9,15,FALSE,0.6,2024,2024-2025
VA,2024-09-30,intra-ucx,13,2,2,0,0,0,0,0,0,2,5,24,18,20,FALSE,0.833333333333333,2024,2024-2025
VA,2024-09-30,intra-ui,2160,263,146,46,12,16,7,9,4,202,1118,3983,3278,3541,FALSE,0.889028370574944,2024,2024-2025
VA,2024-10-31,inter-total,168,26,7,5,1,1,0,5,1,24,113,351,281,307,FALSE,0.874643874643875,2024,2024-2025
VA,2024-10-31,inter-ucfe,0,0,1,0,0,0,0,0,0,2,0,3,0,0,FALSE,0,2024,2024-2025
VA,2024-10-31,inter-ucx,1,0,0,0,0,0,0,0,0,0,0,1,1,1,FALSE,1,2024,2024-2025
VA,2024-10-31,inter-ui,167,26,6,5,1,1,0,5,1,22,113,347,280,306,FALSE,0.881844380403458,2024,2024-2025
VA,2024-10-31,intra-total,1789,243,227,103,54,33,26,22,18,343,3372,6230,5161,5404,FALSE,0.867415730337079,2024,2024-2025
VA,2024-10-31,intra-ucfe,4,2,3,5,1,0,0,1,0,6,8,30,12,14,FALSE,0.466666666666667,2024,2024-2025
VA,2024-10-31,intra-ucx,4,2,2,0,1,1,0,2,0,1,12,25,16,18,FALSE,0.72,2024,2024-2025
VA,2024-10-31,intra-ui,1781,239,222,98,52,32,26,19,18,336,3352,6175,5133,5372,FALSE,0.869959514170041,2024,2024-2025
VA,2024-11-30,inter-total,129,16,11,3,3,1,1,2,1,28,84,279,213,229,FALSE,0.82078853046595,2024,2024-2025
VA,2024-11-30,inter-ucfe,1,1,0,0,0,0,0,1,1,1,3,8,4,5,FALSE,0.625,2024,2024-2025
VA,2024-11-30,inter-ucx,0,0,0,0,0,0,0,0,0,0,0,0,0,0,FALSE,0,2024,2024-2025
VA,2024-11-30,inter-ui,128,15,11,3,3,1,1,1,0,27,81,271,209,224,FALSE,0.826568265682657,2024,2024-2025
VA,2024-11-30,intra-total,1364,131,207,118,52,30,23,15,17,207,1595,3759,2959,3090,FALSE,0.822027134876297,2024,2024-2025
VA,2024-11-30,intra-ucfe,9,0,3,1,0,1,0,0,1,4,4,23,13,13,FALSE,0.565217391304348,2024,2024-2025
VA,2024-11-30,intra-ucx,4,0,3,0,2,1,0,0,0,2,4,16,8,8,FALSE,0.5,2024,2024-2025
VA,2024-11-30,intra-ui,1351,131,201,117,50,28,23,15,16,201,1587,3720,2938,3069,FALSE,0.825,2024,2024-2025
VA,2024-12-31,inter-total,165,28,13,6,6,5,2,0,2,16,108,351,273,301,FALSE,0.857549857549858,2024,2024-2025
VA,2024-12-31,inter-ucfe,1,2,2,1,0,0,0,0,0,0,0,6,1,3,FALSE,0.5,2024,2024-2025
VA,2024-12-31,inter-ucx,0,0,0,0,0,0,0,0,0,0,0,0,0,0,FALSE,0,2024,2024-2025
VA,2024-12-31,inter-ui,164,26,11,5,6,5,2,0,2,16,108,345,272,298,FALSE,0.863768115942029,2024,2024-2025
VA,2024-12-31,intra-total,2047,331,120,39,30,22,14,26,22,143,1279,4073,3326,3657,FALSE,0.897863982322612,2024,2024-2025
VA,2024-12-31,intra-ucfe,10,2,0,4,0,0,0,1,0,4,2,23,12,14,FALSE,0.608695652173913,2024,2024-2025
VA,2024-12-31,intra-ucx,3,4,2,0,0,0,0,0,0,1,3,13,6,10,FALSE,0.769230769230769,2024,2024-2025
VA,2024-12-31,intra-ui,2034,325,118,35,30,22,14,25,22,138,1274,4037,3308,3633,FALSE,0.899925687391628,2024,2024-2025
VI,2019-01-31,inter-total,1,0,2,1,1,0,0,0,0,0,0,5,1,1,FALSE,0.2,2018,2018-2019
VI,2019-01-31,inter-ucfe,0,0,0,0,0,0,0,0,0,0,0,0,0,0,FALSE,0,2018,2018-2019
VI,2019-01-31,inter-ucx,0,0,0,0,0,0,0,0,0,0,0,0,0,0,FALSE,0,2018,2018-2019
VI,2019-01-31,inter-ui,1,0,2,1,1,0,0,0,0,0,0,5,1,1,FALSE,0.2,2018,2018-2019
VI,2019-01-31,intra-total,33,8,1,5,1,1,0,0,0,1,18,68,51,59,FALSE,0.867647058823529,2018,2018-2019
VI,2019-01-31,intra-ucfe,0,0,0,0,0,0,0,0,0,0,0,0,0,0,FALSE,0,2018,2018-2019
VI,2019-01-31,intra-ucx,0,0,0,0,0,0,0,0,0,0,0,0,0,0,FALSE,0,2018,2018-2019
VI,2019-01-31,intra-ui,33,8,1,5,1,1,0,0,0,1,18,68,51,59,FALSE,0.867647058823529,2018,2018-2019
VI,2019-02-28,inter-total,9,0,0,0,0,0,0,0,0,0,3,12,12,12,FALSE,1,2018,2018-2019
VI,2019-02-28,inter-ucfe,2,0,0,0,0,0,0,0,0,0,0,2,2,2,FALSE,1,2018,2018-2019
VI,2019-02-28,inter-ucx,0,0,0,0,0,0,0,0,0,0,0,0,0,0,FALSE,0,2018,2018-2019
VI,2019-02-28,inter-ui,7,0,0,0,0,0,0,0,0,0,3,10,10,10,FALSE,1,2018,2018-2019
VI,2019-02-28,intra-total,76,2,0,0,1,0,1,0,0,2,19,101,95,97,FALSE,0.96039603960396,2018,2018-2019
VI,2019-02-28,intra-ucfe,0,0,0,0,0,0,0,0,0,0,0,0,0,0,FALSE,0,2018,2018-2019
VI,2019-02-28,intra-ucx,0,1,0,0,0,0,0,0,0,0,0,1,0,1,FALSE,1,2018,2018-2019
VI,2019-02-28,intra-ui,76,1,0,0,1,0,1,0,0,2,19,100,95,96,FALSE,0.96,2018,2018-2019
VI,2019-03-31,inter-total,3,1,0,1,0,0,0,0,0,0,0,5,3,4,FALSE,0.8,2018,2018-2019
VI,2019-03-31,inter-ucfe,0,0,0,0,0,0,0,0,0,0,0,0,0,0,FALSE,0,2018,2018-2019
VI,2019-03-31,inter-ucx,0,0,0,0,0,0,0,0,0,0,0,0,0,0,FALSE,0,2018,2018-2019
VI,2019-03-31,inter-ui,3,1,0,1,0,0,0,0,0,0,0,5,3,4,FALSE,0.8,2018,2018-2019
VI,2019-03-31,intra-total,52,3,1,0,1,0,0,0,0,2,19,78,71,74,FALSE,0.948717948717949,2018,2018-2019
VI,2019-03-31,intra-ucfe,0,0,0,0,0,0,0,0,0,0,1,1,1,1,FALSE,1,2018,2018-2019
VI,2019-03-31,intra-ucx,1,0,0,0,0,0,0,0,0,0,0,1,1,1,FALSE,1,2018,2018-2019
VI,2019-03-31,intra-ui,51,3,1,0,1,0,0,0,0,2,18,76,69,72,FALSE,0.947368421052632,2018,2018-2019
VI,2019-04-30,inter-total,3,0,2,2,0,0,0,0,0,0,4,11,7,7,FALSE,0.636363636363636,2018,2018-2019
VI,2019-04-30,inter-ucfe,1,0,0,0,0,0,0,0,0,0,0,1,1,1,FALSE,1,2018,2018-2019
VI,2019-04-30,inter-ucx,0,0,0,0,0,0,0,0,0,0,0,0,0,0,FALSE,0,2018,2018-2019
VI,2019-04-30,inter-ui,2,0,2,2,0,0,0,0,0,0,4,10,6,6,FALSE,0.6,2018,2018-2019
VI,2019-04-30,intra-total,30,7,3,5,0,3,0,0,0,2,33,83,63,70,FALSE,0.843373493975904,2018,2018-2019
VI,2019-04-30,intra-ucfe,0,0,0,0,0,0,0,0,0,0,0,0,0,0,FALSE,0,2018,2018-2019
VI,2019-04-30,intra-ucx,0,0,0,0,0,0,0,0,0,0,0,0,0,0,FALSE,0,2018,2018-2019
VI,2019-04-30,intra-ui,30,7,3,5,0,3,0,0,0,2,33,83,63,70,FALSE,0.843373493975904,2018,2018-2019
VI,2019-05-31,inter-total,5,5,3,3,0,0,0,1,0,0,4,21,9,14,FALSE,0.666666666666667,2018,2018-2019
VI,2019-05-31,inter-ucfe,0,0,0,0,0,0,0,0,0,0,0,0,0,0,FALSE,0,2018,2018-2019
VI,2019-05-31,inter-ucx,0,0,0,0,0,0,0,0,0,0,0,0,0,0,FALSE,0,2018,2018-2019
VI,2019-05-31,inter-ui,5,5,3,3,0,0,0,1,0,0,4,21,9,14,FALSE,0.666666666666667,2018,2018-2019
VI,2019-05-31,intra-total,48,8,2,1,0,1,0,0,0,2,33,95,81,89,FALSE,0.936842105263158,2018,2018-2019
VI,2019-05-31,intra-ucfe,0,0,0,0,0,0,0,0,0,0,0,0,0,0,FALSE,0,2018,2018-2019
VI,2019-05-31,intra-ucx,0,0,0,0,0,0,0,0,0,0,0,0,0,0,FALSE,0,2018,2018-2019
VI,2019-05-31,intra-ui,48,8,2,1,0,1,0,0,0,2,33,95,81,89,FALSE,0.936842105263158,2018,2018-2019
VI,2019-06-30,inter-total,1,3,1,2,0,1,0,0,0,0,4,12,5,8,FALSE,0.666666666666667,2018,2018-2019
VI,2019-06-30,inter-ucfe,0,0,0,0,0,1,0,0,0,0,1,2,1,1,FALSE,0.5,2018,2018-2019
VI,2019-06-30,inter-ucx,0,0,0,0,0,0,0,0,0,0,0,0,0,0,FALSE,0,2018,2018-2019
VI,2019-06-30,inter-ui,1,3,1,2,0,0,0,0,0,0,3,10,4,7,FALSE,0.7,2018,2018-2019
VI,2019-06-30,intra-total,27,5,4,0,0,1,0,0,0,0,23,60,50,55,FALSE,0.916666666666667,2018,2018-2019
VI,2019-06-30,intra-ucfe,0,0,0,0,0,0,0,0,0,0,0,0,0,0,FALSE,0,2018,2018-2019
VI,2019-06-30,intra-ucx,0,0,0,0,0,0,0,0,0,0,0,0,0,0,FALSE,0,2018,2018-2019
VI,2019-06-30,intra-ui,27,5,4,0,0,1,0,0,0,0,23,60,50,55,FALSE,0.916666666666667,2018,2018-2019
VI,2019-07-31,inter-total,3,2,0,0,1,0,1,0,0,0,1,8,4,6,FALSE,0.75,2019,2019-2020
VI,2019-07-31,inter-ucfe,0,0,0,0,0,0,0,0,0,0,0,0,0,0,FALSE,0,2019,2019-2020
VI,2019-07-31,inter-ucx,0,0,0,0,0,0,0,0,0,0,0,0,0,0,FALSE,0,2019,2019-2020
VI,2019-07-31,inter-ui,3,2,0,0,1,0,1,0,0,0,1,8,4,6,FALSE,0.75,2019,2019-2020
VI,2019-07-31,intra-total,58,11,5,1,1,1,0,0,1,4,32,114,90,101,FALSE,0.885964912280702,2019,2019-2020
VI,2019-07-31,intra-ucfe,0,0,0,0,0,0,0,0,0,0,0,0,0,0,FALSE,0,2019,2019-2020
VI,2019-07-31,intra-ucx,1,0,0,0,0,0,0,0,0,1,0,2,1,1,FALSE,0.5,2019,2019-2020
VI,2019-07-31,intra-ui,57,11,5,1,1,1,0,0,1,3,32,112,89,100,FALSE,0.892857142857143,2019,2019-2020
VI,2019-08-31,inter-total,3,0,1,2,1,0,0,0,0,1,4,12,7,7,FALSE,0.583333333333333,2019,2019-2020
VI,2019-08-31,inter-ucfe,0,0,1,0,0,0,0,0,0,0,0,1,0,0,FALSE,0,2019,2019-2020
VI,2019-08-31,inter-ucx,0,0,0,0,0,0,0,0,0,0,0,0,0,0,FALSE,0,2019,2019-2020
VI,2019-08-31,inter-ui,3,0,0,2,1,0,0,0,0,1,4,11,7,7,FALSE,0.636363636363636,2019,2019-2020
VI,2019-08-31,intra-total,54,7,5,2,0,0,1,0,0,0,19,88,73,80,FALSE,0.909090909090909,2019,2019-2020
VI,2019-08-31,intra-ucfe,0,0,0,0,0,0,0,0,0,0,1,1,1,1,FALSE,1,2019,2019-2020
VI,2019-08-31,intra-ucx,0,1,0,1,0,0,0,0,0,0,0,2,0,1,FALSE,0.5,2019,2019-2020
VI,2019-08-31,intra-ui,54,6,5,1,0,0,1,0,0,0,18,85,72,78,FALSE,0.917647058823529,2019,2019-2020
VI,2019-09-30,inter-total,1,2,1,2,1,1,0,0,0,0,1,9,2,4,FALSE,0.444444444444444,2019,2019-2020
VI,2019-09-30,inter-ucfe,0,0,0,0,0,0,0,0,0,0,0,0,0,0,FALSE,0,2019,2019-2020
VI,2019-09-30,inter-ucx,0,0,0,0,0,0,0,0,0,0,0,0,0,0,FALSE,0,2019,2019-2020
VI,2019-09-30,inter-ui,1,2,1,2,1,1,0,0,0,0,1,9,2,4,FALSE,0.444444444444444,2019,2019-2020
VI,2019-09-30,intra-total,42,8,2,1,3,2,0,0,0,2,24,84,66,74,FALSE,0.880952380952381,2019,2019-2020
VI,2019-09-30,intra-ucfe,0,0,0,0,0,0,0,0,0,0,0,0,0,0,FALSE,0,2019,2019-2020
VI,2019-09-30,intra-ucx,0,0,0,0,0,0,0,0,0,0,0,0,0,0,FALSE,0,2019,2019-2020
VI,2019-09-30,intra-ui,42,8,2,1,3,2,0,0,0,2,24,84,66,74,FALSE,0.880952380952381,2019,2019-2020
VI,2019-10-31,inter-total,3,1,2,5,0,0,1,0,0,0,4,16,7,8,FALSE,0.5,2019,2019-2020
VI,2019-10-31,inter-ucfe,0,0,0,0,0,0,0,0,0,0,0,0,0,0,FALSE,0,2019,2019-2020
VI,2019-10-31,inter-ucx,0,0,0,0,0,0,0,0,0,0,0,0,0,0,FALSE,0,2019,2019-2020
VI,2019-10-31,inter-ui,3,1,2,5,0,0,1,0,0,0,4,16,7,8,FALSE,0.5,2019,2019-2020
VI,2019-10-31,intra-total,70,20,4,4,5,3,0,0,1,1,51,159,121,141,FALSE,0.886792452830189,2019,2019-2020
VI,2019-10-31,intra-ucfe,0,0,0,0,1,0,0,0,0,0,0,1,0,0,FALSE,0,2019,2019-2020
VI,2019-10-31,intra-ucx,0,0,0,0,0,0,0,0,0,0,0,0,0,0,FALSE,0,2019,2019-2020
VI,2019-10-31,intra-ui,70,20,4,4,4,3,0,0,1,1,51,158,121,141,FALSE,0.892405063291139,2019,2019-2020
VI,2019-11-30,inter-total,3,2,3,3,1,0,0,0,0,2,5,19,8,10,FALSE,0.526315789473684,2019,2019-2020
VI,2019-11-30,inter-ucfe,0,0,0,0,0,0,0,0,0,0,0,0,0,0,FALSE,0,2019,2019-2020
VI,2019-11-30,inter-ucx,0,0,0,0,0,0,0,0,0,0,0,0,0,0,FALSE,0,2019,2019-2020
VI,2019-11-30,inter-ui,3,2,3,3,1,0,0,0,0,2,5,19,8,10,FALSE,0.526315789473684,2019,2019-2020
VI,2019-11-30,intra-total,47,11,6,3,2,0,1,0,1,0,27,98,74,85,FALSE,0.86734693877551,2019,2019-2020
VI,2019-11-30,intra-ucfe,0,0,0,0,0,0,0,0,0,0,0,0,0,0,FALSE,0,2019,2019-2020
VI,2019-11-30,intra-ucx,0,0,0,1,0,0,0,0,0,0,0,1,0,0,FALSE,0,2019,2019-2020
VI,2019-11-30,intra-ui,47,11,6,2,2,0,1,0,1,0,27,97,74,85,FALSE,0.876288659793815,2019,2019-2020
VI,2019-12-31,inter-total,1,2,7,3,1,4,0,0,0,0,5,23,6,8,FALSE,0.347826086956522,2019,2019-2020
VI,2019-12-31,inter-ucfe,0,0,0,0,0,0,0,0,0,0,0,0,0,0,FALSE,0,2019,2019-2020
VI,2019-12-31,inter-ucx,0,0,0,0,0,0,0,0,0,0,0,0,0,0,FALSE,0,2019,2019-2020
VI,2019-12-31,inter-ui,1,2,7,3,1,4,0,0,0,0,5,23,6,8,FALSE,0.347826086956522,2019,2019-2020
VI,2019-12-31,intra-total,20,10,9,4,0,0,1,1,1,2,20,68,40,50,FALSE,0.735294117647059,2019,2019-2020
VI,2019-12-31,intra-ucfe,0,0,0,0,0,0,0,0,1,0,0,1,0,0,FALSE,0,2019,2019-2020
VI,2019-12-31,intra-ucx,0,0,0,0,0,0,0,0,0,0,0,0,0,0,FALSE,0,2019,2019-2020
VI,2019-12-31,intra-ui,20,10,9,4,0,0,1,1,0,2,20,67,40,50,FALSE,0.746268656716418,2019,2019-2020
VI,2020-01-31,inter-total,10,5,4,2,3,1,0,2,1,1,2,31,12,17,FALSE,0.548387096774194,2019,2019-2020
VI,2020-01-31,inter-ucfe,0,0,0,0,0,0,0,0,0,1,0,1,0,0,FALSE,0,2019,2019-2020
VI,2020-01-31,inter-ucx,0,0,0,0,0,0,0,0,0,0,0,0,0,0,FALSE,0,2019,2019-2020
VI,2020-01-31,inter-ui,10,5,4,2,3,1,0,2,1,0,2,30,12,17,FALSE,0.566666666666667,2019,2019-2020
VI,2020-01-31,intra-total,43,6,10,3,2,2,3,2,0,5,24,100,67,73,FALSE,0.73,2019,2019-2020
VI,2020-01-31,intra-ucfe,0,0,0,0,0,0,0,0,0,0,0,0,0,0,FALSE,0,2019,2019-2020
VI,2020-01-31,intra-ucx,0,0,0,0,0,0,0,0,0,0,0,0,0,0,FALSE,0,2019,2019-2020
VI,2020-01-31,intra-ui,43,6,10,3,2,2,3,2,0,5,24,100,67,73,FALSE,0.73,2019,2019-2020
VI,2020-02-29,inter-total,2,6,4,1,0,1,2,0,0,0,4,20,6,12,FALSE,0.6,2019,2019-2020
VI,2020-02-29,inter-ucfe,0,0,0,0,0,0,0,0,0,0,0,0,0,0,FALSE,0,2019,2019-2020
VI,2020-02-29,inter-ucx,0,0,0,0,0,0,0,0,0,0,0,0,0,0,FALSE,0,2019,2019-2020
VI,2020-02-29,inter-ui,2,6,4,1,0,1,2,0,0,0,4,20,6,12,FALSE,0.6,2019,2019-2020
VI,2020-02-29,intra-total,81,9,3,2,1,0,2,1,0,1,19,119,100,109,FALSE,0.915966386554622,2019,2019-2020
VI,2020-02-29,intra-ucfe,0,0,1,0,0,0,0,0,0,0,0,1,0,0,FALSE,0,2019,2019-2020
VI,2020-02-29,intra-ucx,0,0,0,0,0,0,0,0,0,0,0,0,0,0,FALSE,0,2019,2019-2020
VI,2020-02-29,intra-ui,81,9,2,2,1,0,2,1,0,1,19,118,100,109,FALSE,0.923728813559322,2019,2019-2020
VI,2020-03-31,inter-total,11,4,2,0,1,1,1,0,0,2,4,26,15,19,FALSE,0.730769230769231,2019,2019-2020
VI,2020-03-31,inter-ucfe,0,0,0,0,0,0,0,0,0,0,0,0,0,0,FALSE,0,2019,2019-2020
VI,2020-03-31,inter-ucx,0,0,0,0,0,0,0,0,0,0,0,0,0,0,FALSE,0,2019,2019-2020
VI,2020-03-31,inter-ui,11,4,2,0,1,1,1,0,0,2,4,26,15,19,FALSE,0.730769230769231,2019,2019-2020
VI,2020-03-31,intra-total,91,9,2,2,3,0,0,0,0,3,15,125,106,115,FALSE,0.92,2019,2019-2020
VI,2020-03-31,intra-ucfe,1,0,0,0,1,0,0,0,0,1,0,3,1,1,FALSE,0.333333333333333,2019,2019-2020
VI,2020-03-31,intra-ucx,0,0,0,0,0,0,0,0,0,0,0,0,0,0,FALSE,0,2019,2019-2020
VI,2020-03-31,intra-ui,90,9,2,2,2,0,0,0,0,2,15,122,105,114,FALSE,0.934426229508197,2019,2019-2020
VI,2020-04-30,inter-total,14,18,8,3,3,1,2,3,0,1,14,67,28,46,FALSE,0.686567164179104,2019,2019-2020
VI,2020-04-30,inter-ucfe,0,0,0,0,0,0,0,0,0,0,0,0,0,0,FALSE,0,2019,2019-2020
VI,2020-04-30,inter-ucx,0,0,0,0,0,0,0,0,0,0,0,0,0,0,FALSE,0,2019,2019-2020
VI,2020-04-30,inter-ui,14,18,8,3,3,1,2,3,0,1,14,67,28,46,FALSE,0.686567164179104,2019,2019-2020
VI,2020-04-30,intra-total,81,217,255,48,5,1,0,0,0,0,209,816,290,507,FALSE,0.621323529411765,2019,2019-2020
VI,2020-04-30,intra-ucfe,0,0,0,0,0,0,0,0,0,0,0,0,0,0,FALSE,0,2019,2019-2020
VI,2020-04-30,intra-ucx,0,0,0,0,0,0,0,0,0,0,0,0,0,0,FALSE,0,2019,2019-2020
VI,2020-04-30,intra-ui,81,217,255,48,5,1,0,0,0,0,209,816,290,507,FALSE,0.621323529411765,2019,2019-2020
VI,2020-05-31,inter-total,0,1,1,8,17,21,18,7,1,1,2,77,2,3,FALSE,0.038961038961039,2019,2019-2020
VI,2020-05-31,inter-ucfe,0,0,0,0,0,0,0,0,0,0,0,0,0,0,FALSE,0,2019,2019-2020
VI,2020-05-31,inter-ucx,0,0,0,0,0,0,0,0,0,0,0,0,0,0,FALSE,0,2019,2019-2020
VI,2020-05-31,inter-ui,0,1,1,8,17,21,18,7,1,1,2,77,2,3,FALSE,0.038961038961039,2019,2019-2020
VI,2020-05-31,intra-total,7,94,106,474,576,419,190,32,2,1,84,1985,91,185,FALSE,0.0931989924433249,2019,2019-2020
VI,2020-05-31,intra-ucfe,0,0,1,0,0,1,0,0,0,0,0,2,0,0,FALSE,0,2019,2019-2020
VI,2020-05-31,intra-ucx,0,0,0,0,0,0,0,0,0,0,0,0,0,0,FALSE,0,2019,2019-2020
VI,2020-05-31,intra-ui,7,94,105,474,576,418,190,32,2,1,84,1983,91,185,FALSE,0.0932929904185577,2019,2019-2020
VI,2020-06-30,inter-total,0,4,8,4,7,8,16,20,20,17,0,104,0,4,FALSE,0.0384615384615385,2019,2019-2020
VI,2020-06-30,inter-ucfe,0,0,0,0,0,0,0,0,0,0,0,0,0,0,FALSE,0,2019,2019-2020
VI,2020-06-30,inter-ucx,0,0,0,0,0,0,0,0,0,0,0,0,0,0,FALSE,0,2019,2019-2020
VI,2020-06-30,inter-ui,0,4,8,4,7,8,16,20,20,17,0,104,0,4,FALSE,0.0384615384615385,2019,2019-2020
VI,2020-06-30,intra-total,15,139,72,86,119,178,253,276,176,222,119,1655,134,273,FALSE,0.164954682779456,2019,2019-2020
VI,2020-06-30,intra-ucfe,0,0,0,0,0,0,0,0,1,0,0,1,0,0,FALSE,0,2019,2019-2020
VI,2020-06-30,intra-ucx,0,0,0,0,1,0,0,0,0,0,1,2,1,1,FALSE,0.5,2019,2019-2020
VI,2020-06-30,intra-ui,15,139,72,86,118,178,253,276,175,222,118,1652,133,272,FALSE,0.164648910411622,2019,2019-2020
VI,2020-07-31,inter-total,0,3,9,6,3,5,2,8,2,46,2,86,2,5,FALSE,0.0581395348837209,2020,2020-2021
VI,2020-07-31,inter-ucfe,0,0,0,0,0,0,0,0,0,0,0,0,0,0,FALSE,0,2020,2020-2021
VI,2020-07-31,inter-ucx,0,0,0,0,0,0,0,0,0,0,0,0,0,0,FALSE,0,2020,2020-2021
VI,2020-07-31,inter-ui,0,3,9,6,3,5,2,8,2,46,2,86,2,5,FALSE,0.0581395348837209,2020,2020-2021
VI,2020-07-31,intra-total,3,65,56,30,30,18,19,16,27,268,47,579,50,115,FALSE,0.198618307426598,2020,2020-2021
VI,2020-07-31,intra-ucfe,0,0,0,0,0,0,0,0,0,1,0,1,0,0,FALSE,0,2020,2020-2021
VI,2020-07-31,intra-ucx,0,0,0,0,0,0,0,0,0,0,0,0,0,0,FALSE,0,2020,2020-2021
VI,2020-07-31,intra-ui,3,65,56,30,30,18,19,16,27,267,47,578,50,115,FALSE,0.198961937716263,2020,2020-2021
VI,2020-08-31,inter-total,0,3,6,8,9,8,6,4,6,35,0,85,0,3,FALSE,0.0352941176470588,2020,2020-2021
VI,2020-08-31,inter-ucfe,0,0,0,0,0,0,0,0,0,0,0,0,0,0,FALSE,0,2020,2020-2021
VI,2020-08-31,inter-ucx,0,0,0,0,0,0,0,0,0,0,0,0,0,0,FALSE,0,2020,2020-2021
VI,2020-08-31,inter-ui,0,3,6,8,9,8,6,4,6,35,0,85,0,3,FALSE,0.0352941176470588,2020,2020-2021
VI,2020-08-31,intra-total,0,17,35,37,39,18,19,11,9,179,28,392,28,45,FALSE,0.114795918367347,2020,2020-2021
VI,2020-08-31,intra-ucfe,0,0,0,0,0,0,0,0,0,0,0,0,0,0,FALSE,0,2020,2020-2021
VI,2020-08-31,intra-ucx,0,0,0,0,0,0,0,0,0,0,0,0,0,0,FALSE,0,2020,2020-2021
VI,2020-08-31,intra-ui,0,17,35,37,39,18,19,11,9,179,28,392,28,45,FALSE,0.114795918367347,2020,2020-2021
VI,2020-09-30,inter-total,0,2,8,11,10,5,3,3,4,26,0,72,0,2,FALSE,0.0277777777777778,2020,2020-2021
VI,2020-09-30,inter-ucfe,0,0,0,0,0,0,0,0,0,0,0,0,0,0,FALSE,0,2020,2020-2021
VI,2020-09-30,inter-ucx,0,0,0,0,0,0,0,0,0,0,0,0,0,0,FALSE,0,2020,2020-2021
VI,2020-09-30,inter-ui,0,2,8,11,10,5,3,3,4,26,0,72,0,2,FALSE,0.0277777777777778,2020,2020-2021
VI,2020-09-30,intra-total,1,37,28,36,31,19,11,5,8,134,34,344,35,72,FALSE,0.209302325581395,2020,2020-2021
VI,2020-09-30,intra-ucfe,0,0,0,0,0,0,0,0,0,0,0,0,0,0,FALSE,0,2020,2020-2021
VI,2020-09-30,intra-ucx,0,0,0,0,0,0,0,0,0,1,0,1,0,0,FALSE,0,2020,2020-2021
VI,2020-09-30,intra-ui,1,37,28,36,31,19,11,5,8,133,34,343,35,72,FALSE,0.209912536443149,2020,2020-2021
VI,2020-10-31,inter-total,0,1,0,1,5,3,2,4,3,24,0,43,0,1,FALSE,0.0232558139534884,2020,2020-2021
VI,2020-10-31,inter-ucfe,0,0,0,0,0,0,0,0,0,1,0,1,0,0,FALSE,0,2020,2020-2021
VI,2020-10-31,inter-ucx,0,0,0,0,0,0,0,0,0,0,0,0,0,0,FALSE,0,2020,2020-2021
VI,2020-10-31,inter-ui,0,1,0,1,5,3,2,4,3,23,0,42,0,1,FALSE,0.0238095238095238,2020,2020-2021
VI,2020-10-31,intra-total,1,18,13,13,18,18,21,21,13,120,14,270,15,33,FALSE,0.122222222222222,2020,2020-2021
VI,2020-10-31,intra-ucfe,0,0,0,0,0,0,0,0,0,0,0,0,0,0,FALSE,0,2020,2020-2021
VI,2020-10-31,intra-ucx,0,0,0,0,0,0,0,0,0,1,0,1,0,0,FALSE,0,2020,2020-2021
VI,2020-10-31,intra-ui,1,18,13,13,18,18,21,21,13,119,14,269,15,33,FALSE,0.122676579925651,2020,2020-2021
VI,2020-11-30,inter-total,0,0,1,1,0,2,1,0,2,25,0,32,0,0,FALSE,0,2020,2020-2021
VI,2020-11-30,inter-ucfe,0,0,0,0,0,0,0,0,0,0,0,0,0,0,FALSE,0,2020,2020-2021
VI,2020-11-30,inter-ucx,0,0,0,0,0,0,0,0,0,0,0,0,0,0,FALSE,0,2020,2020-2021
VI,2020-11-30,inter-ui,0,0,1,1,0,2,1,0,2,25,0,32,0,0,FALSE,0,2020,2020-2021
VI,2020-11-30,intra-total,0,12,12,7,7,7,21,18,13,176,3,276,3,15,FALSE,0.0543478260869565,2020,2020-2021
VI,2020-11-30,intra-ucfe,0,0,0,0,0,0,0,0,0,0,0,0,0,0,FALSE,0,2020,2020-2021
VI,2020-11-30,intra-ucx,0,0,0,0,0,0,1,0,0,0,0,1,0,0,FALSE,0,2020,2020-2021
VI,2020-11-30,intra-ui,0,12,12,7,7,7,20,18,13,176,3,275,3,15,FALSE,0.0545454545454545,2020,2020-2021
VI,2020-12-31,inter-total,0,0,5,2,4,2,2,0,2,31,0,48,0,0,FALSE,0,2020,2020-2021
VI,2020-12-31,inter-ucfe,0,0,0,0,0,0,0,0,0,0,0,0,0,0,FALSE,0,2020,2020-2021
VI,2020-12-31,inter-ucx,0,0,0,0,0,0,0,0,0,0,0,0,0,0,FALSE,0,2020,2020-2021
VI,2020-12-31,inter-ui,0,0,5,2,4,2,2,0,2,31,0,48,0,0,FALSE,0,2020,2020-2021
VI,2020-12-31,intra-total,0,4,12,6,16,19,4,5,5,126,5,202,5,9,FALSE,0.0445544554455446,2020,2020-2021
VI,2020-12-31,intra-ucfe,0,0,0,0,0,0,0,0,0,1,0,1,0,0,FALSE,0,2020,2020-2021
VI,2020-12-31,intra-ucx,0,0,0,0,0,0,0,1,0,2,0,3,0,0,FALSE,0,2020,2020-2021
VI,2020-12-31,intra-ui,0,4,12,6,16,19,4,4,5,123,5,198,5,9,FALSE,0.0454545454545455,2020,2020-2021
VI,2021-01-31,inter-total,0,0,0,0,0,1,2,2,1,24,0,30,0,0,FALSE,0,2020,2020-2021
VI,2021-01-31,inter-ucfe,0,0,0,0,0,0,0,0,0,0,0,0,0,0,FALSE,0,2020,2020-2021
VI,2021-01-31,inter-ucx,0,0,0,0,0,0,0,0,0,0,0,0,0,0,FALSE,0,2020,2020-2021
VI,2021-01-31,inter-ui,0,0,0,0,0,1,2,2,1,24,0,30,0,0,FALSE,0,2020,2020-2021
VI,2021-01-31,intra-total,0,7,2,11,5,8,2,7,7,77,5,131,5,12,FALSE,0.0916030534351145,2020,2020-2021
VI,2021-01-31,intra-ucfe,0,0,0,0,0,0,0,0,0,0,0,0,0,0,FALSE,0,2020,2020-2021
VI,2021-01-31,intra-ucx,0,0,0,0,0,0,0,0,0,1,0,1,0,0,FALSE,0,2020,2020-2021
VI,2021-01-31,intra-ui,0,7,2,11,5,8,2,7,7,76,5,130,5,12,FALSE,0.0923076923076923,2020,2020-2021
VI,2021-02-28,inter-total,0,0,1,0,3,1,1,1,5,22,0,34,0,0,FALSE,0,2020,2020-2021
VI,2021-02-28,inter-ucfe,0,0,0,0,0,0,0,0,0,0,0,0,0,0,FALSE,0,2020,2020-2021
VI,2021-02-28,inter-ucx,0,0,0,0,0,0,0,0,0,0,0,0,0,0,FALSE,0,2020,2020-2021
VI,2021-02-28,inter-ui,0,0,1,0,3,1,1,1,5,22,0,34,0,0,FALSE,0,2020,2020-2021
VI,2021-02-28,intra-total,1,21,18,10,8,8,8,4,5,96,13,192,14,35,FALSE,0.182291666666667,2020,2020-2021
VI,2021-02-28,intra-ucfe,0,0,0,0,0,0,0,0,0,1,0,1,0,0,FALSE,0,2020,2020-2021
VI,2021-02-28,intra-ucx,0,1,0,0,0,0,0,0,0,1,0,2,0,1,FALSE,0.5,2020,2020-2021
VI,2021-02-28,intra-ui,1,20,18,10,8,8,8,4,5,94,13,189,14,34,FALSE,0.17989417989418,2020,2020-2021
VI,2021-03-31,inter-total,0,0,1,0,1,2,2,4,2,51,0,63,0,0,FALSE,0,2020,2020-2021
VI,2021-03-31,inter-ucfe,0,0,0,0,0,0,0,0,0,0,0,0,0,0,FALSE,0,2020,2020-2021
VI,2021-03-31,inter-ucx,0,0,0,0,0,0,0,0,0,0,0,0,0,0,FALSE,0,2020,2020-2021
VI,2021-03-31,inter-ui,0,0,1,0,1,2,2,4,2,51,0,63,0,0,FALSE,0,2020,2020-2021
VI,2021-03-31,intra-total,0,34,18,13,11,7,12,9,3,86,28,221,28,62,FALSE,0.280542986425339,2020,2020-2021
VI,2021-03-31,intra-ucfe,0,0,0,0,0,0,0,0,0,0,0,0,0,0,FALSE,0,2020,2020-2021
VI,2021-03-31,intra-ucx,0,0,0,0,0,0,0,0,0,0,0,0,0,0,FALSE,0,2020,2020-2021
VI,2021-03-31,intra-ui,0,34,18,13,11,7,12,9,3,86,28,221,28,62,FALSE,0.280542986425339,2020,2020-2021
VI,2021-04-30,inter-total,0,0,1,0,0,1,1,0,0,15,0,18,0,0,FALSE,0,2020,2020-2021
VI,2021-04-30,inter-ucfe,0,0,0,0,0,0,0,0,0,0,0,0,0,0,FALSE,0,2020,2020-2021
VI,2021-04-30,inter-ucx,0,0,0,0,0,0,0,0,0,0,0,0,0,0,FALSE,0,2020,2020-2021
VI,2021-04-30,inter-ui,0,0,1,0,0,1,1,0,0,15,0,18,0,0,FALSE,0,2020,2020-2021
VI,2021-04-30,intra-total,1,16,12,17,7,12,11,10,2,77,12,177,13,29,FALSE,0.163841807909605,2020,2020-2021
VI,2021-04-30,intra-ucfe,0,0,0,0,0,0,0,0,0,0,0,0,0,0,FALSE,0,2020,2020-2021
VI,2021-04-30,intra-ucx,0,0,0,0,0,0,1,0,0,0,0,1,0,0,FALSE,0,2020,2020-2021
VI,2021-04-30,intra-ui,1,16,12,17,7,12,10,10,2,77,12,176,13,29,FALSE,0.164772727272727,2020,2020-2021
VI,2021-05-31,inter-total,0,0,0,1,2,1,2,0,3,13,0,22,0,0,FALSE,0,2020,2020-2021
VI,2021-05-31,inter-ucfe,0,0,0,0,0,0,0,0,0,0,0,0,0,0,FALSE,0,2020,2020-2021
VI,2021-05-31,inter-ucx,0,0,0,0,0,0,0,0,0,0,0,0,0,0,FALSE,0,2020,2020-2021
VI,2021-05-31,inter-ui,0,0,0,1,2,1,2,0,3,13,0,22,0,0,FALSE,0,2020,2020-2021
VI,2021-05-31,intra-total,0,28,30,28,17,5,7,4,6,59,6,190,6,34,FALSE,0.178947368421053,2020,2020-2021
VI,2021-05-31,intra-ucfe,0,0,0,0,0,0,0,0,0,0,0,0,0,0,FALSE,0,2020,2020-2021
VI,2021-05-31,intra-ucx,0,0,0,0,0,0,0,0,0,0,0,0,0,0,FALSE,0,2020,2020-2021
VI,2021-05-31,intra-ui,0,28,30,28,17,5,7,4,6,59,6,190,6,34,FALSE,0.178947368421053,2020,2020-2021
VI,2021-06-30,inter-total,0,0,5,1,0,0,0,1,0,6,0,13,0,0,FALSE,0,2020,2020-2021
VI,2021-06-30,inter-ucfe,0,0,0,0,0,0,0,0,0,0,0,0,0,0,FALSE,0,2020,2020-2021
VI,2021-06-30,inter-ucx,0,0,0,0,0,0,0,0,0,0,0,0,0,0,FALSE,0,2020,2020-2021
VI,2021-06-30,inter-ui,0,0,5,1,0,0,0,1,0,6,0,13,0,0,FALSE,0,2020,2020-2021
VI,2021-06-30,intra-total,0,12,25,14,14,9,6,8,2,28,7,125,7,19,FALSE,0.152,2020,2020-2021
VI,2021-06-30,intra-ucfe,0,0,0,0,0,0,0,0,0,0,0,0,0,0,FALSE,0,2020,2020-2021
VI,2021-06-30,intra-ucx,0,0,0,0,0,0,0,0,0,0,0,0,0,0,FALSE,0,2020,2020-2021
VI,2021-06-30,intra-ui,0,12,25,14,14,9,6,8,2,28,7,125,7,19,FALSE,0.152,2020,2020-2021
VI,2021-07-31,inter-total,0,0,0,2,0,1,2,0,1,4,0,10,0,0,FALSE,0,2021,2021-2022
VI,2021-07-31,inter-ucfe,0,0,0,0,0,0,0,0,0,0,0,0,0,0,FALSE,0,2021,2021-2022
VI,2021-07-31,inter-ucx,0,0,0,0,0,0,0,0,0,0,0,0,0,0,FALSE,0,2021,2021-2022
VI,2021-07-31,inter-ui,0,0,0,2,0,1,2,0,1,4,0,10,0,0,FALSE,0,2021,2021-2022
VI,2021-07-31,intra-total,0,47,28,15,7,14,5,9,6,58,24,213,24,71,FALSE,0.333333333333333,2021,2021-2022
VI,2021-07-31,intra-ucfe,0,0,0,0,0,0,0,0,0,0,0,0,0,0,FALSE,0,2021,2021-2022
VI,2021-07-31,intra-ucx,0,0,0,0,0,0,0,0,0,0,0,0,0,0,FALSE,0,2021,2021-2022
VI,2021-07-31,intra-ui,0,47,28,15,7,14,5,9,6,58,24,213,24,71,FALSE,0.333333333333333,2021,2021-2022
VI,2021-08-31,inter-total,0,0,0,1,1,0,1,0,0,4,0,7,0,0,FALSE,0,2021,2021-2022
VI,2021-08-31,inter-ucfe,0,0,0,0,0,0,0,0,0,0,0,0,0,0,FALSE,0,2021,2021-2022
VI,2021-08-31,inter-ucx,0,0,0,0,0,0,0,0,0,0,0,0,0,0,FALSE,0,2021,2021-2022
VI,2021-08-31,inter-ui,0,0,0,1,1,0,1,0,0,4,0,7,0,0,FALSE,0,2021,2021-2022
VI,2021-08-31,intra-total,0,20,35,46,42,35,18,11,5,41,12,265,12,32,FALSE,0.120754716981132,2021,2021-2022
VI,2021-08-31,intra-ucfe,0,0,0,0,0,0,0,0,0,0,0,0,0,0,FALSE,0,2021,2021-2022
VI,2021-08-31,intra-ucx,0,0,0,0,0,0,0,0,0,0,0,0,0,0,FALSE,0,2021,2021-2022
VI,2021-08-31,intra-ui,0,20,35,46,42,35,18,11,5,41,12,265,12,32,FALSE,0.120754716981132,2021,2021-2022
VI,2021-09-30,inter-total,0,0,0,0,0,0,1,1,0,5,0,7,0,0,FALSE,0,2021,2021-2022
VI,2021-09-30,inter-ucfe,0,0,0,0,0,0,0,0,0,0,0,0,0,0,FALSE,0,2021,2021-2022
VI,2021-09-30,inter-ucx,0,0,0,0,0,0,0,0,0,0,0,0,0,0,FALSE,0,2021,2021-2022
VI,2021-09-30,inter-ui,0,0,0,0,0,0,1,1,0,5,0,7,0,0,FALSE,0,2021,2021-2022
VI,2021-09-30,intra-total,0,8,22,15,18,15,14,17,11,37,2,159,2,10,FALSE,0.0628930817610063,2021,2021-2022
VI,2021-09-30,intra-ucfe,0,0,0,0,0,0,0,0,0,0,0,0,0,0,FALSE,0,2021,2021-2022
VI,2021-09-30,intra-ucx,0,0,0,0,0,0,0,0,0,1,0,1,0,0,FALSE,0,2021,2021-2022
VI,2021-09-30,intra-ui,0,8,22,15,18,15,14,17,11,36,2,158,2,10,FALSE,0.0632911392405063,2021,2021-2022
VI,2021-10-31,inter-total,0,0,0,0,0,0,0,0,0,5,0,5,0,0,FALSE,0,2021,2021-2022
VI,2021-10-31,inter-ucfe,0,0,0,0,0,0,0,0,0,0,0,0,0,0,FALSE,0,2021,2021-2022
VI,2021-10-31,inter-ucx,0,0,0,0,0,0,0,0,0,0,0,0,0,0,FALSE,0,2021,2021-2022
VI,2021-10-31,inter-ui,0,0,0,0,0,0,0,0,0,5,0,5,0,0,FALSE,0,2021,2021-2022
VI,2021-10-31,intra-total,1,16,8,8,13,11,2,4,5,42,4,114,5,21,FALSE,0.184210526315789,2021,2021-2022
VI,2021-10-31,intra-ucfe,0,0,0,0,0,0,0,0,0,0,0,0,0,0,FALSE,0,2021,2021-2022
VI,2021-10-31,intra-ucx,0,0,0,0,0,0,0,0,0,0,0,0,0,0,FALSE,0,2021,2021-2022
VI,2021-10-31,intra-ui,1,16,8,8,13,11,2,4,5,42,4,114,5,21,FALSE,0.184210526315789,2021,2021-2022
VI,2021-11-30,inter-total,0,0,0,0,0,0,0,0,0,2,0,2,0,0,FALSE,0,2021,2021-2022
VI,2021-11-30,inter-ucfe,0,0,0,0,0,0,0,0,0,0,0,0,0,0,FALSE,0,2021,2021-2022
VI,2021-11-30,inter-ucx,0,0,0,0,0,0,0,0,0,0,0,0,0,0,FALSE,0,2021,2021-2022
VI,2021-11-30,inter-ui,0,0,0,0,0,0,0,0,0,2,0,2,0,0,FALSE,0,2021,2021-2022
VI,2021-11-30,intra-total,0,13,16,31,23,32,37,10,4,31,5,202,5,18,FALSE,0.0891089108910891,2021,2021-2022
VI,2021-11-30,intra-ucfe,0,0,0,0,0,0,0,0,0,0,0,0,0,0,FALSE,0,2021,2021-2022
VI,2021-11-30,intra-ucx,0,0,0,0,0,0,0,0,0,0,0,0,0,0,FALSE,0,2021,2021-2022
VI,2021-11-30,intra-ui,0,13,16,31,23,32,37,10,4,31,5,202,5,18,FALSE,0.0891089108910891,2021,2021-2022
VI,2021-12-31,inter-total,0,0,0,0,0,0,0,0,0,0,0,0,0,0,FALSE,0,2021,2021-2022
VI,2021-12-31,inter-ucfe,0,0,0,0,0,0,0,0,0,0,0,0,0,0,FALSE,0,2021,2021-2022
VI,2021-12-31,inter-ucx,0,0,0,0,0,0,0,0,0,0,0,0,0,0,FALSE,0,2021,2021-2022
VI,2021-12-31,inter-ui,0,0,0,0,0,0,0,0,0,0,0,0,0,0,FALSE,0,2021,2021-2022
VI,2021-12-31,intra-total,0,0,0,0,1,1,0,0,0,2,0,4,0,0,FALSE,0,2021,2021-2022
VI,2021-12-31,intra-ucfe,0,0,0,0,0,0,0,0,0,0,0,0,0,0,FALSE,0,2021,2021-2022
VI,2021-12-31,intra-ucx,0,0,0,0,0,0,0,0,0,0,0,0,0,0,FALSE,0,2021,2021-2022
VI,2021-12-31,intra-ui,0,0,0,0,1,1,0,0,0,2,0,4,0,0,FALSE,0,2021,2021-2022
VI,2022-01-31,inter-total,0,0,0,0,0,0,0,1,0,1,0,2,0,0,FALSE,0,2021,2021-2022
VI,2022-01-31,inter-ucfe,0,0,0,0,0,0,0,0,0,0,0,0,0,0,FALSE,0,2021,2021-2022
VI,2022-01-31,inter-ucx,0,0,0,0,0,0,0,0,0,0,0,0,0,0,FALSE,0,2021,2021-2022
VI,2022-01-31,inter-ui,0,0,0,0,0,0,0,1,0,1,0,2,0,0,FALSE,0,2021,2021-2022
VI,2022-01-31,intra-total,0,6,6,8,9,5,6,4,4,32,4,84,4,10,FALSE,0.119047619047619,2021,2021-2022
VI,2022-01-31,intra-ucfe,0,0,0,0,0,0,0,0,0,1,0,1,0,0,FALSE,0,2021,2021-2022
VI,2022-01-31,intra-ucx,0,0,0,0,0,0,0,0,0,0,0,0,0,0,FALSE,0,2021,2021-2022
VI,2022-01-31,intra-ui,0,6,6,8,9,5,6,4,4,31,4,83,4,10,FALSE,0.120481927710843,2021,2021-2022
VI,2022-02-28,inter-total,0,0,0,0,0,0,0,0,0,0,0,0,0,0,FALSE,0,2021,2021-2022
VI,2022-02-28,inter-ucfe,0,0,0,0,0,0,0,0,0,0,0,0,0,0,FALSE,0,2021,2021-2022
VI,2022-02-28,inter-ucx,0,0,0,0,0,0,0,0,0,0,0,0,0,0,FALSE,0,2021,2021-2022
VI,2022-02-28,inter-ui,0,0,0,0,0,0,0,0,0,0,0,0,0,0,FALSE,0,2021,2021-2022
VI,2022-02-28,intra-total,1,8,4,7,8,8,3,3,2,26,12,82,13,21,FALSE,0.25609756097561,2021,2021-2022
VI,2022-02-28,intra-ucfe,0,0,0,0,0,0,0,0,0,0,0,0,0,0,FALSE,0,2021,2021-2022
VI,2022-02-28,intra-ucx,0,0,0,0,0,0,0,0,0,0,0,0,0,0,FALSE,0,2021,2021-2022
VI,2022-02-28,intra-ui,1,8,4,7,8,8,3,3,2,26,12,82,13,21,FALSE,0.25609756097561,2021,2021-2022
VI,2022-03-31,inter-total,0,0,0,0,0,0,0,0,0,1,0,1,0,0,FALSE,0,2021,2021-2022
VI,2022-03-31,inter-ucfe,0,0,0,0,0,0,0,0,0,0,0,0,0,0,FALSE,0,2021,2021-2022
VI,2022-03-31,inter-ucx,0,0,0,0,0,0,0,0,0,0,0,0,0,0,FALSE,0,2021,2021-2022
VI,2022-03-31,inter-ui,0,0,0,0,0,0,0,0,0,1,0,1,0,0,FALSE,0,2021,2021-2022
VI,2022-03-31,intra-total,0,12,8,7,4,5,5,5,5,15,14,80,14,26,FALSE,0.325,2021,2021-2022
VI,2022-03-31,intra-ucfe,0,0,0,0,0,0,0,0,0,0,0,0,0,0,FALSE,0,2021,2021-2022
VI,2022-03-31,intra-ucx,0,0,0,0,0,0,0,0,0,0,0,0,0,0,FALSE,0,2021,2021-2022
VI,2022-03-31,intra-ui,0,12,8,7,4,5,5,5,5,15,14,80,14,26,FALSE,0.325,2021,2021-2022
VI,2022-04-30,inter-total,0,0,0,0,0,0,0,0,0,3,0,3,0,0,FALSE,0,2021,2021-2022
VI,2022-04-30,inter-ucfe,0,0,0,0,0,0,0,0,0,0,0,0,0,0,FALSE,0,2021,2021-2022
VI,2022-04-30,inter-ucx,0,0,0,0,0,0,0,0,0,0,0,0,0,0,FALSE,0,2021,2021-2022
VI,2022-04-30,inter-ui,0,0,0,0,0,0,0,0,0,3,0,3,0,0,FALSE,0,2021,2021-2022
VI,2022-04-30,intra-total,1,13,4,2,0,3,2,2,1,15,10,53,11,24,FALSE,0.452830188679245,2021,2021-2022
VI,2022-04-30,intra-ucfe,0,0,0,0,0,0,0,0,0,0,0,0,0,0,FALSE,0,2021,2021-2022
VI,2022-04-30,intra-ucx,0,0,0,0,0,0,0,0,0,0,0,0,0,0,FALSE,0,2021,2021-2022
VI,2022-04-30,intra-ui,1,13,4,2,0,3,2,2,1,15,10,53,11,24,FALSE,0.452830188679245,2021,2021-2022
VI,2022-05-31,inter-total,0,0,0,0,0,0,0,0,0,0,0,0,0,0,FALSE,0,2021,2021-2022
VI,2022-05-31,inter-ucfe,0,0,0,0,0,0,0,0,0,0,0,0,0,0,FALSE,0,2021,2021-2022
VI,2022-05-31,inter-ucx,0,0,0,0,0,0,0,0,0,0,0,0,0,0,FALSE,0,2021,2021-2022
VI,2022-05-31,inter-ui,0,0,0,0,0,0,0,0,0,0,0,0,0,0,FALSE,0,2021,2021-2022
VI,2022-05-31,intra-total,4,8,5,3,6,0,3,1,0,16,10,56,14,22,FALSE,0.392857142857143,2021,2021-2022
VI,2022-05-31,intra-ucfe,0,0,0,0,0,0,0,0,0,0,0,0,0,0,FALSE,0,2021,2021-2022
VI,2022-05-31,intra-ucx,0,0,2,0,0,0,0,0,0,0,0,2,0,0,FALSE,0,2021,2021-2022
VI,2022-05-31,intra-ui,4,8,3,3,6,0,3,1,0,16,10,54,14,22,FALSE,0.407407407407407,2021,2021-2022
VI,2022-06-30,inter-total,0,0,0,0,0,0,0,0,0,0,0,0,0,0,FALSE,0,2021,2021-2022
VI,2022-06-30,inter-ucfe,0,0,0,0,0,0,0,0,0,0,0,0,0,0,FALSE,0,2021,2021-2022
VI,2022-06-30,inter-ucx,0,0,0,0,0,0,0,0,0,0,0,0,0,0,FALSE,0,2021,2021-2022
VI,2022-06-30,inter-ui,0,0,0,0,0,0,0,0,0,0,0,0,0,0,FALSE,0,2021,2021-2022
VI,2022-06-30,intra-total,17,16,16,4,1,4,2,1,1,7,12,81,29,45,FALSE,0.555555555555556,2021,2021-2022
VI,2022-06-30,intra-ucfe,0,0,0,0,0,0,0,0,0,0,0,0,0,0,FALSE,0,2021,2021-2022
VI,2022-06-30,intra-ucx,0,0,0,0,0,0,0,0,0,0,0,0,0,0,FALSE,0,2021,2021-2022
VI,2022-06-30,intra-ui,17,16,16,4,1,4,2,1,1,7,12,81,29,45,FALSE,0.555555555555556,2021,2021-2022
VI,2022-07-31,inter-total,0,0,0,0,0,0,0,0,0,0,0,0,0,0,FALSE,0,2022,2022-2023
VI,2022-07-31,inter-ucfe,0,0,0,0,0,0,0,0,0,0,0,0,0,0,FALSE,0,2022,2022-2023
VI,2022-07-31,inter-ucx,0,0,0,0,0,0,0,0,0,0,0,0,0,0,FALSE,0,2022,2022-2023
VI,2022-07-31,inter-ui,0,0,0,0,0,0,0,0,0,0,0,0,0,0,FALSE,0,2022,2022-2023
VI,2022-07-31,intra-total,4,18,10,4,8,2,4,4,1,11,28,94,32,50,FALSE,0.531914893617021,2022,2022-2023
VI,2022-07-31,intra-ucfe,0,0,0,0,0,0,0,0,0,0,0,0,0,0,FALSE,0,2022,2022-2023
VI,2022-07-31,intra-ucx,0,0,0,0,0,0,0,0,0,0,1,1,1,1,FALSE,1,2022,2022-2023
VI,2022-07-31,intra-ui,4,18,10,4,8,2,4,4,1,11,27,93,31,49,FALSE,0.526881720430108,2022,2022-2023
VI,2022-08-31,inter-total,0,0,0,0,0,0,0,0,0,0,0,0,0,0,FALSE,0,2022,2022-2023
VI,2022-08-31,inter-ucfe,0,0,0,0,0,0,0,0,0,0,0,0,0,0,FALSE,0,2022,2022-2023
VI,2022-08-31,inter-ucx,0,0,0,0,0,0,0,0,0,0,0,0,0,0,FALSE,0,2022,2022-2023
VI,2022-08-31,inter-ui,0,0,0,0,0,0,0,0,0,0,0,0,0,0,FALSE,0,2022,2022-2023
VI,2022-08-31,intra-total,2,20,8,2,2,1,2,2,0,11,12,62,14,34,FALSE,0.548387096774194,2022,2022-2023
VI,2022-08-31,intra-ucfe,0,0,0,0,0,0,0,0,0,0,0,0,0,0,FALSE,0,2022,2022-2023
VI,2022-08-31,intra-ucx,0,0,0,0,0,0,0,0,0,0,0,0,0,0,FALSE,0,2022,2022-2023
VI,2022-08-31,intra-ui,2,20,8,2,2,1,2,2,0,11,12,62,14,34,FALSE,0.548387096774194,2022,2022-2023
VI,2022-09-30,inter-total,0,0,0,0,0,0,0,0,0,0,0,0,0,0,FALSE,0,2022,2022-2023
VI,2022-09-30,inter-ucfe,0,0,0,0,0,0,0,0,0,0,0,0,0,0,FALSE,0,2022,2022-2023
VI,2022-09-30,inter-ucx,0,0,0,0,0,0,0,0,0,0,0,0,0,0,FALSE,0,2022,2022-2023
VI,2022-09-30,inter-ui,0,0,0,0,0,0,0,0,0,0,0,0,0,0,FALSE,0,2022,2022-2023
VI,2022-09-30,intra-total,12,35,11,11,3,1,1,0,1,7,40,122,52,87,FALSE,0.713114754098361,2022,2022-2023
VI,2022-09-30,intra-ucfe,0,0,0,1,0,0,0,0,0,0,1,2,1,1,FALSE,0.5,2022,2022-2023
VI,2022-09-30,intra-ucx,0,0,0,0,0,0,0,0,0,0,0,0,0,0,FALSE,0,2022,2022-2023
VI,2022-09-30,intra-ui,12,35,11,10,3,1,1,0,1,7,39,120,51,86,FALSE,0.716666666666667,2022,2022-2023
VI,2022-10-31,inter-total,0,0,0,0,0,0,0,0,0,0,0,0,0,0,FALSE,0,2022,2022-2023
VI,2022-10-31,inter-ucfe,0,0,0,0,0,0,0,0,0,0,0,0,0,0,FALSE,0,2022,2022-2023
VI,2022-10-31,inter-ucx,0,0,0,0,0,0,0,0,0,0,0,0,0,0,FALSE,0,2022,2022-2023
VI,2022-10-31,inter-ui,0,0,0,0,0,0,0,0,0,0,0,0,0,0,FALSE,0,2022,2022-2023
VI,2022-10-31,intra-total,8,30,13,10,6,2,3,0,1,1,22,96,30,60,FALSE,0.625,2022,2022-2023
VI,2022-10-31,intra-ucfe,0,0,0,0,0,0,0,0,0,0,0,0,0,0,FALSE,0,2022,2022-2023
VI,2022-10-31,intra-ucx,0,0,0,0,0,0,0,0,0,0,0,0,0,0,FALSE,0,2022,2022-2023
VI,2022-10-31,intra-ui,8,30,13,10,6,2,3,0,1,1,22,96,30,60,FALSE,0.625,2022,2022-2023
VI,2022-11-30,inter-total,0,0,0,0,0,0,0,0,0,0,0,0,0,0,FALSE,0,2022,2022-2023
VI,2022-11-30,inter-ucfe,0,0,0,0,0,0,0,0,0,0,0,0,0,0,FALSE,0,2022,2022-2023
VI,2022-11-30,inter-ucx,0,0,0,0,0,0,0,0,0,0,0,0,0,0,FALSE,0,2022,2022-2023
VI,2022-11-30,inter-ui,0,0,0,0,0,0,0,0,0,0,0,0,0,0,FALSE,0,2022,2022-2023
VI,2022-11-30,intra-total,6,11,9,6,3,2,0,0,0,6,10,53,16,27,FALSE,0.509433962264151,2022,2022-2023
VI,2022-11-30,intra-ucfe,0,0,0,0,0,0,0,0,0,1,0,1,0,0,FALSE,0,2022,2022-2023
VI,2022-11-30,intra-ucx,0,0,0,0,0,0,0,0,0,0,0,0,0,0,FALSE,0,2022,2022-2023
VI,2022-11-30,intra-ui,6,11,9,6,3,2,0,0,0,5,10,52,16,27,FALSE,0.519230769230769,2022,2022-2023
VI,2022-12-31,inter-total,0,0,0,0,0,0,0,0,0,0,0,0,0,0,FALSE,0,2022,2022-2023
VI,2022-12-31,inter-ucfe,0,0,0,0,0,0,0,0,0,0,0,0,0,0,FALSE,0,2022,2022-2023
VI,2022-12-31,inter-ucx,0,0,0,0,0,0,0,0,0,0,0,0,0,0,FALSE,0,2022,2022-2023
VI,2022-12-31,inter-ui,0,0,0,0,0,0,0,0,0,0,0,0,0,0,FALSE,0,2022,2022-2023
VI,2022-12-31,intra-total,12,8,1,4,1,2,1,1,1,6,10,47,22,30,FALSE,0.638297872340426,2022,2022-2023
VI,2022-12-31,intra-ucfe,0,0,0,0,0,0,0,0,0,0,0,0,0,0,FALSE,0,2022,2022-2023
VI,2022-12-31,intra-ucx,0,0,0,0,0,0,0,0,0,0,0,0,0,0,FALSE,0,2022,2022-2023
VI,2022-12-31,intra-ui,12,8,1,4,1,2,1,1,1,6,10,47,22,30,FALSE,0.638297872340426,2022,2022-2023
VI,2023-01-31,inter-total,0,0,0,0,0,0,0,0,0,0,0,0,0,0,FALSE,0,2022,2022-2023
VI,2023-01-31,inter-ucfe,0,0,0,0,0,0,0,0,0,0,0,0,0,0,FALSE,0,2022,2022-2023
VI,2023-01-31,inter-ucx,0,0,0,0,0,0,0,0,0,0,0,0,0,0,FALSE,0,2022,2022-2023
VI,2023-01-31,inter-ui,0,0,0,0,0,0,0,0,0,0,0,0,0,0,FALSE,0,2022,2022-2023
VI,2023-01-31,intra-total,5,5,0,4,1,1,1,0,0,3,11,31,16,21,FALSE,0.67741935483871,2022,2022-2023
VI,2023-01-31,intra-ucfe,0,0,0,0,0,0,0,0,0,0,0,0,0,0,FALSE,0,2022,2022-2023
VI,2023-01-31,intra-ucx,0,0,0,0,0,0,0,0,0,0,0,0,0,0,FALSE,0,2022,2022-2023
VI,2023-01-31,intra-ui,5,5,0,4,1,1,1,0,0,3,11,31,16,21,FALSE,0.67741935483871,2022,2022-2023
VI,2023-02-28,inter-total,0,0,0,0,0,0,0,0,0,0,0,0,0,0,FALSE,0,2022,2022-2023
VI,2023-02-28,inter-ucfe,0,0,0,0,0,0,0,0,0,0,0,0,0,0,FALSE,0,2022,2022-2023
VI,2023-02-28,inter-ucx,0,0,0,0,0,0,0,0,0,0,0,0,0,0,FALSE,0,2022,2022-2023
VI,2023-02-28,inter-ui,0,0,0,0,0,0,0,0,0,0,0,0,0,0,FALSE,0,2022,2022-2023
VI,2023-02-28,intra-total,10,15,8,2,3,0,0,0,0,1,8,47,18,33,FALSE,0.702127659574468,2022,2022-2023
VI,2023-02-28,intra-ucfe,0,0,0,1,1,0,0,0,0,0,0,2,0,0,FALSE,0,2022,2022-2023
VI,2023-02-28,intra-ucx,0,0,0,0,0,0,0,0,0,0,0,0,0,0,FALSE,0,2022,2022-2023
VI,2023-02-28,intra-ui,10,15,8,1,2,0,0,0,0,1,8,45,18,33,FALSE,0.733333333333333,2022,2022-2023
VI,2023-03-31,inter-total,0,0,0,0,0,0,0,0,0,0,0,0,0,0,FALSE,0,2022,2022-2023
VI,2023-03-31,inter-ucfe,0,0,0,0,0,0,0,0,0,0,0,0,0,0,FALSE,0,2022,2022-2023
VI,2023-03-31,inter-ucx,0,0,0,0,0,0,0,0,0,0,0,0,0,0,FALSE,0,2022,2022-2023
VI,2023-03-31,inter-ui,0,0,0,0,0,0,0,0,0,0,0,0,0,0,FALSE,0,2022,2022-2023
VI,2023-03-31,intra-total,18,7,2,4,3,1,0,0,1,6,24,66,42,49,FALSE,0.742424242424242,2022,2022-2023
VI,2023-03-31,intra-ucfe,0,0,0,0,0,0,0,0,0,0,0,0,0,0,FALSE,0,2022,2022-2023
VI,2023-03-31,intra-ucx,1,0,0,0,0,0,0,0,0,0,0,1,1,1,FALSE,1,2022,2022-2023
VI,2023-03-31,intra-ui,17,7,2,4,3,1,0,0,1,6,24,65,41,48,FALSE,0.738461538461539,2022,2022-2023
VI,2023-04-30,inter-total,0,0,0,0,0,0,0,0,0,0,0,0,0,0,FALSE,0,2022,2022-2023
VI,2023-04-30,inter-ucfe,0,0,0,0,0,0,0,0,0,0,0,0,0,0,FALSE,0,2022,2022-2023
VI,2023-04-30,inter-ucx,0,0,0,0,0,0,0,0,0,0,0,0,0,0,FALSE,0,2022,2022-2023
VI,2023-04-30,inter-ui,0,0,0,0,0,0,0,0,0,0,0,0,0,0,FALSE,0,2022,2022-2023
VI,2023-04-30,intra-total,10,15,7,1,2,0,0,0,0,3,13,51,23,38,FALSE,0.745098039215686,2022,2022-2023
VI,2023-04-30,intra-ucfe,0,0,0,0,0,0,0,0,0,0,0,0,0,0,FALSE,0,2022,2022-2023
VI,2023-04-30,intra-ucx,0,1,0,0,0,0,0,0,0,0,0,1,0,1,FALSE,1,2022,2022-2023
VI,2023-04-30,intra-ui,10,14,7,1,2,0,0,0,0,3,13,50,23,37,FALSE,0.74,2022,2022-2023
VI,2023-05-31,inter-total,0,0,0,0,0,0,0,0,0,0,0,0,0,0,FALSE,0,2022,2022-2023
VI,2023-05-31,inter-ucfe,0,0,0,0,0,0,0,0,0,0,0,0,0,0,FALSE,0,2022,2022-2023
VI,2023-05-31,inter-ucx,0,0,0,0,0,0,0,0,0,0,0,0,0,0,FALSE,0,2022,2022-2023
VI,2023-05-31,inter-ui,0,0,0,0,0,0,0,0,0,0,0,0,0,0,FALSE,0,2022,2022-2023
VI,2023-05-31,intra-total,15,10,4,2,3,0,0,0,0,1,18,53,33,43,FALSE,0.811320754716981,2022,2022-2023
VI,2023-05-31,intra-ucfe,0,1,0,0,0,0,0,0,0,0,0,1,0,1,FALSE,1,2022,2022-2023
VI,2023-05-31,intra-ucx,0,0,0,0,0,0,0,0,0,0,0,0,0,0,FALSE,0,2022,2022-2023
VI,2023-05-31,intra-ui,15,9,4,2,3,0,0,0,0,1,18,52,33,42,FALSE,0.807692307692308,2022,2022-2023
VI,2023-06-30,inter-total,0,0,0,0,0,0,0,0,0,0,0,0,0,0,FALSE,0,2022,2022-2023
VI,2023-06-30,inter-ucfe,0,0,0,0,0,0,0,0,0,0,0,0,0,0,FALSE,0,2022,2022-2023
VI,2023-06-30,inter-ucx,0,0,0,0,0,0,0,0,0,0,0,0,0,0,FALSE,0,2022,2022-2023
VI,2023-06-30,inter-ui,0,0,0,0,0,0,0,0,0,0,0,0,0,0,FALSE,0,2022,2022-2023
VI,2023-06-30,intra-total,26,8,9,1,0,4,3,1,2,2,21,77,47,55,FALSE,0.714285714285714,2022,2022-2023
VI,2023-06-30,intra-ucfe,0,0,1,0,0,0,0,0,0,0,0,1,0,0,FALSE,0,2022,2022-2023
VI,2023-06-30,intra-ucx,0,0,0,0,0,0,0,0,0,0,0,0,0,0,FALSE,0,2022,2022-2023
VI,2023-06-30,intra-ui,26,8,8,1,0,4,3,1,2,2,21,76,47,55,FALSE,0.723684210526316,2022,2022-2023
VI,2023-07-31,inter-total,0,0,0,0,0,0,0,0,0,0,0,0,0,0,FALSE,0,2023,2023-2024
VI,2023-07-31,inter-ucfe,0,0,0,0,0,0,0,0,0,0,0,0,0,0,FALSE,0,2023,2023-2024
VI,2023-07-31,inter-ucx,0,0,0,0,0,0,0,0,0,0,0,0,0,0,FALSE,0,2023,2023-2024
VI,2023-07-31,inter-ui,0,0,0,0,0,0,0,0,0,0,0,0,0,0,FALSE,0,2023,2023-2024
VI,2023-07-31,intra-total,25,6,3,4,3,0,0,0,0,1,26,68,51,57,FALSE,0.838235294117647,2023,2023-2024
VI,2023-07-31,intra-ucfe,0,0,0,0,0,0,0,0,0,0,0,0,0,0,FALSE,0,2023,2023-2024
VI,2023-07-31,intra-ucx,0,0,0,0,0,0,0,0,0,0,0,0,0,0,FALSE,0,2023,2023-2024
VI,2023-07-31,intra-ui,25,6,3,4,3,0,0,0,0,1,26,68,51,57,FALSE,0.838235294117647,2023,2023-2024
VI,2023-08-31,inter-total,0,0,0,0,0,0,0,0,0,0,0,0,0,0,FALSE,0,2023,2023-2024
VI,2023-08-31,inter-ucfe,0,0,0,0,0,0,0,0,0,0,0,0,0,0,FALSE,0,2023,2023-2024
VI,2023-08-31,inter-ucx,0,0,0,0,0,0,0,0,0,0,0,0,0,0,FALSE,0,2023,2023-2024
VI,2023-08-31,inter-ui,0,0,0,0,0,0,0,0,0,0,0,0,0,0,FALSE,0,2023,2023-2024
VI,2023-08-31,intra-total,33,12,5,3,0,0,1,1,1,0,23,79,56,68,FALSE,0.860759493670886,2023,2023-2024
VI,2023-08-31,intra-ucfe,0,0,0,0,0,0,0,0,0,0,0,0,0,0,FALSE,0,2023,2023-2024
VI,2023-08-31,intra-ucx,0,0,0,0,0,0,0,0,0,0,0,0,0,0,FALSE,0,2023,2023-2024
VI,2023-08-31,intra-ui,33,12,5,3,0,0,1,1,1,0,23,79,56,68,FALSE,0.860759493670886,2023,2023-2024
VI,2023-09-30,inter-total,0,1,0,0,0,1,0,0,0,0,0,2,0,1,FALSE,0.5,2023,2023-2024
VI,2023-09-30,inter-ucfe,0,0,0,0,0,0,0,0,0,0,0,0,0,0,FALSE,0,2023,2023-2024
VI,2023-09-30,inter-ucx,0,0,0,0,0,0,0,0,0,0,0,0,0,0,FALSE,0,2023,2023-2024
VI,2023-09-30,inter-ui,0,1,0,0,0,1,0,0,0,0,0,2,0,1,FALSE,0.5,2023,2023-2024
VI,2023-09-30,intra-total,50,17,1,3,1,0,1,1,0,2,36,112,86,103,FALSE,0.919642857142857,2023,2023-2024
VI,2023-09-30,intra-ucfe,0,0,0,0,0,0,0,0,0,0,1,1,1,1,FALSE,1,2023,2023-2024
VI,2023-09-30,intra-ucx,0,0,0,0,0,0,1,0,0,0,0,1,0,0,FALSE,0,2023,2023-2024
VI,2023-09-30,intra-ui,50,17,1,3,1,0,0,1,0,2,35,110,85,102,FALSE,0.927272727272727,2023,2023-2024
VI,2023-10-31,inter-total,0,0,0,0,0,0,0,0,0,0,0,0,0,0,FALSE,0,2023,2023-2024
VI,2023-10-31,inter-ucfe,0,0,0,0,0,0,0,0,0,0,0,0,0,0,FALSE,0,2023,2023-2024
VI,2023-10-31,inter-ucx,0,0,0,0,0,0,0,0,0,0,0,0,0,0,FALSE,0,2023,2023-2024
VI,2023-10-31,inter-ui,0,0,0,0,0,0,0,0,0,0,0,0,0,0,FALSE,0,2023,2023-2024
VI,2023-10-31,intra-total,17,17,11,4,1,2,0,0,0,0,38,90,55,72,FALSE,0.8,2023,2023-2024
VI,2023-10-31,intra-ucfe,0,0,0,0,0,0,0,0,0,0,0,0,0,0,FALSE,0,2023,2023-2024
VI,2023-10-31,intra-ucx,0,0,0,0,0,0,0,0,0,0,0,0,0,0,FALSE,0,2023,2023-2024
VI,2023-10-31,intra-ui,17,17,11,4,1,2,0,0,0,0,38,90,55,72,FALSE,0.8,2023,2023-2024
VI,2023-11-30,inter-total,0,0,0,0,0,0,0,0,0,0,0,0,0,0,FALSE,0,2023,2023-2024
VI,2023-11-30,inter-ucfe,0,0,0,0,0,0,0,0,0,0,0,0,0,0,FALSE,0,2023,2023-2024
VI,2023-11-30,inter-ucx,0,0,0,0,0,0,0,0,0,0,0,0,0,0,FALSE,0,2023,2023-2024
VI,2023-11-30,inter-ui,0,0,0,0,0,0,0,0,0,0,0,0,0,0,FALSE,0,2023,2023-2024
VI,2023-11-30,intra-total,17,6,3,3,4,0,2,0,0,1,15,51,32,38,FALSE,0.745098039215686,2023,2023-2024
VI,2023-11-30,intra-ucfe,0,0,0,0,0,0,0,0,0,0,0,0,0,0,FALSE,0,2023,2023-2024
VI,2023-11-30,intra-ucx,0,0,0,0,0,0,0,0,0,0,0,0,0,0,FALSE,0,2023,2023-2024
VI,2023-11-30,intra-ui,17,6,3,3,4,0,2,0,0,1,15,51,32,38,FALSE,0.745098039215686,2023,2023-2024
VI,2023-12-31,inter-total,1,0,1,1,0,0,0,0,0,0,0,3,1,1,FALSE,0.333333333333333,2023,2023-2024
VI,2023-12-31,inter-ucfe,0,0,0,0,0,0,0,0,0,0,0,0,0,0,FALSE,0,2023,2023-2024
VI,2023-12-31,inter-ucx,0,0,0,0,0,0,0,0,0,0,0,0,0,0,FALSE,0,2023,2023-2024
VI,2023-12-31,inter-ui,1,0,1,1,0,0,0,0,0,0,0,3,1,1,FALSE,0.333333333333333,2023,2023-2024
VI,2023-12-31,intra-total,15,3,0,5,1,0,1,0,0,1,7,33,22,25,FALSE,0.757575757575758,2023,2023-2024
VI,2023-12-31,intra-ucfe,0,0,0,1,1,0,0,0,0,0,0,2,0,0,FALSE,0,2023,2023-2024
VI,2023-12-31,intra-ucx,0,0,0,0,0,0,0,0,0,0,0,0,0,0,FALSE,0,2023,2023-2024
VI,2023-12-31,intra-ui,15,3,0,4,0,0,1,0,0,1,7,31,22,25,FALSE,0.806451612903226,2023,2023-2024
VI,2024-01-31,inter-total,0,0,1,0,1,0,0,0,0,0,1,3,1,1,FALSE,0.333333333333333,2023,2023-2024
VI,2024-01-31,inter-ucfe,0,0,0,0,0,0,0,0,0,0,0,0,0,0,FALSE,0,2023,2023-2024
VI,2024-01-31,inter-ucx,0,0,0,0,0,0,0,0,0,0,0,0,0,0,FALSE,0,2023,2023-2024
VI,2024-01-31,inter-ui,0,0,1,0,1,0,0,0,0,0,1,3,1,1,FALSE,0.333333333333333,2023,2023-2024
VI,2024-01-31,intra-total,27,9,3,0,1,3,0,0,0,3,14,60,41,50,FALSE,0.833333333333333,2023,2023-2024
VI,2024-01-31,intra-ucfe,0,0,0,0,0,0,0,0,0,0,0,0,0,0,FALSE,0,2023,2023-2024
VI,2024-01-31,intra-ucx,0,0,0,0,0,0,0,0,0,0,0,0,0,0,FALSE,0,2023,2023-2024
VI,2024-01-31,intra-ui,27,9,3,0,1,3,0,0,0,3,14,60,41,50,FALSE,0.833333333333333,2023,2023-2024
VI,2024-02-29,inter-total,0,0,0,0,0,0,0,0,0,0,0,0,0,0,FALSE,0,2023,2023-2024
VI,2024-02-29,inter-ucfe,0,0,0,0,0,0,0,0,0,0,0,0,0,0,FALSE,0,2023,2023-2024
VI,2024-02-29,inter-ucx,0,0,0,0,0,0,0,0,0,0,0,0,0,0,FALSE,0,2023,2023-2024
VI,2024-02-29,inter-ui,0,0,0,0,0,0,0,0,0,0,0,0,0,0,FALSE,0,2023,2023-2024
VI,2024-02-29,intra-total,16,7,4,0,2,0,0,0,0,0,15,44,31,38,FALSE,0.863636363636364,2023,2023-2024
VI,2024-02-29,intra-ucfe,0,1,1,0,0,0,0,0,0,0,0,2,0,1,FALSE,0.5,2023,2023-2024
VI,2024-02-29,intra-ucx,0,0,0,0,0,0,0,0,0,0,0,0,0,0,FALSE,0,2023,2023-2024
VI,2024-02-29,intra-ui,16,6,3,0,2,0,0,0,0,0,15,42,31,37,FALSE,0.880952380952381,2023,2023-2024
VI,2024-03-31,inter-total,1,0,0,0,0,0,0,0,0,0,0,1,1,1,FALSE,1,2023,2023-2024
VI,2024-03-31,inter-ucfe,0,0,0,0,0,0,0,0,0,0,0,0,0,0,FALSE,0,2023,2023-2024
VI,2024-03-31,inter-ucx,0,0,0,0,0,0,0,0,0,0,0,0,0,0,FALSE,0,2023,2023-2024
VI,2024-03-31,inter-ui,1,0,0,0,0,0,0,0,0,0,0,1,1,1,FALSE,1,2023,2023-2024
VI,2024-03-31,intra-total,35,6,4,1,1,0,0,0,0,2,28,77,63,69,FALSE,0.896103896103896,2023,2023-2024
VI,2024-03-31,intra-ucfe,0,0,0,0,0,0,0,0,0,0,2,2,2,2,FALSE,1,2023,2023-2024
VI,2024-03-31,intra-ucx,0,0,0,0,0,0,0,0,0,0,1,1,1,1,FALSE,1,2023,2023-2024
VI,2024-03-31,intra-ui,35,6,4,1,1,0,0,0,0,2,25,74,60,66,FALSE,0.891891891891892,2023,2023-2024
VI,2024-04-30,inter-total,1,0,0,0,0,0,0,0,0,0,1,2,2,2,FALSE,1,2023,2023-2024
VI,2024-04-30,inter-ucfe,0,0,0,0,0,0,0,0,0,0,0,0,0,0,FALSE,0,2023,2023-2024
VI,2024-04-30,inter-ucx,0,0,0,0,0,0,0,0,0,0,0,0,0,0,FALSE,0,2023,2023-2024
VI,2024-04-30,inter-ui,1,0,0,0,0,0,0,0,0,0,1,2,2,2,FALSE,1,2023,2023-2024
VI,2024-04-30,intra-total,16,6,5,1,3,1,0,1,0,0,10,43,26,32,FALSE,0.744186046511628,2023,2023-2024
VI,2024-04-30,intra-ucfe,0,0,0,0,0,0,0,0,0,0,0,0,0,0,FALSE,0,2023,2023-2024
VI,2024-04-30,intra-ucx,0,0,0,0,0,0,0,0,0,0,0,0,0,0,FALSE,0,2023,2023-2024
VI,2024-04-30,intra-ui,16,6,5,1,3,1,0,1,0,0,10,43,26,32,FALSE,0.744186046511628,2023,2023-2024
VI,2024-05-31,inter-total,0,1,0,0,0,0,0,0,0,0,1,2,1,2,FALSE,1,2023,2023-2024
VI,2024-05-31,inter-ucfe,0,0,0,0,0,0,0,0,0,0,0,0,0,0,FALSE,0,2023,2023-2024
VI,2024-05-31,inter-ucx,0,0,0,0,0,0,0,0,0,0,0,0,0,0,FALSE,0,2023,2023-2024
VI,2024-05-31,inter-ui,0,1,0,0,0,0,0,0,0,0,1,2,1,2,FALSE,1,2023,2023-2024
VI,2024-05-31,intra-total,17,3,3,3,2,1,0,0,0,1,16,46,33,36,FALSE,0.782608695652174,2023,2023-2024
VI,2024-05-31,intra-ucfe,0,0,0,0,0,0,0,0,0,0,0,0,0,0,FALSE,0,2023,2023-2024
VI,2024-05-31,intra-ucx,0,0,0,0,0,0,0,0,0,0,0,0,0,0,FALSE,0,2023,2023-2024
VI,2024-05-31,intra-ui,17,3,3,3,2,1,0,0,0,1,16,46,33,36,FALSE,0.782608695652174,2023,2023-2024
VI,2024-06-30,inter-total,0,1,0,0,0,0,0,0,0,1,2,4,2,3,FALSE,0.75,2023,2023-2024
VI,2024-06-30,inter-ucfe,0,0,0,0,0,0,0,0,0,0,0,0,0,0,FALSE,0,2023,2023-2024
VI,2024-06-30,inter-ucx,0,0,0,0,0,0,0,0,0,0,0,0,0,0,FALSE,0,2023,2023-2024
VI,2024-06-30,inter-ui,0,1,0,0,0,0,0,0,0,1,2,4,2,3,FALSE,0.75,2023,2023-2024
VI,2024-06-30,intra-total,44,7,1,4,0,1,0,0,1,0,15,73,59,66,FALSE,0.904109589041096,2023,2023-2024
VI,2024-06-30,intra-ucfe,0,0,0,1,0,0,0,0,0,0,0,1,0,0,FALSE,0,2023,2023-2024
VI,2024-06-30,intra-ucx,0,0,0,0,0,0,0,0,0,0,0,0,0,0,FALSE,0,2023,2023-2024
VI,2024-06-30,intra-ui,44,7,1,3,0,1,0,0,1,0,15,72,59,66,FALSE,0.916666666666667,2023,2023-2024
VI,2024-07-31,inter-total,1,0,0,0,0,0,0,0,1,1,0,3,1,1,FALSE,0.333333333333333,2024,2024-2025
VI,2024-07-31,inter-ucfe,0,0,0,0,0,0,0,0,0,0,0,0,0,0,FALSE,0,2024,2024-2025
VI,2024-07-31,inter-ucx,0,0,0,0,0,0,0,0,0,0,0,0,0,0,FALSE,0,2024,2024-2025
VI,2024-07-31,inter-ui,1,0,0,0,0,0,0,0,1,1,0,3,1,1,FALSE,0.333333333333333,2024,2024-2025
VI,2024-07-31,intra-total,18,21,6,0,0,0,0,1,0,1,33,80,51,72,FALSE,0.9,2024,2024-2025
VI,2024-07-31,intra-ucfe,0,1,0,0,0,0,0,0,0,0,0,1,0,1,FALSE,1,2024,2024-2025
VI,2024-07-31,intra-ucx,0,0,0,0,0,0,0,0,0,0,0,0,0,0,FALSE,0,2024,2024-2025
VI,2024-07-31,intra-ui,18,20,6,0,0,0,0,1,0,1,33,79,51,71,FALSE,0.89873417721519,2024,2024-2025
VI,2024-08-31,inter-total,0,0,0,1,0,0,0,0,0,0,0,1,0,0,FALSE,0,2024,2024-2025
VI,2024-08-31,inter-ucfe,0,0,0,0,0,0,0,0,0,0,0,0,0,0,FALSE,0,2024,2024-2025
VI,2024-08-31,inter-ucx,0,0,0,0,0,0,0,0,0,0,0,0,0,0,FALSE,0,2024,2024-2025
VI,2024-08-31,inter-ui,0,0,0,1,0,0,0,0,0,0,0,1,0,0,FALSE,0,2024,2024-2025
VI,2024-08-31,intra-total,19,6,6,6,0,0,1,1,0,2,20,61,39,45,FALSE,0.737704918032787,2024,2024-2025
VI,2024-08-31,intra-ucfe,1,0,0,0,0,0,0,0,0,0,0,1,1,1,FALSE,1,2024,2024-2025
VI,2024-08-31,intra-ucx,0,0,0,0,0,0,0,0,0,0,0,0,0,0,FALSE,0,2024,2024-2025
VI,2024-08-31,intra-ui,18,6,6,6,0,0,1,1,0,2,20,60,38,44,FALSE,0.733333333333333,2024,2024-2025
VI,2024-09-30,inter-total,0,0,0,0,0,0,0,0,0,1,0,1,0,0,FALSE,0,2024,2024-2025
VI,2024-09-30,inter-ucfe,0,0,0,0,0,0,0,0,0,0,0,0,0,0,FALSE,0,2024,2024-2025
VI,2024-09-30,inter-ucx,0,0,0,0,0,0,0,0,0,0,0,0,0,0,FALSE,0,2024,2024-2025
VI,2024-09-30,inter-ui,0,0,0,0,0,0,0,0,0,1,0,1,0,0,FALSE,0,2024,2024-2025
VI,2024-09-30,intra-total,54,23,9,6,2,1,2,1,0,4,38,140,92,115,FALSE,0.821428571428571,2024,2024-2025
VI,2024-09-30,intra-ucfe,0,0,0,0,0,1,0,1,0,0,0,2,0,0,FALSE,0,2024,2024-2025
VI,2024-09-30,intra-ucx,0,0,0,0,0,0,0,0,0,0,0,0,0,0,FALSE,0,2024,2024-2025
VI,2024-09-30,intra-ui,54,23,9,6,2,0,2,0,0,4,38,138,92,115,FALSE,0.833333333333333,2024,2024-2025
VI,2024-10-31,inter-total,0,1,0,0,0,0,0,0,0,0,0,1,0,1,FALSE,1,2024,2024-2025
VI,2024-10-31,inter-ucfe,0,0,0,0,0,0,0,0,0,0,0,0,0,0,FALSE,0,2024,2024-2025
VI,2024-10-31,inter-ucx,0,0,0,0,0,0,0,0,0,0,0,0,0,0,FALSE,0,2024,2024-2025
VI,2024-10-31,inter-ui,0,1,0,0,0,0,0,0,0,0,0,1,0,1,FALSE,1,2024,2024-2025
VI,2024-10-31,intra-total,43,19,14,6,5,1,2,0,0,2,30,122,73,92,FALSE,0.754098360655738,2024,2024-2025
VI,2024-10-31,intra-ucfe,0,0,0,0,0,0,0,0,0,0,0,0,0,0,FALSE,0,2024,2024-2025
VI,2024-10-31,intra-ucx,0,0,0,0,0,0,0,0,0,0,0,0,0,0,FALSE,0,2024,2024-2025
VI,2024-10-31,intra-ui,43,19,14,6,5,1,2,0,0,2,30,122,73,92,FALSE,0.754098360655738,2024,2024-2025
VI,2024-11-30,inter-total,0,1,0,0,0,0,0,1,1,0,0,3,0,1,FALSE,0.333333333333333,2024,2024-2025
VI,2024-11-30,inter-ucfe,0,0,0,0,0,0,0,0,0,0,0,0,0,0,FALSE,0,2024,2024-2025
VI,2024-11-30,inter-ucx,0,0,0,0,0,0,0,0,0,0,0,0,0,0,FALSE,0,2024,2024-2025
VI,2024-11-30,inter-ui,0,1,0,0,0,0,0,1,1,0,0,3,0,1,FALSE,0.333333333333333,2024,2024-2025
VI,2024-11-30,intra-total,16,6,11,6,5,1,2,1,0,1,12,61,28,34,FALSE,0.557377049180328,2024,2024-2025
VI,2024-11-30,intra-ucfe,0,0,0,1,0,0,0,0,0,0,0,1,0,0,FALSE,0,2024,2024-2025
VI,2024-11-30,intra-ucx,0,0,0,0,0,0,0,0,0,0,0,0,0,0,FALSE,0,2024,2024-2025
VI,2024-11-30,intra-ui,16,6,11,5,5,1,2,1,0,1,12,60,28,34,FALSE,0.566666666666667,2024,2024-2025
VT,2019-01-31,inter-total,41,20,9,8,5,2,0,0,0,0,70,155,111,131,FALSE,0.845161290322581,2018,2018-2019
VT,2019-01-31,inter-ucfe,1,2,0,0,1,0,0,0,0,0,6,10,7,9,FALSE,0.9,2018,2018-2019
VT,2019-01-31,inter-ucx,0,0,0,0,0,0,0,0,0,0,0,0,0,0,FALSE,0,2018,2018-2019
VT,2019-01-31,inter-ui,40,18,9,8,4,2,0,0,0,0,64,145,104,122,FALSE,0.841379310344828,2018,2018-2019
VT,2019-01-31,intra-total,1039,320,80,52,15,7,6,0,1,7,974,2501,2013,2333,FALSE,0.932826869252299,2018,2018-2019
VT,2019-01-31,intra-ucfe,11,4,3,0,0,0,1,0,0,0,37,56,48,52,FALSE,0.928571428571429,2018,2018-2019
VT,2019-01-31,intra-ucx,0,1,0,0,0,0,0,0,0,0,0,1,0,1,FALSE,1,2018,2018-2019
VT,2019-01-31,intra-ui,1028,315,77,52,15,7,5,0,1,7,937,2444,1965,2280,FALSE,0.932896890343699,2018,2018-2019
VT,2019-02-28,inter-total,60,19,5,4,2,2,1,1,1,4,30,129,90,109,FALSE,0.844961240310077,2018,2018-2019
VT,2019-02-28,inter-ucfe,0,0,0,0,0,0,0,0,0,0,1,1,1,1,FALSE,1,2018,2018-2019
VT,2019-02-28,inter-ucx,0,0,0,0,0,0,0,0,0,0,0,0,0,0,FALSE,0,2018,2018-2019
VT,2019-02-28,inter-ui,60,19,5,4,2,2,1,1,1,4,29,128,89,108,FALSE,0.84375,2018,2018-2019
VT,2019-02-28,intra-total,585,178,69,31,21,6,2,4,2,16,411,1325,996,1174,FALSE,0.886037735849057,2018,2018-2019
VT,2019-02-28,intra-ucfe,0,1,0,0,0,0,0,0,0,0,0,1,0,1,FALSE,1,2018,2018-2019
VT,2019-02-28,intra-ucx,0,0,0,0,0,0,0,0,0,0,1,1,1,1,FALSE,1,2018,2018-2019
VT,2019-02-28,intra-ui,585,177,69,31,21,6,2,4,2,16,410,1323,995,1172,FALSE,0.885865457294029,2018,2018-2019
VT,2019-03-31,inter-total,18,12,5,3,0,2,0,0,0,2,21,63,39,51,FALSE,0.80952380952381,2018,2018-2019
VT,2019-03-31,inter-ucfe,0,0,0,0,0,0,0,0,0,1,0,1,0,0,FALSE,0,2018,2018-2019
VT,2019-03-31,inter-ucx,0,0,0,0,0,0,0,0,0,0,0,0,0,0,FALSE,0,2018,2018-2019
VT,2019-03-31,inter-ui,18,12,5,3,0,2,0,0,0,1,21,62,39,51,FALSE,0.82258064516129,2018,2018-2019
VT,2019-03-31,intra-total,432,142,78,32,17,4,4,3,0,6,358,1076,790,932,FALSE,0.866171003717472,2018,2018-2019
VT,2019-03-31,intra-ucfe,1,0,0,0,0,0,1,0,0,0,0,2,1,1,FALSE,0.5,2018,2018-2019
VT,2019-03-31,intra-ucx,0,0,0,0,0,0,0,0,0,0,0,0,0,0,FALSE,0,2018,2018-2019
VT,2019-03-31,intra-ui,431,142,78,32,17,4,3,3,0,6,358,1074,789,931,FALSE,0.866852886405959,2018,2018-2019
VT,2019-04-30,inter-total,30,9,5,4,2,0,0,0,0,1,22,73,52,61,FALSE,0.835616438356164,2018,2018-2019
VT,2019-04-30,inter-ucfe,0,0,0,0,0,0,0,0,0,0,0,0,0,0,FALSE,0,2018,2018-2019
VT,2019-04-30,inter-ucx,0,0,0,0,0,0,0,0,0,0,0,0,0,0,FALSE,0,2018,2018-2019
VT,2019-04-30,inter-ui,30,9,5,4,2,0,0,0,0,1,22,73,52,61,FALSE,0.835616438356164,2018,2018-2019
VT,2019-04-30,intra-total,510,171,60,44,10,9,4,2,3,9,417,1239,927,1098,FALSE,0.886198547215497,2018,2018-2019
VT,2019-04-30,intra-ucfe,0,0,1,0,0,0,0,0,0,1,1,3,1,1,FALSE,0.333333333333333,2018,2018-2019
VT,2019-04-30,intra-ucx,0,0,0,0,0,0,0,0,0,0,0,0,0,0,FALSE,0,2018,2018-2019
VT,2019-04-30,intra-ui,510,171,59,44,10,9,4,2,3,8,416,1236,926,1097,FALSE,0.887540453074434,2018,2018-2019
VT,2019-05-31,inter-total,22,8,8,6,1,0,1,0,0,1,22,69,44,52,FALSE,0.753623188405797,2018,2018-2019
VT,2019-05-31,inter-ucfe,0,0,0,0,0,0,0,0,0,0,0,0,0,0,FALSE,0,2018,2018-2019
VT,2019-05-31,inter-ucx,0,0,0,0,0,0,0,0,0,0,0,0,0,0,FALSE,0,2018,2018-2019
VT,2019-05-31,inter-ui,22,8,8,6,1,0,1,0,0,1,22,69,44,52,FALSE,0.753623188405797,2018,2018-2019
VT,2019-05-31,intra-total,380,139,82,48,14,4,3,1,3,22,332,1028,712,851,FALSE,0.827821011673152,2018,2018-2019
VT,2019-05-31,intra-ucfe,0,0,0,0,0,0,0,0,0,1,0,1,0,0,FALSE,0,2018,2018-2019
VT,2019-05-31,intra-ucx,0,0,0,0,0,0,0,0,0,0,0,0,0,0,FALSE,0,2018,2018-2019
VT,2019-05-31,intra-ui,380,139,82,48,14,4,3,1,3,21,332,1027,712,851,FALSE,0.828627069133398,2018,2018-2019
VT,2019-06-30,inter-total,19,7,6,1,2,1,0,0,0,0,15,51,34,41,FALSE,0.803921568627451,2018,2018-2019
VT,2019-06-30,inter-ucfe,0,0,0,0,0,0,0,0,0,0,0,0,0,0,FALSE,0,2018,2018-2019
VT,2019-06-30,inter-ucx,0,0,0,0,0,0,0,0,0,0,0,0,0,0,FALSE,0,2018,2018-2019
VT,2019-06-30,inter-ui,19,7,6,1,2,1,0,0,0,0,15,51,34,41,FALSE,0.803921568627451,2018,2018-2019
VT,2019-06-30,intra-total,259,92,55,20,8,3,3,2,3,6,153,604,412,504,FALSE,0.834437086092715,2018,2018-2019
VT,2019-06-30,intra-ucfe,0,0,0,1,0,0,1,0,0,0,0,2,0,0,FALSE,0,2018,2018-2019
VT,2019-06-30,intra-ucx,0,0,0,0,0,0,0,0,0,0,0,0,0,0,FALSE,0,2018,2018-2019
VT,2019-06-30,intra-ui,259,92,55,19,8,3,2,2,3,6,153,602,412,504,FALSE,0.837209302325582,2018,2018-2019
VT,2019-07-31,inter-total,25,13,6,4,3,2,0,1,0,1,19,74,44,57,FALSE,0.77027027027027,2019,2019-2020
VT,2019-07-31,inter-ucfe,0,0,0,0,0,0,0,0,0,0,0,0,0,0,FALSE,0,2019,2019-2020
VT,2019-07-31,inter-ucx,0,0,0,0,0,0,0,0,0,0,0,0,0,0,FALSE,0,2019,2019-2020
VT,2019-07-31,inter-ui,25,13,6,4,3,2,0,1,0,1,19,74,44,57,FALSE,0.77027027027027,2019,2019-2020
VT,2019-07-31,intra-total,383,183,73,38,21,16,2,1,2,6,329,1054,712,895,FALSE,0.849146110056926,2019,2019-2020
VT,2019-07-31,intra-ucfe,1,0,0,0,1,0,0,0,0,0,0,2,1,1,FALSE,0.5,2019,2019-2020
VT,2019-07-31,intra-ucx,0,0,0,0,0,0,0,0,0,0,0,0,0,0,FALSE,0,2019,2019-2020
VT,2019-07-31,intra-ui,382,183,73,38,20,16,2,1,2,6,329,1052,711,894,FALSE,0.849809885931559,2019,2019-2020
VT,2019-08-31,inter-total,11,11,2,1,0,1,1,0,0,2,16,45,27,38,FALSE,0.844444444444445,2019,2019-2020
VT,2019-08-31,inter-ucfe,0,0,0,0,0,0,0,0,0,1,0,1,0,0,FALSE,0,2019,2019-2020
VT,2019-08-31,inter-ucx,0,0,0,0,0,0,0,0,0,0,0,0,0,0,FALSE,0,2019,2019-2020
VT,2019-08-31,inter-ui,11,11,2,1,0,1,1,0,0,1,16,44,27,38,FALSE,0.863636363636364,2019,2019-2020
VT,2019-08-31,intra-total,145,78,32,15,9,9,1,3,2,12,157,463,302,380,FALSE,0.8207343412527,2019,2019-2020
VT,2019-08-31,intra-ucfe,0,0,1,0,0,0,0,0,0,0,1,2,1,1,FALSE,0.5,2019,2019-2020
VT,2019-08-31,intra-ucx,0,0,0,0,0,0,0,0,0,0,0,0,0,0,FALSE,0,2019,2019-2020
VT,2019-08-31,intra-ui,145,78,31,15,9,9,1,3,2,12,156,461,301,379,FALSE,0.822125813449024,2019,2019-2020
VT,2019-09-30,inter-total,10,9,5,0,0,0,0,0,0,2,14,40,24,33,FALSE,0.825,2019,2019-2020
VT,2019-09-30,inter-ucfe,0,1,0,0,0,0,0,0,0,0,0,1,0,1,FALSE,1,2019,2019-2020
VT,2019-09-30,inter-ucx,0,0,0,0,0,0,0,0,0,0,0,0,0,0,FALSE,0,2019,2019-2020
VT,2019-09-30,inter-ui,10,8,5,0,0,0,0,0,0,2,14,39,24,32,FALSE,0.82051282051282,2019,2019-2020
VT,2019-09-30,intra-total,127,61,24,9,7,3,2,1,0,11,131,376,258,319,FALSE,0.848404255319149,2019,2019-2020
VT,2019-09-30,intra-ucfe,0,0,0,0,0,0,0,0,0,0,0,0,0,0,FALSE,0,2019,2019-2020
VT,2019-09-30,intra-ucx,0,0,0,0,0,0,0,0,0,0,0,0,0,0,FALSE,0,2019,2019-2020
VT,2019-09-30,intra-ui,127,61,24,9,7,3,2,1,0,11,131,376,258,319,FALSE,0.848404255319149,2019,2019-2020
VT,2019-10-31,inter-total,14,9,4,2,3,1,1,0,1,1,16,52,30,39,FALSE,0.75,2019,2019-2020
VT,2019-10-31,inter-ucfe,0,0,0,0,0,0,0,0,0,0,0,0,0,0,FALSE,0,2019,2019-2020
VT,2019-10-31,inter-ucx,0,0,0,0,0,0,0,0,0,0,0,0,0,0,FALSE,0,2019,2019-2020
VT,2019-10-31,inter-ui,14,9,4,2,3,1,1,0,1,1,16,52,30,39,FALSE,0.75,2019,2019-2020
VT,2019-10-31,intra-total,191,68,31,12,17,8,10,2,4,3,180,526,371,439,FALSE,0.834600760456274,2019,2019-2020
VT,2019-10-31,intra-ucfe,0,1,0,0,0,0,1,0,0,0,1,3,1,2,FALSE,0.666666666666667,2019,2019-2020
VT,2019-10-31,intra-ucx,0,0,0,0,0,0,0,0,0,0,0,0,0,0,FALSE,0,2019,2019-2020
VT,2019-10-31,intra-ui,191,67,31,12,17,8,9,2,4,3,179,523,370,437,FALSE,0.835564053537285,2019,2019-2020
VT,2019-11-30,inter-total,32,9,3,2,0,1,0,1,0,1,39,88,71,80,FALSE,0.909090909090909,2019,2019-2020
VT,2019-11-30,inter-ucfe,0,0,0,0,0,0,0,0,0,0,0,0,0,0,FALSE,0,2019,2019-2020
VT,2019-11-30,inter-ucx,0,0,0,0,0,0,0,0,0,0,0,0,0,0,FALSE,0,2019,2019-2020
VT,2019-11-30,inter-ui,32,9,3,2,0,1,0,1,0,1,39,88,71,80,FALSE,0.909090909090909,2019,2019-2020
VT,2019-11-30,intra-total,374,95,29,12,7,4,3,1,3,6,355,889,729,824,FALSE,0.926884139482565,2019,2019-2020
VT,2019-11-30,intra-ucfe,1,0,0,0,0,0,0,0,0,0,2,3,3,3,FALSE,1,2019,2019-2020
VT,2019-11-30,intra-ucx,0,0,0,0,0,0,0,0,0,0,0,0,0,0,FALSE,0,2019,2019-2020
VT,2019-11-30,intra-ui,373,95,29,12,7,4,3,1,3,6,353,886,726,821,FALSE,0.926636568848758,2019,2019-2020
VT,2019-12-31,inter-total,54,10,5,5,1,1,0,0,2,0,41,119,95,105,FALSE,0.882352941176471,2019,2019-2020
VT,2019-12-31,inter-ucfe,0,0,0,1,0,0,0,0,1,0,1,3,1,1,FALSE,0.333333333333333,2019,2019-2020
VT,2019-12-31,inter-ucx,0,0,0,0,0,0,0,0,0,0,0,0,0,0,FALSE,0,2019,2019-2020
VT,2019-12-31,inter-ui,54,10,5,4,1,1,0,0,1,0,40,116,94,104,FALSE,0.896551724137931,2019,2019-2020
VT,2019-12-31,intra-total,1004,202,45,32,15,13,5,1,2,6,633,1958,1637,1839,FALSE,0.939223697650664,2019,2019-2020
VT,2019-12-31,intra-ucfe,1,0,0,0,2,0,0,0,0,0,0,3,1,1,FALSE,0.333333333333333,2019,2019-2020
VT,2019-12-31,intra-ucx,0,0,0,0,0,0,0,0,0,0,0,0,0,0,FALSE,0,2019,2019-2020
VT,2019-12-31,intra-ui,1003,202,45,32,13,13,5,1,2,6,633,1955,1636,1838,FALSE,0.940153452685422,2019,2019-2020
VT,2020-01-31,inter-total,52,10,2,2,1,4,1,1,0,0,47,120,99,109,FALSE,0.908333333333333,2019,2019-2020
VT,2020-01-31,inter-ucfe,0,0,0,0,0,0,0,1,0,0,1,2,1,1,FALSE,0.5,2019,2019-2020
VT,2020-01-31,inter-ucx,0,0,0,0,0,0,0,0,0,0,0,0,0,0,FALSE,0,2019,2019-2020
VT,2020-01-31,inter-ui,52,10,2,2,1,4,1,0,0,0,46,118,98,108,FALSE,0.915254237288136,2019,2019-2020
VT,2020-01-31,intra-total,802,283,37,27,19,19,23,6,6,20,779,2021,1581,1864,FALSE,0.922315685304305,2019,2019-2020
VT,2020-01-31,intra-ucfe,0,0,0,0,0,0,0,0,0,0,0,0,0,0,FALSE,0,2019,2019-2020
VT,2020-01-31,intra-ucx,0,0,0,0,0,0,0,0,1,0,0,1,0,0,FALSE,0,2019,2019-2020
VT,2020-01-31,intra-ui,802,283,37,27,19,19,23,6,5,20,779,2020,1581,1864,FALSE,0.922772277227723,2019,2019-2020
VT,2020-02-29,inter-total,20,8,4,3,2,2,5,1,1,1,24,71,44,52,FALSE,0.732394366197183,2019,2019-2020
VT,2020-02-29,inter-ucfe,0,0,0,0,0,0,0,0,0,0,0,0,0,0,FALSE,0,2019,2019-2020
VT,2020-02-29,inter-ucx,0,0,0,0,0,0,0,0,0,0,0,0,0,0,FALSE,0,2019,2019-2020
VT,2020-02-29,inter-ui,20,8,4,3,2,2,5,1,1,1,24,71,44,52,FALSE,0.732394366197183,2019,2019-2020
VT,2020-02-29,intra-total,456,142,47,32,21,26,15,15,6,28,381,1169,837,979,FALSE,0.837467921300257,2019,2019-2020
VT,2020-02-29,intra-ucfe,1,0,0,0,0,0,0,0,0,0,1,2,2,2,FALSE,1,2019,2019-2020
VT,2020-02-29,intra-ucx,0,0,0,0,0,0,0,0,0,0,1,1,1,1,FALSE,1,2019,2019-2020
VT,2020-02-29,intra-ui,455,142,47,32,21,26,15,15,6,28,379,1166,834,976,FALSE,0.83704974271012,2019,2019-2020
VT,2020-03-31,inter-total,91,6,4,3,1,4,1,2,0,0,25,137,116,122,FALSE,0.89051094890511,2019,2019-2020
VT,2020-03-31,inter-ucfe,1,0,0,0,0,0,0,0,0,0,0,1,1,1,FALSE,1,2019,2019-2020
VT,2020-03-31,inter-ucx,0,0,0,0,0,0,0,0,0,0,0,0,0,0,FALSE,0,2019,2019-2020
VT,2020-03-31,inter-ui,90,6,4,3,1,4,1,2,0,0,25,136,115,121,FALSE,0.889705882352941,2019,2019-2020
VT,2020-03-31,intra-total,3582,134,44,28,13,15,14,16,11,24,670,4551,4252,4386,FALSE,0.963744232036915,2019,2019-2020
VT,2020-03-31,intra-ucfe,0,0,0,0,0,0,0,0,0,0,0,0,0,0,FALSE,0,2019,2019-2020
VT,2020-03-31,intra-ucx,0,0,0,0,0,0,0,0,0,1,0,1,0,0,FALSE,0,2019,2019-2020
VT,2020-03-31,intra-ui,3582,134,44,28,13,15,14,16,11,23,670,4550,4252,4386,FALSE,0.963956043956044,2019,2019-2020
VT,2020-04-30,inter-total,111,84,85,17,8,4,3,4,3,6,111,436,222,306,FALSE,0.701834862385321,2019,2019-2020
VT,2020-04-30,inter-ucfe,0,0,0,0,0,0,0,0,0,0,0,0,0,0,FALSE,0,2019,2019-2020
VT,2020-04-30,inter-ucx,0,0,0,0,0,0,0,0,0,0,0,0,0,0,FALSE,0,2019,2019-2020
VT,2020-04-30,inter-ui,111,84,85,17,8,4,3,4,3,6,111,436,222,306,FALSE,0.701834862385321,2019,2019-2020
VT,2020-04-30,intra-total,12558,10920,7969,1755,251,51,48,55,37,82,12558,46284,25116,36036,FALSE,0.778584392014519,2019,2019-2020
VT,2020-04-30,intra-ucfe,1,0,2,0,0,0,0,0,0,0,1,4,2,2,FALSE,0.5,2019,2019-2020
VT,2020-04-30,intra-ucx,0,0,1,1,0,0,0,0,0,0,0,2,0,0,FALSE,0,2019,2019-2020
VT,2020-04-30,intra-ui,12557,10920,7966,1754,251,51,48,55,37,82,12557,46278,25114,36034,FALSE,0.778642119365573,2019,2019-2020
VT,2020-05-31,inter-total,9,10,11,16,15,8,7,8,6,12,9,111,18,28,FALSE,0.252252252252252,2019,2019-2020
VT,2020-05-31,inter-ucfe,0,0,0,0,0,0,0,0,0,0,0,0,0,0,FALSE,0,2019,2019-2020
VT,2020-05-31,inter-ucx,0,0,0,0,0,0,0,0,0,0,0,0,0,0,FALSE,0,2019,2019-2020
VT,2020-05-31,inter-ui,9,10,11,16,15,8,7,8,6,12,9,111,18,28,FALSE,0.252252252252252,2019,2019-2020
VT,2020-05-31,intra-total,2387,1465,1006,1094,831,235,221,252,172,376,2387,10426,4774,6239,FALSE,0.598407826587378,2019,2019-2020
VT,2020-05-31,intra-ucfe,0,0,0,0,4,1,1,1,0,1,0,8,0,0,FALSE,0,2019,2019-2020
VT,2020-05-31,intra-ucx,1,0,0,0,1,1,1,1,1,1,1,8,2,2,FALSE,0.25,2019,2019-2020
VT,2020-05-31,intra-ui,2386,1465,1006,1094,826,233,219,250,171,374,2386,10410,4772,6237,FALSE,0.599135446685879,2019,2019-2020
VT,2020-06-30,inter-total,92,36,21,5,12,11,14,10,15,44,103,363,195,231,FALSE,0.636363636363636,2019,2019-2020
VT,2020-06-30,inter-ucfe,0,0,0,0,0,0,0,0,0,1,0,1,0,0,FALSE,0,2019,2019-2020
VT,2020-06-30,inter-ucx,0,0,0,0,0,0,0,0,0,1,0,1,0,0,FALSE,0,2019,2019-2020
VT,2020-06-30,inter-ui,92,36,21,5,12,11,14,10,15,42,103,361,195,231,FALSE,0.6398891966759,2019,2019-2020
VT,2020-06-30,intra-total,1014,422,151,126,153,133,150,155,115,306,1247,3972,2261,2683,FALSE,0.675478348439074,2019,2019-2020
VT,2020-06-30,intra-ucfe,1,0,0,0,0,0,1,2,2,2,0,8,1,1,FALSE,0.125,2019,2019-2020
VT,2020-06-30,intra-ucx,1,0,0,0,0,0,1,1,2,2,0,7,1,1,FALSE,0.142857142857143,2019,2019-2020
VT,2020-06-30,intra-ui,1012,422,151,126,153,133,148,152,111,302,1247,3957,2259,2681,FALSE,0.677533484963356,2019,2019-2020
VT,2020-07-31,inter-total,63,26,14,8,8,7,10,4,4,46,64,254,127,153,FALSE,0.602362204724409,2020,2020-2021
VT,2020-07-31,inter-ucfe,0,0,0,0,0,0,0,0,0,0,0,0,0,0,FALSE,0,2020,2020-2021
VT,2020-07-31,inter-ucx,0,0,0,0,0,0,0,0,0,0,0,0,0,0,FALSE,0,2020,2020-2021
VT,2020-07-31,inter-ui,63,26,14,8,8,7,10,4,4,46,64,254,127,153,FALSE,0.602362204724409,2020,2020-2021
VT,2020-07-31,intra-total,1035,273,124,97,99,79,56,48,55,382,899,3147,1934,2207,FALSE,0.701302828090245,2020,2020-2021
VT,2020-07-31,intra-ucfe,0,0,0,0,0,0,1,0,0,2,0,3,0,0,FALSE,0,2020,2020-2021
VT,2020-07-31,intra-ucx,0,0,0,0,0,2,0,0,0,1,1,4,1,1,FALSE,0.25,2020,2020-2021
VT,2020-07-31,intra-ui,1035,273,124,97,99,77,55,48,55,379,898,3140,1933,2206,FALSE,0.702547770700637,2020,2020-2021
VT,2020-08-31,inter-total,41,12,5,4,5,8,5,8,4,33,27,152,68,80,FALSE,0.526315789473684,2020,2020-2021
VT,2020-08-31,inter-ucfe,0,0,0,0,0,0,0,0,0,1,0,1,0,0,FALSE,0,2020,2020-2021
VT,2020-08-31,inter-ucx,0,0,0,0,0,0,0,0,0,0,0,0,0,0,FALSE,0,2020,2020-2021
VT,2020-08-31,inter-ui,41,12,5,4,5,8,5,8,4,32,27,151,68,80,FALSE,0.529801324503311,2020,2020-2021
VT,2020-08-31,intra-total,444,97,54,67,72,67,55,66,43,337,301,1603,745,842,FALSE,0.525265127885215,2020,2020-2021
VT,2020-08-31,intra-ucfe,1,0,0,0,0,0,0,0,0,1,0,2,1,1,FALSE,0.5,2020,2020-2021
VT,2020-08-31,intra-ucx,0,0,0,0,0,0,0,0,0,2,0,2,0,0,FALSE,0,2020,2020-2021
VT,2020-08-31,intra-ui,443,97,54,67,72,67,55,66,43,334,301,1599,744,841,FALSE,0.525953721075672,2020,2020-2021
VT,2020-09-30,inter-total,44,4,0,0,1,0,3,4,7,35,34,132,78,82,FALSE,0.621212121212121,2020,2020-2021
VT,2020-09-30,inter-ucfe,0,0,0,0,0,0,0,0,0,1,0,1,0,0,FALSE,0,2020,2020-2021
VT,2020-09-30,inter-ucx,0,0,0,0,0,0,0,0,0,0,0,0,0,0,FALSE,0,2020,2020-2021
VT,2020-09-30,inter-ui,44,4,0,0,1,0,3,4,7,34,34,131,78,82,FALSE,0.625954198473283,2020,2020-2021
VT,2020-09-30,intra-total,433,74,28,13,18,20,27,31,31,214,262,1151,695,769,FALSE,0.668114682884448,2020,2020-2021
VT,2020-09-30,intra-ucfe,1,0,0,1,1,0,0,0,0,2,0,5,1,1,FALSE,0.2,2020,2020-2021
VT,2020-09-30,intra-ucx,1,0,0,0,0,0,0,0,0,0,0,1,1,1,FALSE,1,2020,2020-2021
VT,2020-09-30,intra-ui,431,74,28,12,17,20,27,31,31,212,262,1145,693,767,FALSE,0.669868995633188,2020,2020-2021
VT,2020-10-31,inter-total,28,5,2,2,0,1,0,1,2,26,35,102,63,68,FALSE,0.666666666666667,2020,2020-2021
VT,2020-10-31,inter-ucfe,0,0,0,0,0,0,0,0,0,0,0,0,0,0,FALSE,0,2020,2020-2021
VT,2020-10-31,inter-ucx,0,0,0,0,0,0,0,0,0,0,0,0,0,0,FALSE,0,2020,2020-2021
VT,2020-10-31,inter-ui,28,5,2,2,0,1,0,1,2,26,35,102,63,68,FALSE,0.666666666666667,2020,2020-2021
VT,2020-10-31,intra-total,361,45,26,15,13,10,18,16,15,169,232,920,593,638,FALSE,0.693478260869565,2020,2020-2021
VT,2020-10-31,intra-ucfe,2,1,1,0,0,0,0,0,0,1,0,5,2,3,FALSE,0.6,2020,2020-2021
VT,2020-10-31,intra-ucx,0,0,0,0,0,1,0,0,0,0,0,1,0,0,FALSE,0,2020,2020-2021
VT,2020-10-31,intra-ui,359,44,25,15,13,9,18,16,15,168,232,914,591,635,FALSE,0.694748358862144,2020,2020-2021
VT,2020-11-30,inter-total,29,3,1,0,1,2,5,3,4,26,22,96,51,54,FALSE,0.5625,2020,2020-2021
VT,2020-11-30,inter-ucfe,0,0,0,0,0,0,0,0,0,0,0,0,0,0,FALSE,0,2020,2020-2021
VT,2020-11-30,inter-ucx,0,0,0,0,0,0,0,0,0,0,0,0,0,0,FALSE,0,2020,2020-2021
VT,2020-11-30,inter-ui,29,3,1,0,1,2,5,3,4,26,22,96,51,54,FALSE,0.5625,2020,2020-2021
VT,2020-11-30,intra-total,488,60,21,13,10,19,17,18,13,161,348,1168,836,896,FALSE,0.767123287671233,2020,2020-2021
VT,2020-11-30,intra-ucfe,1,0,0,2,0,0,1,0,0,0,1,5,2,2,FALSE,0.4,2020,2020-2021
VT,2020-11-30,intra-ucx,1,1,0,0,0,0,0,0,0,0,0,2,1,2,FALSE,1,2020,2020-2021
VT,2020-11-30,intra-ui,486,59,21,11,10,19,16,18,13,161,347,1161,833,892,FALSE,0.768303186907838,2020,2020-2021
VT,2020-12-31,inter-total,39,16,5,7,3,0,3,0,2,16,37,128,76,92,FALSE,0.71875,2020,2020-2021
VT,2020-12-31,inter-ucfe,0,0,0,0,0,0,0,0,0,0,0,0,0,0,FALSE,0,2020,2020-2021
VT,2020-12-31,inter-ucx,0,0,0,0,0,0,0,0,0,0,0,0,0,0,FALSE,0,2020,2020-2021
VT,2020-12-31,inter-ui,39,16,5,7,3,0,3,0,2,16,37,128,76,92,FALSE,0.71875,2020,2020-2021
VT,2020-12-31,intra-total,892,151,96,54,51,33,16,7,13,133,528,1974,1420,1571,FALSE,0.795845997973658,2020,2020-2021
VT,2020-12-31,intra-ucfe,1,2,0,0,1,0,0,1,0,0,2,7,3,5,FALSE,0.714285714285714,2020,2020-2021
VT,2020-12-31,intra-ucx,0,0,0,1,0,0,0,0,0,0,1,2,1,1,FALSE,0.5,2020,2020-2021
VT,2020-12-31,intra-ui,891,149,96,53,50,33,16,6,13,133,525,1965,1416,1565,FALSE,0.796437659033079,2020,2020-2021
VT,2021-01-31,inter-total,59,9,6,5,1,3,3,2,0,13,41,142,100,109,FALSE,0.767605633802817,2020,2020-2021
VT,2021-01-31,inter-ucfe,0,0,0,0,0,0,0,0,0,1,0,1,0,0,FALSE,0,2020,2020-2021
VT,2021-01-31,inter-ucx,0,0,0,0,0,0,0,0,0,0,0,0,0,0,FALSE,0,2020,2020-2021
VT,2021-01-31,inter-ui,59,9,6,5,1,3,3,2,0,12,41,141,100,109,FALSE,0.773049645390071,2020,2020-2021
VT,2021-01-31,intra-total,1004,129,66,61,57,38,38,20,8,108,565,2094,1569,1698,FALSE,0.810888252148997,2020,2020-2021
VT,2021-01-31,intra-ucfe,0,0,1,0,0,0,2,0,1,2,2,8,2,2,FALSE,0.25,2020,2020-2021
VT,2021-01-31,intra-ucx,0,1,0,0,1,0,0,0,0,0,1,3,1,2,FALSE,0.666666666666667,2020,2020-2021
VT,2021-01-31,intra-ui,1004,128,65,61,56,38,36,20,7,106,562,2083,1566,1694,FALSE,0.813250120019203,2020,2020-2021
VT,2021-02-28,inter-total,38,11,14,7,3,4,3,4,1,17,29,131,67,78,FALSE,0.595419847328244,2020,2020-2021
VT,2021-02-28,inter-ucfe,0,0,0,0,0,1,0,0,0,0,0,1,0,0,FALSE,0,2020,2020-2021
VT,2021-02-28,inter-ucx,0,0,0,0,0,0,0,0,0,0,0,0,0,0,FALSE,0,2020,2020-2021
VT,2021-02-28,inter-ui,38,11,14,7,3,3,3,4,1,17,29,130,67,78,FALSE,0.6,2020,2020-2021
VT,2021-02-28,intra-total,519,171,113,121,111,72,59,38,21,111,408,1744,927,1098,FALSE,0.629587155963303,2020,2020-2021
VT,2021-02-28,intra-ucfe,0,2,2,1,0,3,0,0,0,8,2,18,2,4,FALSE,0.222222222222222,2020,2020-2021
VT,2021-02-28,intra-ucx,1,0,0,0,0,0,0,0,0,0,0,1,1,1,FALSE,1,2020,2020-2021
VT,2021-02-28,intra-ui,518,169,111,120,111,69,59,38,21,103,406,1725,924,1093,FALSE,0.633623188405797,2020,2020-2021
VT,2021-03-31,inter-total,35,10,11,3,5,4,3,2,0,15,22,110,57,67,FALSE,0.609090909090909,2020,2020-2021
VT,2021-03-31,inter-ucfe,1,0,0,0,0,0,0,1,0,0,0,2,1,1,FALSE,0.5,2020,2020-2021
VT,2021-03-31,inter-ucx,0,0,0,0,0,0,0,0,0,0,0,0,0,0,FALSE,0,2020,2020-2021
VT,2021-03-31,inter-ui,34,10,11,3,5,4,3,1,0,15,22,108,56,66,FALSE,0.611111111111111,2020,2020-2021
VT,2021-03-31,intra-total,869,201,145,75,33,25,22,10,7,80,493,1960,1362,1563,FALSE,0.797448979591837,2020,2020-2021
VT,2021-03-31,intra-ucfe,1,1,0,0,1,0,0,0,0,2,0,5,1,2,FALSE,0.4,2020,2020-2021
VT,2021-03-31,intra-ucx,0,0,0,0,0,0,0,0,0,0,0,0,0,0,FALSE,0,2020,2020-2021
VT,2021-03-31,intra-ui,868,200,145,75,32,25,22,10,7,78,493,1955,1361,1561,FALSE,0.79846547314578,2020,2020-2021
VT,2021-04-30,inter-total,74,30,21,4,3,0,0,0,0,6,61,199,135,165,FALSE,0.829145728643216,2020,2020-2021
VT,2021-04-30,inter-ucfe,0,0,0,0,0,0,0,0,0,0,0,0,0,0,FALSE,0,2020,2020-2021
VT,2021-04-30,inter-ucx,0,0,0,0,0,0,0,0,0,0,0,0,0,0,FALSE,0,2020,2020-2021
VT,2021-04-30,inter-ui,74,30,21,4,3,0,0,0,0,6,61,199,135,165,FALSE,0.829145728643216,2020,2020-2021
VT,2021-04-30,intra-total,1676,704,323,147,84,10,9,3,6,59,1777,4798,3453,4157,FALSE,0.866402667778241,2020,2020-2021
VT,2021-04-30,intra-ucfe,0,2,0,1,0,0,0,0,0,1,0,4,0,2,FALSE,0.5,2020,2020-2021
VT,2021-04-30,intra-ucx,0,1,0,0,0,0,0,0,0,0,1,2,1,2,FALSE,1,2020,2020-2021
VT,2021-04-30,intra-ui,1676,701,323,146,84,10,9,3,6,58,1776,4792,3452,4153,FALSE,0.866652754590985,2020,2020-2021
VT,2021-05-31,inter-total,5,13,15,7,10,4,2,0,0,6,25,87,30,43,FALSE,0.494252873563218,2020,2020-2021
VT,2021-05-31,inter-ucfe,0,0,0,0,0,0,0,0,0,1,0,1,0,0,FALSE,0,2020,2020-2021
VT,2021-05-31,inter-ucx,0,0,0,0,0,0,0,0,0,0,0,0,0,0,FALSE,0,2020,2020-2021
VT,2021-05-31,inter-ui,5,13,15,7,10,4,2,0,0,5,25,86,30,43,FALSE,0.5,2020,2020-2021
VT,2021-05-31,intra-total,212,232,161,153,118,95,116,41,17,49,482,1676,694,926,FALSE,0.552505966587112,2020,2020-2021
VT,2021-05-31,intra-ucfe,1,0,0,0,0,0,0,0,0,1,1,3,2,2,FALSE,0.666666666666667,2020,2020-2021
VT,2021-05-31,intra-ucx,0,0,0,0,0,0,0,0,0,1,0,1,0,0,FALSE,0,2020,2020-2021
VT,2021-05-31,intra-ui,211,232,161,153,118,95,116,41,17,47,481,1672,692,924,FALSE,0.552631578947369,2020,2020-2021
VT,2021-06-30,inter-total,8,2,0,2,5,5,5,4,2,15,10,58,18,20,FALSE,0.344827586206897,2020,2020-2021
VT,2021-06-30,inter-ucfe,0,0,0,0,0,0,0,0,0,0,0,0,0,0,FALSE,0,2020,2020-2021
VT,2021-06-30,inter-ucx,0,0,0,0,0,0,0,0,0,0,0,0,0,0,FALSE,0,2020,2020-2021
VT,2021-06-30,inter-ui,8,2,0,2,5,5,5,4,2,15,10,58,18,20,FALSE,0.344827586206897,2020,2020-2021
VT,2021-06-30,intra-total,121,99,66,59,100,61,55,45,41,128,268,1043,389,488,FALSE,0.467881112176414,2020,2020-2021
VT,2021-06-30,intra-ucfe,1,0,0,0,0,0,0,1,0,0,1,3,2,2,FALSE,0.666666666666667,2020,2020-2021
VT,2021-06-30,intra-ucx,0,0,0,0,0,0,0,0,0,0,0,0,0,0,FALSE,0,2020,2020-2021
VT,2021-06-30,intra-ui,120,99,66,59,100,61,55,44,41,128,267,1040,387,486,FALSE,0.467307692307692,2020,2020-2021
VT,2021-07-31,inter-total,5,7,1,3,1,2,2,2,0,19,11,53,16,23,FALSE,0.433962264150943,2021,2021-2022
VT,2021-07-31,inter-ucfe,0,0,0,0,0,0,0,0,0,0,0,0,0,0,FALSE,0,2021,2021-2022
VT,2021-07-31,inter-ucx,0,0,0,0,0,0,0,0,0,1,0,1,0,0,FALSE,0,2021,2021-2022
VT,2021-07-31,inter-ui,5,7,1,3,1,2,2,2,0,18,11,52,16,23,FALSE,0.442307692307692,2021,2021-2022
VT,2021-07-31,intra-total,89,118,46,47,62,32,22,21,12,183,240,872,329,447,FALSE,0.512614678899083,2021,2021-2022
VT,2021-07-31,intra-ucfe,0,0,0,0,0,0,0,0,0,3,0,3,0,0,FALSE,0,2021,2021-2022
VT,2021-07-31,intra-ucx,0,0,0,0,0,0,0,0,0,0,0,0,0,0,FALSE,0,2021,2021-2022
VT,2021-07-31,intra-ui,89,118,46,47,62,32,22,21,12,180,240,869,329,447,FALSE,0.514384349827388,2021,2021-2022
VT,2021-08-31,inter-total,5,7,3,6,4,5,5,0,1,13,11,60,16,23,FALSE,0.383333333333333,2021,2021-2022
VT,2021-08-31,inter-ucfe,0,0,0,0,0,0,0,0,0,0,0,0,0,0,FALSE,0,2021,2021-2022
VT,2021-08-31,inter-ucx,0,0,0,0,0,0,0,0,0,0,0,0,0,0,FALSE,0,2021,2021-2022
VT,2021-08-31,inter-ui,5,7,3,6,4,5,5,0,1,13,11,60,16,23,FALSE,0.383333333333333,2021,2021-2022
VT,2021-08-31,intra-total,64,41,30,47,60,45,39,20,16,173,101,636,165,206,FALSE,0.323899371069182,2021,2021-2022
VT,2021-08-31,intra-ucfe,0,0,0,0,0,0,0,0,0,2,0,2,0,0,FALSE,0,2021,2021-2022
VT,2021-08-31,intra-ucx,0,0,0,0,0,0,0,0,0,0,0,0,0,0,FALSE,0,2021,2021-2022
VT,2021-08-31,intra-ui,64,41,30,47,60,45,39,20,16,171,101,634,165,206,FALSE,0.324921135646688,2021,2021-2022
VT,2021-09-30,inter-total,24,9,2,4,3,3,1,1,1,25,27,100,51,60,FALSE,0.6,2021,2021-2022
VT,2021-09-30,inter-ucfe,0,0,0,0,0,1,0,0,0,0,0,1,0,0,FALSE,0,2021,2021-2022
VT,2021-09-30,inter-ucx,0,0,0,0,0,0,0,0,0,0,0,0,0,0,FALSE,0,2021,2021-2022
VT,2021-09-30,inter-ui,24,9,2,4,3,2,1,1,1,25,27,99,51,60,FALSE,0.606060606060606,2021,2021-2022
VT,2021-09-30,intra-total,152,73,30,33,51,40,28,21,17,172,239,856,391,464,FALSE,0.542056074766355,2021,2021-2022
VT,2021-09-30,intra-ucfe,0,1,0,0,0,0,0,0,0,3,0,4,0,1,FALSE,0.25,2021,2021-2022
VT,2021-09-30,intra-ucx,0,0,0,0,0,0,0,0,0,0,0,0,0,0,FALSE,0,2021,2021-2022
VT,2021-09-30,intra-ui,152,72,30,33,51,40,28,21,17,169,239,852,391,463,FALSE,0.543427230046948,2021,2021-2022
VT,2021-10-31,inter-total,7,10,4,4,9,3,3,3,2,18,13,76,20,30,FALSE,0.394736842105263,2021,2021-2022
VT,2021-10-31,inter-ucfe,0,0,0,0,0,0,0,0,0,1,0,1,0,0,FALSE,0,2021,2021-2022
VT,2021-10-31,inter-ucx,0,0,0,0,0,0,0,0,0,0,0,0,0,0,FALSE,0,2021,2021-2022
VT,2021-10-31,inter-ui,7,10,4,4,9,3,3,3,2,17,13,75,20,30,FALSE,0.4,2021,2021-2022
VT,2021-10-31,intra-total,84,65,41,48,45,43,17,12,12,177,122,666,206,271,FALSE,0.406906906906907,2021,2021-2022
VT,2021-10-31,intra-ucfe,0,1,0,0,0,0,0,0,0,0,0,1,0,1,FALSE,1,2021,2021-2022
VT,2021-10-31,intra-ucx,0,0,0,0,0,0,0,0,0,2,0,2,0,0,FALSE,0,2021,2021-2022
VT,2021-10-31,intra-ui,84,64,41,48,45,43,17,12,12,175,122,663,206,270,FALSE,0.407239819004525,2021,2021-2022
VT,2021-11-30,inter-total,14,6,4,6,5,1,1,0,1,12,17,67,31,37,FALSE,0.552238805970149,2021,2021-2022
VT,2021-11-30,inter-ucfe,0,0,0,0,0,0,0,0,0,1,0,1,0,0,FALSE,0,2021,2021-2022
VT,2021-11-30,inter-ucx,0,0,0,0,0,0,0,0,0,0,0,0,0,0,FALSE,0,2021,2021-2022
VT,2021-11-30,inter-ui,14,6,4,6,5,1,1,0,1,11,17,66,31,37,FALSE,0.560606060606061,2021,2021-2022
VT,2021-11-30,intra-total,73,98,64,57,45,17,14,8,7,86,201,670,274,372,FALSE,0.555223880597015,2021,2021-2022
VT,2021-11-30,intra-ucfe,0,1,0,0,0,0,0,0,0,0,0,1,0,1,FALSE,1,2021,2021-2022
VT,2021-11-30,intra-ucx,0,0,0,0,0,0,0,0,0,0,0,0,0,0,FALSE,0,2021,2021-2022
VT,2021-11-30,intra-ui,73,97,64,57,45,17,14,8,7,86,201,669,274,371,FALSE,0.554559043348281,2021,2021-2022
VT,2021-12-31,inter-total,22,19,7,9,4,1,4,2,1,11,35,115,57,76,FALSE,0.660869565217391,2021,2021-2022
VT,2021-12-31,inter-ucfe,0,0,0,0,0,0,0,0,0,0,1,1,1,1,FALSE,1,2021,2021-2022
VT,2021-12-31,inter-ucx,0,0,0,0,0,0,0,0,0,0,0,0,0,0,FALSE,0,2021,2021-2022
VT,2021-12-31,inter-ui,22,19,7,9,4,1,4,2,1,11,34,114,56,75,FALSE,0.657894736842105,2021,2021-2022
VT,2021-12-31,intra-total,221,201,117,75,35,17,12,5,4,77,454,1218,675,876,FALSE,0.719211822660099,2021,2021-2022
VT,2021-12-31,intra-ucfe,0,1,1,0,0,1,0,0,0,2,1,6,1,2,FALSE,0.333333333333333,2021,2021-2022
VT,2021-12-31,intra-ucx,0,0,0,0,0,0,0,0,0,0,0,0,0,0,FALSE,0,2021,2021-2022
VT,2021-12-31,intra-ui,221,200,116,75,35,16,12,5,4,75,453,1212,674,874,FALSE,0.721122112211221,2021,2021-2022
VT,2022-01-31,inter-total,18,24,10,7,5,0,1,1,0,7,56,129,74,98,FALSE,0.75968992248062,2021,2021-2022
VT,2022-01-31,inter-ucfe,0,0,0,0,0,0,1,0,0,0,0,1,0,0,FALSE,0,2021,2021-2022
VT,2022-01-31,inter-ucx,0,0,0,0,0,0,0,0,0,0,0,0,0,0,FALSE,0,2021,2021-2022
VT,2022-01-31,inter-ui,18,24,10,7,5,0,0,1,0,7,56,128,74,98,FALSE,0.765625,2021,2021-2022
VT,2022-01-31,intra-total,336,284,141,84,42,28,13,13,7,77,978,2003,1314,1598,FALSE,0.797803295057414,2021,2021-2022
VT,2022-01-31,intra-ucfe,0,0,0,0,0,0,1,0,0,1,1,3,1,1,FALSE,0.333333333333333,2021,2021-2022
VT,2022-01-31,intra-ucx,0,0,0,0,0,0,0,0,0,0,0,0,0,0,FALSE,0,2021,2021-2022
VT,2022-01-31,intra-ui,336,284,141,84,42,28,12,13,7,76,977,2000,1313,1597,FALSE,0.7985,2021,2021-2022
VT,2022-02-28,inter-total,14,15,3,6,5,2,0,0,1,12,25,83,39,54,FALSE,0.650602409638554,2021,2021-2022
VT,2022-02-28,inter-ucfe,0,0,0,0,0,0,0,0,0,1,0,1,0,0,FALSE,0,2021,2021-2022
VT,2022-02-28,inter-ucx,0,0,0,0,0,0,0,0,0,0,0,0,0,0,FALSE,0,2021,2021-2022
VT,2022-02-28,inter-ui,14,15,3,6,5,2,0,0,1,11,25,82,39,54,FALSE,0.658536585365854,2021,2021-2022
VT,2022-02-28,intra-total,205,195,92,75,31,19,14,8,8,79,398,1124,603,798,FALSE,0.709964412811388,2021,2021-2022
VT,2022-02-28,intra-ucfe,0,0,1,0,0,0,0,0,0,1,1,3,1,1,FALSE,0.333333333333333,2021,2021-2022
VT,2022-02-28,intra-ucx,0,1,0,0,1,0,0,0,0,0,0,2,0,1,FALSE,0.5,2021,2021-2022
VT,2022-02-28,intra-ui,205,194,91,75,30,19,14,8,8,78,397,1119,602,796,FALSE,0.711349419124218,2021,2021-2022
VT,2022-03-31,inter-total,6,11,6,3,1,3,1,1,0,8,11,51,17,28,FALSE,0.549019607843137,2021,2021-2022
VT,2022-03-31,inter-ucfe,0,0,0,0,0,0,0,0,0,0,0,0,0,0,FALSE,0,2021,2021-2022
VT,2022-03-31,inter-ucx,0,0,0,0,0,0,0,0,0,0,0,0,0,0,FALSE,0,2021,2021-2022
VT,2022-03-31,inter-ui,6,11,6,3,1,3,1,1,0,8,11,51,17,28,FALSE,0.549019607843137,2021,2021-2022
VT,2022-03-31,intra-total,119,127,90,36,19,17,15,8,8,86,292,817,411,538,FALSE,0.658506731946144,2021,2021-2022
VT,2022-03-31,intra-ucfe,0,1,0,0,0,0,0,0,0,1,0,2,0,1,FALSE,0.5,2021,2021-2022
VT,2022-03-31,intra-ucx,0,0,0,0,0,0,0,0,0,0,0,0,0,0,FALSE,0,2021,2021-2022
VT,2022-03-31,intra-ui,119,126,90,36,19,17,15,8,8,85,292,815,411,537,FALSE,0.658895705521472,2021,2021-2022
VT,2022-04-30,inter-total,17,17,5,4,0,2,0,0,1,9,17,72,34,51,FALSE,0.708333333333333,2021,2021-2022
VT,2022-04-30,inter-ucfe,0,0,0,0,0,0,0,0,0,1,0,1,0,0,FALSE,0,2021,2021-2022
VT,2022-04-30,inter-ucx,0,0,0,0,0,0,0,0,0,0,0,0,0,0,FALSE,0,2021,2021-2022
VT,2022-04-30,inter-ui,17,17,5,4,0,2,0,0,1,8,17,71,34,51,FALSE,0.71830985915493,2021,2021-2022
VT,2022-04-30,intra-total,250,133,62,33,10,5,4,8,5,57,305,872,555,688,FALSE,0.788990825688074,2021,2021-2022
VT,2022-04-30,intra-ucfe,0,1,1,0,0,0,0,0,0,1,1,4,1,2,FALSE,0.5,2021,2021-2022
VT,2022-04-30,intra-ucx,0,0,0,1,0,0,0,0,1,0,1,3,1,1,FALSE,0.333333333333333,2021,2021-2022
VT,2022-04-30,intra-ui,250,132,61,32,10,5,4,8,4,56,303,865,553,685,FALSE,0.791907514450867,2021,2021-2022
VT,2022-05-31,inter-total,11,17,6,2,0,0,1,1,0,4,18,60,29,46,FALSE,0.766666666666667,2021,2021-2022
VT,2022-05-31,inter-ucfe,0,0,0,0,0,0,0,0,0,0,0,0,0,0,FALSE,0,2021,2021-2022
VT,2022-05-31,inter-ucx,0,0,0,0,0,0,0,0,0,0,0,0,0,0,FALSE,0,2021,2021-2022
VT,2022-05-31,inter-ui,11,17,6,2,0,0,1,1,0,4,18,60,29,46,FALSE,0.766666666666667,2021,2021-2022
VT,2022-05-31,intra-total,147,148,56,19,10,2,3,6,4,41,320,756,467,615,FALSE,0.813492063492063,2021,2021-2022
VT,2022-05-31,intra-ucfe,1,0,0,0,1,0,0,0,0,1,0,3,1,1,FALSE,0.333333333333333,2021,2021-2022
VT,2022-05-31,intra-ucx,0,1,0,0,0,0,0,0,0,0,3,4,3,4,FALSE,1,2021,2021-2022
VT,2022-05-31,intra-ui,146,147,56,19,9,2,3,6,4,40,317,749,463,610,FALSE,0.814419225634179,2021,2021-2022
VT,2022-06-30,inter-total,10,15,2,1,2,0,0,0,1,1,16,48,26,41,FALSE,0.854166666666667,2021,2021-2022
VT,2022-06-30,inter-ucfe,0,0,0,0,0,0,0,0,0,0,0,0,0,0,FALSE,0,2021,2021-2022
VT,2022-06-30,inter-ucx,0,0,0,0,0,0,0,0,0,0,0,0,0,0,FALSE,0,2021,2021-2022
VT,2022-06-30,inter-ui,10,15,2,1,2,0,0,0,1,1,16,48,26,41,FALSE,0.854166666666667,2021,2021-2022
VT,2022-06-30,intra-total,179,108,45,18,9,9,14,7,5,58,227,679,406,514,FALSE,0.75699558173785,2021,2021-2022
VT,2022-06-30,intra-ucfe,0,0,0,0,0,0,0,0,0,0,0,0,0,0,FALSE,0,2021,2021-2022
VT,2022-06-30,intra-ucx,0,0,0,0,0,0,0,0,0,0,2,2,2,2,FALSE,1,2021,2021-2022
VT,2022-06-30,intra-ui,179,108,45,18,9,9,14,7,5,58,225,677,404,512,FALSE,0.756277695716396,2021,2021-2022
VT,2022-07-31,inter-total,8,7,5,2,2,2,2,0,1,4,27,60,35,42,FALSE,0.7,2022,2022-2023
VT,2022-07-31,inter-ucfe,0,0,0,0,0,0,0,0,0,1,0,1,0,0,FALSE,0,2022,2022-2023
VT,2022-07-31,inter-ucx,0,0,0,0,0,0,0,0,0,0,0,0,0,0,FALSE,0,2022,2022-2023
VT,2022-07-31,inter-ui,8,7,5,2,2,2,2,0,1,3,27,59,35,42,FALSE,0.711864406779661,2022,2022-2023
VT,2022-07-31,intra-total,160,108,54,23,8,5,1,3,2,32,306,702,466,574,FALSE,0.817663817663818,2022,2022-2023
VT,2022-07-31,intra-ucfe,1,0,0,0,0,0,0,0,0,0,0,1,1,1,FALSE,1,2022,2022-2023
VT,2022-07-31,intra-ucx,0,0,0,0,0,0,0,0,0,0,1,1,1,1,FALSE,1,2022,2022-2023
VT,2022-07-31,intra-ui,159,108,54,23,8,5,1,3,2,32,305,700,464,572,FALSE,0.817142857142857,2022,2022-2023
VT,2022-08-31,inter-total,11,5,4,1,2,1,0,1,1,1,34,61,45,50,FALSE,0.819672131147541,2022,2022-2023
VT,2022-08-31,inter-ucfe,0,0,0,0,0,0,0,0,0,0,0,0,0,0,FALSE,0,2022,2022-2023
VT,2022-08-31,inter-ucx,0,0,0,0,0,0,0,0,0,0,0,0,0,0,FALSE,0,2022,2022-2023
VT,2022-08-31,inter-ui,11,5,4,1,2,1,0,1,1,1,34,61,45,50,FALSE,0.819672131147541,2022,2022-2023
VT,2022-08-31,intra-total,72,60,34,17,6,4,2,4,1,19,269,488,341,401,FALSE,0.82172131147541,2022,2022-2023
VT,2022-08-31,intra-ucfe,0,0,0,0,0,0,0,0,0,0,0,0,0,0,FALSE,0,2022,2022-2023
VT,2022-08-31,intra-ucx,0,0,0,0,0,0,0,0,0,0,1,1,1,1,FALSE,1,2022,2022-2023
VT,2022-08-31,intra-ui,72,60,34,17,6,4,2,4,1,19,268,487,340,400,FALSE,0.82135523613963,2022,2022-2023
VT,2022-09-30,inter-total,5,3,3,1,1,2,0,1,0,3,11,30,16,19,FALSE,0.633333333333333,2022,2022-2023
VT,2022-09-30,inter-ucfe,0,0,0,0,0,0,0,0,0,0,0,0,0,0,FALSE,0,2022,2022-2023
VT,2022-09-30,inter-ucx,0,0,0,0,0,0,0,0,0,0,0,0,0,0,FALSE,0,2022,2022-2023
VT,2022-09-30,inter-ui,5,3,3,1,1,2,0,1,0,3,11,30,16,19,FALSE,0.633333333333333,2022,2022-2023
VT,2022-09-30,intra-total,69,96,38,35,18,4,2,1,3,18,113,397,182,278,FALSE,0.700251889168766,2022,2022-2023
VT,2022-09-30,intra-ucfe,0,0,0,0,0,0,0,0,0,0,1,1,1,1,FALSE,1,2022,2022-2023
VT,2022-09-30,intra-ucx,0,0,0,0,0,0,0,0,0,0,2,2,2,2,FALSE,1,2022,2022-2023
VT,2022-09-30,intra-ui,69,96,38,35,18,4,2,1,3,18,110,394,179,275,FALSE,0.697969543147208,2022,2022-2023
VT,2022-10-31,inter-total,2,2,1,3,0,0,0,2,0,1,12,23,14,16,FALSE,0.695652173913044,2022,2022-2023
VT,2022-10-31,inter-ucfe,0,0,0,0,0,0,0,0,0,0,0,0,0,0,FALSE,0,2022,2022-2023
VT,2022-10-31,inter-ucx,0,0,0,0,0,0,0,0,0,0,0,0,0,0,FALSE,0,2022,2022-2023
VT,2022-10-31,inter-ui,2,2,1,3,0,0,0,2,0,1,12,23,14,16,FALSE,0.695652173913044,2022,2022-2023
VT,2022-10-31,intra-total,55,31,14,22,15,16,12,8,5,27,96,301,151,182,FALSE,0.604651162790698,2022,2022-2023
VT,2022-10-31,intra-ucfe,0,0,0,0,0,0,0,0,0,0,0,0,0,0,FALSE,0,2022,2022-2023
VT,2022-10-31,intra-ucx,0,0,0,0,0,0,0,0,0,0,0,0,0,0,FALSE,0,2022,2022-2023
VT,2022-10-31,intra-ui,55,31,14,22,15,16,12,8,5,27,96,301,151,182,FALSE,0.604651162790698,2022,2022-2023
VT,2022-11-30,inter-total,13,9,0,1,1,0,2,3,1,5,25,60,38,47,FALSE,0.783333333333333,2022,2022-2023
VT,2022-11-30,inter-ucfe,0,0,0,0,0,0,0,0,0,0,0,0,0,0,FALSE,0,2022,2022-2023
VT,2022-11-30,inter-ucx,0,0,0,0,0,0,0,0,0,0,0,0,0,0,FALSE,0,2022,2022-2023
VT,2022-11-30,inter-ui,13,9,0,1,1,0,2,3,1,5,25,60,38,47,FALSE,0.783333333333333,2022,2022-2023
VT,2022-11-30,intra-total,119,43,8,8,10,12,18,20,13,23,298,572,417,460,FALSE,0.804195804195804,2022,2022-2023
VT,2022-11-30,intra-ucfe,0,1,0,0,0,0,0,0,0,1,0,2,0,1,FALSE,0.5,2022,2022-2023
VT,2022-11-30,intra-ucx,0,0,0,0,0,0,0,0,0,0,1,1,1,1,FALSE,1,2022,2022-2023
VT,2022-11-30,intra-ui,119,42,8,8,10,12,18,20,13,22,297,569,416,458,FALSE,0.804920913884007,2022,2022-2023
VT,2022-12-31,inter-total,31,10,5,1,1,0,0,1,0,5,26,80,57,67,FALSE,0.8375,2022,2022-2023
VT,2022-12-31,inter-ucfe,0,0,0,0,0,0,0,0,0,0,0,0,0,0,FALSE,0,2022,2022-2023
VT,2022-12-31,inter-ucx,0,0,0,0,0,0,0,0,0,0,0,0,0,0,FALSE,0,2022,2022-2023
VT,2022-12-31,inter-ui,31,10,5,1,1,0,0,1,0,5,26,80,57,67,FALSE,0.8375,2022,2022-2023
VT,2022-12-31,intra-total,365,109,22,12,10,8,13,25,32,76,425,1097,790,899,FALSE,0.81950774840474,2022,2022-2023
VT,2022-12-31,intra-ucfe,0,1,0,0,0,0,0,0,0,0,1,2,1,2,FALSE,1,2022,2022-2023
VT,2022-12-31,intra-ucx,0,0,0,0,0,0,0,0,0,0,0,0,0,0,FALSE,0,2022,2022-2023
VT,2022-12-31,intra-ui,365,108,22,12,10,8,13,25,32,76,424,1095,789,897,FALSE,0.819178082191781,2022,2022-2023
VT,2023-01-31,inter-total,20,17,5,4,3,0,2,3,1,14,57,126,77,94,FALSE,0.746031746031746,2022,2022-2023
VT,2023-01-31,inter-ucfe,0,0,0,0,0,0,0,0,0,0,0,0,0,0,FALSE,0,2022,2022-2023
VT,2023-01-31,inter-ucx,0,0,0,0,0,0,0,0,0,0,0,0,0,0,FALSE,0,2022,2022-2023
VT,2023-01-31,inter-ui,20,17,5,4,3,0,2,3,1,14,57,126,77,94,FALSE,0.746031746031746,2022,2022-2023
VT,2023-01-31,intra-total,232,251,50,44,23,19,17,13,24,134,1081,1888,1313,1564,FALSE,0.828389830508475,2022,2022-2023
VT,2023-01-31,intra-ucfe,0,1,0,0,0,0,0,0,0,0,0,1,0,1,FALSE,1,2022,2022-2023
VT,2023-01-31,intra-ucx,0,1,0,0,0,0,1,0,0,0,0,2,0,1,FALSE,0.5,2022,2022-2023
VT,2023-01-31,intra-ui,232,249,50,44,23,19,16,13,24,134,1081,1885,1313,1562,FALSE,0.828647214854111,2022,2022-2023
VT,2023-02-28,inter-total,18,10,1,2,1,4,1,1,2,13,23,76,41,51,FALSE,0.671052631578947,2022,2022-2023
VT,2023-02-28,inter-ucfe,0,0,0,0,0,0,0,0,0,1,0,1,0,0,FALSE,0,2022,2022-2023
VT,2023-02-28,inter-ucx,0,0,0,0,0,0,0,0,0,0,0,0,0,0,FALSE,0,2022,2022-2023
VT,2023-02-28,inter-ui,18,10,1,2,1,4,1,1,2,12,23,75,41,51,FALSE,0.68,2022,2022-2023
VT,2023-02-28,intra-total,235,109,30,17,13,16,19,9,13,134,327,922,562,671,FALSE,0.727765726681128,2022,2022-2023
VT,2023-02-28,intra-ucfe,1,0,0,0,0,0,0,0,0,1,0,2,1,1,FALSE,0.5,2022,2022-2023
VT,2023-02-28,intra-ucx,0,0,0,0,0,0,0,0,0,0,0,0,0,0,FALSE,0,2022,2022-2023
VT,2023-02-28,intra-ui,234,109,30,17,13,16,19,9,13,133,327,920,561,670,FALSE,0.728260869565217,2022,2022-2023
VT,2023-03-31,inter-total,8,2,1,1,1,2,0,3,0,19,16,53,24,26,FALSE,0.490566037735849,2022,2022-2023
VT,2023-03-31,inter-ucfe,0,0,0,0,0,0,0,0,0,0,0,0,0,0,FALSE,0,2022,2022-2023
VT,2023-03-31,inter-ucx,0,0,0,0,0,0,0,0,0,0,0,0,0,0,FALSE,0,2022,2022-2023
VT,2023-03-31,inter-ui,8,2,1,1,1,2,0,3,0,19,16,53,24,26,FALSE,0.490566037735849,2022,2022-2023
VT,2023-03-31,intra-total,170,87,24,16,12,13,11,13,40,211,265,862,435,522,FALSE,0.605568445475638,2022,2022-2023
VT,2023-03-31,intra-ucfe,0,0,0,0,0,0,0,0,0,0,0,0,0,0,FALSE,0,2022,2022-2023
VT,2023-03-31,intra-ucx,1,0,0,0,0,0,0,0,0,0,1,2,2,2,FALSE,1,2022,2022-2023
VT,2023-03-31,intra-ui,169,87,24,16,12,13,11,13,40,211,264,860,433,520,FALSE,0.604651162790698,2022,2022-2023
VT,2023-04-30,inter-total,35,4,1,3,0,1,2,0,3,11,17,77,52,56,FALSE,0.727272727272727,2022,2022-2023
VT,2023-04-30,inter-ucfe,0,0,0,0,0,0,0,0,0,0,0,0,0,0,FALSE,0,2022,2022-2023
VT,2023-04-30,inter-ucx,0,0,0,0,0,0,0,0,0,0,0,0,0,0,FALSE,0,2022,2022-2023
VT,2023-04-30,inter-ui,35,4,1,3,0,1,2,0,3,11,17,77,52,56,FALSE,0.727272727272727,2022,2022-2023
VT,2023-04-30,intra-total,274,79,19,6,12,7,12,26,47,154,257,893,531,610,FALSE,0.683090705487122,2022,2022-2023
VT,2023-04-30,intra-ucfe,0,0,0,0,0,1,0,0,0,1,0,2,0,0,FALSE,0,2022,2022-2023
VT,2023-04-30,intra-ucx,0,0,0,1,0,0,0,0,0,0,0,1,0,0,FALSE,0,2022,2022-2023
VT,2023-04-30,intra-ui,274,79,19,5,12,6,12,26,47,153,257,890,531,610,FALSE,0.685393258426966,2022,2022-2023
VT,2023-05-31,inter-total,9,12,3,3,1,1,0,1,1,13,43,87,52,64,FALSE,0.735632183908046,2022,2022-2023
VT,2023-05-31,inter-ucfe,0,0,0,0,0,0,0,0,0,0,1,1,1,1,FALSE,1,2022,2022-2023
VT,2023-05-31,inter-ucx,0,0,0,0,0,0,0,0,0,0,0,0,0,0,FALSE,0,2022,2022-2023
VT,2023-05-31,inter-ui,9,12,3,3,1,1,0,1,1,13,42,86,51,63,FALSE,0.732558139534884,2022,2022-2023
VT,2023-05-31,intra-total,208,127,36,24,12,6,18,24,42,187,416,1100,624,751,FALSE,0.682727272727273,2022,2022-2023
VT,2023-05-31,intra-ucfe,0,0,0,0,1,0,0,0,0,0,0,1,0,0,FALSE,0,2022,2022-2023
VT,2023-05-31,intra-ucx,0,0,0,0,0,0,0,0,0,0,1,1,1,1,FALSE,1,2022,2022-2023
VT,2023-05-31,intra-ui,208,127,36,24,11,6,18,24,42,187,415,1098,623,750,FALSE,0.683060109289618,2022,2022-2023
VT,2023-06-30,inter-total,12,8,1,4,3,4,1,4,2,13,15,67,27,35,FALSE,0.522388059701493,2022,2022-2023
VT,2023-06-30,inter-ucfe,0,0,0,0,0,0,0,0,0,0,0,0,0,0,FALSE,0,2022,2022-2023
VT,2023-06-30,inter-ucx,0,0,0,0,0,0,0,0,0,0,0,0,0,0,FALSE,0,2022,2022-2023
VT,2023-06-30,inter-ui,12,8,1,4,3,4,1,4,2,13,15,67,27,35,FALSE,0.522388059701493,2022,2022-2023
VT,2023-06-30,intra-total,158,47,25,15,20,31,33,42,37,125,159,692,317,364,FALSE,0.526011560693642,2022,2022-2023
VT,2023-06-30,intra-ucfe,0,0,0,0,0,1,0,0,0,0,1,2,1,1,FALSE,0.5,2022,2022-2023
VT,2023-06-30,intra-ucx,0,0,0,0,0,0,0,0,0,0,0,0,0,0,FALSE,0,2022,2022-2023
VT,2023-06-30,intra-ui,158,47,25,15,20,30,33,42,37,125,158,690,316,363,FALSE,0.526086956521739,2022,2022-2023
VT,2023-07-31,inter-total,6,10,0,2,2,2,1,4,5,7,20,59,26,36,FALSE,0.610169491525424,2023,2023-2024
VT,2023-07-31,inter-ucfe,0,0,0,0,0,0,0,0,0,0,0,0,0,0,FALSE,0,2023,2023-2024
VT,2023-07-31,inter-ucx,0,0,0,0,0,0,0,0,0,0,0,0,0,0,FALSE,0,2023,2023-2024
VT,2023-07-31,inter-ui,6,10,0,2,2,2,1,4,5,7,20,59,26,36,FALSE,0.610169491525424,2023,2023-2024
VT,2023-07-31,intra-total,148,260,15,12,16,17,23,24,36,83,487,1121,635,895,FALSE,0.798394290811775,2023,2023-2024
VT,2023-07-31,intra-ucfe,0,0,0,1,0,0,0,0,0,0,0,1,0,0,FALSE,0,2023,2023-2024
VT,2023-07-31,intra-ucx,0,0,0,0,0,0,0,0,0,0,0,0,0,0,FALSE,0,2023,2023-2024
VT,2023-07-31,intra-ui,148,260,15,11,16,17,23,24,36,83,487,1120,635,895,FALSE,0.799107142857143,2023,2023-2024
VT,2023-08-31,inter-total,12,8,2,2,2,5,2,4,4,6,14,61,26,34,FALSE,0.557377049180328,2023,2023-2024
VT,2023-08-31,inter-ucfe,0,0,0,0,0,0,0,0,0,0,0,0,0,0,FALSE,0,2023,2023-2024
VT,2023-08-31,inter-ucx,0,0,0,0,0,0,0,0,0,0,0,0,0,0,FALSE,0,2023,2023-2024
VT,2023-08-31,inter-ui,12,8,2,2,2,5,2,4,4,6,14,61,26,34,FALSE,0.557377049180328,2023,2023-2024
VT,2023-08-31,intra-total,89,130,95,45,46,31,28,23,41,60,145,733,234,364,FALSE,0.496589358799454,2023,2023-2024
VT,2023-08-31,intra-ucfe,0,0,1,1,0,0,0,0,0,0,0,2,0,0,FALSE,0,2023,2023-2024
VT,2023-08-31,intra-ucx,0,0,0,0,0,0,0,0,0,0,0,0,0,0,FALSE,0,2023,2023-2024
VT,2023-08-31,intra-ui,89,130,94,44,46,31,28,23,41,60,145,731,234,364,FALSE,0.497948016415869,2023,2023-2024
VT,2023-09-30,inter-total,7,1,0,5,4,6,3,3,3,4,3,39,10,11,FALSE,0.282051282051282,2023,2023-2024
VT,2023-09-30,inter-ucfe,0,0,0,0,0,0,0,0,0,0,0,0,0,0,FALSE,0,2023,2023-2024
VT,2023-09-30,inter-ucx,0,0,0,0,0,0,0,0,0,0,0,0,0,0,FALSE,0,2023,2023-2024
VT,2023-09-30,inter-ui,7,1,0,5,4,6,3,3,3,4,3,39,10,11,FALSE,0.282051282051282,2023,2023-2024
VT,2023-09-30,intra-total,65,35,16,26,55,43,51,48,41,51,114,545,179,214,FALSE,0.392660550458716,2023,2023-2024
VT,2023-09-30,intra-ucfe,0,0,0,0,0,0,0,0,0,0,1,1,1,1,FALSE,1,2023,2023-2024
VT,2023-09-30,intra-ucx,1,0,0,0,0,0,0,0,0,0,0,1,1,1,FALSE,1,2023,2023-2024
VT,2023-09-30,intra-ui,64,35,16,26,55,43,51,48,41,51,113,543,177,212,FALSE,0.390423572744015,2023,2023-2024
VT,2023-10-31,inter-total,9,5,1,1,2,3,4,1,0,4,19,49,28,33,FALSE,0.673469387755102,2023,2023-2024
VT,2023-10-31,inter-ucfe,0,0,0,0,0,0,0,0,0,0,0,0,0,0,FALSE,0,2023,2023-2024
VT,2023-10-31,inter-ucx,0,0,0,0,0,0,0,0,0,0,0,0,0,0,FALSE,0,2023,2023-2024
VT,2023-10-31,inter-ui,9,5,1,1,2,3,4,1,0,4,19,49,28,33,FALSE,0.673469387755102,2023,2023-2024
VT,2023-10-31,intra-total,78,44,19,30,49,25,39,17,11,40,98,450,176,220,FALSE,0.488888888888889,2023,2023-2024
VT,2023-10-31,intra-ucfe,0,1,0,0,0,0,0,0,0,0,0,1,0,1,FALSE,1,2023,2023-2024
VT,2023-10-31,intra-ucx,0,0,0,0,0,0,0,0,0,0,0,0,0,0,FALSE,0,2023,2023-2024
VT,2023-10-31,intra-ui,78,43,19,30,49,25,39,17,11,40,98,449,176,219,FALSE,0.487750556792873,2023,2023-2024
VT,2023-11-30,inter-total,10,10,5,1,2,0,0,0,0,0,44,72,54,64,FALSE,0.888888888888889,2023,2023-2024
VT,2023-11-30,inter-ucfe,0,0,0,0,0,0,0,0,0,0,0,0,0,0,FALSE,0,2023,2023-2024
VT,2023-11-30,inter-ucx,0,0,0,0,0,0,0,0,0,0,0,0,0,0,FALSE,0,2023,2023-2024
VT,2023-11-30,inter-ui,10,10,5,1,2,0,0,0,0,0,44,72,54,64,FALSE,0.888888888888889,2023,2023-2024
VT,2023-11-30,intra-total,106,86,17,33,24,21,15,4,4,15,277,602,383,469,FALSE,0.779069767441861,2023,2023-2024
VT,2023-11-30,intra-ucfe,0,0,0,0,0,0,0,0,0,0,1,1,1,1,FALSE,1,2023,2023-2024
VT,2023-11-30,intra-ucx,0,0,0,0,0,0,0,0,0,0,1,1,1,1,FALSE,1,2023,2023-2024
VT,2023-11-30,intra-ui,106,86,17,33,24,21,15,4,4,15,275,600,381,467,FALSE,0.778333333333333,2023,2023-2024
VT,2023-12-31,inter-total,25,12,5,6,7,3,1,1,3,3,37,103,62,74,FALSE,0.718446601941748,2023,2023-2024
VT,2023-12-31,inter-ucfe,0,1,0,0,0,0,0,0,0,0,0,1,0,1,FALSE,1,2023,2023-2024
VT,2023-12-31,inter-ucx,0,0,0,0,0,0,0,0,0,0,0,0,0,0,FALSE,0,2023,2023-2024
VT,2023-12-31,inter-ui,25,11,5,6,7,3,1,1,3,3,37,102,62,73,FALSE,0.715686274509804,2023,2023-2024
VT,2023-12-31,intra-total,220,121,33,31,47,24,20,21,14,30,453,1014,673,794,FALSE,0.783037475345168,2023,2023-2024
VT,2023-12-31,intra-ucfe,0,0,1,1,0,0,0,0,0,0,1,3,1,1,FALSE,0.333333333333333,2023,2023-2024
VT,2023-12-31,intra-ucx,0,0,0,0,0,0,0,0,0,0,1,1,1,1,FALSE,1,2023,2023-2024
VT,2023-12-31,intra-ui,220,121,32,30,47,24,20,21,14,30,451,1010,671,792,FALSE,0.784158415841584,2023,2023-2024
VT,2024-01-31,inter-total,16,28,7,7,5,2,1,1,0,4,47,118,63,91,FALSE,0.771186440677966,2023,2023-2024
VT,2024-01-31,inter-ucfe,0,1,0,0,0,0,0,0,0,1,0,2,0,1,FALSE,0.5,2023,2023-2024
VT,2024-01-31,inter-ucx,0,0,0,0,0,0,0,0,0,0,0,0,0,0,FALSE,0,2023,2023-2024
VT,2024-01-31,inter-ui,16,27,7,7,5,2,1,1,0,3,47,116,63,90,FALSE,0.775862068965517,2023,2023-2024
VT,2024-01-31,intra-total,208,358,128,49,38,23,15,13,24,47,773,1676,981,1339,FALSE,0.798926014319809,2023,2023-2024
VT,2024-01-31,intra-ucfe,0,3,0,0,0,0,0,0,0,1,0,4,0,3,FALSE,0.75,2023,2023-2024
VT,2024-01-31,intra-ucx,0,0,1,0,0,0,0,0,0,0,0,1,0,0,FALSE,0,2023,2023-2024
VT,2024-01-31,intra-ui,208,355,127,49,38,23,15,13,24,46,773,1671,981,1336,FALSE,0.799521244763615,2023,2023-2024
VT,2024-02-29,inter-total,12,12,11,2,7,0,0,1,4,12,37,98,49,61,FALSE,0.622448979591837,2023,2023-2024
VT,2024-02-29,inter-ucfe,0,1,0,0,0,0,0,0,0,1,0,2,0,1,FALSE,0.5,2023,2023-2024
VT,2024-02-29,inter-ucx,0,0,0,0,0,0,0,0,0,0,0,0,0,0,FALSE,0,2023,2023-2024
VT,2024-02-29,inter-ui,12,11,11,2,7,0,0,1,4,11,37,96,49,60,FALSE,0.625,2023,2023-2024
VT,2024-02-29,intra-total,212,139,58,50,32,26,21,23,37,49,387,1034,599,738,FALSE,0.713733075435203,2023,2023-2024
VT,2024-02-29,intra-ucfe,0,0,1,0,0,0,0,0,0,0,2,3,2,2,FALSE,0.666666666666667,2023,2023-2024
VT,2024-02-29,intra-ucx,0,0,0,0,0,0,0,0,0,0,0,0,0,0,FALSE,0,2023,2023-2024
VT,2024-02-29,intra-ui,212,139,57,50,32,26,21,23,37,49,385,1031,597,736,FALSE,0.713870029097963,2023,2023-2024
VT,2024-03-31,inter-total,10,7,4,1,6,5,2,6,1,3,18,63,28,35,FALSE,0.555555555555556,2023,2023-2024
VT,2024-03-31,inter-ucfe,0,0,0,0,0,0,0,0,0,0,0,0,0,0,FALSE,0,2023,2023-2024
VT,2024-03-31,inter-ucx,0,0,0,0,0,0,0,0,0,0,0,0,0,0,FALSE,0,2023,2023-2024
VT,2024-03-31,inter-ui,10,7,4,1,6,5,2,6,1,3,18,63,28,35,FALSE,0.555555555555556,2023,2023-2024
VT,2024-03-31,intra-total,157,66,29,16,20,16,10,27,35,50,271,697,428,494,FALSE,0.708751793400287,2023,2023-2024
VT,2024-03-31,intra-ucfe,1,0,0,0,0,0,0,1,1,0,0,3,1,1,FALSE,0.333333333333333,2023,2023-2024
VT,2024-03-31,intra-ucx,0,0,0,0,0,0,0,0,0,0,0,0,0,0,FALSE,0,2023,2023-2024
VT,2024-03-31,intra-ui,156,66,29,16,20,16,10,26,34,50,271,694,427,493,FALSE,0.710374639769453,2023,2023-2024
VT,2024-04-30,inter-total,16,3,4,1,3,9,4,0,3,8,30,81,46,49,FALSE,0.604938271604938,2023,2023-2024
VT,2024-04-30,inter-ucfe,0,0,0,0,0,0,0,0,0,0,1,1,1,1,FALSE,1,2023,2023-2024
VT,2024-04-30,inter-ucx,0,0,0,0,0,0,0,0,0,0,0,0,0,0,FALSE,0,2023,2023-2024
VT,2024-04-30,inter-ui,16,3,4,1,3,9,4,0,3,8,29,80,45,48,FALSE,0.6,2023,2023-2024
VT,2024-04-30,intra-total,170,78,16,27,20,44,43,36,21,42,310,807,480,558,FALSE,0.691449814126394,2023,2023-2024
VT,2024-04-30,intra-ucfe,0,1,0,0,0,0,0,0,0,0,0,1,0,1,FALSE,1,2023,2023-2024
VT,2024-04-30,intra-ucx,0,0,0,0,0,0,0,0,0,0,0,0,0,0,FALSE,0,2023,2023-2024
VT,2024-04-30,intra-ui,170,77,16,27,20,44,43,36,21,42,310,806,480,557,FALSE,0.691066997518611,2023,2023-2024
VT,2024-05-31,inter-total,14,9,2,2,3,4,4,3,3,4,23,71,37,46,FALSE,0.647887323943662,2023,2023-2024
VT,2024-05-31,inter-ucfe,0,0,0,0,0,0,0,0,0,1,1,2,1,1,FALSE,0.5,2023,2023-2024
VT,2024-05-31,inter-ucx,0,0,0,0,0,0,0,0,0,0,0,0,0,0,FALSE,0,2023,2023-2024
VT,2024-05-31,inter-ui,14,9,2,2,3,4,4,3,3,3,22,69,36,45,FALSE,0.652173913043478,2023,2023-2024
VT,2024-05-31,intra-total,220,100,32,25,29,36,23,13,12,41,260,791,480,580,FALSE,0.733249051833123,2023,2023-2024
VT,2024-05-31,intra-ucfe,0,0,0,0,0,0,0,0,0,0,0,0,0,0,FALSE,0,2023,2023-2024
VT,2024-05-31,intra-ucx,0,0,0,0,0,0,0,0,0,0,0,0,0,0,FALSE,0,2023,2023-2024
VT,2024-05-31,intra-ui,220,100,32,25,29,36,23,13,12,41,260,791,480,580,FALSE,0.733249051833123,2023,2023-2024
VT,2024-06-30,inter-total,32,2,2,1,0,6,3,1,3,1,8,59,40,42,FALSE,0.711864406779661,2023,2023-2024
VT,2024-06-30,inter-ucfe,0,0,0,0,0,0,0,0,0,0,0,0,0,0,FALSE,0,2023,2023-2024
VT,2024-06-30,inter-ucx,0,0,0,0,0,0,0,0,0,0,0,0,0,0,FALSE,0,2023,2023-2024
VT,2024-06-30,inter-ui,32,2,2,1,0,6,3,1,3,1,8,59,40,42,FALSE,0.711864406779661,2023,2023-2024
VT,2024-06-30,intra-total,279,54,11,28,34,30,36,20,13,26,156,687,435,489,FALSE,0.7117903930131,2023,2023-2024
VT,2024-06-30,intra-ucfe,0,0,0,0,0,0,0,0,0,0,0,0,0,0,FALSE,0,2023,2023-2024
VT,2024-06-30,intra-ucx,0,0,0,0,0,0,0,0,0,0,0,0,0,0,FALSE,0,2023,2023-2024
VT,2024-06-30,intra-ui,279,54,11,28,34,30,36,20,13,26,156,687,435,489,FALSE,0.7117903930131,2023,2023-2024
VT,2024-07-31,inter-total,10,5,2,2,3,2,0,0,0,5,37,66,47,52,FALSE,0.787878787878788,2024,2024-2025
VT,2024-07-31,inter-ucfe,0,0,0,0,0,0,0,0,0,0,0,0,0,0,FALSE,0,2024,2024-2025
VT,2024-07-31,inter-ucx,0,0,0,0,0,0,0,0,0,0,0,0,0,0,FALSE,0,2024,2024-2025
VT,2024-07-31,inter-ui,10,5,2,2,3,2,0,0,0,5,37,66,47,52,FALSE,0.787878787878788,2024,2024-2025
VT,2024-07-31,intra-total,155,112,22,13,16,21,26,21,25,53,384,848,539,651,FALSE,0.767688679245283,2024,2024-2025
VT,2024-07-31,intra-ucfe,0,0,0,0,0,0,0,0,0,0,0,0,0,0,FALSE,0,2024,2024-2025
VT,2024-07-31,intra-ucx,0,0,0,0,0,0,0,0,0,0,0,0,0,0,FALSE,0,2024,2024-2025
VT,2024-07-31,intra-ui,155,112,22,13,16,21,26,21,25,53,384,848,539,651,FALSE,0.767688679245283,2024,2024-2025
VT,2024-08-31,inter-total,8,5,1,1,2,0,4,2,0,7,15,45,23,28,FALSE,0.622222222222222,2024,2024-2025
VT,2024-08-31,inter-ucfe,0,0,0,0,0,0,0,0,0,0,0,0,0,0,FALSE,0,2024,2024-2025
VT,2024-08-31,inter-ucx,0,0,0,0,0,0,0,0,0,0,0,0,0,0,FALSE,0,2024,2024-2025
VT,2024-08-31,inter-ui,8,5,1,1,2,0,4,2,0,7,15,45,23,28,FALSE,0.622222222222222,2024,2024-2025
VT,2024-08-31,intra-total,99,46,11,23,12,21,11,34,24,65,115,461,214,260,FALSE,0.563991323210412,2024,2024-2025
VT,2024-08-31,intra-ucfe,0,0,0,0,0,0,0,0,0,0,0,0,0,0,FALSE,0,2024,2024-2025
VT,2024-08-31,intra-ucx,0,0,0,0,0,0,0,0,0,0,0,0,0,0,FALSE,0,2024,2024-2025
VT,2024-08-31,intra-ui,99,46,11,23,12,21,11,34,24,65,115,461,214,260,FALSE,0.563991323210412,2024,2024-2025
VT,2024-09-30,inter-total,6,3,1,2,0,2,2,3,1,16,11,47,17,20,FALSE,0.425531914893617,2024,2024-2025
VT,2024-09-30,inter-ucfe,0,0,0,0,0,0,0,0,0,0,0,0,0,0,FALSE,0,2024,2024-2025
VT,2024-09-30,inter-ucx,0,0,0,0,0,0,0,0,0,0,0,0,0,0,FALSE,0,2024,2024-2025
VT,2024-09-30,inter-ui,6,3,1,2,0,2,2,3,1,16,11,47,17,20,FALSE,0.425531914893617,2024,2024-2025
VT,2024-09-30,intra-total,57,17,13,19,13,22,30,20,15,144,98,448,155,172,FALSE,0.383928571428571,2024,2024-2025
VT,2024-09-30,intra-ucfe,0,1,0,0,0,0,0,0,0,0,0,1,0,1,FALSE,1,2024,2024-2025
VT,2024-09-30,intra-ucx,0,0,0,0,0,0,0,0,0,0,0,0,0,0,FALSE,0,2024,2024-2025
VT,2024-09-30,intra-ui,57,16,13,19,13,22,30,20,15,144,98,447,155,171,FALSE,0.38255033557047,2024,2024-2025
VT,2024-10-31,inter-total,1,2,2,2,0,2,4,5,4,11,15,48,16,18,FALSE,0.375,2024,2024-2025
VT,2024-10-31,inter-ucfe,0,0,0,0,0,0,0,0,0,0,0,0,0,0,FALSE,0,2024,2024-2025
VT,2024-10-31,inter-ucx,0,0,0,0,0,0,0,0,0,0,0,0,0,0,FALSE,0,2024,2024-2025
VT,2024-10-31,inter-ui,1,2,2,2,0,2,4,5,4,11,15,48,16,18,FALSE,0.375,2024,2024-2025
VT,2024-10-31,intra-total,65,28,8,14,16,10,20,29,31,96,88,405,153,181,FALSE,0.446913580246914,2024,2024-2025
VT,2024-10-31,intra-ucfe,0,0,0,0,0,0,0,0,0,0,0,0,0,0,FALSE,0,2024,2024-2025
VT,2024-10-31,intra-ucx,0,0,0,0,0,0,0,0,0,0,1,1,1,1,FALSE,1,2024,2024-2025
VT,2024-10-31,intra-ui,65,28,8,14,16,10,20,29,31,96,87,404,152,180,FALSE,0.445544554455446,2024,2024-2025
VT,2024-11-30,inter-total,10,12,3,0,2,3,3,3,4,8,24,72,34,46,FALSE,0.638888888888889,2024,2024-2025
VT,2024-11-30,inter-ucfe,0,0,0,0,0,0,0,0,0,0,0,0,0,0,FALSE,0,2024,2024-2025
VT,2024-11-30,inter-ucx,0,0,0,0,0,0,0,0,0,0,0,0,0,0,FALSE,0,2024,2024-2025
VT,2024-11-30,inter-ui,10,12,3,0,2,3,3,3,4,8,24,72,34,46,FALSE,0.638888888888889,2024,2024-2025
VT,2024-11-30,intra-total,113,59,11,17,12,6,21,47,44,61,248,639,361,420,FALSE,0.657276995305164,2024,2024-2025
VT,2024-11-30,intra-ucfe,0,0,0,0,0,0,0,0,0,1,0,1,0,0,FALSE,0,2024,2024-2025
VT,2024-11-30,intra-ucx,1,0,0,0,0,0,0,0,0,0,0,1,1,1,FALSE,1,2024,2024-2025
VT,2024-11-30,intra-ui,112,59,11,17,12,6,21,47,44,60,248,637,360,419,FALSE,0.657770800627944,2024,2024-2025
VT,2024-12-31,inter-total,24,16,1,2,1,3,2,6,4,3,43,105,67,83,FALSE,0.79047619047619,2024,2024-2025
VT,2024-12-31,inter-ucfe,0,0,0,0,0,0,0,0,0,0,0,0,0,0,FALSE,0,2024,2024-2025
VT,2024-12-31,inter-ucx,0,0,0,0,0,0,0,0,0,0,0,0,0,0,FALSE,0,2024,2024-2025
VT,2024-12-31,inter-ui,24,16,1,2,1,3,2,6,4,3,43,105,67,83,FALSE,0.79047619047619,2024,2024-2025
VT,2024-12-31,intra-total,357,135,41,21,22,33,55,53,32,60,577,1386,934,1069,FALSE,0.771284271284271,2024,2024-2025
VT,2024-12-31,intra-ucfe,1,2,0,0,0,0,0,0,0,0,1,4,2,4,FALSE,1,2024,2024-2025
VT,2024-12-31,intra-ucx,0,0,0,0,0,0,0,0,0,0,0,0,0,0,FALSE,0,2024,2024-2025
VT,2024-12-31,intra-ui,356,133,41,21,22,33,55,53,32,60,576,1382,932,1065,FALSE,0.770622286541245,2024,2024-2025
WA,2019-01-31,inter-total,479,29,16,10,5,6,4,2,6,11,68,636,547,576,FALSE,0.905660377358491,2018,2018-2019
WA,2019-01-31,inter-ucfe,20,0,1,1,0,0,0,0,3,1,5,31,25,25,FALSE,0.806451612903226,2018,2018-2019
WA,2019-01-31,inter-ucx,2,0,0,0,0,0,0,0,0,0,0,2,2,2,FALSE,1,2018,2018-2019
WA,2019-01-31,inter-ui,457,29,15,9,5,6,4,2,3,10,63,603,520,549,FALSE,0.91044776119403,2018,2018-2019
WA,2019-01-31,intra-total,12656,684,285,116,64,50,34,24,55,255,1991,16214,14647,15331,FALSE,0.94554089058838,2018,2018-2019
WA,2019-01-31,intra-ucfe,782,96,43,3,5,4,1,0,4,5,221,1164,1003,1099,FALSE,0.944158075601375,2018,2018-2019
WA,2019-01-31,intra-ucx,40,6,0,0,0,0,1,1,0,4,9,61,49,55,FALSE,0.901639344262295,2018,2018-2019
WA,2019-01-31,intra-ui,11834,582,242,113,59,46,32,23,51,246,1761,14989,13595,14177,FALSE,0.945826939755821,2018,2018-2019
WA,2019-02-28,inter-total,266,16,16,10,5,5,3,1,0,10,57,389,323,339,FALSE,0.87146529562982,2018,2018-2019
WA,2019-02-28,inter-ucfe,3,3,2,2,2,0,0,0,0,1,2,15,5,8,FALSE,0.533333333333333,2018,2018-2019
WA,2019-02-28,inter-ucx,1,0,0,0,0,0,0,0,0,0,0,1,1,1,FALSE,1,2018,2018-2019
WA,2019-02-28,inter-ui,262,13,14,8,3,5,3,1,0,9,55,373,317,330,FALSE,0.884718498659517,2018,2018-2019
WA,2019-02-28,intra-total,10848,583,231,163,68,38,28,17,27,165,1847,14015,12695,13278,FALSE,0.947413485551195,2018,2018-2019
WA,2019-02-28,intra-ucfe,26,17,15,18,6,7,0,0,3,5,8,105,34,51,FALSE,0.485714285714286,2018,2018-2019
WA,2019-02-28,intra-ucx,46,3,2,0,1,1,0,0,1,1,13,68,59,62,FALSE,0.911764705882353,2018,2018-2019
WA,2019-02-28,intra-ui,10776,563,214,145,61,30,28,17,23,159,1826,13842,12602,13165,FALSE,0.951090882820402,2018,2018-2019
WA,2019-03-31,inter-total,213,27,12,7,8,7,8,6,4,14,69,375,282,309,FALSE,0.824,2018,2018-2019
WA,2019-03-31,inter-ucfe,4,0,0,0,3,0,1,0,1,3,2,14,6,6,FALSE,0.428571428571429,2018,2018-2019
WA,2019-03-31,inter-ucx,1,0,0,0,0,0,0,0,0,0,2,3,3,3,FALSE,1,2018,2018-2019
WA,2019-03-31,inter-ui,208,27,12,7,5,7,7,6,3,11,65,358,273,300,FALSE,0.837988826815642,2018,2018-2019
WA,2019-03-31,intra-total,6775,746,297,141,88,51,41,44,32,218,1690,10123,8465,9211,FALSE,0.909908130000988,2018,2018-2019
WA,2019-03-31,intra-ucfe,29,5,6,3,4,1,3,1,2,6,9,69,38,43,FALSE,0.623188405797102,2018,2018-2019
WA,2019-03-31,intra-ucx,49,5,8,1,0,1,1,0,0,0,10,75,59,64,FALSE,0.853333333333333,2018,2018-2019
WA,2019-03-31,intra-ui,6697,736,283,137,84,49,37,43,30,212,1671,9979,8368,9104,FALSE,0.912315863312957,2018,2018-2019
WA,2019-04-30,inter-total,324,27,10,10,4,2,3,1,3,14,47,445,371,398,FALSE,0.89438202247191,2018,2018-2019
WA,2019-04-30,inter-ucfe,4,1,0,0,0,0,0,0,0,0,1,6,5,6,FALSE,1,2018,2018-2019
WA,2019-04-30,inter-ucx,0,0,0,0,0,0,0,0,0,0,1,1,1,1,FALSE,1,2018,2018-2019
WA,2019-04-30,inter-ui,320,26,10,10,4,2,3,1,3,14,45,438,365,391,FALSE,0.892694063926941,2018,2018-2019
WA,2019-04-30,intra-total,5199,879,264,119,57,35,58,45,33,265,1239,8193,6438,7317,FALSE,0.893079458073966,2018,2018-2019
WA,2019-04-30,intra-ucfe,10,3,4,5,0,1,2,0,1,10,2,38,12,15,FALSE,0.394736842105263,2018,2018-2019
WA,2019-04-30,intra-ucx,56,12,2,0,1,0,0,1,0,2,17,91,73,85,FALSE,0.934065934065934,2018,2018-2019
WA,2019-04-30,intra-ui,5133,864,258,114,56,34,56,44,32,253,1220,8064,6353,7217,FALSE,0.894965277777778,2018,2018-2019
WA,2019-05-31,inter-total,266,41,12,1,8,3,4,2,4,9,49,399,315,356,FALSE,0.892230576441103,2018,2018-2019
WA,2019-05-31,inter-ucfe,1,0,0,0,0,0,0,0,0,0,0,1,1,1,FALSE,1,2018,2018-2019
WA,2019-05-31,inter-ucx,3,0,0,0,0,0,0,0,0,0,0,3,3,3,FALSE,1,2018,2018-2019
WA,2019-05-31,inter-ui,262,41,12,1,8,3,4,2,4,9,49,395,311,352,FALSE,0.891139240506329,2018,2018-2019
WA,2019-05-31,intra-total,4703,1028,373,136,60,32,37,52,30,175,1037,7663,5740,6768,FALSE,0.883205011092262,2018,2018-2019
WA,2019-05-31,intra-ucfe,7,7,5,1,1,1,0,1,0,1,8,32,15,22,FALSE,0.6875,2018,2018-2019
WA,2019-05-31,intra-ucx,48,6,3,2,3,2,0,0,0,2,9,75,57,63,FALSE,0.84,2018,2018-2019
WA,2019-05-31,intra-ui,4648,1015,365,133,56,29,37,51,30,172,1020,7556,5668,6683,FALSE,0.884462678665961,2018,2018-2019
WA,2019-06-30,inter-total,302,34,12,6,5,2,0,5,3,9,49,427,351,385,FALSE,0.901639344262295,2018,2018-2019
WA,2019-06-30,inter-ucfe,2,0,0,0,0,0,0,0,0,0,0,2,2,2,FALSE,1,2018,2018-2019
WA,2019-06-30,inter-ucx,1,1,0,0,0,0,0,0,0,0,0,2,1,2,FALSE,1,2018,2018-2019
WA,2019-06-30,inter-ui,299,33,12,6,5,2,0,5,3,9,49,423,348,381,FALSE,0.900709219858156,2018,2018-2019
WA,2019-06-30,intra-total,5135,762,285,115,60,40,48,38,33,176,948,7640,6083,6845,FALSE,0.895942408376963,2018,2018-2019
WA,2019-06-30,intra-ucfe,7,4,1,1,2,2,1,0,1,5,5,29,12,16,FALSE,0.551724137931035,2018,2018-2019
WA,2019-06-30,intra-ucx,40,5,2,1,1,1,0,0,2,1,6,59,46,51,FALSE,0.864406779661017,2018,2018-2019
WA,2019-06-30,intra-ui,5088,753,282,113,57,37,47,38,30,170,937,7552,6025,6778,FALSE,0.897510593220339,2018,2018-2019
WA,2019-07-31,inter-total,288,33,12,10,6,3,7,1,0,12,66,438,354,387,FALSE,0.883561643835616,2019,2019-2020
WA,2019-07-31,inter-ucfe,1,1,0,0,0,0,0,0,0,1,1,4,2,3,FALSE,0.75,2019,2019-2020
WA,2019-07-31,inter-ucx,2,0,0,0,0,0,0,0,0,0,0,2,2,2,FALSE,1,2019,2019-2020
WA,2019-07-31,inter-ui,285,32,12,10,6,3,7,1,0,11,65,432,350,382,FALSE,0.884259259259259,2019,2019-2020
WA,2019-07-31,intra-total,5800,749,424,131,75,54,47,34,40,145,918,8417,6718,7467,FALSE,0.887133182844244,2019,2019-2020
WA,2019-07-31,intra-ucfe,3,5,3,0,2,0,1,1,1,5,0,21,3,8,FALSE,0.380952380952381,2019,2019-2020
WA,2019-07-31,intra-ucx,29,6,2,0,0,0,0,0,0,3,9,49,38,44,FALSE,0.897959183673469,2019,2019-2020
WA,2019-07-31,intra-ui,5768,738,419,131,73,54,46,33,39,137,909,8347,6677,7415,FALSE,0.888343117287648,2019,2019-2020
WA,2019-08-31,inter-total,279,92,26,16,15,5,1,3,4,5,94,540,373,465,FALSE,0.861111111111111,2019,2019-2020
WA,2019-08-31,inter-ucfe,1,2,0,0,1,1,0,0,0,0,0,5,1,3,FALSE,0.6,2019,2019-2020
WA,2019-08-31,inter-ucx,3,0,0,0,0,0,0,0,0,0,0,3,3,3,FALSE,1,2019,2019-2020
WA,2019-08-31,inter-ui,275,90,26,16,14,4,1,3,4,5,94,532,369,459,FALSE,0.862781954887218,2019,2019-2020
WA,2019-08-31,intra-total,4805,683,286,155,65,32,42,26,29,128,1230,7481,6035,6718,FALSE,0.898008287662077,2019,2019-2020
WA,2019-08-31,intra-ucfe,4,3,1,3,1,0,0,1,0,1,2,16,6,9,FALSE,0.5625,2019,2019-2020
WA,2019-08-31,intra-ucx,42,6,1,0,0,0,0,1,1,2,9,62,51,57,FALSE,0.919354838709677,2019,2019-2020
WA,2019-08-31,intra-ui,4759,674,284,152,64,32,42,24,28,125,1219,7403,5978,6652,FALSE,0.898554640010806,2019,2019-2020
WA,2019-09-30,inter-total,215,36,20,13,6,8,4,5,3,12,58,380,273,309,FALSE,0.813157894736842,2019,2019-2020
WA,2019-09-30,inter-ucfe,3,0,2,0,1,0,0,0,0,0,0,6,3,3,FALSE,0.5,2019,2019-2020
WA,2019-09-30,inter-ucx,0,0,0,0,0,0,0,0,0,0,0,0,0,0,FALSE,0,2019,2019-2020
WA,2019-09-30,inter-ui,212,36,18,13,5,8,4,5,3,12,58,374,270,306,FALSE,0.818181818181818,2019,2019-2020
WA,2019-09-30,intra-total,5144,625,254,126,70,57,41,31,30,167,1138,7683,6282,6907,FALSE,0.89899778732266,2019,2019-2020
WA,2019-09-30,intra-ucfe,9,1,4,1,1,1,0,0,2,1,1,21,10,11,FALSE,0.523809523809524,2019,2019-2020
WA,2019-09-30,intra-ucx,34,4,2,1,3,1,0,0,0,3,10,58,44,48,FALSE,0.827586206896552,2019,2019-2020
WA,2019-09-30,intra-ui,5101,620,248,124,66,55,41,31,28,163,1127,7604,6228,6848,FALSE,0.900578642819569,2019,2019-2020
WA,2019-10-31,inter-total,276,31,18,10,5,5,3,3,2,20,68,441,344,375,FALSE,0.850340136054422,2019,2019-2020
WA,2019-10-31,inter-ucfe,12,1,2,0,0,0,0,0,0,0,5,20,17,18,FALSE,0.9,2019,2019-2020
WA,2019-10-31,inter-ucx,1,0,0,0,0,0,0,0,0,0,0,1,1,1,FALSE,1,2019,2019-2020
WA,2019-10-31,inter-ui,263,30,16,10,5,5,3,3,2,20,63,420,326,356,FALSE,0.847619047619048,2019,2019-2020
WA,2019-10-31,intra-total,5489,812,232,113,52,56,45,30,30,135,1461,8455,6950,7762,FALSE,0.918036664695446,2019,2019-2020
WA,2019-10-31,intra-ucfe,26,2,3,3,1,1,0,0,0,2,5,43,31,33,FALSE,0.767441860465116,2019,2019-2020
WA,2019-10-31,intra-ucx,57,8,2,2,0,0,1,1,0,1,11,83,68,76,FALSE,0.91566265060241,2019,2019-2020
WA,2019-10-31,intra-ui,5406,802,227,108,51,55,44,29,30,132,1445,8329,6851,7653,FALSE,0.91883779565374,2019,2019-2020
WA,2019-11-30,inter-total,483,45,14,13,5,3,2,0,0,4,66,635,549,594,FALSE,0.935433070866142,2019,2019-2020
WA,2019-11-30,inter-ucfe,22,3,2,1,1,0,0,0,0,0,3,32,25,28,FALSE,0.875,2019,2019-2020
WA,2019-11-30,inter-ucx,2,0,0,1,0,0,0,0,0,0,0,3,2,2,FALSE,0.666666666666667,2019,2019-2020
WA,2019-11-30,inter-ui,459,42,12,11,4,3,2,0,0,4,63,600,522,564,FALSE,0.94,2019,2019-2020
WA,2019-11-30,intra-total,7078,889,298,108,63,37,36,34,25,129,1307,10004,8385,9274,FALSE,0.92702918832467,2019,2019-2020
WA,2019-11-30,intra-ucfe,59,5,1,1,3,0,0,0,0,3,6,78,65,70,FALSE,0.897435897435897,2019,2019-2020
WA,2019-11-30,intra-ucx,31,5,3,0,1,1,1,0,0,1,12,55,43,48,FALSE,0.872727272727273,2019,2019-2020
WA,2019-11-30,intra-ui,6988,879,294,107,59,36,35,34,25,125,1289,9871,8277,9156,FALSE,0.927565596190862,2019,2019-2020
WA,2019-12-31,inter-total,712,52,22,17,6,5,3,1,3,15,75,911,787,839,FALSE,0.920965971459934,2019,2019-2020
WA,2019-12-31,inter-ucfe,10,4,1,0,0,1,0,0,0,1,0,17,10,14,FALSE,0.823529411764706,2019,2019-2020
WA,2019-12-31,inter-ucx,2,0,0,0,0,0,0,0,0,0,1,3,3,3,FALSE,1,2019,2019-2020
WA,2019-12-31,inter-ui,700,48,21,17,6,4,3,1,3,14,74,891,774,822,FALSE,0.922558922558922,2019,2019-2020
WA,2019-12-31,intra-total,12457,1155,449,168,88,73,62,43,27,147,1639,16308,14096,15251,FALSE,0.935185185185185,2019,2019-2020
WA,2019-12-31,intra-ucfe,97,8,6,4,4,1,0,2,0,3,18,143,115,123,FALSE,0.86013986013986,2019,2019-2020
WA,2019-12-31,intra-ucx,50,6,5,0,1,1,0,0,0,2,5,70,55,61,FALSE,0.871428571428572,2019,2019-2020
WA,2019-12-31,intra-ui,12310,1141,438,164,83,71,62,41,27,142,1616,16095,13926,15067,FALSE,0.936129232680957,2019,2019-2020
WA,2020-01-31,inter-total,515,50,33,20,8,6,6,0,1,9,85,733,600,650,FALSE,0.886766712141883,2019,2019-2020
WA,2020-01-31,inter-ucfe,23,3,0,1,0,1,0,0,0,1,3,32,26,29,FALSE,0.90625,2019,2019-2020
WA,2020-01-31,inter-ucx,0,1,0,0,0,0,0,0,0,1,1,3,1,2,FALSE,0.666666666666667,2019,2019-2020
WA,2020-01-31,inter-ui,492,46,33,19,8,5,6,0,1,7,81,698,573,619,FALSE,0.886819484240688,2019,2019-2020
WA,2020-01-31,intra-total,12305,892,377,204,92,67,61,37,41,165,1972,16213,14277,15169,FALSE,0.935607228767039,2019,2019-2020
WA,2020-01-31,intra-ucfe,89,6,7,2,2,2,1,1,2,2,9,123,98,104,FALSE,0.845528455284553,2019,2019-2020
WA,2020-01-31,intra-ucx,32,4,2,1,0,2,0,1,0,1,9,52,41,45,FALSE,0.865384615384615,2019,2019-2020
WA,2020-01-31,intra-ui,12184,882,368,201,90,63,60,35,39,162,1954,16038,14138,15020,FALSE,0.936525751340566,2019,2019-2020
WA,2020-02-29,inter-total,281,26,20,11,10,10,3,2,3,9,49,424,330,356,FALSE,0.839622641509434,2019,2019-2020
WA,2020-02-29,inter-ucfe,2,0,0,1,1,0,0,0,0,1,0,5,2,2,FALSE,0.4,2019,2019-2020
WA,2020-02-29,inter-ucx,0,0,0,0,0,0,0,0,0,0,0,0,0,0,FALSE,0,2019,2019-2020
WA,2020-02-29,inter-ui,279,26,20,10,9,10,3,2,3,8,49,419,328,354,FALSE,0.844868735083532,2019,2019-2020
WA,2020-02-29,intra-total,7563,823,281,122,92,42,53,41,33,144,1661,10855,9224,10047,FALSE,0.925564256103178,2019,2019-2020
WA,2020-02-29,intra-ucfe,39,11,1,3,0,0,1,0,2,3,10,70,49,60,FALSE,0.857142857142857,2019,2019-2020
WA,2020-02-29,intra-ucx,45,4,3,1,2,0,0,0,0,1,8,64,53,57,FALSE,0.890625,2019,2019-2020
WA,2020-02-29,intra-ui,7479,808,277,118,90,42,52,41,31,140,1643,10721,9122,9930,FALSE,0.926219569070049,2019,2019-2020
WA,2020-03-31,inter-total,410,26,11,7,3,3,3,1,1,18,60,543,470,496,FALSE,0.913443830570902,2019,2019-2020
WA,2020-03-31,inter-ucfe,3,0,0,0,0,0,0,0,0,0,1,4,4,4,FALSE,1,2019,2019-2020
WA,2020-03-31,inter-ucx,0,0,0,0,0,0,0,0,0,0,1,1,1,1,FALSE,1,2019,2019-2020
WA,2020-03-31,inter-ui,407,26,11,7,3,3,3,1,1,18,58,538,465,491,FALSE,0.912639405204461,2019,2019-2020
WA,2020-03-31,intra-total,52839,658,236,102,51,53,51,32,35,171,1894,56122,54733,55391,FALSE,0.986974804889348,2019,2019-2020
WA,2020-03-31,intra-ucfe,28,5,3,0,0,0,0,0,0,2,4,42,32,37,FALSE,0.880952380952381,2019,2019-2020
WA,2020-03-31,intra-ucx,45,7,1,1,1,0,0,0,0,0,11,66,56,63,FALSE,0.954545454545455,2019,2019-2020
WA,2020-03-31,intra-ui,52766,646,232,101,50,53,51,32,35,169,1879,56014,54645,55291,FALSE,0.987092512586139,2019,2019-2020
WA,2020-04-30,inter-total,1616,162,107,66,6,1,2,6,0,8,304,2278,1920,2082,FALSE,0.913959613696225,2019,2019-2020
WA,2020-04-30,inter-ucfe,2,0,0,0,0,0,0,0,0,0,3,5,5,5,FALSE,1,2019,2019-2020
WA,2020-04-30,inter-ucx,0,0,1,0,0,0,0,0,0,0,0,1,0,0,FALSE,0,2019,2019-2020
WA,2020-04-30,inter-ui,1614,162,106,66,6,1,2,6,0,8,301,2272,1915,2077,FALSE,0.914172535211268,2019,2019-2020
WA,2020-04-30,intra-total,198268,16353,7110,3159,454,57,72,65,41,278,29892,255749,228160,244513,FALSE,0.95606629937947,2019,2019-2020
WA,2020-04-30,intra-ucfe,39,17,11,7,1,0,0,1,0,2,27,105,66,83,FALSE,0.79047619047619,2019,2019-2020
WA,2020-04-30,intra-ucx,101,24,5,2,1,0,0,1,1,0,40,175,141,165,FALSE,0.942857142857143,2019,2019-2020
WA,2020-04-30,intra-ui,198128,16312,7094,3150,452,57,72,63,40,276,29825,255469,227953,244265,FALSE,0.95614340683214,2019,2019-2020
WA,2020-05-31,inter-total,635,73,89,96,107,89,63,22,8,15,103,1300,738,811,FALSE,0.623846153846154,2019,2019-2020
WA,2020-05-31,inter-ucfe,1,1,0,0,0,0,0,1,0,0,2,5,3,4,FALSE,0.8,2019,2019-2020
WA,2020-05-31,inter-ucx,0,0,0,0,0,0,0,0,0,0,0,0,0,0,FALSE,0,2019,2019-2020
WA,2020-05-31,inter-ui,634,72,89,96,107,89,63,21,8,15,101,1295,735,807,FALSE,0.623166023166023,2019,2019-2020
WA,2020-05-31,intra-total,35463,4197,4499,5625,7185,8459,5218,1128,425,375,4368,76942,39831,44028,FALSE,0.572223233084661,2019,2019-2020
WA,2020-05-31,intra-ucfe,21,6,2,2,5,6,4,0,0,3,5,54,26,32,FALSE,0.592592592592593,2019,2019-2020
WA,2020-05-31,intra-ucx,34,5,7,5,6,3,2,0,0,0,12,74,46,51,FALSE,0.689189189189189,2019,2019-2020
WA,2020-05-31,intra-ui,35408,4186,4490,5618,7174,8450,5212,1128,425,372,4351,76814,39759,43945,FALSE,0.572096232457625,2019,2019-2020
WA,2020-06-30,inter-total,323,29,25,30,27,24,31,57,49,166,54,815,377,406,FALSE,0.498159509202454,2019,2019-2020
WA,2020-06-30,inter-ucfe,1,1,0,0,0,0,0,1,0,1,1,5,2,3,FALSE,0.6,2019,2019-2020
WA,2020-06-30,inter-ucx,0,0,0,0,0,0,0,0,0,0,1,1,1,1,FALSE,1,2019,2019-2020
WA,2020-06-30,inter-ui,322,28,25,30,27,24,31,56,49,165,52,809,374,402,FALSE,0.496909765142151,2019,2019-2020
WA,2020-06-30,intra-total,12028,1588,1139,1431,1109,1688,2987,3836,3773,8701,2220,40500,14248,15836,FALSE,0.391012345679012,2019,2019-2020
WA,2020-06-30,intra-ucfe,6,0,3,0,4,1,5,4,7,11,3,44,9,9,FALSE,0.204545454545455,2019,2019-2020
WA,2020-06-30,intra-ucx,32,15,11,17,9,8,8,2,16,19,18,155,50,65,FALSE,0.419354838709677,2019,2019-2020
WA,2020-06-30,intra-ui,11990,1573,1125,1414,1096,1679,2974,3830,3750,8671,2199,40301,14189,15762,FALSE,0.391106920423811,2019,2019-2020
WA,2020-07-31,inter-total,269,46,31,34,28,41,45,53,71,680,59,1357,328,374,FALSE,0.275607958732498,2020,2020-2021
WA,2020-07-31,inter-ucfe,1,0,1,0,0,1,1,2,0,3,0,9,1,1,FALSE,0.111111111111111,2020,2020-2021
WA,2020-07-31,inter-ucx,0,0,0,0,0,0,0,0,0,2,1,3,1,1,FALSE,0.333333333333333,2020,2020-2021
WA,2020-07-31,inter-ui,268,46,30,34,28,40,44,51,71,675,58,1345,326,372,FALSE,0.276579925650558,2020,2020-2021
WA,2020-07-31,intra-total,13497,1514,1289,1072,957,1183,1430,1851,2169,18534,2659,46155,16156,17670,FALSE,0.382840428989275,2020,2020-2021
WA,2020-07-31,intra-ucfe,7,1,3,1,5,3,3,4,3,28,3,61,10,11,FALSE,0.180327868852459,2020,2020-2021
WA,2020-07-31,intra-ucx,48,11,5,6,10,4,8,5,3,39,24,163,72,83,FALSE,0.50920245398773,2020,2020-2021
WA,2020-07-31,intra-ui,13442,1502,1281,1065,942,1176,1419,1842,2163,18467,2632,45931,16074,17576,FALSE,0.382660947943655,2020,2020-2021
WA,2020-08-31,inter-total,205,14,14,12,5,23,23,8,5,214,31,554,236,250,FALSE,0.451263537906137,2020,2020-2021
WA,2020-08-31,inter-ucfe,1,4,1,1,0,0,0,0,0,1,2,10,3,7,FALSE,0.7,2020,2020-2021
WA,2020-08-31,inter-ucx,1,0,0,0,0,0,0,0,0,1,0,2,1,1,FALSE,0.5,2020,2020-2021
WA,2020-08-31,inter-ui,203,10,13,11,5,23,23,8,5,212,29,542,232,242,FALSE,0.44649446494465,2020,2020-2021
WA,2020-08-31,intra-total,6725,491,471,453,367,558,383,257,230,5783,1302,17020,8027,8518,FALSE,0.500470035252644,2020,2020-2021
WA,2020-08-31,intra-ucfe,16,12,6,4,1,0,0,1,3,15,10,68,26,38,FALSE,0.558823529411765,2020,2020-2021
WA,2020-08-31,intra-ucx,42,5,4,3,2,2,1,4,0,22,15,100,57,62,FALSE,0.62,2020,2020-2021
WA,2020-08-31,intra-ui,6667,474,461,446,364,556,382,252,227,5746,1277,16852,7944,8418,FALSE,0.499525278898647,2020,2020-2021
WA,2020-09-30,inter-total,182,14,13,7,9,2,3,10,8,119,29,396,211,225,FALSE,0.568181818181818,2020,2020-2021
WA,2020-09-30,inter-ucfe,6,1,0,0,1,0,0,0,0,0,1,9,7,8,FALSE,0.888888888888889,2020,2020-2021
WA,2020-09-30,inter-ucx,0,0,0,0,0,0,0,0,0,1,1,2,1,1,FALSE,0.5,2020,2020-2021
WA,2020-09-30,inter-ui,176,13,13,7,8,2,3,10,8,118,27,385,203,216,FALSE,0.561038961038961,2020,2020-2021
WA,2020-09-30,intra-total,6433,335,210,167,154,167,207,233,231,3195,1109,12441,7542,7877,FALSE,0.633148460734668,2020,2020-2021
WA,2020-09-30,intra-ucfe,8,1,1,1,1,2,3,1,0,11,7,36,15,16,FALSE,0.444444444444444,2020,2020-2021
WA,2020-09-30,intra-ucx,37,4,7,0,0,2,1,0,2,21,11,85,48,52,FALSE,0.611764705882353,2020,2020-2021
WA,2020-09-30,intra-ui,6388,330,202,166,153,163,203,232,229,3163,1091,12320,7479,7809,FALSE,0.633847402597403,2020,2020-2021
WA,2020-10-31,inter-total,124,11,7,16,13,7,2,9,2,174,25,390,149,160,FALSE,0.41025641025641,2020,2020-2021
WA,2020-10-31,inter-ucfe,5,0,2,0,0,0,0,0,0,1,0,8,5,5,FALSE,0.625,2020,2020-2021
WA,2020-10-31,inter-ucx,1,0,0,0,0,0,0,0,0,0,0,1,1,1,FALSE,1,2020,2020-2021
WA,2020-10-31,inter-ui,118,11,5,16,13,7,2,9,2,173,25,381,143,154,FALSE,0.404199475065617,2020,2020-2021
WA,2020-10-31,intra-total,4165,324,257,246,363,169,128,121,104,3309,812,9998,4977,5301,FALSE,0.530206041208242,2020,2020-2021
WA,2020-10-31,intra-ucfe,9,1,3,2,3,1,0,0,0,15,1,35,10,11,FALSE,0.314285714285714,2020,2020-2021
WA,2020-10-31,intra-ucx,41,7,4,3,2,1,5,3,1,12,12,91,53,60,FALSE,0.659340659340659,2020,2020-2021
WA,2020-10-31,intra-ui,4115,316,250,241,358,167,123,118,103,3282,799,9872,4914,5230,FALSE,0.529781199351702,2020,2020-2021
WA,2020-11-30,inter-total,261,29,12,10,10,18,8,4,4,182,38,576,299,328,FALSE,0.569444444444445,2020,2020-2021
WA,2020-11-30,inter-ucfe,4,1,0,0,0,0,0,0,2,0,2,9,6,7,FALSE,0.777777777777778,2020,2020-2021
WA,2020-11-30,inter-ucx,0,0,0,0,0,0,0,0,0,0,0,0,0,0,FALSE,0,2020,2020-2021
WA,2020-11-30,inter-ui,257,28,12,10,10,18,8,4,2,182,36,567,293,321,FALSE,0.566137566137566,2020,2020-2021
WA,2020-11-30,intra-total,6776,309,244,202,212,243,169,108,86,3485,992,12826,7768,8077,FALSE,0.629736472789646,2020,2020-2021
WA,2020-11-30,intra-ucfe,39,1,5,3,1,1,3,1,1,4,16,75,55,56,FALSE,0.746666666666667,2020,2020-2021
WA,2020-11-30,intra-ucx,24,1,6,2,2,6,4,4,0,12,6,67,30,31,FALSE,0.462686567164179,2020,2020-2021
WA,2020-11-30,intra-ui,6713,307,233,197,209,236,162,103,85,3469,970,12684,7683,7990,FALSE,0.629927467675812,2020,2020-2021
WA,2020-12-31,inter-total,260,38,28,19,31,20,11,15,8,176,40,646,300,338,FALSE,0.523219814241486,2020,2020-2021
WA,2020-12-31,inter-ucfe,6,2,0,3,2,1,1,2,1,2,2,22,8,10,FALSE,0.454545454545455,2020,2020-2021
WA,2020-12-31,inter-ucx,1,0,0,0,0,0,0,0,0,0,0,1,1,1,FALSE,1,2020,2020-2021
WA,2020-12-31,inter-ui,253,36,28,16,29,19,10,13,7,174,38,623,291,327,FALSE,0.524879614767255,2020,2020-2021
WA,2020-12-31,intra-total,7119,616,493,404,315,290,273,270,146,4592,1056,15574,8175,8791,FALSE,0.564466418389624,2020,2020-2021
WA,2020-12-31,intra-ucfe,54,4,8,10,3,7,3,1,1,18,15,124,69,73,FALSE,0.588709677419355,2020,2020-2021
WA,2020-12-31,intra-ucx,18,7,14,2,2,3,2,2,2,29,11,92,29,36,FALSE,0.391304347826087,2020,2020-2021
WA,2020-12-31,intra-ui,7047,605,471,392,310,280,268,267,143,4545,1030,15358,8077,8682,FALSE,0.565307982810262,2020,2020-2021
WA,2021-01-31,inter-total,225,21,14,11,16,20,21,41,22,165,31,587,256,277,FALSE,0.471890971039182,2020,2020-2021
WA,2021-01-31,inter-ucfe,8,1,0,3,1,1,0,2,1,3,3,23,11,12,FALSE,0.521739130434783,2020,2020-2021
WA,2021-01-31,inter-ucx,1,0,0,0,0,0,0,0,0,1,0,2,1,1,FALSE,0.5,2020,2020-2021
WA,2021-01-31,inter-ui,216,20,14,8,15,19,21,39,21,161,28,562,244,264,FALSE,0.469750889679715,2020,2020-2021
WA,2021-01-31,intra-total,7143,365,281,217,245,321,335,696,426,3316,923,14268,8066,8431,FALSE,0.590902719372021,2020,2020-2021
WA,2021-01-31,intra-ucfe,60,9,2,3,2,4,5,2,4,10,21,122,81,90,FALSE,0.737704918032787,2020,2020-2021
WA,2021-01-31,intra-ucx,32,3,4,0,1,2,0,3,0,11,8,64,40,43,FALSE,0.671875,2020,2020-2021
WA,2021-01-31,intra-ui,7051,353,275,214,242,315,330,691,422,3295,894,14082,7945,8298,FALSE,0.589262888794205,2020,2020-2021
WA,2021-02-28,inter-total,92,14,5,19,15,29,22,16,61,186,15,474,107,121,FALSE,0.255274261603376,2020,2020-2021
WA,2021-02-28,inter-ucfe,2,1,0,0,0,2,2,0,2,5,2,16,4,5,FALSE,0.3125,2020,2020-2021
WA,2021-02-28,inter-ucx,1,0,0,0,0,0,0,0,0,2,0,3,1,1,FALSE,0.333333333333333,2020,2020-2021
WA,2021-02-28,inter-ui,89,13,5,19,15,27,20,16,59,179,13,455,102,115,FALSE,0.252747252747253,2020,2020-2021
WA,2021-02-28,intra-total,3648,272,223,262,305,448,359,329,841,3200,618,10505,4266,4538,FALSE,0.431984769157544,2020,2020-2021
WA,2021-02-28,intra-ucfe,23,6,3,6,9,7,5,9,8,25,13,114,36,42,FALSE,0.368421052631579,2020,2020-2021
WA,2021-02-28,intra-ucx,39,3,1,1,0,2,1,1,8,35,8,99,47,50,FALSE,0.505050505050505,2020,2020-2021
WA,2021-02-28,intra-ui,3586,263,219,255,296,439,353,319,825,3140,597,10292,4183,4446,FALSE,0.43198600855033,2020,2020-2021
WA,2021-03-31,inter-total,85,26,15,24,44,38,47,75,45,245,33,677,118,144,FALSE,0.212703101920236,2020,2020-2021
WA,2021-03-31,inter-ucfe,1,0,1,1,1,3,4,8,1,7,2,29,3,3,FALSE,0.103448275862069,2020,2020-2021
WA,2021-03-31,inter-ucx,1,0,0,0,0,0,0,0,0,3,0,4,1,1,FALSE,0.25,2020,2020-2021
WA,2021-03-31,inter-ui,83,26,14,23,43,35,43,67,44,235,31,644,114,140,FALSE,0.217391304347826,2020,2020-2021
WA,2021-03-31,intra-total,3339,505,463,537,601,749,783,1071,831,4706,815,14400,4154,4659,FALSE,0.323541666666667,2020,2020-2021
WA,2021-03-31,intra-ucfe,12,3,2,6,8,8,8,7,8,25,6,93,18,21,FALSE,0.225806451612903,2020,2020-2021
WA,2021-03-31,intra-ucx,32,17,5,1,5,6,4,5,1,17,15,108,47,64,FALSE,0.592592592592593,2020,2020-2021
WA,2021-03-31,intra-ui,3295,485,456,530,588,735,771,1059,822,4664,794,14199,4089,4574,FALSE,0.322135361645186,2020,2020-2021
WA,2021-04-30,inter-total,203,11,10,7,5,6,5,2,5,116,28,398,231,242,FALSE,0.608040201005025,2020,2020-2021
WA,2021-04-30,inter-ucfe,0,0,0,0,0,0,0,0,0,2,0,2,0,0,FALSE,0,2020,2020-2021
WA,2021-04-30,inter-ucx,0,0,0,0,0,0,0,0,0,1,0,1,0,0,FALSE,0,2020,2020-2021
WA,2021-04-30,inter-ui,203,11,10,7,5,6,5,2,5,113,28,395,231,242,FALSE,0.612658227848101,2020,2020-2021
WA,2021-04-30,intra-total,6271,288,159,113,95,92,94,117,117,2204,923,10473,7194,7482,FALSE,0.714408478945861,2020,2020-2021
WA,2021-04-30,intra-ucfe,10,7,1,1,3,0,1,1,5,21,4,54,14,21,FALSE,0.388888888888889,2020,2020-2021
WA,2021-04-30,intra-ucx,34,3,1,1,0,2,0,2,5,37,9,94,43,46,FALSE,0.48936170212766,2020,2020-2021
WA,2021-04-30,intra-ui,6227,278,157,111,92,90,93,114,107,2146,910,10325,7137,7415,FALSE,0.7181598062954,2020,2020-2021
WA,2021-05-31,inter-total,148,19,16,9,9,7,4,2,2,147,49,412,197,216,FALSE,0.524271844660194,2020,2020-2021
WA,2021-05-31,inter-ucfe,1,0,1,0,0,0,0,0,0,3,0,5,1,1,FALSE,0.2,2020,2020-2021
WA,2021-05-31,inter-ucx,0,0,0,0,0,0,0,0,0,0,0,0,0,0,FALSE,0,2020,2020-2021
WA,2021-05-31,inter-ui,147,19,15,9,9,7,4,2,2,144,49,407,196,215,FALSE,0.528255528255528,2020,2020-2021
WA,2021-05-31,intra-total,4484,352,224,207,148,166,104,85,50,2380,802,9002,5286,5638,FALSE,0.626305265496556,2020,2020-2021
WA,2021-05-31,intra-ucfe,10,2,1,1,1,1,0,1,2,19,3,41,13,15,FALSE,0.365853658536585,2020,2020-2021
WA,2021-05-31,intra-ucx,38,10,9,3,2,1,1,4,3,34,19,124,57,67,FALSE,0.540322580645161,2020,2020-2021
WA,2021-05-31,intra-ui,4436,340,214,203,145,164,103,80,45,2327,780,8837,5216,5556,FALSE,0.628720153898382,2020,2020-2021
WA,2021-06-30,inter-total,235,15,16,4,7,6,5,3,5,91,92,479,327,342,FALSE,0.713987473903967,2020,2020-2021
WA,2021-06-30,inter-ucfe,0,0,1,1,1,0,0,0,0,2,0,5,0,0,FALSE,0,2020,2020-2021
WA,2021-06-30,inter-ucx,1,0,0,0,1,0,0,0,0,0,0,2,1,1,FALSE,0.5,2020,2020-2021
WA,2021-06-30,inter-ui,234,15,15,3,5,6,5,3,5,89,92,472,326,341,FALSE,0.722457627118644,2020,2020-2021
WA,2021-06-30,intra-total,9886,414,246,134,87,96,129,75,96,2078,2299,15540,12185,12599,FALSE,0.810746460746461,2020,2020-2021
WA,2021-06-30,intra-ucfe,6,2,0,0,2,0,0,2,0,12,7,31,13,15,FALSE,0.483870967741936,2020,2020-2021
WA,2021-06-30,intra-ucx,31,11,0,0,4,3,2,0,0,7,23,81,54,65,FALSE,0.802469135802469,2020,2020-2021
WA,2021-06-30,intra-ui,9849,401,246,134,81,93,127,73,96,2059,2269,15428,12118,12519,FALSE,0.811446720248898,2020,2020-2021
WA,2021-07-31,inter-total,200,28,58,43,7,4,4,7,4,105,64,524,264,292,FALSE,0.557251908396947,2021,2021-2022
WA,2021-07-31,inter-ucfe,0,0,0,1,0,1,0,1,0,0,0,3,0,0,FALSE,0,2021,2021-2022
WA,2021-07-31,inter-ucx,0,0,0,0,0,0,0,0,0,0,0,0,0,0,FALSE,0,2021,2021-2022
WA,2021-07-31,inter-ui,200,28,58,42,7,3,4,6,4,105,64,521,264,292,FALSE,0.560460652591171,2021,2021-2022
WA,2021-07-31,intra-total,7946,694,719,486,120,85,70,134,71,2113,1726,14164,9672,10366,FALSE,0.731855408076815,2021,2021-2022
WA,2021-07-31,intra-ucfe,3,0,2,1,0,0,0,1,0,8,4,19,7,7,FALSE,0.368421052631579,2021,2021-2022
WA,2021-07-31,intra-ucx,22,8,4,5,2,0,1,0,0,5,10,57,32,40,FALSE,0.701754385964912,2021,2021-2022
WA,2021-07-31,intra-ui,7921,686,713,480,118,85,69,133,71,2100,1712,14088,9633,10319,FALSE,0.732467348097672,2021,2021-2022
WA,2021-08-31,inter-total,71,26,28,46,24,21,16,3,8,106,31,380,102,128,FALSE,0.336842105263158,2021,2021-2022
WA,2021-08-31,inter-ucfe,0,1,0,2,0,1,0,0,0,1,0,5,0,1,FALSE,0.2,2021,2021-2022
WA,2021-08-31,inter-ucx,0,0,0,0,0,0,0,0,0,0,0,0,0,0,FALSE,0,2021,2021-2022
WA,2021-08-31,inter-ui,71,25,28,44,24,20,16,3,8,105,31,375,102,127,FALSE,0.338666666666667,2021,2021-2022
WA,2021-08-31,intra-total,3065,451,558,546,344,268,155,141,119,1997,752,8396,3817,4268,FALSE,0.508337303477847,2021,2021-2022
WA,2021-08-31,intra-ucfe,8,5,0,0,0,1,1,1,1,10,3,30,11,16,FALSE,0.533333333333333,2021,2021-2022
WA,2021-08-31,intra-ucx,15,3,2,1,1,7,1,1,0,12,9,52,24,27,FALSE,0.519230769230769,2021,2021-2022
WA,2021-08-31,intra-ui,3042,443,556,545,343,260,153,139,118,1975,740,8314,3782,4225,FALSE,0.508178975222516,2021,2021-2022
WA,2021-09-30,inter-total,99,6,3,7,10,20,4,6,6,95,30,286,129,135,FALSE,0.472027972027972,2021,2021-2022
WA,2021-09-30,inter-ucfe,0,0,0,1,0,1,0,0,0,0,0,2,0,0,FALSE,0,2021,2021-2022
WA,2021-09-30,inter-ucx,0,0,0,0,0,0,0,0,0,1,0,1,0,0,FALSE,0,2021,2021-2022
WA,2021-09-30,inter-ui,99,6,3,6,10,19,4,6,6,94,30,283,129,135,FALSE,0.477031802120141,2021,2021-2022
WA,2021-09-30,intra-total,2644,214,130,134,160,193,129,134,175,2491,543,6947,3187,3401,FALSE,0.489563840506694,2021,2021-2022
WA,2021-09-30,intra-ucfe,8,1,0,1,0,2,0,1,1,9,3,26,11,12,FALSE,0.461538461538462,2021,2021-2022
WA,2021-09-30,intra-ucx,11,0,2,3,2,5,1,1,1,11,5,42,16,16,FALSE,0.380952380952381,2021,2021-2022
WA,2021-09-30,intra-ui,2625,213,128,130,158,186,128,132,173,2471,535,6879,3160,3373,FALSE,0.490332897223434,2021,2021-2022
WA,2021-10-31,inter-total,137,28,12,13,19,15,17,7,5,125,51,429,188,216,FALSE,0.503496503496504,2021,2021-2022
WA,2021-10-31,inter-ucfe,6,0,0,0,1,0,0,0,0,2,4,13,10,10,FALSE,0.769230769230769,2021,2021-2022
WA,2021-10-31,inter-ucx,0,0,0,1,0,0,1,0,0,1,1,4,1,1,FALSE,0.25,2021,2021-2022
WA,2021-10-31,inter-ui,131,28,12,12,18,15,16,7,5,122,46,412,177,205,FALSE,0.497572815533981,2021,2021-2022
WA,2021-10-31,intra-total,2887,312,239,210,212,211,214,123,91,2767,742,8008,3629,3941,FALSE,0.492132867132867,2021,2021-2022
WA,2021-10-31,intra-ucfe,11,4,1,3,3,1,0,1,0,12,5,41,16,20,FALSE,0.487804878048781,2021,2021-2022
WA,2021-10-31,intra-ucx,21,9,8,3,6,6,6,4,3,16,5,87,26,35,FALSE,0.402298850574713,2021,2021-2022
WA,2021-10-31,intra-ui,2855,299,230,204,203,204,208,118,88,2739,732,7880,3587,3886,FALSE,0.493147208121827,2021,2021-2022
WA,2021-11-30,inter-total,320,23,17,9,11,6,7,7,3,162,64,629,384,407,FALSE,0.647058823529412,2021,2021-2022
WA,2021-11-30,inter-ucfe,9,0,1,1,0,0,0,0,0,2,6,19,15,15,FALSE,0.789473684210526,2021,2021-2022
WA,2021-11-30,inter-ucx,1,0,0,0,0,0,0,0,0,0,0,1,1,1,FALSE,1,2021,2021-2022
WA,2021-11-30,inter-ui,310,23,16,8,11,6,7,7,3,160,58,609,368,391,FALSE,0.642036124794745,2021,2021-2022
WA,2021-11-30,intra-total,4311,312,175,151,97,117,84,108,107,2619,869,8950,5180,5492,FALSE,0.613631284916201,2021,2021-2022
WA,2021-11-30,intra-ucfe,42,11,2,4,0,0,0,1,0,12,20,92,62,73,FALSE,0.793478260869565,2021,2021-2022
WA,2021-11-30,intra-ucx,20,2,0,1,3,3,1,2,0,20,4,56,24,26,FALSE,0.464285714285714,2021,2021-2022
WA,2021-11-30,intra-ui,4249,299,173,146,94,114,83,105,107,2587,845,8802,5094,5393,FALSE,0.612701658713929,2021,2021-2022
WA,2021-12-31,inter-total,424,61,18,21,14,14,21,23,28,125,99,848,523,584,FALSE,0.688679245283019,2021,2021-2022
WA,2021-12-31,inter-ucfe,8,3,3,2,0,1,0,0,0,2,7,26,15,18,FALSE,0.692307692307692,2021,2021-2022
WA,2021-12-31,inter-ucx,0,0,0,0,0,0,0,0,0,0,0,0,0,0,FALSE,0,2021,2021-2022
WA,2021-12-31,inter-ui,416,58,15,19,14,13,21,23,28,123,92,822,508,566,FALSE,0.688564476885645,2021,2021-2022
WA,2021-12-31,intra-total,6228,539,318,254,198,266,613,599,509,1753,1286,12563,7514,8053,FALSE,0.641009313062167,2021,2021-2022
WA,2021-12-31,intra-ucfe,67,12,8,3,2,3,1,3,1,12,25,137,92,104,FALSE,0.759124087591241,2021,2021-2022
WA,2021-12-31,intra-ucx,21,7,2,7,1,4,3,2,3,9,5,64,26,33,FALSE,0.515625,2021,2021-2022
WA,2021-12-31,intra-ui,6140,520,308,244,195,259,609,594,505,1732,1256,12362,7396,7916,FALSE,0.640349458016502,2021,2021-2022
WA,2022-01-31,inter-total,333,31,25,35,38,36,14,17,10,59,73,671,406,437,FALSE,0.651266766020864,2021,2021-2022
WA,2022-01-31,inter-ucfe,8,0,1,0,0,1,1,0,1,1,3,16,11,11,FALSE,0.6875,2021,2021-2022
WA,2022-01-31,inter-ucx,0,0,0,0,0,0,0,0,0,0,0,0,0,0,FALSE,0,2021,2021-2022
WA,2022-01-31,inter-ui,325,31,24,35,38,35,13,17,9,58,70,655,395,426,FALSE,0.650381679389313,2021,2021-2022
WA,2022-01-31,intra-total,9912,801,670,638,546,511,426,291,221,908,1810,16734,11722,12523,FALSE,0.748356639177722,2021,2021-2022
WA,2022-01-31,intra-ucfe,71,4,4,0,4,3,1,0,1,7,18,113,89,93,FALSE,0.823008849557522,2021,2021-2022
WA,2022-01-31,intra-ucx,27,4,5,7,0,2,2,1,1,5,7,61,34,38,FALSE,0.622950819672131,2021,2021-2022
WA,2022-01-31,intra-ui,9814,793,661,631,542,506,423,290,219,896,1785,16560,11599,12392,FALSE,0.748309178743961,2021,2021-2022
WA,2022-02-28,inter-total,147,28,22,44,40,35,13,13,4,41,39,426,186,214,FALSE,0.502347417840376,2021,2021-2022
WA,2022-02-28,inter-ucfe,1,0,2,2,1,0,1,1,0,4,2,14,3,3,FALSE,0.214285714285714,2021,2021-2022
WA,2022-02-28,inter-ucx,0,0,0,0,0,0,0,0,0,0,0,0,0,0,FALSE,0,2021,2021-2022
WA,2022-02-28,inter-ui,146,28,20,42,39,35,12,12,4,37,37,412,183,211,FALSE,0.512135922330097,2021,2021-2022
WA,2022-02-28,intra-total,4562,684,480,630,551,309,151,85,60,630,1297,9439,5859,6543,FALSE,0.693187837694671,2021,2021-2022
WA,2022-02-28,intra-ucfe,28,6,2,8,8,2,1,0,2,11,17,85,45,51,FALSE,0.6,2021,2021-2022
WA,2022-02-28,intra-ucx,18,5,2,9,3,1,0,3,0,7,10,58,28,33,FALSE,0.568965517241379,2021,2021-2022
WA,2022-02-28,intra-ui,4516,673,476,613,540,306,150,82,58,612,1270,9296,5786,6459,FALSE,0.694814974182444,2021,2021-2022
WA,2022-03-31,inter-total,141,35,22,26,13,8,7,9,9,61,64,395,205,240,FALSE,0.607594936708861,2021,2021-2022
WA,2022-03-31,inter-ucfe,3,1,0,0,2,1,0,0,0,2,4,13,7,8,FALSE,0.615384615384615,2021,2021-2022
WA,2022-03-31,inter-ucx,0,0,0,0,0,0,0,0,0,0,0,0,0,0,FALSE,0,2021,2021-2022
WA,2022-03-31,inter-ui,138,34,22,26,11,7,7,9,9,59,60,382,198,232,FALSE,0.607329842931937,2021,2021-2022
WA,2022-03-31,intra-total,4745,697,547,408,196,161,109,104,84,733,1488,9272,6233,6930,FALSE,0.747411561691113,2021,2021-2022
WA,2022-03-31,intra-ucfe,23,4,3,3,1,4,0,1,3,12,9,63,32,36,FALSE,0.571428571428571,2021,2021-2022
WA,2022-03-31,intra-ucx,18,9,8,4,0,3,0,1,0,7,9,59,27,36,FALSE,0.610169491525424,2021,2021-2022
WA,2022-03-31,intra-ui,4704,684,536,401,195,154,109,102,81,714,1470,9150,6174,6858,FALSE,0.749508196721312,2021,2021-2022
WA,2022-04-30,inter-total,261,23,6,5,2,4,4,5,2,59,62,433,323,346,FALSE,0.799076212471132,2021,2021-2022
WA,2022-04-30,inter-ucfe,2,0,0,0,0,0,0,1,0,4,1,8,3,3,FALSE,0.375,2021,2021-2022
WA,2022-04-30,inter-ucx,0,0,0,0,0,0,0,0,0,1,0,1,0,0,FALSE,0,2021,2021-2022
WA,2022-04-30,inter-ui,259,23,6,5,2,4,4,4,2,54,61,424,320,343,FALSE,0.808962264150943,2021,2021-2022
WA,2022-04-30,intra-total,4447,343,176,99,69,60,45,39,33,507,1130,6948,5577,5920,FALSE,0.852043753598158,2021,2021-2022
WA,2022-04-30,intra-ucfe,16,2,0,2,1,0,1,0,0,10,7,39,23,25,FALSE,0.641025641025641,2021,2021-2022
WA,2022-04-30,intra-ucx,34,4,2,3,2,0,0,0,0,4,12,61,46,50,FALSE,0.819672131147541,2021,2021-2022
WA,2022-04-30,intra-ui,4397,337,174,94,66,60,44,39,33,493,1111,6848,5508,5845,FALSE,0.853533878504673,2021,2021-2022
WA,2022-05-31,inter-total,274,24,12,8,4,2,1,2,2,31,55,415,329,353,FALSE,0.850602409638554,2021,2021-2022
WA,2022-05-31,inter-ucfe,1,1,1,0,0,1,0,0,1,3,0,8,1,2,FALSE,0.25,2021,2021-2022
WA,2022-05-31,inter-ucx,0,0,0,0,0,0,0,0,0,0,0,0,0,0,FALSE,0,2021,2021-2022
WA,2022-05-31,inter-ui,273,23,11,8,4,1,1,2,1,28,55,407,328,351,FALSE,0.862407862407862,2021,2021-2022
WA,2022-05-31,intra-total,3910,426,219,117,69,36,35,17,15,373,1179,6396,5089,5515,FALSE,0.862257661038149,2021,2021-2022
WA,2022-05-31,intra-ucfe,3,5,2,0,2,1,1,0,0,8,5,27,8,13,FALSE,0.481481481481482,2021,2021-2022
WA,2022-05-31,intra-ucx,35,5,4,0,1,1,0,0,0,6,11,63,46,51,FALSE,0.80952380952381,2021,2021-2022
WA,2022-05-31,intra-ui,3872,416,213,117,66,34,34,17,15,359,1163,6306,5035,5451,FALSE,0.86441484300666,2021,2021-2022
WA,2022-06-30,inter-total,183,29,24,15,10,6,7,5,2,25,80,386,263,292,FALSE,0.756476683937824,2021,2021-2022
WA,2022-06-30,inter-ucfe,1,2,0,0,0,0,1,0,0,1,0,5,1,3,FALSE,0.6,2021,2021-2022
WA,2022-06-30,inter-ucx,1,0,0,0,0,0,0,0,0,1,1,3,2,2,FALSE,0.666666666666667,2021,2021-2022
WA,2022-06-30,inter-ui,181,27,24,15,10,6,6,5,2,23,79,378,260,287,FALSE,0.759259259259259,2021,2021-2022
WA,2022-06-30,intra-total,3628,549,296,137,87,55,48,24,26,414,1298,6562,4926,5475,FALSE,0.834349283754953,2021,2021-2022
WA,2022-06-30,intra-ucfe,14,2,4,2,0,1,0,0,0,7,3,33,17,19,FALSE,0.575757575757576,2021,2021-2022
WA,2022-06-30,intra-ucx,27,2,3,2,2,0,0,0,0,3,9,48,36,38,FALSE,0.791666666666667,2021,2021-2022
WA,2022-06-30,intra-ui,3587,545,289,133,85,54,48,24,26,404,1286,6481,4873,5418,FALSE,0.835982101527542,2021,2021-2022
WA,2022-07-31,inter-total,198,25,15,18,14,10,6,3,2,29,63,383,261,286,FALSE,0.746736292428198,2022,2022-2023
WA,2022-07-31,inter-ucfe,2,0,0,0,0,0,0,0,0,1,0,3,2,2,FALSE,0.666666666666667,2022,2022-2023
WA,2022-07-31,inter-ucx,2,0,0,0,0,0,0,0,0,0,0,2,2,2,FALSE,1,2022,2022-2023
WA,2022-07-31,inter-ui,194,25,15,18,14,10,6,3,2,28,63,378,257,282,FALSE,0.746031746031746,2022,2022-2023
WA,2022-07-31,intra-total,3913,624,281,171,101,49,33,28,28,317,1343,6888,5256,5880,FALSE,0.853658536585366,2022,2022-2023
WA,2022-07-31,intra-ucfe,1,6,0,0,1,1,0,1,0,1,1,12,2,8,FALSE,0.666666666666667,2022,2022-2023
WA,2022-07-31,intra-ucx,24,5,0,1,2,1,1,0,0,1,9,44,33,38,FALSE,0.863636363636364,2022,2022-2023
WA,2022-07-31,intra-ui,3888,613,281,170,98,47,32,27,28,315,1333,6832,5221,5834,FALSE,0.853922716627635,2022,2022-2023
WA,2022-08-31,inter-total,171,45,27,15,25,18,11,9,2,35,52,410,223,268,FALSE,0.653658536585366,2022,2022-2023
WA,2022-08-31,inter-ucfe,0,2,0,0,0,0,0,0,0,0,2,4,2,4,FALSE,1,2022,2022-2023
WA,2022-08-31,inter-ucx,0,0,0,0,0,0,0,0,0,0,0,0,0,0,FALSE,0,2022,2022-2023
WA,2022-08-31,inter-ui,171,43,27,15,25,18,11,9,2,35,50,406,221,264,FALSE,0.650246305418719,2022,2022-2023
WA,2022-08-31,intra-total,3871,669,374,244,211,127,99,75,49,318,1302,7339,5173,5842,FALSE,0.796021256301949,2022,2022-2023
WA,2022-08-31,intra-ucfe,4,1,0,0,1,0,0,0,0,6,2,14,6,7,FALSE,0.5,2022,2022-2023
WA,2022-08-31,intra-ucx,17,2,4,3,1,1,1,5,0,4,4,42,21,23,FALSE,0.547619047619048,2022,2022-2023
WA,2022-08-31,intra-ui,3850,666,370,241,209,126,98,70,49,308,1296,7283,5146,5812,FALSE,0.798022792805163,2022,2022-2023
WA,2022-09-30,inter-total,143,37,29,30,16,15,12,17,9,56,32,396,175,212,FALSE,0.535353535353535,2022,2022-2023
WA,2022-09-30,inter-ucfe,0,0,0,0,0,0,0,0,0,1,0,1,0,0,FALSE,0,2022,2022-2023
WA,2022-09-30,inter-ucx,0,1,0,0,0,0,0,0,0,0,0,1,0,1,FALSE,1,2022,2022-2023
WA,2022-09-30,inter-ui,143,36,29,30,16,15,12,17,9,55,32,394,175,211,FALSE,0.535532994923858,2022,2022-2023
WA,2022-09-30,intra-total,3239,651,362,287,159,173,114,84,119,646,967,6801,4206,4857,FALSE,0.714159682399647,2022,2022-2023
WA,2022-09-30,intra-ucfe,4,1,2,1,3,1,0,1,0,5,0,18,4,5,FALSE,0.277777777777778,2022,2022-2023
WA,2022-09-30,intra-ucx,22,3,1,2,2,1,0,1,1,7,14,54,36,39,FALSE,0.722222222222222,2022,2022-2023
WA,2022-09-30,intra-ui,3213,647,359,284,154,171,114,82,118,634,953,6729,4166,4813,FALSE,0.715262297518205,2022,2022-2023
WA,2022-10-31,inter-total,135,22,17,34,28,26,30,23,10,42,27,394,162,184,FALSE,0.467005076142132,2022,2022-2023
WA,2022-10-31,inter-ucfe,0,0,0,0,0,0,0,1,0,3,1,5,1,1,FALSE,0.2,2022,2022-2023
WA,2022-10-31,inter-ucx,2,0,0,0,0,0,0,0,0,0,0,2,2,2,FALSE,1,2022,2022-2023
WA,2022-10-31,inter-ui,133,22,17,34,28,26,30,22,10,39,26,387,159,181,FALSE,0.467700258397933,2022,2022-2023
WA,2022-10-31,intra-total,3031,555,432,300,285,221,256,200,133,474,790,6677,3821,4376,FALSE,0.655384154560431,2022,2022-2023
WA,2022-10-31,intra-ucfe,9,2,0,1,2,0,0,0,0,5,3,22,12,14,FALSE,0.636363636363636,2022,2022-2023
WA,2022-10-31,intra-ucx,21,3,4,2,1,4,3,3,0,3,5,49,26,29,FALSE,0.591836734693878,2022,2022-2023
WA,2022-10-31,intra-ui,3001,550,428,297,282,217,253,197,133,466,782,6606,3783,4333,FALSE,0.655918861640933,2022,2022-2023
WA,2022-11-30,inter-total,230,29,35,60,56,26,4,0,1,35,52,528,282,311,FALSE,0.589015151515152,2022,2022-2023
WA,2022-11-30,inter-ucfe,4,0,1,1,3,0,0,0,0,2,3,14,7,7,FALSE,0.5,2022,2022-2023
WA,2022-11-30,inter-ucx,0,0,0,2,0,0,0,0,0,0,0,2,0,0,FALSE,0,2022,2022-2023
WA,2022-11-30,inter-ui,226,29,34,57,53,26,4,0,1,33,49,512,275,304,FALSE,0.59375,2022,2022-2023
WA,2022-11-30,intra-total,4930,553,644,765,597,291,85,49,35,358,1058,9365,5988,6541,FALSE,0.698451681793913,2022,2022-2023
WA,2022-11-30,intra-ucfe,32,5,4,3,2,0,1,1,0,6,11,65,43,48,FALSE,0.738461538461539,2022,2022-2023
WA,2022-11-30,intra-ucx,20,4,9,5,4,4,1,0,0,4,8,59,28,32,FALSE,0.542372881355932,2022,2022-2023
WA,2022-11-30,intra-ui,4878,544,631,757,591,287,83,48,35,348,1039,9241,5917,6461,FALSE,0.699166756844497,2022,2022-2023
WA,2022-12-31,inter-total,349,42,47,81,72,106,30,15,7,38,61,848,410,452,FALSE,0.533018867924528,2022,2022-2023
WA,2022-12-31,inter-ucfe,4,0,0,1,2,4,2,0,0,3,1,17,5,5,FALSE,0.294117647058824,2022,2022-2023
WA,2022-12-31,inter-ucx,0,0,0,0,0,0,0,0,0,0,0,0,0,0,FALSE,0,2022,2022-2023
WA,2022-12-31,inter-ui,345,42,47,80,70,102,28,15,7,35,60,831,405,447,FALSE,0.537906137184116,2022,2022-2023
WA,2022-12-31,intra-total,6933,638,580,883,738,870,319,135,50,469,1314,12929,8247,8885,FALSE,0.687214788460051,2022,2022-2023
WA,2022-12-31,intra-ucfe,48,6,9,2,3,5,2,2,0,2,19,98,67,73,FALSE,0.744897959183674,2022,2022-2023
WA,2022-12-31,intra-ucx,21,5,5,3,3,1,1,1,0,3,6,49,27,32,FALSE,0.653061224489796,2022,2022-2023
WA,2022-12-31,intra-ui,6864,627,566,878,732,864,316,132,50,464,1289,12782,8153,8780,FALSE,0.686903457987795,2022,2022-2023
WA,2023-01-31,inter-total,247,35,33,64,56,48,92,70,25,31,66,767,313,348,FALSE,0.453715775749674,2022,2022-2023
WA,2023-01-31,inter-ucfe,7,1,1,0,1,1,0,1,1,0,2,15,9,10,FALSE,0.666666666666667,2022,2022-2023
WA,2023-01-31,inter-ucx,1,0,0,0,0,0,0,0,0,0,0,1,1,1,FALSE,1,2022,2022-2023
WA,2023-01-31,inter-ui,239,34,32,64,55,47,92,69,24,31,64,751,303,337,FALSE,0.448735019973369,2022,2022-2023
WA,2023-01-31,intra-total,8764,747,584,766,937,646,720,611,152,466,1689,16082,10453,11200,FALSE,0.696430792190026,2022,2022-2023
WA,2023-01-31,intra-ucfe,48,3,4,3,4,6,1,6,0,1,25,101,73,76,FALSE,0.752475247524752,2022,2022-2023
WA,2023-01-31,intra-ucx,18,5,1,7,5,4,6,5,1,5,7,64,25,30,FALSE,0.46875,2022,2022-2023
WA,2023-01-31,intra-ui,8698,739,579,756,928,636,713,600,151,460,1657,15917,10355,11094,FALSE,0.696990638939499,2022,2022-2023
WA,2023-02-28,inter-total,117,33,40,61,76,109,46,23,11,38,32,586,149,182,FALSE,0.310580204778157,2022,2022-2023
WA,2023-02-28,inter-ucfe,0,1,1,2,4,3,0,2,2,1,2,18,2,3,FALSE,0.166666666666667,2022,2022-2023
WA,2023-02-28,inter-ucx,0,0,1,0,0,0,0,0,0,0,0,1,0,0,FALSE,0,2022,2022-2023
WA,2023-02-28,inter-ui,117,32,38,59,72,106,46,21,9,37,30,567,147,179,FALSE,0.315696649029982,2022,2022-2023
WA,2023-02-28,intra-total,4853,839,727,870,1181,1287,665,246,150,549,1308,12675,6161,7000,FALSE,0.552268244575937,2022,2022-2023
WA,2023-02-28,intra-ucfe,17,10,7,7,14,11,3,1,1,2,8,81,25,35,FALSE,0.432098765432099,2022,2022-2023
WA,2023-02-28,intra-ucx,17,4,1,4,4,3,3,1,1,3,7,48,24,28,FALSE,0.583333333333333,2022,2022-2023
WA,2023-02-28,intra-ui,4819,825,719,859,1163,1273,659,244,148,544,1293,12546,6112,6937,FALSE,0.552925235134704,2022,2022-2023
WA,2023-03-31,inter-total,98,27,84,122,77,42,43,10,14,53,23,593,121,148,FALSE,0.249578414839798,2022,2022-2023
WA,2023-03-31,inter-ucfe,1,0,1,2,2,0,1,0,0,1,0,8,1,1,FALSE,0.125,2022,2022-2023
WA,2023-03-31,inter-ucx,0,0,0,0,0,0,0,0,0,0,0,0,0,0,FALSE,0,2022,2022-2023
WA,2023-03-31,inter-ui,97,27,83,120,75,42,42,10,14,52,23,585,120,147,FALSE,0.251282051282051,2022,2022-2023
WA,2023-03-31,intra-total,4486,740,1163,1352,950,844,746,325,189,726,1206,12727,5692,6432,FALSE,0.505382258191247,2022,2022-2023
WA,2023-03-31,intra-ucfe,11,1,7,5,4,2,2,2,2,10,5,51,16,17,FALSE,0.333333333333333,2022,2022-2023
WA,2023-03-31,intra-ucx,8,7,7,1,5,3,0,0,0,2,7,40,15,22,FALSE,0.55,2022,2022-2023
WA,2023-03-31,intra-ui,4467,732,1149,1346,941,839,744,323,187,714,1194,12636,5661,6393,FALSE,0.505935422602089,2022,2022-2023
WA,2023-04-30,inter-total,143,107,73,11,9,11,26,13,10,65,37,505,180,287,FALSE,0.568316831683168,2022,2022-2023
WA,2023-04-30,inter-ucfe,1,1,0,0,0,0,0,0,0,2,0,4,1,2,FALSE,0.5,2022,2022-2023
WA,2023-04-30,inter-ucx,0,0,0,0,0,0,0,0,0,0,0,0,0,0,FALSE,0,2022,2022-2023
WA,2023-04-30,inter-ui,142,106,73,11,9,11,26,13,10,63,37,501,179,285,FALSE,0.568862275449102,2022,2022-2023
WA,2023-04-30,intra-total,4321,1328,868,311,216,207,608,578,224,753,1131,10545,5452,6780,FALSE,0.642958748221906,2022,2022-2023
WA,2023-04-30,intra-ucfe,5,2,6,0,0,2,0,1,0,8,5,29,10,12,FALSE,0.413793103448276,2022,2022-2023
WA,2023-04-30,intra-ucx,20,6,2,1,0,0,3,1,3,3,3,42,23,29,FALSE,0.690476190476191,2022,2022-2023
WA,2023-04-30,intra-ui,4296,1320,860,310,216,205,605,576,221,742,1123,10474,5419,6739,FALSE,0.643402711476036,2022,2022-2023
WA,2023-05-31,inter-total,135,174,46,22,12,16,22,20,8,54,81,590,216,390,FALSE,0.661016949152542,2022,2022-2023
WA,2023-05-31,inter-ucfe,0,0,0,0,0,0,0,0,0,2,1,3,1,1,FALSE,0.333333333333333,2022,2022-2023
WA,2023-05-31,inter-ucx,0,0,0,0,0,0,0,0,0,0,0,0,0,0,FALSE,0,2022,2022-2023
WA,2023-05-31,inter-ui,135,174,46,22,12,16,22,20,8,52,80,587,215,389,FALSE,0.662691652470187,2022,2022-2023
WA,2023-05-31,intra-total,3812,1640,540,312,218,612,853,520,256,930,1371,11064,5183,6823,FALSE,0.616684743311641,2022,2022-2023
WA,2023-05-31,intra-ucfe,3,2,2,1,0,0,0,0,5,7,1,21,4,6,FALSE,0.285714285714286,2022,2022-2023
WA,2023-05-31,intra-ucx,24,7,4,2,2,6,3,3,1,8,4,64,28,35,FALSE,0.546875,2022,2022-2023
WA,2023-05-31,intra-ui,3785,1631,534,309,216,606,850,517,250,915,1366,10979,5151,6782,FALSE,0.61772474724474,2022,2022-2023
WA,2023-06-30,inter-total,150,142,50,27,30,29,17,10,10,49,118,632,268,410,FALSE,0.64873417721519,2022,2022-2023
WA,2023-06-30,inter-ucfe,0,0,0,0,0,0,0,0,0,1,0,1,0,0,FALSE,0,2022,2022-2023
WA,2023-06-30,inter-ucx,0,0,0,0,0,0,0,0,0,0,0,0,0,0,FALSE,0,2022,2022-2023
WA,2023-06-30,inter-ui,150,142,50,27,30,29,17,10,10,48,118,631,268,410,FALSE,0.649762282091918,2022,2022-2023
WA,2023-06-30,intra-total,3845,1097,400,377,881,900,493,256,128,691,1685,10753,5530,6627,FALSE,0.616293127499303,2022,2022-2023
WA,2023-06-30,intra-ucfe,4,1,0,1,1,0,1,1,0,3,0,12,4,5,FALSE,0.416666666666667,2022,2022-2023
WA,2023-06-30,intra-ucx,16,11,3,2,8,6,1,3,0,6,15,71,31,42,FALSE,0.591549295774648,2022,2022-2023
WA,2023-06-30,intra-ui,3825,1085,397,374,872,894,491,252,128,682,1670,10670,5495,6580,FALSE,0.61668228678538,2022,2022-2023
WA,2023-07-31,inter-total,152,100,32,24,26,19,10,8,3,36,68,478,220,320,FALSE,0.669456066945607,2023,2023-2024
WA,2023-07-31,inter-ucfe,0,0,0,0,0,0,0,0,0,1,0,1,0,0,FALSE,0,2023,2023-2024
WA,2023-07-31,inter-ucx,1,0,0,0,0,0,0,0,0,1,0,2,1,1,FALSE,0.5,2023,2023-2024
WA,2023-07-31,inter-ui,151,100,32,24,26,19,10,8,3,34,68,475,219,319,FALSE,0.671578947368421,2023,2023-2024
WA,2023-07-31,intra-total,4656,1191,456,665,808,429,227,109,71,513,1663,10788,6319,7510,FALSE,0.696143863552095,2023,2023-2024
WA,2023-07-31,intra-ucfe,2,1,0,0,0,1,0,1,0,1,2,8,4,5,FALSE,0.625,2023,2023-2024
WA,2023-07-31,intra-ucx,24,9,4,8,4,2,3,1,0,4,5,64,29,38,FALSE,0.59375,2023,2023-2024
WA,2023-07-31,intra-ui,4630,1181,452,657,804,426,224,107,71,508,1656,10716,6286,7467,FALSE,0.696808510638298,2023,2023-2024
WA,2023-08-31,inter-total,135,139,115,35,41,27,7,9,5,42,122,677,257,396,FALSE,0.58493353028065,2023,2023-2024
WA,2023-08-31,inter-ucfe,0,2,0,0,0,0,0,1,0,0,0,3,0,2,FALSE,0.666666666666667,2023,2023-2024
WA,2023-08-31,inter-ucx,0,1,0,0,0,0,0,0,0,0,0,1,0,1,FALSE,1,2023,2023-2024
WA,2023-08-31,inter-ui,135,136,115,35,41,27,7,8,5,42,122,673,257,393,FALSE,0.583952451708767,2023,2023-2024
WA,2023-08-31,intra-total,4439,1272,777,573,780,466,209,76,59,649,1603,10903,6042,7314,FALSE,0.670824543703568,2023,2023-2024
WA,2023-08-31,intra-ucfe,3,1,2,1,3,1,1,0,1,3,1,17,4,5,FALSE,0.294117647058824,2023,2023-2024
WA,2023-08-31,intra-ucx,28,6,2,8,4,2,1,2,1,4,8,66,36,42,FALSE,0.636363636363636,2023,2023-2024
WA,2023-08-31,intra-ui,4408,1265,773,564,773,463,207,74,57,642,1594,10820,6002,7267,FALSE,0.671626617375231,2023,2023-2024
WA,2023-09-30,inter-total,120,41,23,13,23,25,20,15,13,29,133,455,253,294,FALSE,0.646153846153846,2023,2023-2024
WA,2023-09-30,inter-ucfe,0,1,0,0,0,1,0,0,0,1,1,4,1,2,FALSE,0.5,2023,2023-2024
WA,2023-09-30,inter-ucx,1,0,0,0,0,0,0,0,0,0,0,1,1,1,FALSE,1,2023,2023-2024
WA,2023-09-30,inter-ui,119,40,23,13,23,24,20,15,13,28,132,450,251,291,FALSE,0.646666666666667,2023,2023-2024
WA,2023-09-30,intra-total,3922,604,313,317,334,494,484,236,116,573,1549,8942,5471,6075,FALSE,0.679378215164393,2023,2023-2024
WA,2023-09-30,intra-ucfe,5,2,1,3,1,0,1,1,0,7,0,21,5,7,FALSE,0.333333333333333,2023,2023-2024
WA,2023-09-30,intra-ucx,26,7,1,1,0,6,4,2,2,3,12,64,38,45,FALSE,0.703125,2023,2023-2024
WA,2023-09-30,intra-ui,3891,595,311,313,333,488,479,233,114,563,1537,8857,5428,6023,FALSE,0.680027097211245,2023,2023-2024
WA,2023-10-31,inter-total,160,41,24,13,16,31,24,18,14,57,114,512,274,315,FALSE,0.615234375,2023,2023-2024
WA,2023-10-31,inter-ucfe,3,2,0,1,0,0,0,0,0,0,0,6,3,5,FALSE,0.833333333333333,2023,2023-2024
WA,2023-10-31,inter-ucx,0,0,0,1,0,0,0,1,0,0,0,2,0,0,FALSE,0,2023,2023-2024
WA,2023-10-31,inter-ui,157,39,24,11,16,31,24,17,14,57,114,504,271,310,FALSE,0.615079365079365,2023,2023-2024
WA,2023-10-31,intra-total,4391,520,312,270,489,885,640,324,143,644,1448,10066,5839,6359,FALSE,0.631730578183986,2023,2023-2024
WA,2023-10-31,intra-ucfe,8,2,2,0,0,0,0,2,1,4,5,24,13,15,FALSE,0.625,2023,2023-2024
WA,2023-10-31,intra-ucx,16,2,3,6,6,4,2,0,2,1,10,52,26,28,FALSE,0.538461538461538,2023,2023-2024
WA,2023-10-31,intra-ui,4367,516,307,264,483,881,638,322,140,639,1433,9990,5800,6316,FALSE,0.632232232232232,2023,2023-2024
WA,2023-11-30,inter-total,333,36,26,27,28,57,16,11,8,31,138,711,471,507,FALSE,0.713080168776371,2023,2023-2024
WA,2023-11-30,inter-ucfe,5,0,0,1,0,0,0,0,0,1,6,13,11,11,FALSE,0.846153846153846,2023,2023-2024
WA,2023-11-30,inter-ucx,0,0,0,0,0,0,0,0,0,0,2,2,2,2,FALSE,1,2023,2023-2024
WA,2023-11-30,inter-ui,328,36,26,26,28,57,16,11,8,30,130,696,458,494,FALSE,0.709770114942529,2023,2023-2024
WA,2023-11-30,intra-total,6000,493,372,306,658,940,369,178,69,513,1561,11459,7561,8054,FALSE,0.702853652151148,2023,2023-2024
WA,2023-11-30,intra-ucfe,31,6,3,3,1,2,4,1,0,2,12,65,43,49,FALSE,0.753846153846154,2023,2023-2024
WA,2023-11-30,intra-ucx,14,7,4,5,2,3,3,1,0,5,7,51,21,28,FALSE,0.549019607843137,2023,2023-2024
WA,2023-11-30,intra-ui,5955,480,365,298,655,935,362,176,69,506,1542,11343,7497,7977,FALSE,0.703253107643481,2023,2023-2024
WA,2023-12-31,inter-total,357,63,57,76,87,64,31,19,10,26,139,929,496,559,FALSE,0.601722282023681,2023,2023-2024
WA,2023-12-31,inter-ucfe,4,0,1,2,1,0,0,1,0,0,4,13,8,8,FALSE,0.615384615384615,2023,2023-2024
WA,2023-12-31,inter-ucx,2,0,0,0,0,0,0,0,0,0,0,2,2,2,FALSE,1,2023,2023-2024
WA,2023-12-31,inter-ui,351,63,56,74,86,64,31,18,10,26,135,914,486,549,FALSE,0.600656455142232,2023,2023-2024
WA,2023-12-31,intra-total,7297,669,613,651,917,1246,525,234,111,529,1605,14397,8902,9571,FALSE,0.66479127596027,2023,2023-2024
WA,2023-12-31,intra-ucfe,49,6,3,5,7,3,3,2,1,1,11,91,60,66,FALSE,0.725274725274725,2023,2023-2024
WA,2023-12-31,intra-ucx,12,3,1,3,5,9,4,1,1,3,5,47,17,20,FALSE,0.425531914893617,2023,2023-2024
WA,2023-12-31,intra-ui,7236,660,609,643,905,1234,518,231,109,525,1589,14259,8825,9485,FALSE,0.665193912616593,2023,2023-2024
WA,2024-01-31,inter-total,332,33,42,48,37,61,109,40,15,36,107,860,439,472,FALSE,0.548837209302326,2023,2023-2024
WA,2024-01-31,inter-ucfe,10,0,1,0,2,2,1,1,0,1,8,26,18,18,FALSE,0.692307692307692,2023,2023-2024
WA,2024-01-31,inter-ucx,2,0,0,0,0,0,0,0,0,0,1,3,3,3,FALSE,1,2023,2023-2024
WA,2024-01-31,inter-ui,320,33,41,48,35,59,108,39,15,35,98,831,418,451,FALSE,0.542719614921781,2023,2023-2024
WA,2024-01-31,intra-total,9893,793,557,513,561,991,1176,538,197,651,2004,17874,11897,12690,FALSE,0.709969788519637,2023,2023-2024
WA,2024-01-31,intra-ucfe,69,9,4,6,4,4,5,2,0,8,23,134,92,101,FALSE,0.753731343283582,2023,2023-2024
WA,2024-01-31,intra-ucx,31,6,2,6,2,3,6,2,4,3,8,73,39,45,FALSE,0.616438356164384,2023,2023-2024
WA,2024-01-31,intra-ui,9793,778,551,501,555,984,1165,534,193,640,1973,17667,11766,12544,FALSE,0.710024339163412,2023,2023-2024
WA,2024-02-29,inter-total,131,26,32,29,76,152,87,24,16,46,38,657,169,195,FALSE,0.296803652968037,2023,2023-2024
WA,2024-02-29,inter-ucfe,5,1,2,1,2,1,0,0,1,0,3,16,8,9,FALSE,0.5625,2023,2023-2024
WA,2024-02-29,inter-ucx,2,0,0,0,0,0,0,0,0,0,0,2,2,2,FALSE,1,2023,2023-2024
WA,2024-02-29,inter-ui,124,25,30,28,74,151,87,24,15,46,35,639,159,184,FALSE,0.287949921752739,2023,2023-2024
WA,2024-02-29,intra-total,5527,736,596,569,1033,1903,1025,400,154,737,1350,14030,6877,7613,FALSE,0.542622950819672,2023,2023-2024
WA,2024-02-29,intra-ucfe,13,3,5,4,6,5,5,2,1,4,9,57,22,25,FALSE,0.43859649122807,2023,2023-2024
WA,2024-02-29,intra-ucx,24,6,6,5,5,4,4,3,2,3,6,68,30,36,FALSE,0.529411764705882,2023,2023-2024
WA,2024-02-29,intra-ui,5490,727,585,560,1022,1894,1016,395,151,730,1335,13905,6825,7552,FALSE,0.543113987774182,2023,2023-2024
WA,2024-03-31,inter-total,171,62,76,114,124,58,28,13,14,61,55,776,226,288,FALSE,0.371134020618557,2023,2023-2024
WA,2024-03-31,inter-ucfe,3,2,2,1,6,2,1,0,0,1,0,18,3,5,FALSE,0.277777777777778,2023,2023-2024
WA,2024-03-31,inter-ucx,1,0,1,0,0,0,0,0,0,0,0,2,1,1,FALSE,0.5,2023,2023-2024
WA,2024-03-31,inter-ui,167,60,73,113,118,56,27,13,14,60,55,756,222,282,FALSE,0.373015873015873,2023,2023-2024
WA,2024-03-31,intra-total,5322,911,1258,1777,1921,1115,484,248,172,1067,1380,15655,6702,7613,FALSE,0.48629830725008,2023,2023-2024
WA,2024-03-31,intra-ucfe,10,3,2,5,5,2,4,1,2,4,5,43,15,18,FALSE,0.418604651162791,2023,2023-2024
WA,2024-03-31,intra-ucx,27,7,9,8,7,6,4,2,1,11,12,94,39,46,FALSE,0.48936170212766,2023,2023-2024
WA,2024-03-31,intra-ui,5285,901,1247,1764,1909,1107,476,245,169,1052,1363,15518,6648,7549,FALSE,0.486467328263952,2023,2023-2024
WA,2024-04-30,inter-total,344,46,43,25,11,4,6,6,4,75,67,631,411,457,FALSE,0.724247226624406,2023,2023-2024
WA,2024-04-30,inter-ucfe,0,0,0,0,0,0,1,0,0,2,1,4,1,1,FALSE,0.25,2023,2023-2024
WA,2024-04-30,inter-ucx,1,0,1,0,0,0,0,0,0,0,0,2,1,1,FALSE,0.5,2023,2023-2024
WA,2024-04-30,inter-ui,343,46,42,25,11,4,5,6,4,73,66,625,409,455,FALSE,0.728,2023,2023-2024
WA,2024-04-30,intra-total,5399,1424,1200,573,335,168,136,138,97,961,1605,12036,7004,8428,FALSE,0.700232635427052,2023,2023-2024
WA,2024-04-30,intra-ucfe,4,3,3,1,2,0,2,2,1,9,9,36,13,16,FALSE,0.444444444444444,2023,2023-2024
WA,2024-04-30,intra-ucx,27,7,5,3,4,3,0,0,1,13,11,74,38,45,FALSE,0.608108108108108,2023,2023-2024
WA,2024-04-30,intra-ui,5368,1414,1192,569,329,165,134,136,95,939,1585,11926,6953,8367,FALSE,0.7015763877243,2023,2023-2024
WA,2024-05-31,inter-total,390,35,17,7,8,5,4,3,1,31,97,598,487,522,FALSE,0.872909698996656,2023,2023-2024
WA,2024-05-31,inter-ucfe,0,1,0,0,0,0,0,0,0,0,0,1,0,1,FALSE,1,2023,2023-2024
WA,2024-05-31,inter-ucx,2,0,0,0,0,0,0,0,0,0,0,2,2,2,FALSE,1,2023,2023-2024
WA,2024-05-31,inter-ui,388,34,17,7,8,5,4,3,1,31,97,595,485,519,FALSE,0.872268907563025,2023,2023-2024
WA,2024-05-31,intra-total,6122,1001,371,177,118,89,70,54,55,680,2284,11021,8406,9407,FALSE,0.853552309227838,2023,2023-2024
WA,2024-05-31,intra-ucfe,5,8,4,2,1,1,1,0,1,6,4,33,9,17,FALSE,0.515151515151515,2023,2023-2024
WA,2024-05-31,intra-ucx,25,10,2,0,0,0,0,1,1,5,14,58,39,49,FALSE,0.844827586206897,2023,2023-2024
WA,2024-05-31,intra-ui,6092,983,365,175,117,88,69,53,53,669,2266,10930,8358,9341,FALSE,0.854620311070448,2023,2023-2024
WA,2024-06-30,inter-total,277,40,22,9,9,12,3,2,3,34,88,499,365,405,FALSE,0.811623246492986,2023,2023-2024
WA,2024-06-30,inter-ucfe,0,0,1,1,0,0,0,0,0,1,2,5,2,2,FALSE,0.4,2023,2023-2024
WA,2024-06-30,inter-ucx,3,0,0,0,0,0,0,0,0,0,0,3,3,3,FALSE,1,2023,2023-2024
WA,2024-06-30,inter-ui,274,40,21,8,9,12,3,2,3,33,86,491,360,400,FALSE,0.814663951120163,2023,2023-2024
WA,2024-06-30,intra-total,5084,1010,436,177,121,94,75,69,57,626,1862,9611,6946,7956,FALSE,0.827801477473728,2023,2023-2024
WA,2024-06-30,intra-ucfe,7,3,3,1,2,0,1,0,0,2,4,23,11,14,FALSE,0.608695652173913,2023,2023-2024
WA,2024-06-30,intra-ucx,34,6,3,0,0,1,0,0,0,3,14,61,48,54,FALSE,0.885245901639344,2023,2023-2024
WA,2024-06-30,intra-ui,5043,1001,430,176,119,93,74,69,57,621,1844,9527,6887,7888,FALSE,0.827962632518107,2023,2023-2024
WA,2024-07-31,inter-total,242,64,29,10,3,7,4,1,3,28,104,495,346,410,FALSE,0.828282828282828,2024,2024-2025
WA,2024-07-31,inter-ucfe,0,1,0,0,0,0,1,0,1,1,0,4,0,1,FALSE,0.25,2024,2024-2025
WA,2024-07-31,inter-ucx,1,0,1,0,0,0,0,0,0,0,1,3,2,2,FALSE,0.666666666666667,2024,2024-2025
WA,2024-07-31,inter-ui,241,63,28,10,3,7,3,1,2,27,103,488,344,407,FALSE,0.834016393442623,2024,2024-2025
WA,2024-07-31,intra-total,6381,1462,591,249,109,83,57,54,62,404,1906,11358,8287,9749,FALSE,0.858337735516816,2024,2024-2025
WA,2024-07-31,intra-ucfe,2,3,2,1,0,0,0,0,0,4,0,12,2,5,FALSE,0.416666666666667,2024,2024-2025
WA,2024-07-31,intra-ucx,32,12,3,1,3,0,0,1,0,1,19,72,51,63,FALSE,0.875,2024,2024-2025
WA,2024-07-31,intra-ui,6347,1447,586,247,106,83,57,53,62,399,1887,11274,8234,9681,FALSE,0.85870143693454,2024,2024-2025
WA,2024-08-31,inter-total,279,48,36,12,17,5,2,5,5,26,39,474,318,366,FALSE,0.772151898734177,2024,2024-2025
WA,2024-08-31,inter-ucfe,1,0,0,1,0,0,0,1,0,1,0,4,1,1,FALSE,0.25,2024,2024-2025
WA,2024-08-31,inter-ucx,2,0,0,0,0,0,0,0,0,0,0,2,2,2,FALSE,1,2024,2024-2025
WA,2024-08-31,inter-ui,276,48,36,11,17,5,2,4,5,25,39,468,315,363,FALSE,0.775641025641026,2024,2024-2025
WA,2024-08-31,intra-total,5678,1193,1082,377,209,114,73,79,57,460,969,10291,6647,7840,FALSE,0.76183072587698,2024,2024-2025
WA,2024-08-31,intra-ucfe,7,3,1,0,0,2,0,2,0,1,4,20,11,14,FALSE,0.7,2024,2024-2025
WA,2024-08-31,intra-ucx,39,13,5,1,0,2,0,2,1,2,3,68,42,55,FALSE,0.808823529411765,2024,2024-2025
WA,2024-08-31,intra-ui,5632,1177,1076,376,209,110,73,75,56,457,962,10203,6594,7771,FALSE,0.761638733705773,2024,2024-2025
WA,2024-09-30,inter-total,249,16,27,25,15,9,7,3,7,22,26,406,275,291,FALSE,0.716748768472906,2024,2024-2025
WA,2024-09-30,inter-ucfe,0,1,0,0,0,0,0,1,0,1,0,3,0,1,FALSE,0.333333333333333,2024,2024-2025
WA,2024-09-30,inter-ucx,0,0,0,1,0,0,0,0,0,0,0,1,0,0,FALSE,0,2024,2024-2025
WA,2024-09-30,inter-ui,249,15,27,24,15,9,7,2,7,21,26,402,275,290,FALSE,0.721393034825871,2024,2024-2025
WA,2024-09-30,intra-total,5508,443,844,671,246,134,103,86,80,390,830,9335,6338,6781,FALSE,0.726405998928763,2024,2024-2025
WA,2024-09-30,intra-ucfe,4,3,1,3,1,0,0,0,2,4,2,20,6,9,FALSE,0.45,2024,2024-2025
WA,2024-09-30,intra-ucx,45,9,2,4,0,1,2,0,0,0,7,70,52,61,FALSE,0.871428571428572,2024,2024-2025
WA,2024-09-30,intra-ui,5459,431,841,664,245,133,101,86,78,386,821,9245,6280,6711,FALSE,0.725905895078421,2024,2024-2025
WA,2024-10-31,inter-total,285,17,28,49,14,10,6,10,6,37,43,505,328,345,FALSE,0.683168316831683,2024,2024-2025
WA,2024-10-31,inter-ucfe,3,1,1,0,0,0,0,0,0,0,1,6,4,5,FALSE,0.833333333333333,2024,2024-2025
WA,2024-10-31,inter-ucx,5,0,0,0,0,0,0,0,0,0,2,7,7,7,FALSE,1,2024,2024-2025
WA,2024-10-31,inter-ui,277,16,27,49,14,10,6,10,6,37,40,492,317,333,FALSE,0.676829268292683,2024,2024-2025
WA,2024-10-31,intra-total,6214,493,666,1378,661,286,155,133,106,619,995,11706,7209,7702,FALSE,0.657953186400137,2024,2024-2025
WA,2024-10-31,intra-ucfe,15,2,2,3,0,2,1,0,1,2,3,31,18,20,FALSE,0.645161290322581,2024,2024-2025
WA,2024-10-31,intra-ucx,35,3,4,8,3,2,0,0,0,3,8,66,43,46,FALSE,0.696969696969697,2024,2024-2025
WA,2024-10-31,intra-ui,6164,488,660,1367,658,282,154,133,105,614,984,11609,7148,7636,FALSE,0.65776552674649,2024,2024-2025
WA,2024-11-30,inter-total,554,35,41,31,13,6,10,6,4,23,67,790,621,656,FALSE,0.830379746835443,2024,2024-2025
WA,2024-11-30,inter-ucfe,23,0,1,1,0,0,1,0,1,1,2,30,25,25,FALSE,0.833333333333333,2024,2024-2025
WA,2024-11-30,inter-ucx,0,1,0,0,0,0,0,0,0,0,1,2,1,2,FALSE,1,2024,2024-2025
WA,2024-11-30,inter-ui,531,34,40,30,13,6,9,6,3,22,64,758,595,629,FALSE,0.829815303430079,2024,2024-2025
WA,2024-11-30,intra-total,7329,682,1280,944,375,177,111,100,67,493,1290,12848,8619,9301,FALSE,0.723925902864259,2024,2024-2025
WA,2024-11-30,intra-ucfe,48,2,3,1,1,0,0,0,1,3,12,71,60,62,FALSE,0.873239436619718,2024,2024-2025
WA,2024-11-30,intra-ucx,32,3,9,3,3,0,0,1,2,4,5,62,37,40,FALSE,0.645161290322581,2024,2024-2025
WA,2024-11-30,intra-ui,7249,677,1268,940,371,177,111,99,64,486,1273,12715,8522,9199,FALSE,0.72347620920173,2024,2024-2025
WA,2024-12-31,inter-total,623,65,73,51,30,17,13,7,3,38,125,1045,748,813,FALSE,0.77799043062201,2024,2024-2025
WA,2024-12-31,inter-ucfe,11,1,1,1,3,0,1,0,0,0,2,20,13,14,FALSE,0.7,2024,2024-2025
WA,2024-12-31,inter-ucx,1,0,0,0,0,0,0,0,0,1,2,4,3,3,FALSE,0.75,2024,2024-2025
WA,2024-12-31,inter-ui,611,64,72,50,27,17,12,7,3,37,121,1021,732,796,FALSE,0.779627815866797,2024,2024-2025
WA,2024-12-31,intra-total,11316,1047,1660,1111,421,231,150,129,78,547,1918,18608,13234,14281,FALSE,0.767465606190886,2024,2024-2025
WA,2024-12-31,intra-ucfe,110,7,7,6,0,3,1,3,1,2,11,151,121,128,FALSE,0.847682119205298,2024,2024-2025
WA,2024-12-31,intra-ucx,42,7,8,3,2,1,1,1,2,5,13,85,55,62,FALSE,0.729411764705882,2024,2024-2025
WA,2024-12-31,intra-ui,11164,1033,1645,1102,419,227,148,125,75,540,1894,18372,13058,14091,FALSE,0.766982364467668,2024,2024-2025
WI,2019-01-31,inter-total,551,26,13,5,3,2,3,1,2,4,106,716,657,683,FALSE,0.95391061452514,2018,2018-2019
WI,2019-01-31,inter-ucfe,2,0,0,0,0,0,0,0,0,0,3,5,5,5,FALSE,1,2018,2018-2019
WI,2019-01-31,inter-ucx,0,0,0,0,0,0,0,0,0,0,0,0,0,0,FALSE,0,2018,2018-2019
WI,2019-01-31,inter-ui,549,26,13,5,3,2,3,1,2,4,103,711,652,678,FALSE,0.953586497890295,2018,2018-2019
WI,2019-01-31,intra-total,15364,912,414,165,67,55,31,28,21,52,1993,19102,17357,18269,FALSE,0.956392000837609,2018,2018-2019
WI,2019-01-31,intra-ucfe,164,11,3,3,0,0,0,1,0,0,93,275,257,268,FALSE,0.974545454545454,2018,2018-2019
WI,2019-01-31,intra-ucx,8,0,0,1,0,0,0,0,0,0,4,13,12,12,FALSE,0.923076923076923,2018,2018-2019
WI,2019-01-31,intra-ui,15192,901,411,161,67,55,31,27,21,52,1896,18814,17088,17989,FALSE,0.95614967577336,2018,2018-2019
WI,2019-02-28,inter-total,300,46,21,8,7,3,1,0,3,3,56,448,356,402,FALSE,0.897321428571429,2018,2018-2019
WI,2019-02-28,inter-ucfe,0,0,1,0,0,1,0,0,0,0,1,3,1,1,FALSE,0.333333333333333,2018,2018-2019
WI,2019-02-28,inter-ucx,1,0,0,0,0,0,0,0,0,0,0,1,1,1,FALSE,1,2018,2018-2019
WI,2019-02-28,inter-ui,299,46,20,8,7,2,1,0,3,3,55,444,354,400,FALSE,0.900900900900901,2018,2018-2019
WI,2019-02-28,intra-total,8837,1176,646,276,133,60,59,35,33,68,1583,12906,10420,11596,FALSE,0.898496823183016,2018,2018-2019
WI,2019-02-28,intra-ucfe,5,9,10,9,3,0,0,0,0,1,4,41,9,18,FALSE,0.439024390243902,2018,2018-2019
WI,2019-02-28,intra-ucx,3,0,1,1,0,0,0,0,0,0,4,9,7,7,FALSE,0.777777777777778,2018,2018-2019
WI,2019-02-28,intra-ui,8829,1167,635,266,130,60,59,35,33,67,1575,12856,10404,11571,FALSE,0.900046670815184,2018,2018-2019
WI,2019-03-31,inter-total,126,20,17,10,6,3,1,0,3,4,20,210,146,166,FALSE,0.79047619047619,2018,2018-2019
WI,2019-03-31,inter-ucfe,0,0,0,0,0,0,0,0,0,0,0,0,0,0,FALSE,0,2018,2018-2019
WI,2019-03-31,inter-ucx,0,0,0,0,0,0,0,0,0,0,0,0,0,0,FALSE,0,2018,2018-2019
WI,2019-03-31,inter-ui,126,20,17,10,6,3,1,0,3,4,20,210,146,166,FALSE,0.79047619047619,2018,2018-2019
WI,2019-03-31,intra-total,5363,813,447,241,103,71,51,35,16,52,1255,8447,6618,7431,FALSE,0.879720610867764,2018,2018-2019
WI,2019-03-31,intra-ucfe,4,2,0,0,0,0,0,0,0,0,2,8,6,8,FALSE,1,2018,2018-2019
WI,2019-03-31,intra-ucx,2,2,0,0,0,0,0,0,0,0,0,4,2,4,FALSE,1,2018,2018-2019
WI,2019-03-31,intra-ui,5357,809,447,241,103,71,51,35,16,52,1253,8435,6610,7419,FALSE,0.879549496147007,2018,2018-2019
WI,2019-04-30,inter-total,108,14,7,3,2,3,0,2,0,2,25,166,133,147,FALSE,0.885542168674699,2018,2018-2019
WI,2019-04-30,inter-ucfe,0,0,0,0,0,0,0,0,0,0,0,0,0,0,FALSE,0,2018,2018-2019
WI,2019-04-30,inter-ucx,0,0,0,0,0,0,0,0,0,0,0,0,0,0,FALSE,0,2018,2018-2019
WI,2019-04-30,inter-ui,108,14,7,3,2,3,0,2,0,2,25,166,133,147,FALSE,0.885542168674699,2018,2018-2019
WI,2019-04-30,intra-total,4736,535,240,124,83,50,32,15,19,67,1117,7018,5853,6388,FALSE,0.910230834995725,2018,2018-2019
WI,2019-04-30,intra-ucfe,10,4,1,1,0,0,0,0,0,1,2,19,12,16,FALSE,0.842105263157895,2018,2018-2019
WI,2019-04-30,intra-ucx,4,0,0,0,0,0,0,0,0,0,2,6,6,6,FALSE,1,2018,2018-2019
WI,2019-04-30,intra-ui,4722,531,239,123,83,50,32,15,19,66,1113,6993,5835,6366,FALSE,0.91033891033891,2018,2018-2019
WI,2019-05-31,inter-total,95,14,5,5,4,2,0,1,0,1,27,154,122,136,FALSE,0.883116883116883,2018,2018-2019
WI,2019-05-31,inter-ucfe,0,0,0,0,0,0,0,0,0,0,0,0,0,0,FALSE,0,2018,2018-2019
WI,2019-05-31,inter-ucx,0,0,0,0,0,0,0,0,0,0,0,0,0,0,FALSE,0,2018,2018-2019
WI,2019-05-31,inter-ui,95,14,5,5,4,2,0,1,0,1,27,154,122,136,FALSE,0.883116883116883,2018,2018-2019
WI,2019-05-31,intra-total,3666,360,141,82,49,46,37,29,23,46,933,5412,4599,4959,FALSE,0.91629711751663,2018,2018-2019
WI,2019-05-31,intra-ucfe,5,1,2,0,0,0,0,0,2,0,5,15,10,11,FALSE,0.733333333333333,2018,2018-2019
WI,2019-05-31,intra-ucx,3,0,0,0,0,0,0,0,0,0,0,3,3,3,FALSE,1,2018,2018-2019
WI,2019-05-31,intra-ui,3658,359,139,82,49,46,37,29,21,46,928,5394,4586,4945,FALSE,0.916759362254357,2018,2018-2019
WI,2019-06-30,inter-total,83,6,8,6,4,5,0,0,1,3,27,143,110,116,FALSE,0.811188811188811,2018,2018-2019
WI,2019-06-30,inter-ucfe,0,0,0,0,0,0,0,0,0,0,0,0,0,0,FALSE,0,2018,2018-2019
WI,2019-06-30,inter-ucx,0,0,0,0,0,0,0,0,0,0,0,0,0,0,FALSE,0,2018,2018-2019
WI,2019-06-30,inter-ui,83,6,8,6,4,5,0,0,1,3,27,143,110,116,FALSE,0.811188811188811,2018,2018-2019
WI,2019-06-30,intra-total,5261,319,130,77,53,41,32,13,14,51,862,6853,6123,6442,FALSE,0.940026265868963,2018,2018-2019
WI,2019-06-30,intra-ucfe,4,4,0,1,0,0,0,0,1,1,3,14,7,11,FALSE,0.785714285714286,2018,2018-2019
WI,2019-06-30,intra-ucx,5,0,0,0,0,1,0,0,0,0,0,6,5,5,FALSE,0.833333333333333,2018,2018-2019
WI,2019-06-30,intra-ui,5252,315,130,76,53,40,32,13,13,50,859,6833,6111,6426,FALSE,0.940436118835065,2018,2018-2019
WI,2019-07-31,inter-total,78,9,4,3,3,0,2,1,1,2,23,126,101,110,FALSE,0.873015873015873,2019,2019-2020
WI,2019-07-31,inter-ucfe,0,0,0,0,0,0,0,0,0,0,0,0,0,0,FALSE,0,2019,2019-2020
WI,2019-07-31,inter-ucx,0,0,0,0,0,0,0,0,0,0,0,0,0,0,FALSE,0,2019,2019-2020
WI,2019-07-31,inter-ui,78,9,4,3,3,0,2,1,1,2,23,126,101,110,FALSE,0.873015873015873,2019,2019-2020
WI,2019-07-31,intra-total,5986,479,169,88,55,26,24,11,7,50,1242,8137,7228,7707,FALSE,0.947154971119577,2019,2019-2020
WI,2019-07-31,intra-ucfe,2,2,1,0,0,0,0,0,0,0,0,5,2,4,FALSE,0.8,2019,2019-2020
WI,2019-07-31,intra-ucx,6,0,0,0,0,0,0,0,0,0,1,7,7,7,FALSE,1,2019,2019-2020
WI,2019-07-31,intra-ui,5978,477,168,88,55,26,24,11,7,50,1241,8125,7219,7696,FALSE,0.9472,2019,2019-2020
WI,2019-08-31,inter-total,68,9,6,4,5,2,1,1,0,2,25,123,93,102,FALSE,0.829268292682927,2019,2019-2020
WI,2019-08-31,inter-ucfe,0,0,0,2,0,0,0,0,0,0,1,3,1,1,FALSE,0.333333333333333,2019,2019-2020
WI,2019-08-31,inter-ucx,0,0,0,0,0,0,0,0,0,0,0,0,0,0,FALSE,0,2019,2019-2020
WI,2019-08-31,inter-ui,68,9,6,2,5,2,1,1,0,2,24,120,92,101,FALSE,0.841666666666667,2019,2019-2020
WI,2019-08-31,intra-total,4006,375,163,86,71,49,37,19,10,51,952,5819,4958,5333,FALSE,0.9164804949304,2019,2019-2020
WI,2019-08-31,intra-ucfe,3,0,0,1,0,0,0,0,0,2,1,7,4,4,FALSE,0.571428571428571,2019,2019-2020
WI,2019-08-31,intra-ucx,4,0,0,0,0,0,0,0,0,0,0,4,4,4,FALSE,1,2019,2019-2020
WI,2019-08-31,intra-ui,3999,375,163,85,71,49,37,19,10,49,951,5808,4950,5325,FALSE,0.916838842975207,2019,2019-2020
WI,2019-09-30,inter-total,52,9,2,2,2,4,1,1,0,0,19,92,71,80,FALSE,0.869565217391304,2019,2019-2020
WI,2019-09-30,inter-ucfe,0,0,0,0,0,0,0,0,0,0,0,0,0,0,FALSE,0,2019,2019-2020
WI,2019-09-30,inter-ucx,0,0,0,0,0,0,0,0,0,0,0,0,0,0,FALSE,0,2019,2019-2020
WI,2019-09-30,inter-ui,52,9,2,2,2,4,1,1,0,0,19,92,71,80,FALSE,0.869565217391304,2019,2019-2020
WI,2019-09-30,intra-total,3472,265,117,68,48,52,23,10,5,39,750,4849,4222,4487,FALSE,0.925345432047845,2019,2019-2020
WI,2019-09-30,intra-ucfe,4,0,0,0,0,0,0,0,0,0,0,4,4,4,FALSE,1,2019,2019-2020
WI,2019-09-30,intra-ucx,4,0,0,1,0,1,0,0,0,1,3,10,7,7,FALSE,0.7,2019,2019-2020
WI,2019-09-30,intra-ui,3464,265,117,67,48,51,23,10,5,38,747,4835,4211,4476,FALSE,0.925749741468459,2019,2019-2020
WI,2019-10-31,inter-total,76,9,2,2,1,2,2,2,0,2,17,115,93,102,FALSE,0.886956521739131,2019,2019-2020
WI,2019-10-31,inter-ucfe,0,0,0,0,0,0,0,0,0,0,0,0,0,0,FALSE,0,2019,2019-2020
WI,2019-10-31,inter-ucx,0,0,0,0,0,0,0,0,0,0,0,0,0,0,FALSE,0,2019,2019-2020
WI,2019-10-31,inter-ui,76,9,2,2,1,2,2,2,0,2,17,115,93,102,FALSE,0.886956521739131,2019,2019-2020
WI,2019-10-31,intra-total,3782,290,118,67,53,43,26,16,17,48,826,5286,4608,4898,FALSE,0.926598562239879,2019,2019-2020
WI,2019-10-31,intra-ucfe,9,1,1,0,0,0,0,0,0,1,2,14,11,12,FALSE,0.857142857142857,2019,2019-2020
WI,2019-10-31,intra-ucx,9,0,0,0,0,0,0,0,0,1,3,13,12,12,FALSE,0.923076923076923,2019,2019-2020
WI,2019-10-31,intra-ui,3764,289,117,67,53,43,26,16,17,46,821,5259,4585,4874,FALSE,0.926792165810991,2019,2019-2020
WI,2019-11-30,inter-total,128,5,7,6,0,2,2,0,0,3,35,188,163,168,FALSE,0.893617021276596,2019,2019-2020
WI,2019-11-30,inter-ucfe,0,0,0,0,0,1,0,0,0,0,1,2,1,1,FALSE,0.5,2019,2019-2020
WI,2019-11-30,inter-ucx,0,0,0,0,0,0,0,0,0,0,0,0,0,0,FALSE,0,2019,2019-2020
WI,2019-11-30,inter-ui,128,5,7,6,0,1,2,0,0,3,34,186,162,167,FALSE,0.897849462365591,2019,2019-2020
WI,2019-11-30,intra-total,5603,279,97,70,62,26,28,13,9,43,920,7150,6523,6802,FALSE,0.951328671328671,2019,2019-2020
WI,2019-11-30,intra-ucfe,13,1,1,0,0,0,0,0,0,0,3,18,16,17,FALSE,0.944444444444444,2019,2019-2020
WI,2019-11-30,intra-ucx,2,0,0,1,0,0,0,0,0,0,1,4,3,3,FALSE,0.75,2019,2019-2020
WI,2019-11-30,intra-ui,5588,278,96,69,62,26,28,13,9,43,916,7128,6504,6782,FALSE,0.951459034792368,2019,2019-2020
WI,2019-12-31,inter-total,245,26,12,5,2,3,1,1,1,0,61,357,306,332,FALSE,0.929971988795518,2019,2019-2020
WI,2019-12-31,inter-ucfe,0,0,0,0,0,0,0,0,0,0,0,0,0,0,FALSE,0,2019,2019-2020
WI,2019-12-31,inter-ucx,0,0,0,0,0,0,0,0,0,0,0,0,0,0,FALSE,0,2019,2019-2020
WI,2019-12-31,inter-ui,245,26,12,5,2,3,1,1,1,0,61,357,306,332,FALSE,0.929971988795518,2019,2019-2020
WI,2019-12-31,intra-total,12267,570,240,92,59,50,26,17,5,45,1477,14848,13744,14314,FALSE,0.964035560344828,2019,2019-2020
WI,2019-12-31,intra-ucfe,15,3,2,0,0,0,0,1,0,0,3,24,18,21,FALSE,0.875,2019,2019-2020
WI,2019-12-31,intra-ucx,5,1,1,0,0,0,0,0,0,0,1,8,6,7,FALSE,0.875,2019,2019-2020
WI,2019-12-31,intra-ui,12247,566,237,92,59,50,26,16,5,45,1473,14816,13720,14286,FALSE,0.964227861771058,2019,2019-2020
WI,2020-01-31,inter-total,485,25,13,10,6,5,1,1,3,4,106,659,591,616,FALSE,0.934749620637329,2019,2019-2020
WI,2020-01-31,inter-ucfe,0,1,0,0,0,0,0,0,0,0,0,1,0,1,FALSE,1,2019,2019-2020
WI,2020-01-31,inter-ucx,0,0,0,0,0,0,0,0,0,0,0,0,0,0,FALSE,0,2019,2019-2020
WI,2020-01-31,inter-ui,485,24,13,10,6,5,1,1,3,4,106,658,591,615,FALSE,0.934650455927052,2019,2019-2020
WI,2020-01-31,intra-total,14271,975,494,165,84,51,41,18,21,56,2059,18235,16330,17305,FALSE,0.948999177406087,2019,2019-2020
WI,2020-01-31,intra-ucfe,20,3,6,2,0,0,1,0,0,0,5,37,25,28,FALSE,0.756756756756757,2019,2019-2020
WI,2020-01-31,intra-ucx,7,1,3,0,1,0,0,0,0,0,2,14,9,10,FALSE,0.714285714285714,2019,2019-2020
WI,2020-01-31,intra-ui,14244,971,485,163,83,51,40,18,21,56,2052,18184,16296,17267,FALSE,0.949571051473823,2019,2019-2020
WI,2020-02-29,inter-total,328,52,29,18,10,2,2,7,3,2,91,544,419,471,FALSE,0.865808823529412,2019,2019-2020
WI,2020-02-29,inter-ucfe,0,1,0,0,0,0,0,0,0,0,1,2,1,2,FALSE,1,2019,2019-2020
WI,2020-02-29,inter-ucx,0,0,0,0,0,0,0,0,0,0,0,0,0,0,FALSE,0,2019,2019-2020
WI,2020-02-29,inter-ui,328,51,29,18,10,2,2,7,3,2,90,542,418,469,FALSE,0.865313653136531,2019,2019-2020
WI,2020-02-29,intra-total,7835,954,507,238,131,49,34,43,32,63,1528,11414,9363,10317,FALSE,0.903889959698616,2019,2019-2020
WI,2020-02-29,intra-ucfe,2,2,3,1,2,0,0,0,0,0,3,13,5,7,FALSE,0.538461538461538,2019,2019-2020
WI,2020-02-29,intra-ucx,2,1,1,1,0,0,0,0,0,1,3,9,5,6,FALSE,0.666666666666667,2019,2019-2020
WI,2020-02-29,intra-ui,7831,951,503,236,129,49,34,43,32,62,1522,11392,9353,10304,FALSE,0.904494382022472,2019,2019-2020
WI,2020-03-31,inter-total,202,13,11,11,5,5,2,1,1,0,32,283,234,247,FALSE,0.872791519434629,2019,2019-2020
WI,2020-03-31,inter-ucfe,0,0,0,0,0,0,0,0,0,0,0,0,0,0,FALSE,0,2019,2019-2020
WI,2020-03-31,inter-ucx,0,0,0,0,0,0,0,0,0,0,0,0,0,0,FALSE,0,2019,2019-2020
WI,2020-03-31,inter-ui,202,13,11,11,5,5,2,1,1,0,32,283,234,247,FALSE,0.872791519434629,2019,2019-2020
WI,2020-03-31,intra-total,23954,544,238,121,81,55,40,22,14,65,1338,26472,25292,25836,FALSE,0.975974614687217,2019,2019-2020
WI,2020-03-31,intra-ucfe,9,1,0,1,1,0,1,0,0,0,3,16,12,13,FALSE,0.8125,2019,2019-2020
WI,2020-03-31,intra-ucx,9,0,0,0,0,0,0,0,0,0,1,10,10,10,FALSE,1,2019,2019-2020
WI,2020-03-31,intra-ui,23936,543,238,120,80,55,39,22,14,65,1334,26446,25270,25813,FALSE,0.976064433184603,2019,2019-2020
WI,2020-04-30,inter-total,620,128,76,67,26,3,1,0,3,3,228,1155,848,976,FALSE,0.845021645021645,2019,2019-2020
WI,2020-04-30,inter-ucfe,0,0,0,0,0,0,0,0,0,0,0,0,0,0,FALSE,0,2019,2019-2020
WI,2020-04-30,inter-ucx,0,0,0,1,0,0,0,0,0,0,0,1,0,0,FALSE,0,2019,2019-2020
WI,2020-04-30,inter-ui,620,128,76,66,26,3,1,0,3,3,228,1154,848,976,FALSE,0.845753899480069,2019,2019-2020
WI,2020-04-30,intra-total,124506,12338,10416,8325,1832,59,42,44,30,116,25739,183447,150245,162583,FALSE,0.886266878171897,2019,2019-2020
WI,2020-04-30,intra-ucfe,5,3,4,2,2,0,0,0,0,1,4,21,9,12,FALSE,0.571428571428571,2019,2019-2020
WI,2020-04-30,intra-ucx,15,7,7,6,1,0,0,0,0,2,7,45,22,29,FALSE,0.644444444444445,2019,2019-2020
WI,2020-04-30,intra-ui,124486,12328,10405,8317,1829,59,42,44,30,113,25728,183381,150214,162542,FALSE,0.886362273081726,2019,2019-2020
WI,2020-05-31,inter-total,90,12,12,33,51,49,45,20,13,6,32,363,122,134,FALSE,0.369146005509642,2019,2019-2020
WI,2020-05-31,inter-ucfe,0,0,0,0,0,0,0,0,0,0,0,0,0,0,FALSE,0,2019,2019-2020
WI,2020-05-31,inter-ucx,0,0,0,0,0,0,0,0,0,0,0,0,0,0,FALSE,0,2019,2019-2020
WI,2020-05-31,inter-ui,90,12,12,33,51,49,45,20,13,6,32,363,122,134,FALSE,0.369146005509642,2019,2019-2020
WI,2020-05-31,intra-total,9690,1038,1255,2960,5398,6093,4396,2400,637,120,2286,36273,11976,13014,FALSE,0.358779257298817,2019,2019-2020
WI,2020-05-31,intra-ucfe,0,2,2,3,1,5,3,2,1,1,2,22,2,4,FALSE,0.181818181818182,2019,2019-2020
WI,2020-05-31,intra-ucx,1,3,0,1,1,2,3,0,1,1,4,17,5,8,FALSE,0.470588235294118,2019,2019-2020
WI,2020-05-31,intra-ui,9689,1033,1253,2956,5396,6086,4390,2398,635,118,2280,36234,11969,13002,FALSE,0.358834244080146,2019,2019-2020
WI,2020-06-30,inter-total,52,1,4,8,7,9,10,13,23,115,16,258,68,69,FALSE,0.267441860465116,2019,2019-2020
WI,2020-06-30,inter-ucfe,0,0,0,0,0,0,0,0,0,0,0,0,0,0,FALSE,0,2019,2019-2020
WI,2020-06-30,inter-ucx,0,0,0,0,0,0,0,0,0,0,0,0,0,0,FALSE,0,2019,2019-2020
WI,2020-06-30,inter-ui,52,1,4,8,7,9,10,13,23,115,16,258,68,69,FALSE,0.267441860465116,2019,2019-2020
WI,2020-06-30,intra-total,6247,215,163,250,397,384,576,769,1816,6885,1160,18862,7407,7622,FALSE,0.404092885165942,2019,2019-2020
WI,2020-06-30,intra-ucfe,0,1,0,0,0,0,1,1,4,15,0,22,0,1,FALSE,0.0454545454545455,2019,2019-2020
WI,2020-06-30,intra-ucx,1,0,0,0,0,0,1,0,2,2,3,9,4,4,FALSE,0.444444444444444,2019,2019-2020
WI,2020-06-30,intra-ui,6246,214,163,250,397,384,574,768,1810,6868,1157,18831,7403,7617,FALSE,0.404492592002549,2019,2019-2020
WI,2020-07-31,inter-total,53,1,4,7,2,5,7,4,2,168,16,269,69,70,FALSE,0.260223048327138,2020,2020-2021
WI,2020-07-31,inter-ucfe,0,0,0,0,0,0,0,0,0,0,0,0,0,0,FALSE,0,2020,2020-2021
WI,2020-07-31,inter-ucx,0,0,0,0,0,0,0,0,0,0,0,0,0,0,FALSE,0,2020,2020-2021
WI,2020-07-31,inter-ui,53,1,4,7,2,5,7,4,2,168,16,269,69,70,FALSE,0.260223048327138,2020,2020-2021
WI,2020-07-31,intra-total,5025,297,223,204,198,179,161,214,259,7629,1021,15410,6046,6343,FALSE,0.411615833874108,2020,2020-2021
WI,2020-07-31,intra-ucfe,1,1,0,0,0,0,0,0,0,7,0,9,1,2,FALSE,0.222222222222222,2020,2020-2021
WI,2020-07-31,intra-ucx,0,2,1,0,0,0,0,1,0,1,1,6,1,3,FALSE,0.5,2020,2020-2021
WI,2020-07-31,intra-ui,5024,294,222,204,198,179,161,213,259,7621,1020,15395,6044,6338,FALSE,0.411692107827217,2020,2020-2021
WI,2020-08-31,inter-total,67,5,1,3,3,2,1,3,6,144,29,264,96,101,FALSE,0.382575757575758,2020,2020-2021
WI,2020-08-31,inter-ucfe,0,0,0,1,0,0,0,0,0,0,1,2,1,1,FALSE,0.5,2020,2020-2021
WI,2020-08-31,inter-ucx,0,0,0,0,0,0,0,0,0,0,0,0,0,0,FALSE,0,2020,2020-2021
WI,2020-08-31,inter-ui,67,5,1,2,3,2,1,3,6,144,28,262,95,100,FALSE,0.381679389312977,2020,2020-2021
WI,2020-08-31,intra-total,4774,221,143,128,128,122,111,117,110,4143,1147,11144,5921,6142,FALSE,0.551148600143575,2020,2020-2021
WI,2020-08-31,intra-ucfe,1,1,1,0,0,2,0,0,1,11,1,18,2,3,FALSE,0.166666666666667,2020,2020-2021
WI,2020-08-31,intra-ucx,8,2,1,0,0,0,0,0,0,3,2,16,10,12,FALSE,0.75,2020,2020-2021
WI,2020-08-31,intra-ui,4765,218,141,128,128,120,111,117,109,4129,1144,11110,5909,6127,FALSE,0.551485148514852,2020,2020-2021
WI,2020-09-30,inter-total,66,9,11,7,1,2,3,3,4,122,25,253,91,100,FALSE,0.395256916996047,2020,2020-2021
WI,2020-09-30,inter-ucfe,0,0,0,1,0,0,0,0,0,0,0,1,0,0,FALSE,0,2020,2020-2021
WI,2020-09-30,inter-ucx,0,0,0,0,0,0,0,0,0,0,0,0,0,0,FALSE,0,2020,2020-2021
WI,2020-09-30,inter-ui,66,9,11,6,1,2,3,3,4,122,25,252,91,100,FALSE,0.396825396825397,2020,2020-2021
WI,2020-09-30,intra-total,4157,276,216,193,162,122,90,87,96,3621,987,10007,5144,5420,FALSE,0.541620865394224,2020,2020-2021
WI,2020-09-30,intra-ucfe,1,1,1,1,1,0,0,0,0,1,1,7,2,3,FALSE,0.428571428571429,2020,2020-2021
WI,2020-09-30,intra-ucx,3,0,0,1,0,0,1,0,0,1,1,7,4,4,FALSE,0.571428571428571,2020,2020-2021
WI,2020-09-30,intra-ui,4153,275,215,191,161,122,89,87,96,3619,985,9993,5138,5413,FALSE,0.541679175422796,2020,2020-2021
WI,2020-10-31,inter-total,73,14,2,6,5,6,5,4,2,107,36,260,109,123,FALSE,0.473076923076923,2020,2020-2021
WI,2020-10-31,inter-ucfe,0,0,0,0,0,0,0,0,0,0,1,1,1,1,FALSE,1,2020,2020-2021
WI,2020-10-31,inter-ucx,0,0,0,0,0,0,0,0,0,0,0,0,0,0,FALSE,0,2020,2020-2021
WI,2020-10-31,inter-ui,73,14,2,6,5,6,5,4,2,107,35,259,108,122,FALSE,0.471042471042471,2020,2020-2021
WI,2020-10-31,intra-total,4683,268,183,179,134,138,132,153,95,3219,1065,10249,5748,6016,FALSE,0.586984096009367,2020,2020-2021
WI,2020-10-31,intra-ucfe,3,0,1,0,0,1,0,0,0,6,3,14,6,6,FALSE,0.428571428571429,2020,2020-2021
WI,2020-10-31,intra-ucx,4,2,0,0,0,1,0,0,0,1,3,11,7,9,FALSE,0.818181818181818,2020,2020-2021
WI,2020-10-31,intra-ui,4676,266,182,179,134,136,132,153,95,3212,1059,10224,5735,6001,FALSE,0.586952269170579,2020,2020-2021
WI,2020-11-30,inter-total,146,12,9,10,3,2,1,2,1,78,44,308,190,202,FALSE,0.655844155844156,2020,2020-2021
WI,2020-11-30,inter-ucfe,0,0,0,0,0,0,0,0,0,0,0,0,0,0,FALSE,0,2020,2020-2021
WI,2020-11-30,inter-ucx,0,0,0,0,0,0,0,0,0,0,0,0,0,0,FALSE,0,2020,2020-2021
WI,2020-11-30,inter-ui,146,12,9,10,3,2,1,2,1,78,44,308,190,202,FALSE,0.655844155844156,2020,2020-2021
WI,2020-11-30,intra-total,7420,375,270,264,304,316,262,181,141,2672,1471,13676,8891,9266,FALSE,0.677537291605733,2020,2020-2021
WI,2020-11-30,intra-ucfe,5,6,3,1,1,1,2,1,0,10,7,37,12,18,FALSE,0.486486486486487,2020,2020-2021
WI,2020-11-30,intra-ucx,1,0,0,0,1,2,0,0,1,3,1,9,2,2,FALSE,0.222222222222222,2020,2020-2021
WI,2020-11-30,intra-ui,7414,369,267,263,302,313,260,180,140,2659,1463,13630,8877,9246,FALSE,0.678356566397652,2020,2020-2021
WI,2020-12-31,inter-total,289,33,23,14,26,18,14,7,15,276,78,793,367,400,FALSE,0.504413619167718,2020,2020-2021
WI,2020-12-31,inter-ucfe,0,0,0,2,0,2,0,0,0,1,2,7,2,2,FALSE,0.285714285714286,2020,2020-2021
WI,2020-12-31,inter-ucx,0,0,0,0,0,0,0,0,0,2,0,2,0,0,FALSE,0,2020,2020-2021
WI,2020-12-31,inter-ui,289,33,23,12,26,16,14,7,15,273,76,784,365,398,FALSE,0.50765306122449,2020,2020-2021
WI,2020-12-31,intra-total,13212,1778,1434,1111,978,937,752,733,630,9588,4395,35548,17607,19385,FALSE,0.545319005288624,2020,2020-2021
WI,2020-12-31,intra-ucfe,10,8,4,9,4,4,7,7,2,33,18,106,28,36,FALSE,0.339622641509434,2020,2020-2021
WI,2020-12-31,intra-ucx,0,2,3,4,3,2,2,1,2,10,2,31,2,4,FALSE,0.129032258064516,2020,2020-2021
WI,2020-12-31,intra-ui,13202,1768,1427,1098,971,931,743,725,626,9545,4375,35411,17577,19345,FALSE,0.546299172573494,2020,2020-2021
WI,2021-01-31,inter-total,301,50,14,12,12,14,9,4,9,96,93,614,394,444,FALSE,0.723127035830619,2020,2020-2021
WI,2021-01-31,inter-ucfe,0,0,0,0,0,0,0,0,0,0,1,1,1,1,FALSE,1,2020,2020-2021
WI,2021-01-31,inter-ucx,0,0,0,0,0,0,0,0,0,0,0,0,0,0,FALSE,0,2020,2020-2021
WI,2021-01-31,inter-ui,301,50,14,12,12,14,9,4,9,96,92,613,393,443,FALSE,0.722675367047308,2020,2020-2021
WI,2021-01-31,intra-total,9281,976,702,547,421,344,265,272,222,2642,2422,18094,11703,12679,FALSE,0.700729523598983,2020,2020-2021
WI,2021-01-31,intra-ucfe,3,8,4,4,3,4,2,1,1,11,3,44,6,14,FALSE,0.318181818181818,2020,2020-2021
WI,2021-01-31,intra-ucx,4,1,2,4,1,1,1,1,0,8,5,28,9,10,FALSE,0.357142857142857,2020,2020-2021
WI,2021-01-31,intra-ui,9274,967,696,539,417,339,262,270,221,2623,2414,18022,11688,12655,FALSE,0.702197314393519,2020,2020-2021
WI,2021-02-28,inter-total,72,20,16,8,7,9,9,5,7,75,29,257,101,121,FALSE,0.470817120622568,2020,2020-2021
WI,2021-02-28,inter-ucfe,0,1,0,0,1,0,0,0,1,0,0,3,0,1,FALSE,0.333333333333333,2020,2020-2021
WI,2021-02-28,inter-ucx,0,0,0,0,0,0,0,0,0,0,0,0,0,0,FALSE,0,2020,2020-2021
WI,2021-02-28,inter-ui,72,19,16,8,6,9,9,5,6,75,29,254,101,120,FALSE,0.47244094488189,2020,2020-2021
WI,2021-02-28,intra-total,3127,343,241,181,242,226,154,146,139,1633,864,7296,3991,4334,FALSE,0.594024122807018,2020,2020-2021
WI,2021-02-28,intra-ucfe,2,0,4,1,3,0,2,0,0,18,2,32,4,4,FALSE,0.125,2020,2020-2021
WI,2021-02-28,intra-ucx,0,0,1,0,1,0,0,0,0,3,2,7,2,2,FALSE,0.285714285714286,2020,2020-2021
WI,2021-02-28,intra-ui,3125,343,236,180,238,226,152,146,139,1612,860,7257,3985,4328,FALSE,0.596389692710487,2020,2020-2021
WI,2021-03-31,inter-total,51,12,7,4,7,1,1,1,3,69,18,174,69,81,FALSE,0.46551724137931,2020,2020-2021
WI,2021-03-31,inter-ucfe,0,0,0,0,0,0,0,0,0,0,0,0,0,0,FALSE,0,2020,2020-2021
WI,2021-03-31,inter-ucx,0,0,0,0,0,0,0,0,0,0,0,0,0,0,FALSE,0,2020,2020-2021
WI,2021-03-31,inter-ui,51,12,7,4,7,1,1,1,3,69,18,174,69,81,FALSE,0.46551724137931,2020,2020-2021
WI,2021-03-31,intra-total,3076,884,159,118,84,76,58,41,66,1142,818,6522,3894,4778,FALSE,0.732597362772156,2020,2020-2021
WI,2021-03-31,intra-ucfe,4,2,2,3,0,1,0,0,0,8,1,21,5,7,FALSE,0.333333333333333,2020,2020-2021
WI,2021-03-31,intra-ucx,0,0,0,0,0,0,0,0,0,0,0,0,0,0,FALSE,0,2020,2020-2021
WI,2021-03-31,intra-ui,3072,882,157,115,84,75,58,41,66,1134,817,6501,3889,4771,FALSE,0.733887094293186,2020,2020-2021
WI,2021-04-30,inter-total,78,3,2,2,1,1,0,2,1,92,11,193,89,92,FALSE,0.476683937823834,2020,2020-2021
WI,2021-04-30,inter-ucfe,0,0,0,0,0,0,0,0,0,0,0,0,0,0,FALSE,0,2020,2020-2021
WI,2021-04-30,inter-ucx,0,0,0,0,0,0,0,0,0,0,0,0,0,0,FALSE,0,2020,2020-2021
WI,2021-04-30,inter-ui,78,3,2,2,1,1,0,2,1,92,11,193,89,92,FALSE,0.476683937823834,2020,2020-2021
WI,2021-04-30,intra-total,3902,212,158,91,49,63,60,32,34,1022,523,6146,4425,4637,FALSE,0.754474454930036,2020,2020-2021
WI,2021-04-30,intra-ucfe,7,1,2,1,1,0,0,0,0,9,4,25,11,12,FALSE,0.48,2020,2020-2021
WI,2021-04-30,intra-ucx,1,0,0,0,0,0,0,0,0,2,2,5,3,3,FALSE,0.6,2020,2020-2021
WI,2021-04-30,intra-ui,3894,211,156,90,48,63,60,32,34,1011,517,6116,4411,4622,FALSE,0.755722694571615,2020,2020-2021
WI,2021-05-31,inter-total,46,4,8,5,4,2,1,4,1,52,10,137,56,60,FALSE,0.437956204379562,2020,2020-2021
WI,2021-05-31,inter-ucfe,0,0,0,0,0,0,0,1,0,0,0,1,0,0,FALSE,0,2020,2020-2021
WI,2021-05-31,inter-ucx,1,0,0,0,0,0,0,0,0,0,0,1,1,1,FALSE,1,2020,2020-2021
WI,2021-05-31,inter-ui,45,4,8,5,4,2,1,3,1,52,10,135,55,59,FALSE,0.437037037037037,2020,2020-2021
WI,2021-05-31,intra-total,2253,221,177,150,130,96,67,44,30,859,417,4444,2670,2891,FALSE,0.650540054005401,2020,2020-2021
WI,2021-05-31,intra-ucfe,4,2,1,1,0,0,0,0,0,8,1,17,5,7,FALSE,0.411764705882353,2020,2020-2021
WI,2021-05-31,intra-ucx,2,1,0,0,0,0,0,0,0,2,0,5,2,3,FALSE,0.6,2020,2020-2021
WI,2021-05-31,intra-ui,2247,218,176,149,130,96,67,44,30,849,416,4422,2663,2881,FALSE,0.651515151515152,2020,2020-2021
WI,2021-06-30,inter-total,10,4,3,6,1,2,2,4,0,43,5,80,15,19,FALSE,0.2375,2020,2020-2021
WI,2021-06-30,inter-ucfe,0,0,0,0,0,1,0,0,0,0,0,1,0,0,FALSE,0,2020,2020-2021
WI,2021-06-30,inter-ucx,0,0,0,0,0,0,0,0,0,0,0,0,0,0,FALSE,0,2020,2020-2021
WI,2021-06-30,inter-ui,10,4,3,6,1,1,2,4,0,43,5,79,15,19,FALSE,0.240506329113924,2020,2020-2021
WI,2021-06-30,intra-total,2219,141,96,84,73,65,57,41,38,664,299,3777,2518,2659,FALSE,0.703997881916865,2020,2020-2021
WI,2021-06-30,intra-ucfe,3,0,1,0,0,0,0,1,0,2,0,7,3,3,FALSE,0.428571428571429,2020,2020-2021
WI,2021-06-30,intra-ucx,1,0,0,1,0,0,0,0,0,1,0,3,1,1,FALSE,0.333333333333333,2020,2020-2021
WI,2021-06-30,intra-ui,2215,141,95,83,73,65,57,40,38,661,299,3767,2514,2655,FALSE,0.704804884523494,2020,2020-2021
WI,2021-07-31,inter-total,23,2,5,2,1,4,5,4,0,51,9,106,32,34,FALSE,0.320754716981132,2021,2021-2022
WI,2021-07-31,inter-ucfe,0,0,0,0,1,0,0,0,0,0,0,1,0,0,FALSE,0,2021,2021-2022
WI,2021-07-31,inter-ucx,0,0,0,0,0,0,0,0,0,0,0,0,0,0,FALSE,0,2021,2021-2022
WI,2021-07-31,inter-ui,23,2,5,2,0,4,5,4,0,51,9,105,32,34,FALSE,0.323809523809524,2021,2021-2022
WI,2021-07-31,intra-total,1881,140,73,73,68,48,44,27,35,762,320,3471,2201,2341,FALSE,0.674445404782483,2021,2021-2022
WI,2021-07-31,intra-ucfe,4,1,0,1,0,0,0,0,0,2,2,10,6,7,FALSE,0.7,2021,2021-2022
WI,2021-07-31,intra-ucx,1,1,0,0,0,0,0,0,0,0,1,3,2,3,FALSE,1,2021,2021-2022
WI,2021-07-31,intra-ui,1876,138,73,72,68,48,44,27,35,760,317,3458,2193,2331,FALSE,0.674089068825911,2021,2021-2022
WI,2021-08-31,inter-total,18,5,1,4,0,1,0,0,1,40,5,75,23,28,FALSE,0.373333333333333,2021,2021-2022
WI,2021-08-31,inter-ucfe,0,0,0,0,0,0,0,0,0,0,0,0,0,0,FALSE,0,2021,2021-2022
WI,2021-08-31,inter-ucx,0,0,0,0,0,0,0,0,0,0,0,0,0,0,FALSE,0,2021,2021-2022
WI,2021-08-31,inter-ui,18,5,1,4,0,1,0,0,1,40,5,75,23,28,FALSE,0.373333333333333,2021,2021-2022
WI,2021-08-31,intra-total,1902,145,81,76,55,30,20,31,23,557,236,3156,2138,2283,FALSE,0.723384030418251,2021,2021-2022
WI,2021-08-31,intra-ucfe,2,0,0,0,0,0,1,0,0,3,2,8,4,4,FALSE,0.5,2021,2021-2022
WI,2021-08-31,intra-ucx,0,0,0,1,0,0,0,0,0,1,1,3,1,1,FALSE,0.333333333333333,2021,2021-2022
WI,2021-08-31,intra-ui,1900,145,81,75,55,30,19,31,23,553,233,3145,2133,2278,FALSE,0.724324324324324,2021,2021-2022
WI,2021-09-30,inter-total,20,2,0,2,5,1,0,0,1,24,8,63,28,30,FALSE,0.476190476190476,2021,2021-2022
WI,2021-09-30,inter-ucfe,0,0,0,0,0,0,0,0,0,0,0,0,0,0,FALSE,0,2021,2021-2022
WI,2021-09-30,inter-ucx,0,0,0,0,0,0,0,0,0,0,0,0,0,0,FALSE,0,2021,2021-2022
WI,2021-09-30,inter-ui,20,2,0,2,5,1,0,0,1,24,8,63,28,30,FALSE,0.476190476190476,2021,2021-2022
WI,2021-09-30,intra-total,2793,211,125,93,65,36,29,21,13,342,399,4127,3192,3403,FALSE,0.824569905500363,2021,2021-2022
WI,2021-09-30,intra-ucfe,1,0,0,3,1,0,1,0,0,0,1,7,2,2,FALSE,0.285714285714286,2021,2021-2022
WI,2021-09-30,intra-ucx,1,0,1,0,0,0,0,0,1,3,1,7,2,2,FALSE,0.285714285714286,2021,2021-2022
WI,2021-09-30,intra-ui,2791,211,124,90,64,36,28,21,12,339,397,4113,3188,3399,FALSE,0.826404084609774,2021,2021-2022
WI,2021-10-31,inter-total,23,5,7,5,0,1,1,0,0,22,10,74,33,38,FALSE,0.513513513513514,2021,2021-2022
WI,2021-10-31,inter-ucfe,0,0,0,0,0,0,0,0,0,0,1,1,1,1,FALSE,1,2021,2021-2022
WI,2021-10-31,inter-ucx,0,0,0,0,0,0,0,0,0,0,0,0,0,0,FALSE,0,2021,2021-2022
WI,2021-10-31,inter-ui,23,5,7,5,0,1,1,0,0,22,9,73,32,37,FALSE,0.506849315068493,2021,2021-2022
WI,2021-10-31,intra-total,2595,357,232,130,63,46,25,20,19,293,581,4361,3176,3533,FALSE,0.810135290071085,2021,2021-2022
WI,2021-10-31,intra-ucfe,5,0,3,0,1,0,0,0,0,1,1,11,6,6,FALSE,0.545454545454545,2021,2021-2022
WI,2021-10-31,intra-ucx,1,0,0,0,0,0,0,0,0,0,1,2,2,2,FALSE,1,2021,2021-2022
WI,2021-10-31,intra-ui,2589,357,229,130,62,46,25,20,19,292,579,4348,3168,3525,FALSE,0.810717571297148,2021,2021-2022
WI,2021-11-30,inter-total,115,11,5,2,8,0,2,2,0,26,20,191,135,146,FALSE,0.764397905759162,2021,2021-2022
WI,2021-11-30,inter-ucfe,0,0,0,0,0,0,0,0,0,0,0,0,0,0,FALSE,0,2021,2021-2022
WI,2021-11-30,inter-ucx,0,0,0,0,0,0,0,0,0,0,0,0,0,0,FALSE,0,2021,2021-2022
WI,2021-11-30,inter-ui,115,11,5,2,8,0,2,2,0,26,20,191,135,146,FALSE,0.764397905759162,2021,2021-2022
WI,2021-11-30,intra-total,4896,373,223,159,102,60,73,42,29,308,657,6922,5553,5926,FALSE,0.856110950592314,2021,2021-2022
WI,2021-11-30,intra-ucfe,12,2,0,0,1,0,0,0,1,2,2,20,14,16,FALSE,0.8,2021,2021-2022
WI,2021-11-30,intra-ucx,3,1,0,0,0,0,0,0,0,0,2,6,5,6,FALSE,1,2021,2021-2022
WI,2021-11-30,intra-ui,4881,370,223,159,101,60,73,42,28,306,653,6896,5534,5904,FALSE,0.85614849187935,2021,2021-2022
WI,2021-12-31,inter-total,203,18,8,5,4,6,3,4,2,18,32,303,235,253,FALSE,0.834983498349835,2021,2021-2022
WI,2021-12-31,inter-ucfe,1,1,0,0,0,0,0,1,0,1,0,4,1,2,FALSE,0.5,2021,2021-2022
WI,2021-12-31,inter-ucx,0,0,0,0,0,0,0,0,0,0,0,0,0,0,FALSE,0,2021,2021-2022
WI,2021-12-31,inter-ui,202,17,8,5,4,6,3,3,2,17,32,299,234,251,FALSE,0.839464882943144,2021,2021-2022
WI,2021-12-31,intra-total,8729,440,254,127,103,75,49,33,23,349,1215,11397,9944,10384,FALSE,0.911116960603668,2021,2021-2022
WI,2021-12-31,intra-ucfe,22,1,3,1,1,0,1,0,1,4,14,48,36,37,FALSE,0.770833333333333,2021,2021-2022
WI,2021-12-31,intra-ucx,1,0,1,0,0,2,0,0,0,0,0,4,1,1,FALSE,0.25,2021,2021-2022
WI,2021-12-31,intra-ui,8706,439,250,126,102,73,48,33,22,345,1201,11345,9907,10346,FALSE,0.911943587483473,2021,2021-2022
WI,2022-01-31,inter-total,440,25,13,11,5,5,8,5,2,20,74,608,514,539,FALSE,0.886513157894737,2021,2021-2022
WI,2022-01-31,inter-ucfe,0,1,0,0,0,0,0,0,0,0,0,1,0,1,FALSE,1,2021,2021-2022
WI,2022-01-31,inter-ucx,0,0,0,0,0,0,0,0,0,0,0,0,0,0,FALSE,0,2021,2021-2022
WI,2022-01-31,inter-ui,440,24,13,11,5,5,8,5,2,20,74,607,514,538,FALSE,0.886326194398682,2021,2021-2022
WI,2022-01-31,intra-total,11808,556,265,166,105,76,56,40,24,362,1756,15214,13564,14120,FALSE,0.928092546338898,2021,2021-2022
WI,2022-01-31,intra-ucfe,13,2,1,1,1,1,2,1,0,1,3,26,16,18,FALSE,0.692307692307692,2021,2021-2022
WI,2022-01-31,intra-ucx,3,1,0,0,0,0,1,0,0,2,4,11,7,8,FALSE,0.727272727272727,2021,2021-2022
WI,2022-01-31,intra-ui,11792,553,264,165,104,75,53,39,24,359,1749,15177,13541,14094,FALSE,0.928642024115438,2021,2021-2022
WI,2022-02-28,inter-total,281,73,22,19,6,2,6,5,7,29,112,562,393,466,FALSE,0.829181494661922,2021,2021-2022
WI,2022-02-28,inter-ucfe,3,0,0,0,0,0,0,0,0,1,0,4,3,3,FALSE,0.75,2021,2021-2022
WI,2022-02-28,inter-ucx,0,0,0,0,0,0,0,0,0,0,0,0,0,0,FALSE,0,2021,2021-2022
WI,2022-02-28,inter-ui,278,73,22,19,6,2,6,5,7,28,112,558,390,463,FALSE,0.829749103942652,2021,2021-2022
WI,2022-02-28,intra-total,5798,480,234,166,89,71,62,53,48,535,1620,9156,7418,7898,FALSE,0.86260375709917,2021,2021-2022
WI,2022-02-28,intra-ucfe,9,2,2,6,1,0,0,1,1,2,3,27,12,14,FALSE,0.518518518518519,2021,2021-2022
WI,2022-02-28,intra-ucx,2,0,0,0,2,0,0,0,0,0,0,4,2,2,FALSE,0.5,2021,2021-2022
WI,2022-02-28,intra-ui,5787,478,232,160,86,71,62,52,47,533,1617,9125,7404,7882,FALSE,0.863780821917808,2021,2021-2022
WI,2022-03-31,inter-total,141,22,10,11,14,16,7,9,5,33,48,316,189,211,FALSE,0.667721518987342,2021,2021-2022
WI,2022-03-31,inter-ucfe,0,0,0,0,0,0,0,0,0,0,0,0,0,0,FALSE,0,2021,2021-2022
WI,2022-03-31,inter-ucx,0,0,0,0,0,0,0,0,0,0,0,0,0,0,FALSE,0,2021,2021-2022
WI,2022-03-31,inter-ui,141,22,10,11,14,16,7,9,5,33,48,316,189,211,FALSE,0.667721518987342,2021,2021-2022
WI,2022-03-31,intra-total,4248,318,137,82,73,67,70,83,61,444,1283,6866,5531,5849,FALSE,0.851878823186717,2021,2021-2022
WI,2022-03-31,intra-ucfe,11,2,0,2,0,0,0,0,0,4,5,24,16,18,FALSE,0.75,2021,2021-2022
WI,2022-03-31,intra-ucx,2,0,1,0,0,0,0,0,0,2,0,5,2,2,FALSE,0.4,2021,2021-2022
WI,2022-03-31,intra-ui,4235,316,136,80,73,67,70,83,61,438,1278,6837,5513,5829,FALSE,0.852566915313734,2021,2021-2022
WI,2022-04-30,inter-total,100,14,3,2,2,4,5,5,3,35,30,203,130,144,FALSE,0.70935960591133,2021,2021-2022
WI,2022-04-30,inter-ucfe,0,0,0,0,0,0,0,0,0,0,0,0,0,0,FALSE,0,2021,2021-2022
WI,2022-04-30,inter-ucx,0,0,0,0,0,0,0,0,0,0,0,0,0,0,FALSE,0,2021,2021-2022
WI,2022-04-30,inter-ui,100,14,3,2,2,4,5,5,3,35,30,203,130,144,FALSE,0.70935960591133,2021,2021-2022
WI,2022-04-30,intra-total,2994,301,126,78,41,39,46,37,42,366,1036,5106,4030,4331,FALSE,0.848217783000392,2021,2021-2022
WI,2022-04-30,intra-ucfe,4,0,0,0,0,1,0,0,0,4,2,11,6,6,FALSE,0.545454545454545,2021,2021-2022
WI,2022-04-30,intra-ucx,1,0,0,0,0,0,0,0,1,1,1,4,2,2,FALSE,0.5,2021,2021-2022
WI,2022-04-30,intra-ui,2989,301,126,78,41,38,46,37,41,361,1033,5091,4022,4323,FALSE,0.849145550972304,2021,2021-2022
WI,2022-05-31,inter-total,67,11,4,3,1,3,1,3,4,24,21,142,88,99,FALSE,0.697183098591549,2021,2021-2022
WI,2022-05-31,inter-ucfe,0,0,0,0,0,0,0,0,0,0,0,0,0,0,FALSE,0,2021,2021-2022
WI,2022-05-31,inter-ucx,0,0,0,0,0,0,0,0,0,0,0,0,0,0,FALSE,0,2021,2021-2022
WI,2022-05-31,inter-ui,67,11,4,3,1,3,1,3,4,24,21,142,88,99,FALSE,0.697183098591549,2021,2021-2022
WI,2022-05-31,intra-total,2163,278,130,79,49,46,40,41,26,327,823,4002,2986,3264,FALSE,0.815592203898051,2021,2021-2022
WI,2022-05-31,intra-ucfe,2,1,0,0,1,0,0,0,0,3,2,9,4,5,FALSE,0.555555555555556,2021,2021-2022
WI,2022-05-31,intra-ucx,1,0,0,0,0,0,0,0,0,0,1,2,2,2,FALSE,1,2021,2021-2022
WI,2022-05-31,intra-ui,2160,277,130,79,48,46,40,41,26,324,820,3991,2980,3257,FALSE,0.816086193936357,2021,2021-2022
WI,2022-06-30,inter-total,47,6,4,5,2,1,4,2,3,16,14,104,61,67,FALSE,0.644230769230769,2021,2021-2022
WI,2022-06-30,inter-ucfe,0,0,0,0,0,0,0,0,0,0,0,0,0,0,FALSE,0,2021,2021-2022
WI,2022-06-30,inter-ucx,0,0,0,0,0,0,0,0,0,0,0,0,0,0,FALSE,0,2021,2021-2022
WI,2022-06-30,inter-ui,47,6,4,5,2,1,4,2,3,16,14,104,61,67,FALSE,0.644230769230769,2021,2021-2022
WI,2022-06-30,intra-total,4131,285,139,84,69,57,45,43,28,241,1060,6182,5191,5476,FALSE,0.885797476544808,2021,2021-2022
WI,2022-06-30,intra-ucfe,1,0,2,1,0,1,1,0,0,0,2,8,3,3,FALSE,0.375,2021,2021-2022
WI,2022-06-30,intra-ucx,1,0,0,0,0,0,0,0,0,0,1,2,2,2,FALSE,1,2021,2021-2022
WI,2022-06-30,intra-ui,4129,285,137,83,69,56,44,43,28,241,1057,6172,5186,5471,FALSE,0.886422553467271,2021,2021-2022
WI,2022-07-31,inter-total,39,7,5,5,2,3,2,2,0,12,17,94,56,63,FALSE,0.670212765957447,2022,2022-2023
WI,2022-07-31,inter-ucfe,0,0,0,0,0,0,0,0,0,1,0,1,0,0,FALSE,0,2022,2022-2023
WI,2022-07-31,inter-ucx,0,0,0,0,0,0,0,0,0,0,0,0,0,0,FALSE,0,2022,2022-2023
WI,2022-07-31,inter-ui,39,7,5,5,2,3,2,2,0,11,17,93,56,63,FALSE,0.67741935483871,2022,2022-2023
WI,2022-07-31,intra-total,3542,352,155,89,77,55,51,18,17,121,1211,5688,4753,5105,FALSE,0.897503516174402,2022,2022-2023
WI,2022-07-31,intra-ucfe,3,1,0,3,1,0,0,0,0,1,0,9,3,4,FALSE,0.444444444444444,2022,2022-2023
WI,2022-07-31,intra-ucx,3,0,1,0,0,0,0,1,0,0,0,5,3,3,FALSE,0.6,2022,2022-2023
WI,2022-07-31,intra-ui,3536,351,154,86,76,55,51,17,17,120,1211,5674,4747,5098,FALSE,0.898484314416637,2022,2022-2023
WI,2022-08-31,inter-total,47,7,6,6,3,0,1,1,1,12,13,97,60,67,FALSE,0.690721649484536,2022,2022-2023
WI,2022-08-31,inter-ucfe,0,0,0,0,0,0,0,0,0,0,0,0,0,0,FALSE,0,2022,2022-2023
WI,2022-08-31,inter-ucx,0,0,0,0,0,0,0,0,0,0,0,0,0,0,FALSE,0,2022,2022-2023
WI,2022-08-31,inter-ui,47,7,6,6,3,0,1,1,1,12,13,97,60,67,FALSE,0.690721649484536,2022,2022-2023
WI,2022-08-31,intra-total,3001,322,154,85,87,47,28,19,24,255,1010,5032,4011,4333,FALSE,0.861089030206677,2022,2022-2023
WI,2022-08-31,intra-ucfe,4,0,1,1,1,1,0,2,0,3,4,17,8,8,FALSE,0.470588235294118,2022,2022-2023
WI,2022-08-31,intra-ucx,2,0,0,0,0,0,0,0,0,0,0,2,2,2,FALSE,1,2022,2022-2023
WI,2022-08-31,intra-ui,2995,322,153,84,86,46,28,17,24,252,1006,5013,4001,4323,FALSE,0.862357869539198,2022,2022-2023
WI,2022-09-30,inter-total,42,8,5,3,1,1,3,0,0,10,12,85,54,62,FALSE,0.729411764705882,2022,2022-2023
WI,2022-09-30,inter-ucfe,0,0,0,0,0,0,0,0,0,0,0,0,0,0,FALSE,0,2022,2022-2023
WI,2022-09-30,inter-ucx,0,0,0,0,0,0,0,0,0,0,0,0,0,0,FALSE,0,2022,2022-2023
WI,2022-09-30,inter-ui,42,8,5,3,1,1,3,0,0,10,12,85,54,62,FALSE,0.729411764705882,2022,2022-2023
WI,2022-09-30,intra-total,2038,284,149,90,77,64,28,19,17,148,730,3644,2768,3052,FALSE,0.837541163556531,2022,2022-2023
WI,2022-09-30,intra-ucfe,2,0,0,0,1,0,1,0,1,2,1,8,3,3,FALSE,0.375,2022,2022-2023
WI,2022-09-30,intra-ucx,2,0,0,0,0,0,0,0,0,0,0,2,2,2,FALSE,1,2022,2022-2023
WI,2022-09-30,intra-ui,2034,284,149,90,76,64,27,19,16,146,729,3634,2763,3047,FALSE,0.838470005503577,2022,2022-2023
WI,2022-10-31,inter-total,49,8,6,1,3,3,2,3,2,12,16,105,65,73,FALSE,0.695238095238095,2022,2022-2023
WI,2022-10-31,inter-ucfe,0,0,0,0,0,0,0,0,0,0,0,0,0,0,FALSE,0,2022,2022-2023
WI,2022-10-31,inter-ucx,0,0,0,0,0,0,0,0,0,0,0,0,0,0,FALSE,0,2022,2022-2023
WI,2022-10-31,inter-ui,49,8,6,1,3,3,2,3,2,12,16,105,65,73,FALSE,0.695238095238095,2022,2022-2023
WI,2022-10-31,intra-total,2261,204,121,64,54,52,33,18,17,104,680,3608,2941,3145,FALSE,0.871674057649667,2022,2022-2023
WI,2022-10-31,intra-ucfe,5,1,0,0,0,0,0,0,1,0,4,11,9,10,FALSE,0.909090909090909,2022,2022-2023
WI,2022-10-31,intra-ucx,3,0,0,0,0,1,0,0,0,0,0,4,3,3,FALSE,0.75,2022,2022-2023
WI,2022-10-31,intra-ui,2253,203,121,64,54,51,33,18,16,104,676,3593,2929,3132,FALSE,0.871694962426941,2022,2022-2023
WI,2022-11-30,inter-total,123,14,5,5,4,7,4,3,0,5,43,213,166,180,FALSE,0.845070422535211,2022,2022-2023
WI,2022-11-30,inter-ucfe,0,0,0,0,0,1,0,0,0,0,2,3,2,2,FALSE,0.666666666666667,2022,2022-2023
WI,2022-11-30,inter-ucx,0,0,0,0,0,0,0,0,0,0,0,0,0,0,FALSE,0,2022,2022-2023
WI,2022-11-30,inter-ui,123,14,5,5,4,6,4,3,0,5,41,210,164,178,FALSE,0.847619047619048,2022,2022-2023
WI,2022-11-30,intra-total,3917,287,141,85,56,43,33,12,9,98,946,5627,4863,5150,FALSE,0.915230140394526,2022,2022-2023
WI,2022-11-30,intra-ucfe,9,2,1,0,1,1,0,0,0,0,2,16,11,13,FALSE,0.8125,2022,2022-2023
WI,2022-11-30,intra-ucx,3,1,0,0,0,0,0,0,0,0,3,7,6,7,FALSE,1,2022,2022-2023
WI,2022-11-30,intra-ui,3905,284,140,85,55,42,33,12,9,98,941,5604,4846,5130,FALSE,0.91541755888651,2022,2022-2023
WI,2022-12-31,inter-total,244,20,17,8,3,2,2,0,0,5,49,350,293,313,FALSE,0.894285714285714,2022,2022-2023
WI,2022-12-31,inter-ucfe,0,1,0,0,0,0,0,0,0,0,0,1,0,1,FALSE,1,2022,2022-2023
WI,2022-12-31,inter-ucx,0,0,0,0,0,0,0,0,0,0,0,0,0,0,FALSE,0,2022,2022-2023
WI,2022-12-31,inter-ui,244,19,17,8,3,2,2,0,0,5,49,349,293,312,FALSE,0.893982808022923,2022,2022-2023
WI,2022-12-31,intra-total,7518,435,210,99,62,50,37,21,15,94,1783,10324,9301,9736,FALSE,0.943045331266951,2022,2022-2023
WI,2022-12-31,intra-ucfe,10,3,1,0,1,0,2,0,0,1,7,25,17,20,FALSE,0.8,2022,2022-2023
WI,2022-12-31,intra-ucx,2,0,1,0,0,0,1,0,0,1,0,5,2,2,FALSE,0.4,2022,2022-2023
WI,2022-12-31,intra-ui,7506,432,208,99,61,50,34,21,15,92,1776,10294,9282,9714,FALSE,0.943656498931416,2022,2022-2023
WI,2023-01-31,inter-total,555,14,15,6,6,5,2,6,2,7,107,725,662,676,FALSE,0.932413793103448,2022,2022-2023
WI,2023-01-31,inter-ucfe,0,0,0,0,0,0,0,0,0,0,0,0,0,0,FALSE,0,2022,2022-2023
WI,2023-01-31,inter-ucx,0,0,0,0,0,0,0,0,0,0,0,0,0,0,FALSE,0,2022,2022-2023
WI,2023-01-31,inter-ui,555,14,15,6,6,5,2,6,2,7,107,725,662,676,FALSE,0.932413793103448,2022,2022-2023
WI,2023-01-31,intra-total,11053,754,294,148,110,67,51,33,20,83,2717,15330,13770,14524,FALSE,0.947423352902805,2022,2022-2023
WI,2023-01-31,intra-ucfe,19,1,1,0,1,0,0,0,0,1,8,31,27,28,FALSE,0.903225806451613,2022,2022-2023
WI,2023-01-31,intra-ucx,1,3,0,1,0,0,0,0,0,0,1,6,2,5,FALSE,0.833333333333333,2022,2022-2023
WI,2023-01-31,intra-ui,11033,750,293,147,109,67,51,33,20,82,2708,15293,13741,14491,FALSE,0.947557706140064,2022,2022-2023
WI,2023-02-28,inter-total,344,77,35,17,10,3,5,1,1,5,122,620,466,543,FALSE,0.875806451612903,2022,2022-2023
WI,2023-02-28,inter-ucfe,2,1,0,0,0,0,0,0,0,0,0,3,2,3,FALSE,1,2022,2022-2023
WI,2023-02-28,inter-ucx,0,0,0,0,0,0,0,0,0,0,0,0,0,0,FALSE,0,2022,2022-2023
WI,2023-02-28,inter-ui,342,76,35,17,10,3,5,1,1,5,122,617,464,540,FALSE,0.875202593192869,2022,2022-2023
WI,2023-02-28,intra-total,5808,667,316,178,152,81,55,34,20,89,1965,9365,7773,8440,FALSE,0.901227976508275,2022,2022-2023
WI,2023-02-28,intra-ucfe,11,2,1,0,1,0,1,1,0,1,6,24,17,19,FALSE,0.791666666666667,2022,2022-2023
WI,2023-02-28,intra-ucx,2,0,0,0,0,1,0,0,0,0,1,4,3,3,FALSE,0.75,2022,2022-2023
WI,2023-02-28,intra-ui,5795,665,315,178,151,80,54,33,20,88,1958,9337,7753,8418,FALSE,0.901574381492985,2022,2022-2023
WI,2023-03-31,inter-total,167,20,15,13,6,9,7,8,7,17,57,326,224,244,FALSE,0.748466257668712,2022,2022-2023
WI,2023-03-31,inter-ucfe,0,0,0,0,0,0,0,0,0,0,0,0,0,0,FALSE,0,2022,2022-2023
WI,2023-03-31,inter-ucx,0,0,0,0,0,0,0,0,0,0,0,0,0,0,FALSE,0,2022,2022-2023
WI,2023-03-31,inter-ui,167,20,15,13,6,9,7,8,7,17,57,326,224,244,FALSE,0.748466257668712,2022,2022-2023
WI,2023-03-31,intra-total,4261,403,206,132,82,69,57,42,33,109,1506,6900,5767,6170,FALSE,0.894202898550725,2022,2022-2023
WI,2023-03-31,intra-ucfe,7,3,0,2,0,0,0,0,0,2,2,16,9,12,FALSE,0.75,2022,2022-2023
WI,2023-03-31,intra-ucx,1,0,0,0,0,0,0,0,0,0,0,1,1,1,FALSE,1,2022,2022-2023
WI,2023-03-31,intra-ui,4253,400,206,130,82,69,57,42,33,107,1504,6883,5757,6157,FALSE,0.894522737178556,2022,2022-2023
WI,2023-04-30,inter-total,142,13,9,7,6,7,2,0,2,8,40,236,182,195,FALSE,0.826271186440678,2022,2022-2023
WI,2023-04-30,inter-ucfe,0,0,0,0,0,0,0,0,0,0,0,0,0,0,FALSE,0,2022,2022-2023
WI,2023-04-30,inter-ucx,1,0,0,0,0,0,0,0,0,0,0,1,1,1,FALSE,1,2022,2022-2023
WI,2023-04-30,inter-ui,141,13,9,7,6,7,2,0,2,8,40,235,181,194,FALSE,0.825531914893617,2022,2022-2023
WI,2023-04-30,intra-total,3392,310,145,75,59,63,47,32,17,115,1104,5359,4496,4806,FALSE,0.896809106176525,2022,2022-2023
WI,2023-04-30,intra-ucfe,4,2,1,0,0,0,0,0,0,0,4,11,8,10,FALSE,0.909090909090909,2022,2022-2023
WI,2023-04-30,intra-ucx,3,0,0,0,0,0,0,0,0,0,0,3,3,3,FALSE,1,2022,2022-2023
WI,2023-04-30,intra-ui,3385,308,144,75,59,63,47,32,17,115,1100,5345,4485,4793,FALSE,0.896725912067353,2022,2022-2023
WI,2023-05-31,inter-total,126,12,7,6,1,1,0,1,3,9,49,215,175,187,FALSE,0.869767441860465,2022,2022-2023
WI,2023-05-31,inter-ucfe,0,0,0,0,0,0,0,0,0,0,0,0,0,0,FALSE,0,2022,2022-2023
WI,2023-05-31,inter-ucx,0,0,0,0,0,0,0,0,0,0,0,0,0,0,FALSE,0,2022,2022-2023
WI,2023-05-31,inter-ui,126,12,7,6,1,1,0,1,3,9,49,215,175,187,FALSE,0.869767441860465,2022,2022-2023
WI,2023-05-31,intra-total,3148,302,140,71,80,44,31,24,11,94,961,4906,4109,4411,FALSE,0.899103139013453,2022,2022-2023
WI,2023-05-31,intra-ucfe,1,1,1,0,0,0,1,0,0,2,3,9,4,5,FALSE,0.555555555555556,2022,2022-2023
WI,2023-05-31,intra-ucx,2,0,0,0,0,0,0,0,0,0,1,3,3,3,FALSE,1,2022,2022-2023
WI,2023-05-31,intra-ui,3145,301,139,71,80,44,30,24,11,92,957,4894,4102,4403,FALSE,0.89967306906416,2022,2022-2023
WI,2023-06-30,inter-total,70,13,8,5,1,1,3,0,2,5,23,131,93,106,FALSE,0.809160305343512,2022,2022-2023
WI,2023-06-30,inter-ucfe,0,0,0,0,0,0,0,0,0,0,0,0,0,0,FALSE,0,2022,2022-2023
WI,2023-06-30,inter-ucx,1,0,0,0,0,0,0,0,0,0,0,1,1,1,FALSE,1,2022,2022-2023
WI,2023-06-30,inter-ui,69,13,8,5,1,1,3,0,2,5,23,130,92,105,FALSE,0.807692307692308,2022,2022-2023
WI,2023-06-30,intra-total,4650,333,136,108,58,53,41,30,26,76,1079,6590,5729,6062,FALSE,0.919878603945372,2022,2022-2023
WI,2023-06-30,intra-ucfe,2,0,1,1,0,1,0,0,0,1,0,6,2,2,FALSE,0.333333333333333,2022,2022-2023
WI,2023-06-30,intra-ucx,4,0,0,1,0,0,0,0,0,0,0,5,4,4,FALSE,0.8,2022,2022-2023
WI,2023-06-30,intra-ui,4644,333,135,106,58,52,41,30,26,75,1079,6579,5723,6056,FALSE,0.920504635962912,2022,2022-2023
WI,2023-07-31,inter-total,55,10,6,3,0,6,1,2,0,11,23,117,78,88,FALSE,0.752136752136752,2023,2023-2024
WI,2023-07-31,inter-ucfe,0,0,0,0,0,0,0,0,0,1,0,1,0,0,FALSE,0,2023,2023-2024
WI,2023-07-31,inter-ucx,0,0,0,0,0,0,0,0,0,0,0,0,0,0,FALSE,0,2023,2023-2024
WI,2023-07-31,inter-ui,55,10,6,3,0,6,1,2,0,10,23,116,78,88,FALSE,0.758620689655172,2023,2023-2024
WI,2023-07-31,intra-total,4151,452,200,94,55,65,44,21,20,67,1309,6478,5460,5912,FALSE,0.912627354121643,2023,2023-2024
WI,2023-07-31,intra-ucfe,2,0,0,1,0,0,0,0,0,0,2,5,4,4,FALSE,0.8,2023,2023-2024
WI,2023-07-31,intra-ucx,3,0,0,0,0,0,0,0,0,0,0,3,3,3,FALSE,1,2023,2023-2024
WI,2023-07-31,intra-ui,4146,452,200,93,55,65,44,21,20,67,1307,6470,5453,5905,FALSE,0.912673879443586,2023,2023-2024
WI,2023-08-31,inter-total,65,12,7,3,3,5,1,2,1,6,17,122,82,94,FALSE,0.770491803278689,2023,2023-2024
WI,2023-08-31,inter-ucfe,0,0,0,0,0,0,0,0,0,0,0,0,0,0,FALSE,0,2023,2023-2024
WI,2023-08-31,inter-ucx,0,0,0,0,0,0,0,0,0,0,0,0,0,0,FALSE,0,2023,2023-2024
WI,2023-08-31,inter-ui,65,12,7,3,3,5,1,2,1,6,17,122,82,94,FALSE,0.770491803278689,2023,2023-2024
WI,2023-08-31,intra-total,3263,351,156,115,101,57,56,40,25,66,938,5168,4201,4552,FALSE,0.880804953560372,2023,2023-2024
WI,2023-08-31,intra-ucfe,4,2,0,0,0,0,0,0,0,1,1,8,5,7,FALSE,0.875,2023,2023-2024
WI,2023-08-31,intra-ucx,3,0,0,0,0,0,0,0,0,0,0,3,3,3,FALSE,1,2023,2023-2024
WI,2023-08-31,intra-ui,3256,349,156,115,101,57,56,40,25,65,937,5157,4193,4542,FALSE,0.880744618964514,2023,2023-2024
WI,2023-09-30,inter-total,59,12,8,7,0,4,5,2,1,4,13,115,72,84,FALSE,0.730434782608696,2023,2023-2024
WI,2023-09-30,inter-ucfe,0,0,0,1,0,0,0,0,0,0,0,1,0,0,FALSE,0,2023,2023-2024
WI,2023-09-30,inter-ucx,0,0,0,0,0,0,0,0,0,0,0,0,0,0,FALSE,0,2023,2023-2024
WI,2023-09-30,inter-ui,59,12,8,6,0,4,5,2,1,4,13,114,72,84,FALSE,0.736842105263158,2023,2023-2024
WI,2023-09-30,intra-total,2401,283,113,77,68,64,45,38,25,85,785,3984,3186,3469,FALSE,0.870732931726908,2023,2023-2024
WI,2023-09-30,intra-ucfe,3,1,0,2,1,0,0,0,0,0,1,8,4,5,FALSE,0.625,2023,2023-2024
WI,2023-09-30,intra-ucx,1,0,0,0,0,0,0,0,0,0,2,3,3,3,FALSE,1,2023,2023-2024
WI,2023-09-30,intra-ui,2397,282,113,75,67,64,45,38,25,85,782,3973,3179,3461,FALSE,0.871130128366474,2023,2023-2024
WI,2023-10-31,inter-total,88,12,4,3,3,4,1,0,2,4,16,137,104,116,FALSE,0.846715328467153,2023,2023-2024
WI,2023-10-31,inter-ucfe,0,0,0,0,0,0,0,0,0,0,0,0,0,0,FALSE,0,2023,2023-2024
WI,2023-10-31,inter-ucx,1,0,0,0,0,0,0,0,0,0,0,1,1,1,FALSE,1,2023,2023-2024
WI,2023-10-31,inter-ui,87,12,4,3,3,4,1,0,2,4,16,136,103,115,FALSE,0.845588235294118,2023,2023-2024
WI,2023-10-31,intra-total,2870,272,129,70,63,34,32,26,11,68,788,4363,3658,3930,FALSE,0.900756360302544,2023,2023-2024
WI,2023-10-31,intra-ucfe,1,0,2,0,1,1,0,0,0,0,6,11,7,7,FALSE,0.636363636363636,2023,2023-2024
WI,2023-10-31,intra-ucx,2,1,1,0,0,0,0,0,0,0,0,4,2,3,FALSE,0.75,2023,2023-2024
WI,2023-10-31,intra-ui,2867,271,126,70,62,33,32,26,11,68,782,4348,3649,3920,FALSE,0.901563937442502,2023,2023-2024
WI,2023-11-30,inter-total,150,11,6,3,1,3,4,1,1,5,33,218,183,194,FALSE,0.889908256880734,2023,2023-2024
WI,2023-11-30,inter-ucfe,0,0,0,1,0,0,0,0,0,0,0,1,0,0,FALSE,0,2023,2023-2024
WI,2023-11-30,inter-ucx,0,0,0,0,0,0,0,0,0,0,0,0,0,0,FALSE,0,2023,2023-2024
WI,2023-11-30,inter-ui,150,11,6,2,1,3,4,1,1,5,33,217,183,194,FALSE,0.894009216589862,2023,2023-2024
WI,2023-11-30,intra-total,4096,379,165,103,68,42,30,26,15,75,1067,6066,5163,5542,FALSE,0.913616880975931,2023,2023-2024
WI,2023-11-30,intra-ucfe,10,3,2,0,0,1,0,0,0,0,2,18,12,15,FALSE,0.833333333333333,2023,2023-2024
WI,2023-11-30,intra-ucx,1,0,0,0,0,0,0,0,0,0,1,2,2,2,FALSE,1,2023,2023-2024
WI,2023-11-30,intra-ui,4085,376,163,103,68,41,30,26,15,75,1064,6046,5149,5525,FALSE,0.91382732385048,2023,2023-2024
WI,2023-12-31,inter-total,246,20,4,5,8,2,1,3,1,6,46,342,292,312,FALSE,0.912280701754386,2023,2023-2024
WI,2023-12-31,inter-ucfe,0,1,0,0,0,0,0,0,0,0,0,1,0,1,FALSE,1,2023,2023-2024
WI,2023-12-31,inter-ucx,0,0,0,0,0,0,0,0,0,0,0,0,0,0,FALSE,0,2023,2023-2024
WI,2023-12-31,inter-ui,246,19,4,5,8,2,1,3,1,6,46,341,292,311,FALSE,0.912023460410557,2023,2023-2024
WI,2023-12-31,intra-total,7454,385,199,125,61,51,39,17,19,85,1513,9948,8967,9352,FALSE,0.940088459991958,2023,2023-2024
WI,2023-12-31,intra-ucfe,7,0,0,0,2,1,0,0,0,0,4,14,11,11,FALSE,0.785714285714286,2023,2023-2024
WI,2023-12-31,intra-ucx,0,0,1,1,0,0,0,0,1,1,1,5,1,1,FALSE,0.2,2023,2023-2024
WI,2023-12-31,intra-ui,7447,385,198,124,59,50,39,17,18,84,1508,9929,8955,9340,FALSE,0.940678819619297,2023,2023-2024
WI,2024-01-31,inter-total,638,32,14,11,6,3,2,1,2,4,144,857,782,814,FALSE,0.949824970828471,2023,2023-2024
WI,2024-01-31,inter-ucfe,2,0,0,0,0,0,0,0,0,0,0,2,2,2,FALSE,1,2023,2023-2024
WI,2024-01-31,inter-ucx,0,0,0,0,0,0,0,0,0,0,0,0,0,0,FALSE,0,2023,2023-2024
WI,2024-01-31,inter-ui,636,32,14,11,6,3,2,1,2,4,144,855,780,812,FALSE,0.949707602339181,2023,2023-2024
WI,2024-01-31,intra-total,12186,746,334,161,102,65,53,43,19,85,2985,16779,15171,15917,FALSE,0.948626259014244,2023,2023-2024
WI,2024-01-31,intra-ucfe,13,3,2,0,1,0,0,1,0,0,4,24,17,20,FALSE,0.833333333333333,2023,2023-2024
WI,2024-01-31,intra-ucx,3,0,0,0,1,0,0,0,0,0,1,5,4,4,FALSE,0.8,2023,2023-2024
WI,2024-01-31,intra-ui,12170,743,332,161,100,65,53,42,19,85,2980,16750,15150,15893,FALSE,0.948835820895522,2023,2023-2024
WI,2024-02-29,inter-total,371,39,24,13,11,7,3,3,4,10,118,603,489,528,FALSE,0.875621890547264,2023,2023-2024
WI,2024-02-29,inter-ucfe,0,0,0,0,0,0,0,0,0,0,0,0,0,0,FALSE,0,2023,2023-2024
WI,2024-02-29,inter-ucx,0,0,0,0,0,0,0,0,0,0,0,0,0,0,FALSE,0,2023,2023-2024
WI,2024-02-29,inter-ui,371,39,24,13,11,7,3,3,4,10,118,603,489,528,FALSE,0.875621890547264,2023,2023-2024
WI,2024-02-29,intra-total,6255,625,306,157,104,81,65,27,34,123,1894,9671,8149,8774,FALSE,0.907248474821632,2023,2023-2024
WI,2024-02-29,intra-ucfe,5,2,1,0,1,0,0,0,1,0,3,13,8,10,FALSE,0.769230769230769,2023,2023-2024
WI,2024-02-29,intra-ucx,1,0,0,1,1,0,0,0,0,0,0,3,1,1,FALSE,0.333333333333333,2023,2023-2024
WI,2024-02-29,intra-ui,6249,623,305,156,102,81,65,27,33,123,1891,9655,8140,8763,FALSE,0.907612635939928,2023,2023-2024
WI,2024-03-31,inter-total,200,16,16,10,8,8,3,3,3,10,43,320,243,259,FALSE,0.809375,2023,2023-2024
WI,2024-03-31,inter-ucfe,2,0,0,0,0,0,0,0,0,1,0,3,2,2,FALSE,0.666666666666667,2023,2023-2024
WI,2024-03-31,inter-ucx,0,0,0,0,0,0,0,0,0,0,0,0,0,0,FALSE,0,2023,2023-2024
WI,2024-03-31,inter-ui,198,16,16,10,8,8,3,3,3,9,43,317,241,257,FALSE,0.810725552050473,2023,2023-2024
WI,2024-03-31,intra-total,4277,368,181,100,87,83,69,30,27,89,1272,6583,5549,5917,FALSE,0.898830320522558,2023,2023-2024
WI,2024-03-31,intra-ucfe,2,3,0,3,0,0,1,0,0,3,1,13,3,6,FALSE,0.461538461538462,2023,2023-2024
WI,2024-03-31,intra-ucx,1,0,0,0,0,0,0,0,0,0,1,2,2,2,FALSE,1,2023,2023-2024
WI,2024-03-31,intra-ui,4274,365,181,97,87,83,68,30,27,86,1270,6568,5544,5909,FALSE,0.899665042630938,2023,2023-2024
WI,2024-04-30,inter-total,127,15,6,2,3,5,2,0,3,3,32,198,159,174,FALSE,0.878787878787879,2023,2023-2024
WI,2024-04-30,inter-ucfe,0,0,0,0,0,0,0,0,0,0,0,0,0,0,FALSE,0,2023,2023-2024
WI,2024-04-30,inter-ucx,0,0,0,0,0,0,0,0,0,0,0,0,0,0,FALSE,0,2023,2023-2024
WI,2024-04-30,inter-ui,127,15,6,2,3,5,2,0,3,3,32,198,159,174,FALSE,0.878787878787879,2023,2023-2024
WI,2024-04-30,intra-total,4155,401,138,96,62,56,50,28,11,94,1351,6442,5506,5907,FALSE,0.916951257373487,2023,2023-2024
WI,2024-04-30,intra-ucfe,4,1,1,2,1,0,0,0,0,0,3,12,7,8,FALSE,0.666666666666667,2023,2023-2024
WI,2024-04-30,intra-ucx,5,1,1,0,0,1,0,0,0,0,1,9,6,7,FALSE,0.777777777777778,2023,2023-2024
WI,2024-04-30,intra-ui,4146,399,136,94,61,55,50,28,11,94,1347,6421,5493,5892,FALSE,0.917614078803925,2023,2023-2024
WI,2024-05-31,inter-total,94,10,7,3,2,2,0,1,0,8,32,159,126,136,FALSE,0.855345911949686,2023,2023-2024
WI,2024-05-31,inter-ucfe,0,0,0,0,0,0,0,0,0,0,0,0,0,0,FALSE,0,2023,2023-2024
WI,2024-05-31,inter-ucx,0,0,0,0,0,0,0,0,0,0,0,0,0,0,FALSE,0,2023,2023-2024
WI,2024-05-31,inter-ui,94,10,7,3,2,2,0,1,0,8,32,159,126,136,FALSE,0.855345911949686,2023,2023-2024
WI,2024-05-31,intra-total,3036,317,162,101,73,57,41,15,18,92,1025,4937,4061,4378,FALSE,0.886773344136115,2023,2023-2024
WI,2024-05-31,intra-ucfe,1,1,0,0,0,0,0,0,0,0,2,4,3,4,FALSE,1,2023,2023-2024
WI,2024-05-31,intra-ucx,2,0,0,0,0,0,0,0,0,0,0,2,2,2,FALSE,1,2023,2023-2024
WI,2024-05-31,intra-ui,3033,316,162,101,73,57,41,15,18,92,1023,4931,4056,4372,FALSE,0.886635570878118,2023,2023-2024
WI,2024-06-30,inter-total,66,10,6,5,4,2,0,2,0,5,29,129,95,105,FALSE,0.813953488372093,2023,2023-2024
WI,2024-06-30,inter-ucfe,0,0,0,0,0,0,0,0,0,0,0,0,0,0,FALSE,0,2023,2023-2024
WI,2024-06-30,inter-ucx,0,0,0,0,0,0,0,0,0,0,0,0,0,0,FALSE,0,2023,2023-2024
WI,2024-06-30,inter-ui,66,10,6,5,4,2,0,2,0,5,29,129,95,105,FALSE,0.813953488372093,2023,2023-2024
WI,2024-06-30,intra-total,4674,337,149,100,72,61,33,23,16,106,1190,6761,5864,6201,FALSE,0.917172015973968,2023,2023-2024
WI,2024-06-30,intra-ucfe,1,1,0,0,0,0,0,1,0,1,1,5,2,3,FALSE,0.6,2023,2023-2024
WI,2024-06-30,intra-ucx,2,0,0,0,0,0,0,0,0,1,3,6,5,5,FALSE,0.833333333333333,2023,2023-2024
WI,2024-06-30,intra-ui,4671,336,149,100,72,61,33,22,16,104,1186,6750,5857,6193,FALSE,0.917481481481481,2023,2023-2024
WI,2024-07-31,inter-total,638,32,14,11,6,3,2,1,2,4,144,857,782,814,FALSE,0.949824970828471,2024,2024-2025
WI,2024-07-31,inter-ucfe,2,0,0,0,0,0,0,0,0,0,0,2,2,2,FALSE,1,2024,2024-2025
WI,2024-07-31,inter-ucx,0,0,0,0,0,0,0,0,0,0,0,0,0,0,FALSE,0,2024,2024-2025
WI,2024-07-31,inter-ui,636,32,14,11,6,3,2,1,2,4,144,855,780,812,FALSE,0.949707602339181,2024,2024-2025
WI,2024-07-31,intra-total,12186,746,334,161,102,65,53,43,19,85,2985,16779,15171,15917,FALSE,0.948626259014244,2024,2024-2025
WI,2024-07-31,intra-ucfe,13,3,2,0,1,0,0,1,0,0,4,24,17,20,FALSE,0.833333333333333,2024,2024-2025
WI,2024-07-31,intra-ucx,3,0,0,0,1,0,0,0,0,0,1,5,4,4,FALSE,0.8,2024,2024-2025
WI,2024-07-31,intra-ui,12170,743,332,161,100,65,53,42,19,85,2980,16750,15150,15893,FALSE,0.948835820895522,2024,2024-2025
WI,2024-08-31,inter-total,60,12,7,3,4,4,2,1,2,2,31,128,91,103,FALSE,0.8046875,2024,2024-2025
WI,2024-08-31,inter-ucfe,0,0,0,0,0,0,0,0,0,0,0,0,0,0,FALSE,0,2024,2024-2025
WI,2024-08-31,inter-ucx,0,0,0,0,0,0,0,0,0,0,0,0,0,0,FALSE,0,2024,2024-2025
WI,2024-08-31,inter-ui,60,12,7,3,4,4,2,1,2,2,31,128,91,103,FALSE,0.8046875,2024,2024-2025
WI,2024-08-31,intra-total,3299,418,235,134,94,85,44,30,21,103,1191,5654,4490,4908,FALSE,0.868058012026884,2024,2024-2025
WI,2024-08-31,intra-ucfe,0,2,3,2,0,0,0,0,0,1,0,8,0,2,FALSE,0.25,2024,2024-2025
WI,2024-08-31,intra-ucx,2,0,0,0,0,0,0,0,0,0,2,4,4,4,FALSE,1,2024,2024-2025
WI,2024-08-31,intra-ui,3297,416,232,132,94,85,44,30,21,102,1189,5642,4486,4902,FALSE,0.868840836582772,2024,2024-2025
WI,2024-09-30,inter-total,44,8,9,4,0,0,1,2,1,4,12,85,56,64,FALSE,0.752941176470588,2024,2024-2025
WI,2024-09-30,inter-ucfe,0,0,0,0,0,0,0,0,0,0,0,0,0,0,FALSE,0,2024,2024-2025
WI,2024-09-30,inter-ucx,0,0,0,0,0,0,0,0,0,0,0,0,0,0,FALSE,0,2024,2024-2025
WI,2024-09-30,inter-ui,44,8,9,4,0,0,1,2,1,4,12,85,56,64,FALSE,0.752941176470588,2024,2024-2025
WI,2024-09-30,intra-total,3377,347,147,90,45,50,49,28,17,89,1383,5622,4760,5107,FALSE,0.908395588758449,2024,2024-2025
WI,2024-09-30,intra-ucfe,1,1,1,1,1,0,0,0,0,0,0,5,1,2,FALSE,0.4,2024,2024-2025
WI,2024-09-30,intra-ucx,5,0,0,0,0,1,0,0,1,0,0,7,5,5,FALSE,0.714285714285714,2024,2024-2025
WI,2024-09-30,intra-ui,3371,346,146,89,44,49,49,28,16,89,1383,5610,4754,5100,FALSE,0.909090909090909,2024,2024-2025
WI,2024-10-31,inter-total,77,10,7,5,6,0,1,2,0,6,22,136,99,109,FALSE,0.801470588235294,2024,2024-2025
WI,2024-10-31,inter-ucfe,0,1,0,0,0,0,0,0,0,0,0,1,0,1,FALSE,1,2024,2024-2025
WI,2024-10-31,inter-ucx,0,0,0,0,0,0,0,0,0,0,0,0,0,0,FALSE,0,2024,2024-2025
WI,2024-10-31,inter-ui,77,9,7,5,6,0,1,2,0,6,22,135,99,108,FALSE,0.8,2024,2024-2025
WI,2024-10-31,intra-total,3127,317,154,79,76,50,58,31,13,96,1176,5177,4303,4620,FALSE,0.892408730925246,2024,2024-2025
WI,2024-10-31,intra-ucfe,2,2,0,0,1,0,1,0,0,0,2,8,4,6,FALSE,0.75,2024,2024-2025
WI,2024-10-31,intra-ucx,5,0,0,0,0,0,0,0,0,0,3,8,8,8,FALSE,1,2024,2024-2025
WI,2024-10-31,intra-ui,3120,315,154,79,75,50,57,31,13,96,1171,5161,4291,4606,FALSE,0.892462701026933,2024,2024-2025
WI,2024-11-30,inter-total,125,15,9,5,2,2,1,0,1,6,31,197,156,171,FALSE,0.868020304568528,2024,2024-2025
WI,2024-11-30,inter-ucfe,0,0,0,0,0,0,0,0,0,0,1,1,1,1,FALSE,1,2024,2024-2025
WI,2024-11-30,inter-ucx,0,0,0,0,0,0,0,0,0,0,0,0,0,0,FALSE,0,2024,2024-2025
WI,2024-11-30,inter-ui,125,15,9,5,2,2,1,0,1,6,30,196,155,170,FALSE,0.86734693877551,2024,2024-2025
WI,2024-11-30,intra-total,3583,342,165,86,55,63,43,23,25,87,970,5442,4553,4895,FALSE,0.899485483278207,2024,2024-2025
WI,2024-11-30,intra-ucfe,9,0,2,2,0,2,0,0,0,3,1,19,10,10,FALSE,0.526315789473684,2024,2024-2025
WI,2024-11-30,intra-ucx,7,0,0,0,0,0,0,0,0,0,0,7,7,7,FALSE,1,2024,2024-2025
WI,2024-11-30,intra-ui,3567,342,163,84,55,61,43,23,25,84,969,5416,4536,4878,FALSE,0.900664697193501,2024,2024-2025
WI,2024-12-31,inter-total,264,12,7,7,2,1,0,0,0,5,47,345,311,323,FALSE,0.936231884057971,2024,2024-2025
WI,2024-12-31,inter-ucfe,0,0,0,0,0,0,0,0,0,0,0,0,0,0,FALSE,0,2024,2024-2025
WI,2024-12-31,inter-ucx,0,0,0,0,0,0,0,0,0,0,0,0,0,0,FALSE,0,2024,2024-2025
WI,2024-12-31,inter-ui,264,12,7,7,2,1,0,0,0,5,47,345,311,323,FALSE,0.936231884057971,2024,2024-2025
WI,2024-12-31,intra-total,8700,461,193,101,77,53,37,35,17,83,1681,11438,10381,10842,FALSE,0.947892988284665,2024,2024-2025
WI,2024-12-31,intra-ucfe,11,1,0,0,0,0,1,0,0,1,7,21,18,19,FALSE,0.904761904761905,2024,2024-2025
WI,2024-12-31,intra-ucx,4,0,0,0,0,0,0,0,0,0,2,6,6,6,FALSE,1,2024,2024-2025
WI,2024-12-31,intra-ui,8685,460,193,101,77,53,36,35,17,82,1672,11411,10357,10817,FALSE,0.947944965384278,2024,2024-2025
WV,2019-01-31,inter-total,1019,50,17,5,8,3,3,1,1,2,134,1243,1153,1203,FALSE,0.96781979082864,2018,2018-2019
WV,2019-01-31,inter-ucfe,25,1,1,0,0,0,0,0,0,0,8,35,33,34,FALSE,0.971428571428571,2018,2018-2019
WV,2019-01-31,inter-ucx,0,0,0,0,0,0,0,0,0,0,0,0,0,0,FALSE,0,2018,2018-2019
WV,2019-01-31,inter-ui,994,49,16,5,8,3,3,1,1,2,126,1208,1120,1169,FALSE,0.967715231788079,2018,2018-2019
WV,2019-01-31,intra-total,4442,361,91,29,11,18,8,3,3,4,1582,6552,6024,6385,FALSE,0.9745115995116,2018,2018-2019
WV,2019-01-31,intra-ucfe,135,4,2,0,0,0,1,0,0,0,51,193,186,190,FALSE,0.984455958549223,2018,2018-2019
WV,2019-01-31,intra-ucx,5,0,0,0,0,0,0,0,0,0,1,6,6,6,FALSE,1,2018,2018-2019
WV,2019-01-31,intra-ui,4302,357,89,29,11,18,7,3,3,4,1530,6353,5832,6189,FALSE,0.974185424209035,2018,2018-2019
WV,2019-02-28,inter-total,661,58,30,9,13,3,1,1,1,2,88,867,749,807,FALSE,0.930795847750865,2018,2018-2019
WV,2019-02-28,inter-ucfe,0,0,0,0,0,0,0,0,0,0,0,0,0,0,FALSE,0,2018,2018-2019
WV,2019-02-28,inter-ucx,0,0,0,0,0,0,0,0,0,0,0,0,0,0,FALSE,0,2018,2018-2019
WV,2019-02-28,inter-ui,661,58,30,9,13,3,1,1,1,2,88,867,749,807,FALSE,0.930795847750865,2018,2018-2019
WV,2019-02-28,intra-total,2216,334,76,17,14,10,7,1,0,6,918,3599,3134,3468,FALSE,0.963601000277855,2018,2018-2019
WV,2019-02-28,intra-ucfe,0,2,0,1,0,1,0,0,0,0,2,6,2,4,FALSE,0.666666666666667,2018,2018-2019
WV,2019-02-28,intra-ucx,3,1,0,0,0,0,0,0,0,0,3,7,6,7,FALSE,1,2018,2018-2019
WV,2019-02-28,intra-ui,2213,331,76,16,14,9,7,1,0,6,913,3586,3126,3457,FALSE,0.964026770775237,2018,2018-2019
WV,2019-03-31,inter-total,414,30,10,4,8,3,6,2,2,7,76,562,490,520,FALSE,0.925266903914591,2018,2018-2019
WV,2019-03-31,inter-ucfe,1,0,0,0,0,0,0,0,0,0,0,1,1,1,FALSE,1,2018,2018-2019
WV,2019-03-31,inter-ucx,0,0,0,0,0,0,0,0,0,0,0,0,0,0,FALSE,0,2018,2018-2019
WV,2019-03-31,inter-ui,413,30,10,4,8,3,6,2,2,7,76,561,489,519,FALSE,0.925133689839572,2018,2018-2019
WV,2019-03-31,intra-total,1294,199,46,20,13,13,7,3,4,17,537,2153,1831,2030,FALSE,0.942870413376684,2018,2018-2019
WV,2019-03-31,intra-ucfe,5,0,0,1,0,1,0,0,0,0,5,12,10,10,FALSE,0.833333333333333,2018,2018-2019
WV,2019-03-31,intra-ucx,5,0,0,0,0,0,0,0,0,0,0,5,5,5,FALSE,1,2018,2018-2019
WV,2019-03-31,intra-ui,1284,199,46,19,13,12,7,3,4,17,532,2136,1816,2015,FALSE,0.943352059925094,2018,2018-2019
WV,2019-04-30,inter-total,330,8,2,3,1,0,1,4,0,3,44,396,374,382,FALSE,0.964646464646465,2018,2018-2019
WV,2019-04-30,inter-ucfe,0,0,0,0,0,0,0,0,0,0,1,1,1,1,FALSE,1,2018,2018-2019
WV,2019-04-30,inter-ucx,0,0,0,0,0,0,0,0,0,0,0,0,0,0,FALSE,0,2018,2018-2019
WV,2019-04-30,inter-ui,330,8,2,3,1,0,1,4,0,3,43,395,373,381,FALSE,0.964556962025316,2018,2018-2019
WV,2019-04-30,intra-total,1270,86,38,14,16,6,4,3,1,7,328,1773,1598,1684,FALSE,0.949802594472645,2018,2018-2019
WV,2019-04-30,intra-ucfe,4,0,1,0,1,0,0,0,0,0,2,8,6,6,FALSE,0.75,2018,2018-2019
WV,2019-04-30,intra-ucx,2,1,0,0,0,0,0,0,0,0,0,3,2,3,FALSE,1,2018,2018-2019
WV,2019-04-30,intra-ui,1264,85,37,14,15,6,4,3,1,7,326,1762,1590,1675,FALSE,0.950624290578888,2018,2018-2019
WV,2019-05-31,inter-total,239,12,3,3,5,0,1,1,1,3,43,311,282,294,FALSE,0.945337620578778,2018,2018-2019
WV,2019-05-31,inter-ucfe,0,0,0,0,0,0,0,0,0,0,0,0,0,0,FALSE,0,2018,2018-2019
WV,2019-05-31,inter-ucx,0,0,0,0,0,0,0,0,0,0,0,0,0,0,FALSE,0,2018,2018-2019
WV,2019-05-31,inter-ui,239,12,3,3,5,0,1,1,1,3,43,311,282,294,FALSE,0.945337620578778,2018,2018-2019
WV,2019-05-31,intra-total,1122,134,31,13,10,7,5,3,0,2,430,1757,1552,1686,FALSE,0.959590210586227,2018,2018-2019
WV,2019-05-31,intra-ucfe,0,0,1,0,0,0,0,0,0,0,0,1,0,0,FALSE,0,2018,2018-2019
WV,2019-05-31,intra-ucx,7,0,0,0,0,0,0,0,0,0,0,7,7,7,FALSE,1,2018,2018-2019
WV,2019-05-31,intra-ui,1115,134,30,13,10,7,5,3,0,2,430,1749,1545,1679,FALSE,0.959977129788451,2018,2018-2019
WV,2019-06-30,inter-total,183,7,2,1,7,2,1,0,0,0,26,229,209,216,FALSE,0.943231441048035,2018,2018-2019
WV,2019-06-30,inter-ucfe,0,0,0,0,0,0,0,0,0,0,0,0,0,0,FALSE,0,2018,2018-2019
WV,2019-06-30,inter-ucx,0,0,0,0,0,0,0,0,0,0,0,0,0,0,FALSE,0,2018,2018-2019
WV,2019-06-30,inter-ui,183,7,2,1,7,2,1,0,0,0,26,229,209,216,FALSE,0.943231441048035,2018,2018-2019
WV,2019-06-30,intra-total,1110,138,31,14,5,9,3,3,2,1,440,1756,1550,1688,FALSE,0.96127562642369,2018,2018-2019
WV,2019-06-30,intra-ucfe,2,0,1,0,0,0,0,0,1,0,0,4,2,2,FALSE,0.5,2018,2018-2019
WV,2019-06-30,intra-ucx,10,0,0,0,0,0,0,0,0,0,0,10,10,10,FALSE,1,2018,2018-2019
WV,2019-06-30,intra-ui,1098,138,30,14,5,9,3,3,1,1,440,1742,1538,1676,FALSE,0.96211251435132,2018,2018-2019
WV,2019-07-31,inter-total,249,20,2,1,3,2,1,1,0,1,50,330,299,319,FALSE,0.966666666666667,2019,2019-2020
WV,2019-07-31,inter-ucfe,2,0,0,0,0,0,0,0,0,0,0,2,2,2,FALSE,1,2019,2019-2020
WV,2019-07-31,inter-ucx,0,0,0,0,0,0,0,0,0,0,0,0,0,0,FALSE,0,2019,2019-2020
WV,2019-07-31,inter-ui,247,20,2,1,3,2,1,1,0,1,50,328,297,317,FALSE,0.966463414634146,2019,2019-2020
WV,2019-07-31,intra-total,1244,215,42,12,17,9,1,2,3,4,614,2163,1858,2073,FALSE,0.958391123439667,2019,2019-2020
WV,2019-07-31,intra-ucfe,2,1,2,0,0,0,0,0,0,0,1,6,3,4,FALSE,0.666666666666667,2019,2019-2020
WV,2019-07-31,intra-ucx,3,0,0,0,0,0,0,0,0,0,1,4,4,4,FALSE,1,2019,2019-2020
WV,2019-07-31,intra-ui,1239,214,40,12,17,9,1,2,3,4,612,2153,1851,2065,FALSE,0.959126799814213,2019,2019-2020
WV,2019-08-31,inter-total,181,10,3,4,0,0,0,0,2,1,31,232,212,222,FALSE,0.956896551724138,2019,2019-2020
WV,2019-08-31,inter-ucfe,0,0,0,0,0,0,0,0,0,0,1,1,1,1,FALSE,1,2019,2019-2020
WV,2019-08-31,inter-ucx,0,0,0,0,0,0,0,0,0,0,0,0,0,0,FALSE,0,2019,2019-2020
WV,2019-08-31,inter-ui,181,10,3,4,0,0,0,0,2,1,30,231,211,221,FALSE,0.956709956709957,2019,2019-2020
WV,2019-08-31,intra-total,906,119,28,9,9,9,7,5,1,3,358,1454,1264,1383,FALSE,0.951169188445667,2019,2019-2020
WV,2019-08-31,intra-ucfe,2,1,0,0,0,0,0,0,0,0,1,4,3,4,FALSE,1,2019,2019-2020
WV,2019-08-31,intra-ucx,2,0,1,0,0,0,0,0,0,0,1,4,3,3,FALSE,0.75,2019,2019-2020
WV,2019-08-31,intra-ui,902,118,27,9,9,9,7,5,1,3,356,1446,1258,1376,FALSE,0.951590594744122,2019,2019-2020
WV,2019-09-30,inter-total,254,12,8,6,5,2,0,3,0,0,40,330,294,306,FALSE,0.927272727272727,2019,2019-2020
WV,2019-09-30,inter-ucfe,0,0,0,0,0,0,0,0,0,0,0,0,0,0,FALSE,0,2019,2019-2020
WV,2019-09-30,inter-ucx,0,0,0,0,0,0,0,0,0,0,0,0,0,0,FALSE,0,2019,2019-2020
WV,2019-09-30,inter-ui,254,12,8,6,5,2,0,3,0,0,40,330,294,306,FALSE,0.927272727272727,2019,2019-2020
WV,2019-09-30,intra-total,1126,133,44,15,12,14,8,2,3,4,349,1710,1475,1608,FALSE,0.940350877192983,2019,2019-2020
WV,2019-09-30,intra-ucfe,1,0,0,0,0,0,0,0,0,1,1,3,2,2,FALSE,0.666666666666667,2019,2019-2020
WV,2019-09-30,intra-ucx,8,0,0,0,0,0,0,0,0,0,1,9,9,9,FALSE,1,2019,2019-2020
WV,2019-09-30,intra-ui,1117,133,44,15,12,14,8,2,3,3,347,1698,1464,1597,FALSE,0.940518256772674,2019,2019-2020
WV,2019-10-31,inter-total,373,13,4,4,2,2,0,1,2,3,61,465,434,447,FALSE,0.961290322580645,2019,2019-2020
WV,2019-10-31,inter-ucfe,0,0,0,0,0,0,0,0,0,0,1,1,1,1,FALSE,1,2019,2019-2020
WV,2019-10-31,inter-ucx,0,0,0,0,0,0,0,0,0,0,0,0,0,0,FALSE,0,2019,2019-2020
WV,2019-10-31,inter-ui,373,13,4,4,2,2,0,1,2,3,60,464,433,446,FALSE,0.961206896551724,2019,2019-2020
WV,2019-10-31,intra-total,1790,128,24,10,9,10,8,1,0,4,580,2564,2370,2498,FALSE,0.974258970358814,2019,2019-2020
WV,2019-10-31,intra-ucfe,4,0,2,0,0,0,0,0,0,0,1,7,5,5,FALSE,0.714285714285714,2019,2019-2020
WV,2019-10-31,intra-ucx,10,0,0,0,0,0,0,0,0,0,1,11,11,11,FALSE,1,2019,2019-2020
WV,2019-10-31,intra-ui,1776,128,22,10,9,10,8,1,0,4,578,2546,2354,2482,FALSE,0.974862529457973,2019,2019-2020
WV,2019-11-30,inter-total,433,21,7,6,1,0,0,0,0,1,48,517,481,502,FALSE,0.970986460348163,2019,2019-2020
WV,2019-11-30,inter-ucfe,1,0,0,0,0,0,0,0,0,0,0,1,1,1,FALSE,1,2019,2019-2020
WV,2019-11-30,inter-ucx,0,0,0,0,0,0,0,0,0,0,0,0,0,0,FALSE,0,2019,2019-2020
WV,2019-11-30,inter-ui,432,21,7,6,1,0,0,0,0,1,48,516,480,501,FALSE,0.970930232558139,2019,2019-2020
WV,2019-11-30,intra-total,1858,161,26,19,15,13,9,5,3,4,452,2565,2310,2471,FALSE,0.963352826510721,2019,2019-2020
WV,2019-11-30,intra-ucfe,3,1,0,0,0,0,0,0,0,0,0,4,3,4,FALSE,1,2019,2019-2020
WV,2019-11-30,intra-ucx,4,1,0,0,0,0,0,0,0,0,2,7,6,7,FALSE,1,2019,2019-2020
WV,2019-11-30,intra-ui,1851,159,26,19,15,13,9,5,3,4,450,2554,2301,2460,FALSE,0.96319498825372,2019,2019-2020
WV,2019-12-31,inter-total,600,34,11,5,6,2,1,0,1,0,66,726,666,700,FALSE,0.964187327823691,2019,2019-2020
WV,2019-12-31,inter-ucfe,1,0,0,0,1,0,0,0,0,0,0,2,1,1,FALSE,0.5,2019,2019-2020
WV,2019-12-31,inter-ucx,0,0,0,0,0,0,0,0,0,0,0,0,0,0,FALSE,0,2019,2019-2020
WV,2019-12-31,inter-ui,599,34,11,5,5,2,1,0,1,0,66,724,665,699,FALSE,0.965469613259669,2019,2019-2020
WV,2019-12-31,intra-total,3038,322,94,47,28,16,12,8,1,8,1161,4735,4199,4521,FALSE,0.95480464625132,2019,2019-2020
WV,2019-12-31,intra-ucfe,2,7,0,2,0,0,0,0,0,0,5,16,7,14,FALSE,0.875,2019,2019-2020
WV,2019-12-31,intra-ucx,7,0,0,0,0,1,0,0,0,0,4,12,11,11,FALSE,0.916666666666667,2019,2019-2020
WV,2019-12-31,intra-ui,3029,315,94,45,28,15,12,8,1,8,1152,4707,4181,4496,FALSE,0.955173146377735,2019,2019-2020
WV,2020-01-31,inter-total,697,53,9,9,5,5,4,3,0,1,110,896,807,860,FALSE,0.959821428571429,2019,2019-2020
WV,2020-01-31,inter-ucfe,0,0,0,0,0,0,0,0,0,0,0,0,0,0,FALSE,0,2019,2019-2020
WV,2020-01-31,inter-ucx,0,0,0,0,0,0,0,0,0,0,0,0,0,0,FALSE,0,2019,2019-2020
WV,2020-01-31,inter-ui,697,53,9,9,5,5,4,3,0,1,110,896,807,860,FALSE,0.959821428571429,2019,2019-2020
WV,2020-01-31,intra-total,3771,468,155,43,26,14,10,8,5,7,1927,6434,5698,6166,FALSE,0.95834628535903,2019,2019-2020
WV,2020-01-31,intra-ucfe,5,1,0,0,0,0,0,0,0,0,5,11,10,11,FALSE,1,2019,2019-2020
WV,2020-01-31,intra-ucx,3,0,0,0,0,0,0,0,0,0,1,4,4,4,FALSE,1,2019,2019-2020
WV,2020-01-31,intra-ui,3763,467,155,43,26,14,10,8,5,7,1921,6419,5684,6151,FALSE,0.958248948434336,2019,2019-2020
WV,2020-02-29,inter-total,502,35,15,10,5,5,2,1,0,3,74,652,576,611,FALSE,0.937116564417178,2019,2019-2020
WV,2020-02-29,inter-ucfe,1,0,0,0,0,0,0,0,0,0,0,1,1,1,FALSE,1,2019,2019-2020
WV,2020-02-29,inter-ucx,0,0,0,0,0,0,0,0,0,0,0,0,0,0,FALSE,0,2019,2019-2020
WV,2020-02-29,inter-ui,501,35,15,10,5,5,2,1,0,3,74,651,575,610,FALSE,0.937019969278034,2019,2019-2020
WV,2020-02-29,intra-total,2338,276,56,30,21,13,6,0,2,9,919,3670,3257,3533,FALSE,0.96267029972752,2019,2019-2020
WV,2020-02-29,intra-ucfe,2,5,2,0,1,0,1,0,0,0,2,13,4,9,FALSE,0.692307692307692,2019,2019-2020
WV,2020-02-29,intra-ucx,4,0,1,1,0,0,0,0,0,0,0,6,4,4,FALSE,0.666666666666667,2019,2019-2020
WV,2020-02-29,intra-ui,2332,271,53,29,20,13,5,0,2,9,917,3651,3249,3520,FALSE,0.964119419337168,2019,2019-2020
WV,2020-03-31,inter-total,502,35,15,10,5,5,2,1,0,3,74,652,576,611,FALSE,0.937116564417178,2019,2019-2020
WV,2020-03-31,inter-ucfe,1,0,0,0,0,0,0,0,0,0,0,1,1,1,FALSE,1,2019,2019-2020
WV,2020-03-31,inter-ucx,0,0,0,0,0,0,0,0,0,0,0,0,0,0,FALSE,0,2019,2019-2020
WV,2020-03-31,inter-ui,501,35,15,10,5,5,2,1,0,3,74,651,575,610,FALSE,0.937019969278034,2019,2019-2020
WV,2020-03-31,intra-total,2338,276,56,30,21,13,6,0,2,9,919,3670,3257,3533,FALSE,0.96267029972752,2019,2019-2020
WV,2020-03-31,intra-ucfe,2,5,2,0,1,0,1,0,0,0,2,13,4,9,FALSE,0.692307692307692,2019,2019-2020
WV,2020-03-31,intra-ucx,4,0,1,1,0,0,0,0,0,0,0,6,4,4,FALSE,0.666666666666667,2019,2019-2020
WV,2020-03-31,intra-ui,2332,271,53,29,20,13,5,0,2,9,917,3651,3249,3520,FALSE,0.964119419337168,2019,2019-2020
WV,2020-04-30,inter-total,3383,510,147,40,6,0,0,2,2,2,1955,6047,5338,5848,FALSE,0.96709111956342,2019,2019-2020
WV,2020-04-30,inter-ucfe,0,0,0,0,0,0,0,0,0,0,0,0,0,0,FALSE,0,2019,2019-2020
WV,2020-04-30,inter-ucx,0,0,0,0,0,0,0,0,0,0,1,1,1,1,FALSE,1,2019,2019-2020
WV,2020-04-30,inter-ui,3383,510,147,40,6,0,0,2,2,2,1954,6046,5337,5847,FALSE,0.967085676480318,2019,2019-2020
WV,2020-04-30,intra-total,24056,7199,1993,577,30,18,2,2,2,4,28423,62306,52479,59678,FALSE,0.957821076621834,2019,2019-2020
WV,2020-04-30,intra-ucfe,2,1,2,1,0,0,0,0,0,0,7,13,9,10,FALSE,0.769230769230769,2019,2019-2020
WV,2020-04-30,intra-ucx,8,1,0,0,0,0,0,0,0,0,10,19,18,19,FALSE,1,2019,2019-2020
WV,2020-04-30,intra-ui,24046,7197,1991,576,30,18,2,2,2,4,28406,62274,52452,59649,FALSE,0.957847576837846,2019,2019-2020
WV,2020-05-31,inter-total,1536,318,222,186,139,70,38,9,0,1,455,2974,1991,2309,FALSE,0.776395427034297,2019,2019-2020
WV,2020-05-31,inter-ucfe,0,0,1,1,0,0,0,0,0,0,0,2,0,0,FALSE,0,2019,2019-2020
WV,2020-05-31,inter-ucx,0,0,0,0,0,0,0,0,0,0,0,0,0,0,FALSE,0,2019,2019-2020
WV,2020-05-31,inter-ui,1536,318,221,185,139,70,38,9,0,1,455,2972,1991,2309,FALSE,0.776917900403769,2019,2019-2020
WV,2020-05-31,intra-total,7889,3216,2646,2159,1506,722,358,129,12,8,4031,22676,11920,15136,FALSE,0.667489857117657,2019,2019-2020
WV,2020-05-31,intra-ucfe,9,5,7,2,3,2,0,1,0,0,9,38,18,23,FALSE,0.605263157894737,2019,2019-2020
WV,2020-05-31,intra-ucx,5,3,3,0,1,0,0,0,0,0,3,15,8,11,FALSE,0.733333333333333,2019,2019-2020
WV,2020-05-31,intra-ui,7875,3208,2636,2157,1502,720,358,128,12,8,4019,22623,11894,15102,FALSE,0.66755072271582,2019,2019-2020
WV,2020-06-30,inter-total,534,71,44,42,46,62,46,57,50,61,139,1152,673,744,FALSE,0.645833333333333,2019,2019-2020
WV,2020-06-30,inter-ucfe,0,1,0,0,0,1,0,0,0,0,1,3,1,2,FALSE,0.666666666666667,2019,2019-2020
WV,2020-06-30,inter-ucx,0,0,0,0,0,0,0,0,0,0,0,0,0,0,FALSE,0,2019,2019-2020
WV,2020-06-30,inter-ui,534,70,44,42,46,61,46,57,50,61,138,1149,672,742,FALSE,0.645778938207137,2019,2019-2020
WV,2020-06-30,intra-total,4272,537,338,257,281,433,472,523,457,487,1226,9283,5498,6035,FALSE,0.650113109985996,2019,2019-2020
WV,2020-06-30,intra-ucfe,3,0,0,1,1,0,2,0,0,0,1,8,4,4,FALSE,0.5,2019,2019-2020
WV,2020-06-30,intra-ucx,6,1,1,4,0,2,1,0,0,1,3,19,9,10,FALSE,0.526315789473684,2019,2019-2020
WV,2020-06-30,intra-ui,4263,536,337,252,280,431,469,523,457,486,1222,9256,5485,6021,FALSE,0.650496974935177,2019,2019-2020
WV,2020-07-31,inter-total,469,40,29,18,15,8,10,8,23,123,93,836,562,602,FALSE,0.720095693779904,2020,2020-2021
WV,2020-07-31,inter-ucfe,0,0,0,0,0,0,0,0,1,0,0,1,0,0,FALSE,0,2020,2020-2021
WV,2020-07-31,inter-ucx,0,0,0,0,0,0,0,0,0,0,0,0,0,0,FALSE,0,2020,2020-2021
WV,2020-07-31,inter-ui,469,40,29,18,15,8,10,8,22,123,93,835,562,602,FALSE,0.720958083832335,2020,2020-2021
WV,2020-07-31,intra-total,2280,332,166,138,100,89,76,70,84,939,824,5098,3104,3436,FALSE,0.673989799921538,2020,2020-2021
WV,2020-07-31,intra-ucfe,2,2,1,0,0,0,0,0,0,7,1,13,3,5,FALSE,0.384615384615385,2020,2020-2021
WV,2020-07-31,intra-ucx,3,1,0,0,0,1,0,0,0,1,5,11,8,9,FALSE,0.818181818181818,2020,2020-2021
WV,2020-07-31,intra-ui,2275,329,165,138,100,88,76,70,84,931,818,5074,3093,3422,FALSE,0.674418604651163,2020,2020-2021
WV,2020-08-31,inter-total,170,39,27,12,13,14,16,14,7,94,51,457,221,260,FALSE,0.568927789934354,2020,2020-2021
WV,2020-08-31,inter-ucfe,0,0,0,0,0,0,1,0,0,1,0,2,0,0,FALSE,0,2020,2020-2021
WV,2020-08-31,inter-ucx,0,0,0,0,0,0,0,0,0,0,0,0,0,0,FALSE,0,2020,2020-2021
WV,2020-08-31,inter-ui,170,39,27,12,13,14,15,14,7,93,51,455,221,260,FALSE,0.571428571428571,2020,2020-2021
WV,2020-08-31,intra-total,1263,230,153,111,79,76,52,75,74,1028,410,3551,1673,1903,FALSE,0.535905378766545,2020,2020-2021
WV,2020-08-31,intra-ucfe,3,1,0,0,0,1,0,0,1,4,5,15,8,9,FALSE,0.6,2020,2020-2021
WV,2020-08-31,intra-ucx,9,0,0,0,1,1,0,0,0,0,1,12,10,10,FALSE,0.833333333333333,2020,2020-2021
WV,2020-08-31,intra-ui,1251,229,153,111,78,74,52,75,73,1024,404,3524,1655,1884,FALSE,0.534619750283768,2020,2020-2021
WV,2020-09-30,inter-total,141,23,25,9,11,13,8,4,2,99,43,378,184,207,FALSE,0.547619047619048,2020,2020-2021
WV,2020-09-30,inter-ucfe,1,0,0,0,0,1,0,0,0,1,1,4,2,2,FALSE,0.5,2020,2020-2021
WV,2020-09-30,inter-ucx,0,0,0,0,0,0,0,0,0,0,1,1,1,1,FALSE,1,2020,2020-2021
WV,2020-09-30,inter-ui,140,23,25,9,11,12,8,4,2,98,41,373,181,204,FALSE,0.546916890080429,2020,2020-2021
WV,2020-09-30,intra-total,971,171,102,56,54,48,46,33,46,622,396,2545,1367,1538,FALSE,0.604322200392927,2020,2020-2021
WV,2020-09-30,intra-ucfe,2,0,0,0,0,0,1,0,0,2,1,6,3,3,FALSE,0.5,2020,2020-2021
WV,2020-09-30,intra-ucx,3,0,0,0,0,0,0,0,0,0,3,6,6,6,FALSE,1,2020,2020-2021
WV,2020-09-30,intra-ui,966,171,102,56,54,48,45,33,46,620,392,2533,1358,1529,FALSE,0.603632056849586,2020,2020-2021
WV,2020-10-31,inter-total,127,19,16,7,2,5,8,8,4,57,28,281,155,174,FALSE,0.619217081850534,2020,2020-2021
WV,2020-10-31,inter-ucfe,0,0,0,0,0,0,0,0,0,0,0,0,0,0,FALSE,0,2020,2020-2021
WV,2020-10-31,inter-ucx,0,0,0,0,0,0,0,0,0,0,0,0,0,0,FALSE,0,2020,2020-2021
WV,2020-10-31,inter-ui,127,19,16,7,2,5,8,8,4,57,28,281,155,174,FALSE,0.619217081850534,2020,2020-2021
WV,2020-10-31,intra-total,846,118,72,43,40,21,32,32,37,562,307,2110,1153,1271,FALSE,0.602369668246445,2020,2020-2021
WV,2020-10-31,intra-ucfe,2,1,0,0,0,0,1,2,1,1,3,11,5,6,FALSE,0.545454545454545,2020,2020-2021
WV,2020-10-31,intra-ucx,4,0,1,0,0,1,0,0,1,2,2,11,6,6,FALSE,0.545454545454545,2020,2020-2021
WV,2020-10-31,intra-ui,840,117,71,43,40,20,31,30,35,559,302,2088,1142,1259,FALSE,0.602969348659004,2020,2020-2021
WV,2020-11-30,inter-total,203,22,14,10,5,6,2,4,2,40,40,348,243,265,FALSE,0.761494252873563,2020,2020-2021
WV,2020-11-30,inter-ucfe,0,0,0,0,0,0,0,0,0,0,1,1,1,1,FALSE,1,2020,2020-2021
WV,2020-11-30,inter-ucx,0,0,0,0,0,0,0,0,0,0,0,0,0,0,FALSE,0,2020,2020-2021
WV,2020-11-30,inter-ui,203,22,14,10,5,6,2,4,2,40,39,347,242,264,FALSE,0.760806916426513,2020,2020-2021
WV,2020-11-30,intra-total,1170,166,84,34,35,18,19,16,21,390,399,2352,1569,1735,FALSE,0.737670068027211,2020,2020-2021
WV,2020-11-30,intra-ucfe,14,16,8,3,0,0,0,0,0,1,17,59,31,47,FALSE,0.796610169491525,2020,2020-2021
WV,2020-11-30,intra-ucx,3,1,1,1,0,0,0,0,0,1,1,8,4,5,FALSE,0.625,2020,2020-2021
WV,2020-11-30,intra-ui,1153,149,75,30,35,18,19,16,21,388,381,2285,1534,1683,FALSE,0.736542669584245,2020,2020-2021
WV,2020-12-31,inter-total,230,39,23,12,9,13,6,4,4,52,58,450,288,327,FALSE,0.726666666666667,2020,2020-2021
WV,2020-12-31,inter-ucfe,0,0,0,0,0,0,0,0,0,1,1,2,1,1,FALSE,0.5,2020,2020-2021
WV,2020-12-31,inter-ucx,0,0,0,0,0,0,0,0,0,0,0,0,0,0,FALSE,0,2020,2020-2021
WV,2020-12-31,inter-ui,230,39,23,12,9,13,6,4,4,51,57,448,287,326,FALSE,0.727678571428571,2020,2020-2021
WV,2020-12-31,intra-total,1877,357,139,51,33,27,21,22,23,401,1040,3991,2917,3274,FALSE,0.820345778000501,2020,2020-2021
WV,2020-12-31,intra-ucfe,7,10,2,4,1,0,0,1,1,2,8,36,15,25,FALSE,0.694444444444445,2020,2020-2021
WV,2020-12-31,intra-ucx,3,1,0,1,0,0,0,0,0,0,2,7,5,6,FALSE,0.857142857142857,2020,2020-2021
WV,2020-12-31,intra-ui,1867,346,137,46,32,27,21,21,22,399,1030,3948,2897,3243,FALSE,0.821428571428571,2020,2020-2021
WV,2021-01-31,inter-total,265,55,25,19,14,13,11,6,2,62,91,563,356,411,FALSE,0.730017761989343,2020,2020-2021
WV,2021-01-31,inter-ucfe,1,0,0,0,1,0,0,0,0,1,0,3,1,1,FALSE,0.333333333333333,2020,2020-2021
WV,2021-01-31,inter-ucx,0,0,0,0,0,0,0,0,0,1,0,1,0,0,FALSE,0,2020,2020-2021
WV,2021-01-31,inter-ui,264,55,25,19,13,13,11,6,2,60,91,559,355,410,FALSE,0.73345259391771,2020,2020-2021
WV,2021-01-31,intra-total,2386,501,203,74,61,29,30,28,17,336,1297,4962,3683,4184,FALSE,0.843208383716243,2020,2020-2021
WV,2021-01-31,intra-ucfe,9,2,4,0,0,1,1,1,0,3,8,29,17,19,FALSE,0.655172413793103,2020,2020-2021
WV,2021-01-31,intra-ucx,2,0,0,0,1,0,0,0,0,1,0,4,2,2,FALSE,0.5,2020,2020-2021
WV,2021-01-31,intra-ui,2375,499,199,74,60,28,29,27,17,332,1289,4929,3664,4163,FALSE,0.844593223777643,2020,2020-2021
WV,2021-02-28,inter-total,268,41,30,25,11,16,10,4,3,59,73,540,341,382,FALSE,0.707407407407407,2020,2020-2021
WV,2021-02-28,inter-ucfe,0,0,0,0,0,0,0,0,0,0,1,1,1,1,FALSE,1,2020,2020-2021
WV,2021-02-28,inter-ucx,0,0,0,0,0,0,0,0,0,0,0,0,0,0,FALSE,0,2020,2020-2021
WV,2021-02-28,inter-ui,268,41,30,25,11,16,10,4,3,59,72,539,340,381,FALSE,0.706864564007421,2020,2020-2021
WV,2021-02-28,intra-total,1843,412,167,111,86,48,33,23,18,360,872,3973,2715,3127,FALSE,0.787062673043041,2020,2020-2021
WV,2021-02-28,intra-ucfe,4,8,7,2,5,1,3,0,0,5,10,45,14,22,FALSE,0.488888888888889,2020,2020-2021
WV,2021-02-28,intra-ucx,0,3,0,0,0,0,1,0,0,0,2,6,2,5,FALSE,0.833333333333333,2020,2020-2021
WV,2021-02-28,intra-ui,1839,401,160,109,81,47,29,23,18,355,860,3922,2699,3100,FALSE,0.790413054563998,2020,2020-2021
WV,2021-03-31,inter-total,264,21,23,10,9,13,8,5,5,52,52,462,316,337,FALSE,0.72943722943723,2020,2020-2021
WV,2021-03-31,inter-ucfe,0,1,0,0,0,0,0,0,0,1,0,2,0,1,FALSE,0.5,2020,2020-2021
WV,2021-03-31,inter-ucx,0,0,0,0,0,0,0,0,0,0,0,0,0,0,FALSE,0,2020,2020-2021
WV,2021-03-31,inter-ui,264,20,23,10,9,13,8,5,5,51,52,460,316,336,FALSE,0.730434782608696,2020,2020-2021
WV,2021-03-31,intra-total,1162,288,108,55,54,46,40,17,23,363,608,2764,1770,2058,FALSE,0.744573082489146,2020,2020-2021
WV,2021-03-31,intra-ucfe,2,3,0,0,2,2,0,1,3,3,6,22,8,11,FALSE,0.5,2020,2020-2021
WV,2021-03-31,intra-ucx,3,3,1,0,0,0,2,0,0,2,1,12,4,7,FALSE,0.583333333333333,2020,2020-2021
WV,2021-03-31,intra-ui,1157,282,107,55,52,44,38,16,20,358,601,2730,1758,2040,FALSE,0.747252747252747,2020,2020-2021
WV,2021-04-30,inter-total,256,25,11,7,3,4,3,3,1,43,42,398,298,323,FALSE,0.811557788944724,2020,2020-2021
WV,2021-04-30,inter-ucfe,0,0,0,0,0,0,0,0,0,1,1,2,1,1,FALSE,0.5,2020,2020-2021
WV,2021-04-30,inter-ucx,0,0,0,0,0,0,0,0,0,0,0,0,0,0,FALSE,0,2020,2020-2021
WV,2021-04-30,inter-ui,256,25,11,7,3,4,3,3,1,42,41,396,297,322,FALSE,0.813131313131313,2020,2020-2021
WV,2021-04-30,intra-total,1733,199,90,40,30,23,10,11,17,246,557,2956,2290,2489,FALSE,0.842016238159675,2020,2020-2021
WV,2021-04-30,intra-ucfe,1,1,0,1,0,3,0,0,0,4,5,15,6,7,FALSE,0.466666666666667,2020,2020-2021
WV,2021-04-30,intra-ucx,1,1,0,0,0,0,0,1,0,0,1,4,2,3,FALSE,0.75,2020,2020-2021
WV,2021-04-30,intra-ui,1731,197,90,39,30,20,10,10,17,242,551,2937,2282,2479,FALSE,0.844058563159687,2020,2020-2021
WV,2021-05-31,inter-total,247,17,14,10,7,4,6,6,7,41,39,398,286,303,FALSE,0.761306532663317,2020,2020-2021
WV,2021-05-31,inter-ucfe,1,0,0,0,0,0,0,0,0,0,0,1,1,1,FALSE,1,2020,2020-2021
WV,2021-05-31,inter-ucx,0,0,0,0,0,0,0,0,0,0,0,0,0,0,FALSE,0,2020,2020-2021
WV,2021-05-31,inter-ui,246,17,14,10,7,4,6,6,7,41,39,397,285,302,FALSE,0.760705289672544,2020,2020-2021
WV,2021-05-31,intra-total,1118,192,101,68,61,29,24,15,13,231,453,2305,1571,1763,FALSE,0.764859002169198,2020,2020-2021
WV,2021-05-31,intra-ucfe,3,3,3,1,2,1,0,0,0,3,2,18,5,8,FALSE,0.444444444444444,2020,2020-2021
WV,2021-05-31,intra-ucx,3,0,1,0,0,0,0,0,0,0,1,5,4,4,FALSE,0.8,2020,2020-2021
WV,2021-05-31,intra-ui,1112,189,97,67,59,28,24,15,13,228,450,2282,1562,1751,FALSE,0.767309377738826,2020,2020-2021
WV,2021-06-30,inter-total,85,18,13,10,12,7,6,9,10,29,25,224,110,128,FALSE,0.571428571428571,2020,2020-2021
WV,2021-06-30,inter-ucfe,0,0,0,0,0,0,0,0,0,0,0,0,0,0,FALSE,0,2020,2020-2021
WV,2021-06-30,inter-ucx,0,0,0,0,0,0,0,0,0,0,0,0,0,0,FALSE,0,2020,2020-2021
WV,2021-06-30,inter-ui,85,18,13,10,12,7,6,9,10,29,25,224,110,128,FALSE,0.571428571428571,2020,2020-2021
WV,2021-06-30,intra-total,925,256,110,72,54,41,40,35,21,323,497,2374,1422,1678,FALSE,0.706823925863522,2020,2020-2021
WV,2021-06-30,intra-ucfe,1,1,0,2,1,2,0,1,1,4,1,14,2,3,FALSE,0.214285714285714,2020,2020-2021
WV,2021-06-30,intra-ucx,2,0,1,0,0,0,0,0,0,0,0,3,2,2,FALSE,0.666666666666667,2020,2020-2021
WV,2021-06-30,intra-ui,922,255,109,70,53,39,40,34,20,319,496,2357,1418,1673,FALSE,0.709800593975392,2020,2020-2021
WV,2021-07-31,inter-total,95,20,7,8,6,8,5,6,1,33,29,218,124,144,FALSE,0.660550458715596,2021,2021-2022
WV,2021-07-31,inter-ucfe,0,0,0,0,0,0,0,0,0,0,1,1,1,1,FALSE,1,2021,2021-2022
WV,2021-07-31,inter-ucx,0,0,0,0,0,0,0,0,0,0,0,0,0,0,FALSE,0,2021,2021-2022
WV,2021-07-31,inter-ui,95,20,7,8,6,8,5,6,1,33,28,217,123,143,FALSE,0.658986175115207,2021,2021-2022
WV,2021-07-31,intra-total,1119,175,84,42,48,36,23,26,16,261,411,2241,1530,1705,FALSE,0.760821062025881,2021,2021-2022
WV,2021-07-31,intra-ucfe,4,1,1,0,1,1,1,0,1,5,1,16,5,6,FALSE,0.375,2021,2021-2022
WV,2021-07-31,intra-ucx,0,0,0,0,0,0,0,1,0,0,2,3,2,2,FALSE,0.666666666666667,2021,2021-2022
WV,2021-07-31,intra-ui,1115,174,83,42,47,35,22,25,15,256,408,2222,1523,1697,FALSE,0.763726372637264,2021,2021-2022
WV,2021-08-31,inter-total,170,19,5,8,6,1,3,3,3,23,34,275,204,223,FALSE,0.810909090909091,2021,2021-2022
WV,2021-08-31,inter-ucfe,0,0,0,0,0,1,0,0,0,0,1,2,1,1,FALSE,0.5,2021,2021-2022
WV,2021-08-31,inter-ucx,0,0,0,0,0,0,0,0,0,0,0,0,0,0,FALSE,0,2021,2021-2022
WV,2021-08-31,inter-ui,170,19,5,8,6,0,3,3,3,23,33,273,203,222,FALSE,0.813186813186813,2021,2021-2022
WV,2021-08-31,intra-total,982,136,63,37,31,29,20,15,18,255,348,1934,1330,1466,FALSE,0.758014477766288,2021,2021-2022
WV,2021-08-31,intra-ucfe,2,1,0,0,1,0,0,0,0,3,2,9,4,5,FALSE,0.555555555555556,2021,2021-2022
WV,2021-08-31,intra-ucx,2,0,0,0,1,0,0,0,0,1,1,5,3,3,FALSE,0.6,2021,2021-2022
WV,2021-08-31,intra-ui,978,135,63,37,29,29,20,15,18,251,345,1920,1323,1458,FALSE,0.759375,2021,2021-2022
WV,2021-09-30,inter-total,58,22,12,6,6,2,2,1,4,36,18,167,76,98,FALSE,0.586826347305389,2021,2021-2022
WV,2021-09-30,inter-ucfe,0,0,1,0,0,1,0,0,0,1,1,4,1,1,FALSE,0.25,2021,2021-2022
WV,2021-09-30,inter-ucx,0,0,0,0,0,1,0,0,0,0,0,1,0,0,FALSE,0,2021,2021-2022
WV,2021-09-30,inter-ui,58,22,11,6,6,0,2,1,4,35,17,162,75,97,FALSE,0.598765432098765,2021,2021-2022
WV,2021-09-30,intra-total,435,127,65,26,15,17,12,10,8,281,306,1302,741,868,FALSE,0.666666666666667,2021,2021-2022
WV,2021-09-30,intra-ucfe,2,2,1,1,0,0,0,0,0,1,0,7,2,4,FALSE,0.571428571428571,2021,2021-2022
WV,2021-09-30,intra-ucx,1,1,1,0,0,0,0,0,0,0,2,5,3,4,FALSE,0.8,2021,2021-2022
WV,2021-09-30,intra-ui,432,124,63,25,15,17,12,10,8,280,304,1290,736,860,FALSE,0.666666666666667,2021,2021-2022
WV,2021-10-31,inter-total,53,9,3,2,1,5,2,1,0,16,16,108,69,78,FALSE,0.722222222222222,2021,2021-2022
WV,2021-10-31,inter-ucfe,0,0,0,0,0,0,0,0,0,0,0,0,0,0,FALSE,0,2021,2021-2022
WV,2021-10-31,inter-ucx,0,0,0,0,0,0,0,0,0,0,0,0,0,0,FALSE,0,2021,2021-2022
WV,2021-10-31,inter-ui,53,9,3,2,1,5,2,1,0,16,16,108,69,78,FALSE,0.722222222222222,2021,2021-2022
WV,2021-10-31,intra-total,476,74,32,14,11,13,15,16,13,237,201,1102,677,751,FALSE,0.681488203266788,2021,2021-2022
WV,2021-10-31,intra-ucfe,1,0,0,0,0,0,0,0,0,2,2,5,3,3,FALSE,0.6,2021,2021-2022
WV,2021-10-31,intra-ucx,3,0,0,0,0,1,0,0,0,1,1,6,4,4,FALSE,0.666666666666667,2021,2021-2022
WV,2021-10-31,intra-ui,472,74,32,14,11,12,15,16,13,234,198,1091,670,744,FALSE,0.681943171402383,2021,2021-2022
WV,2021-11-30,inter-total,117,16,10,3,2,0,1,1,0,22,19,191,136,152,FALSE,0.795811518324607,2021,2021-2022
WV,2021-11-30,inter-ucfe,0,0,1,0,0,0,0,0,0,0,0,1,0,0,FALSE,0,2021,2021-2022
WV,2021-11-30,inter-ucx,0,0,0,0,0,0,0,0,0,0,0,0,0,0,FALSE,0,2021,2021-2022
WV,2021-11-30,inter-ui,117,16,9,3,2,0,1,1,0,22,19,190,136,152,FALSE,0.8,2021,2021-2022
WV,2021-11-30,intra-total,896,101,46,25,16,7,10,6,8,164,255,1534,1151,1252,FALSE,0.816166883963494,2021,2021-2022
WV,2021-11-30,intra-ucfe,6,1,0,0,0,0,0,0,0,0,2,9,8,9,FALSE,1,2021,2021-2022
WV,2021-11-30,intra-ucx,6,0,0,1,0,0,0,0,0,0,1,8,7,7,FALSE,0.875,2021,2021-2022
WV,2021-11-30,intra-ui,884,100,46,24,16,7,10,6,8,164,252,1517,1136,1236,FALSE,0.814765985497693,2021,2021-2022
WV,2021-12-31,inter-total,133,12,6,6,4,0,3,0,2,18,40,224,173,185,FALSE,0.825892857142857,2021,2021-2022
WV,2021-12-31,inter-ucfe,0,0,0,0,0,0,0,0,0,0,0,0,0,0,FALSE,0,2021,2021-2022
WV,2021-12-31,inter-ucx,0,0,0,0,0,0,0,0,0,0,0,0,0,0,FALSE,0,2021,2021-2022
WV,2021-12-31,inter-ui,133,12,6,6,4,0,3,0,2,18,40,224,173,185,FALSE,0.825892857142857,2021,2021-2022
WV,2021-12-31,intra-total,1147,172,48,20,16,13,7,4,5,140,581,2153,1728,1900,FALSE,0.882489549465862,2021,2021-2022
WV,2021-12-31,intra-ucfe,5,0,2,1,0,0,0,0,0,0,4,12,9,9,FALSE,0.75,2021,2021-2022
WV,2021-12-31,intra-ucx,4,0,0,0,0,0,0,0,1,1,4,10,8,8,FALSE,0.8,2021,2021-2022
WV,2021-12-31,intra-ui,1138,172,46,19,16,13,7,4,4,139,573,2131,1711,1883,FALSE,0.883622712341624,2021,2021-2022
WV,2022-01-31,inter-total,227,41,14,6,4,2,3,2,0,30,82,411,309,350,FALSE,0.851581508515815,2021,2021-2022
WV,2022-01-31,inter-ucfe,0,0,0,0,0,0,1,0,0,1,1,3,1,1,FALSE,0.333333333333333,2021,2021-2022
WV,2022-01-31,inter-ucx,0,0,0,0,0,0,0,0,0,0,0,0,0,0,FALSE,0,2021,2021-2022
WV,2022-01-31,inter-ui,227,41,14,6,4,2,2,2,0,29,81,408,308,349,FALSE,0.855392156862745,2021,2021-2022
WV,2022-01-31,intra-total,1975,333,94,27,23,11,9,10,5,100,1116,3703,3091,3424,FALSE,0.92465568458007,2021,2021-2022
WV,2022-01-31,intra-ucfe,0,1,3,2,0,0,0,0,0,1,1,8,1,2,FALSE,0.25,2021,2021-2022
WV,2022-01-31,intra-ucx,1,0,0,0,0,0,0,0,0,0,2,3,3,3,FALSE,1,2021,2021-2022
WV,2022-01-31,intra-ui,1974,332,91,25,23,11,9,10,5,99,1113,3692,3087,3419,FALSE,0.926056338028169,2021,2021-2022
WV,2022-02-28,inter-total,142,43,27,6,11,4,1,2,0,15,59,310,201,244,FALSE,0.787096774193548,2021,2021-2022
WV,2022-02-28,inter-ucfe,0,0,0,0,0,0,0,0,0,0,0,0,0,0,FALSE,0,2021,2021-2022
WV,2022-02-28,inter-ucx,0,0,0,0,0,0,0,0,0,0,0,0,0,0,FALSE,0,2021,2021-2022
WV,2022-02-28,inter-ui,142,43,27,6,11,4,1,2,0,15,59,310,201,244,FALSE,0.787096774193548,2021,2021-2022
WV,2022-02-28,intra-total,1171,297,137,54,28,11,8,8,10,124,793,2641,1964,2261,FALSE,0.856115107913669,2021,2021-2022
WV,2022-02-28,intra-ucfe,3,4,0,0,1,0,0,0,0,1,1,10,4,8,FALSE,0.8,2021,2021-2022
WV,2022-02-28,intra-ucx,3,1,1,0,0,0,0,1,0,0,2,8,5,6,FALSE,0.75,2021,2021-2022
WV,2022-02-28,intra-ui,1165,292,136,54,27,11,8,7,10,123,790,2623,1955,2247,FALSE,0.856652687762104,2021,2021-2022
WV,2022-03-31,inter-total,103,9,7,5,4,4,6,4,1,17,34,194,137,146,FALSE,0.752577319587629,2021,2021-2022
WV,2022-03-31,inter-ucfe,2,0,0,0,0,0,0,0,0,0,0,2,2,2,FALSE,1,2021,2021-2022
WV,2022-03-31,inter-ucx,0,0,0,0,0,0,0,0,0,0,0,0,0,0,FALSE,0,2021,2021-2022
WV,2022-03-31,inter-ui,101,9,7,5,4,4,6,4,1,17,34,192,135,144,FALSE,0.75,2021,2021-2022
WV,2022-03-31,intra-total,718,144,62,30,29,20,13,10,6,153,367,1552,1085,1229,FALSE,0.791881443298969,2021,2021-2022
WV,2022-03-31,intra-ucfe,2,1,1,1,0,0,0,0,0,0,2,7,4,5,FALSE,0.714285714285714,2021,2021-2022
WV,2022-03-31,intra-ucx,1,0,1,0,0,0,0,0,0,0,0,2,1,1,FALSE,0.5,2021,2021-2022
WV,2022-03-31,intra-ui,715,143,60,29,29,20,13,10,6,153,365,1543,1080,1223,FALSE,0.792611795204148,2021,2021-2022
WV,2022-04-30,inter-total,82,8,8,1,6,4,3,0,3,8,25,148,107,115,FALSE,0.777027027027027,2021,2021-2022
WV,2022-04-30,inter-ucfe,0,0,0,1,0,0,0,0,0,1,0,2,0,0,FALSE,0,2021,2021-2022
WV,2022-04-30,inter-ucx,0,0,0,0,0,0,0,0,0,0,0,0,0,0,FALSE,0,2021,2021-2022
WV,2022-04-30,inter-ui,82,8,8,0,6,4,3,0,3,7,25,146,107,115,FALSE,0.787671232876712,2021,2021-2022
WV,2022-04-30,intra-total,662,82,28,19,20,10,7,12,6,141,279,1266,941,1023,FALSE,0.808056872037915,2021,2021-2022
WV,2022-04-30,intra-ucfe,2,0,1,0,1,0,0,0,0,0,1,5,3,3,FALSE,0.6,2021,2021-2022
WV,2022-04-30,intra-ucx,1,0,0,0,0,1,0,0,0,0,2,4,3,3,FALSE,0.75,2021,2021-2022
WV,2022-04-30,intra-ui,659,82,27,19,19,9,7,12,6,141,276,1257,935,1017,FALSE,0.809069212410501,2021,2021-2022
WV,2022-05-31,inter-total,77,16,1,3,3,0,3,1,0,9,36,149,113,129,FALSE,0.865771812080537,2021,2021-2022
WV,2022-05-31,inter-ucfe,0,0,0,0,0,0,0,0,0,0,0,0,0,0,FALSE,0,2021,2021-2022
WV,2022-05-31,inter-ucx,0,0,0,0,0,0,0,0,0,0,0,0,0,0,FALSE,0,2021,2021-2022
WV,2022-05-31,inter-ui,77,16,1,3,3,0,3,1,0,9,36,149,113,129,FALSE,0.865771812080537,2021,2021-2022
WV,2022-05-31,intra-total,707,112,38,21,10,6,8,2,2,143,287,1336,994,1106,FALSE,0.827844311377245,2021,2021-2022
WV,2022-05-31,intra-ucfe,1,0,0,3,1,1,0,0,0,0,0,6,1,1,FALSE,0.166666666666667,2021,2021-2022
WV,2022-05-31,intra-ucx,4,2,1,0,0,0,0,0,0,0,2,9,6,8,FALSE,0.888888888888889,2021,2021-2022
WV,2022-05-31,intra-ui,702,110,37,18,9,5,8,2,2,143,285,1321,987,1097,FALSE,0.830431491294474,2021,2021-2022
WV,2022-06-30,inter-total,77,21,10,3,1,3,1,4,0,6,34,160,111,132,FALSE,0.825,2021,2021-2022
WV,2022-06-30,inter-ucfe,1,0,0,0,0,0,0,0,0,0,0,1,1,1,FALSE,1,2021,2021-2022
WV,2022-06-30,inter-ucx,0,0,0,0,0,0,0,0,0,0,0,0,0,0,FALSE,0,2021,2021-2022
WV,2022-06-30,inter-ui,76,21,10,3,1,3,1,4,0,6,34,159,110,131,FALSE,0.823899371069182,2021,2021-2022
WV,2022-06-30,intra-total,947,152,44,18,12,14,5,6,1,92,428,1719,1375,1527,FALSE,0.888307155322862,2021,2021-2022
WV,2022-06-30,intra-ucfe,6,0,0,2,0,0,0,0,0,0,0,8,6,6,FALSE,0.75,2021,2021-2022
WV,2022-06-30,intra-ucx,1,1,0,0,0,0,0,0,0,0,1,3,2,3,FALSE,1,2021,2021-2022
WV,2022-06-30,intra-ui,940,151,44,16,12,14,5,6,1,92,427,1708,1367,1518,FALSE,0.888758782201405,2021,2021-2022
WV,2022-07-31,inter-total,63,11,9,4,1,0,0,0,3,4,39,134,102,113,FALSE,0.843283582089552,2022,2022-2023
WV,2022-07-31,inter-ucfe,0,0,0,0,0,0,0,0,1,0,1,2,1,1,FALSE,0.5,2022,2022-2023
WV,2022-07-31,inter-ucx,0,0,0,0,0,0,0,0,0,0,0,0,0,0,FALSE,0,2022,2022-2023
WV,2022-07-31,inter-ui,63,11,9,4,1,0,0,0,2,4,38,132,101,112,FALSE,0.848484848484848,2022,2022-2023
WV,2022-07-31,intra-total,496,181,33,17,14,11,11,5,6,62,378,1214,874,1055,FALSE,0.869028006589786,2022,2022-2023
WV,2022-07-31,intra-ucfe,0,0,0,0,0,1,0,0,0,1,1,3,1,1,FALSE,0.333333333333333,2022,2022-2023
WV,2022-07-31,intra-ucx,1,0,0,0,0,0,0,0,0,1,2,4,3,3,FALSE,0.75,2022,2022-2023
WV,2022-07-31,intra-ui,495,181,33,17,14,10,11,5,6,60,375,1207,870,1051,FALSE,0.870753935376968,2022,2022-2023
WV,2022-08-31,inter-total,65,25,17,11,0,3,2,0,1,5,37,166,102,127,FALSE,0.765060240963855,2022,2022-2023
WV,2022-08-31,inter-ucfe,1,0,0,0,0,0,0,0,0,0,0,1,1,1,FALSE,1,2022,2022-2023
WV,2022-08-31,inter-ucx,0,0,0,0,0,0,0,0,0,0,0,0,0,0,FALSE,0,2022,2022-2023
WV,2022-08-31,inter-ui,64,25,17,11,0,3,2,0,1,5,37,165,101,126,FALSE,0.763636363636364,2022,2022-2023
WV,2022-08-31,intra-total,642,230,93,43,19,17,10,6,3,77,376,1516,1018,1248,FALSE,0.823218997361478,2022,2022-2023
WV,2022-08-31,intra-ucfe,2,0,0,0,0,0,0,0,0,3,1,6,3,3,FALSE,0.5,2022,2022-2023
WV,2022-08-31,intra-ucx,3,0,0,0,0,0,0,0,0,0,1,4,4,4,FALSE,1,2022,2022-2023
WV,2022-08-31,intra-ui,637,230,93,43,19,17,10,6,3,74,374,1506,1011,1241,FALSE,0.824037184594954,2022,2022-2023
WV,2022-09-30,inter-total,57,11,2,2,2,2,5,2,0,5,35,123,92,103,FALSE,0.83739837398374,2022,2022-2023
WV,2022-09-30,inter-ucfe,1,0,0,0,0,0,0,0,0,0,0,1,1,1,FALSE,1,2022,2022-2023
WV,2022-09-30,inter-ucx,0,0,0,0,0,0,0,0,0,0,0,0,0,0,FALSE,0,2022,2022-2023
WV,2022-09-30,inter-ui,56,11,2,2,2,2,5,2,0,5,35,122,91,102,FALSE,0.836065573770492,2022,2022-2023
WV,2022-09-30,intra-total,459,84,34,21,8,9,21,16,9,38,225,924,684,768,FALSE,0.831168831168831,2022,2022-2023
WV,2022-09-30,intra-ucfe,2,2,2,0,0,1,0,2,0,1,0,10,2,4,FALSE,0.4,2022,2022-2023
WV,2022-09-30,intra-ucx,0,0,0,0,0,0,0,0,0,1,0,1,0,0,FALSE,0,2022,2022-2023
WV,2022-09-30,intra-ui,457,82,32,21,8,8,21,14,9,36,225,913,682,764,FALSE,0.836801752464403,2022,2022-2023
WV,2022-10-31,inter-total,97,9,2,0,2,2,0,1,1,3,28,145,125,134,FALSE,0.924137931034483,2022,2022-2023
WV,2022-10-31,inter-ucfe,0,0,0,0,0,0,0,0,0,0,0,0,0,0,FALSE,0,2022,2022-2023
WV,2022-10-31,inter-ucx,0,0,0,0,0,0,0,0,0,0,0,0,0,0,FALSE,0,2022,2022-2023
WV,2022-10-31,inter-ui,97,9,2,0,2,2,0,1,1,3,28,145,125,134,FALSE,0.924137931034483,2022,2022-2023
WV,2022-10-31,intra-total,668,53,29,6,16,15,11,10,6,31,218,1063,886,939,FALSE,0.883349012229539,2022,2022-2023
WV,2022-10-31,intra-ucfe,2,0,0,0,0,0,0,0,0,0,0,2,2,2,FALSE,1,2022,2022-2023
WV,2022-10-31,intra-ucx,4,0,0,0,1,0,0,0,0,0,0,5,4,4,FALSE,0.8,2022,2022-2023
WV,2022-10-31,intra-ui,662,53,29,6,15,15,11,10,6,31,218,1056,880,933,FALSE,0.883522727272727,2022,2022-2023
WV,2022-11-30,inter-total,138,16,8,3,0,1,2,0,0,5,35,208,173,189,FALSE,0.908653846153846,2022,2022-2023
WV,2022-11-30,inter-ucfe,0,0,0,0,0,0,0,0,0,0,1,1,1,1,FALSE,1,2022,2022-2023
WV,2022-11-30,inter-ucx,0,0,0,0,0,0,0,0,0,0,0,0,0,0,FALSE,0,2022,2022-2023
WV,2022-11-30,inter-ui,138,16,8,3,0,1,2,0,0,5,34,207,172,188,FALSE,0.908212560386474,2022,2022-2023
WV,2022-11-30,intra-total,1071,112,26,13,12,14,10,4,5,25,324,1616,1395,1507,FALSE,0.932549504950495,2022,2022-2023
WV,2022-11-30,intra-ucfe,3,4,0,1,0,0,0,0,0,0,2,10,5,9,FALSE,0.9,2022,2022-2023
WV,2022-11-30,intra-ucx,1,1,0,0,0,1,0,0,0,0,1,4,2,3,FALSE,0.75,2022,2022-2023
WV,2022-11-30,intra-ui,1067,107,26,12,12,13,10,4,5,25,321,1602,1388,1495,FALSE,0.933208489388265,2022,2022-2023
WV,2022-12-31,inter-total,191,20,8,5,2,1,1,0,1,4,56,289,247,267,FALSE,0.923875432525952,2022,2022-2023
WV,2022-12-31,inter-ucfe,0,0,0,0,0,0,0,0,0,0,0,0,0,0,FALSE,0,2022,2022-2023
WV,2022-12-31,inter-ucx,0,0,0,0,0,0,0,0,0,0,0,0,0,0,FALSE,0,2022,2022-2023
WV,2022-12-31,inter-ui,191,20,8,5,2,1,1,0,1,4,56,289,247,267,FALSE,0.923875432525952,2022,2022-2023
WV,2022-12-31,intra-total,1395,209,50,29,10,10,5,6,1,42,673,2430,2068,2277,FALSE,0.937037037037037,2022,2022-2023
WV,2022-12-31,intra-ucfe,4,0,0,0,0,0,0,0,0,0,7,11,11,11,FALSE,1,2022,2022-2023
WV,2022-12-31,intra-ucx,4,0,0,0,1,0,0,0,0,0,4,9,8,8,FALSE,0.888888888888889,2022,2022-2023
WV,2022-12-31,intra-ui,1387,209,50,29,9,10,5,6,1,42,662,2410,2049,2258,FALSE,0.936929460580913,2022,2022-2023
WV,2023-01-31,inter-total,315,42,9,5,3,1,1,0,0,3,115,494,430,472,FALSE,0.955465587044534,2022,2022-2023
WV,2023-01-31,inter-ucfe,0,0,0,0,0,0,0,0,0,0,0,0,0,0,FALSE,0,2022,2022-2023
WV,2023-01-31,inter-ucx,0,0,0,0,0,0,0,0,0,0,0,0,0,0,FALSE,0,2022,2022-2023
WV,2023-01-31,inter-ui,315,42,9,5,3,1,1,0,0,3,115,494,430,472,FALSE,0.955465587044534,2022,2022-2023
WV,2023-01-31,intra-total,2126,324,96,32,10,9,9,5,2,19,1189,3821,3315,3639,FALSE,0.952368489924104,2022,2022-2023
WV,2023-01-31,intra-ucfe,2,2,0,0,0,0,0,0,0,0,3,7,5,7,FALSE,1,2022,2022-2023
WV,2023-01-31,intra-ucx,2,1,2,0,0,0,0,0,0,0,1,6,3,4,FALSE,0.666666666666667,2022,2022-2023
WV,2023-01-31,intra-ui,2122,321,94,32,10,9,9,5,2,19,1185,3808,3307,3628,FALSE,0.952731092436975,2022,2022-2023
WV,2023-02-28,inter-total,179,30,12,2,2,2,1,0,0,1,57,286,236,266,FALSE,0.93006993006993,2022,2022-2023
WV,2023-02-28,inter-ucfe,0,0,0,0,0,0,0,0,0,0,0,0,0,0,FALSE,0,2022,2022-2023
WV,2023-02-28,inter-ucx,0,0,0,0,0,0,0,0,0,0,0,0,0,0,FALSE,0,2022,2022-2023
WV,2023-02-28,inter-ui,179,30,12,2,2,2,1,0,0,1,57,286,236,266,FALSE,0.93006993006993,2022,2022-2023
WV,2023-02-28,intra-total,1208,195,65,33,24,10,4,12,2,14,594,2161,1802,1997,FALSE,0.924109208699676,2022,2022-2023
WV,2023-02-28,intra-ucfe,3,2,0,0,0,0,0,0,0,0,1,6,4,6,FALSE,1,2022,2022-2023
WV,2023-02-28,intra-ucx,1,0,0,0,0,0,0,0,0,0,0,1,1,1,FALSE,1,2022,2022-2023
WV,2023-02-28,intra-ui,1204,193,65,33,24,10,4,12,2,14,593,2154,1797,1990,FALSE,0.923862581244197,2022,2022-2023
WV,2023-03-31,inter-total,139,15,6,6,6,4,3,2,3,5,42,231,181,196,FALSE,0.848484848484848,2022,2022-2023
WV,2023-03-31,inter-ucfe,0,0,0,0,1,1,0,0,1,0,0,3,0,0,FALSE,0,2022,2022-2023
WV,2023-03-31,inter-ucx,0,0,0,0,0,0,0,0,0,0,0,0,0,0,FALSE,0,2022,2022-2023
WV,2023-03-31,inter-ui,139,15,6,6,5,3,3,2,2,5,42,228,181,196,FALSE,0.859649122807018,2022,2022-2023
WV,2023-03-31,intra-total,928,100,33,18,25,22,11,6,6,59,370,1578,1298,1398,FALSE,0.885931558935361,2022,2022-2023
WV,2023-03-31,intra-ucfe,0,0,1,0,0,0,0,0,0,0,0,1,0,0,FALSE,0,2022,2022-2023
WV,2023-03-31,intra-ucx,3,0,0,0,0,0,0,0,0,0,0,3,3,3,FALSE,1,2022,2022-2023
WV,2023-03-31,intra-ui,925,100,32,18,25,22,11,6,6,59,370,1574,1295,1395,FALSE,0.886277001270648,2022,2022-2023
WV,2023-04-30,inter-total,85,10,2,3,1,2,0,1,1,4,30,139,115,125,FALSE,0.899280575539568,2022,2022-2023
WV,2023-04-30,inter-ucfe,0,0,0,0,0,0,0,0,0,0,0,0,0,0,FALSE,0,2022,2022-2023
WV,2023-04-30,inter-ucx,0,0,0,0,0,0,0,0,0,0,0,0,0,0,FALSE,0,2022,2022-2023
WV,2023-04-30,inter-ui,85,10,2,3,1,2,0,1,1,4,30,139,115,125,FALSE,0.899280575539568,2022,2022-2023
WV,2023-04-30,intra-total,664,87,27,13,15,17,7,5,3,41,265,1144,929,1016,FALSE,0.888111888111888,2022,2022-2023
WV,2023-04-30,intra-ucfe,1,0,0,0,0,0,1,0,0,1,2,5,3,3,FALSE,0.6,2022,2022-2023
WV,2023-04-30,intra-ucx,2,0,0,0,0,0,0,0,0,0,1,3,3,3,FALSE,1,2022,2022-2023
WV,2023-04-30,intra-ui,661,87,27,13,15,17,6,5,3,40,262,1136,923,1010,FALSE,0.889084507042254,2022,2022-2023
WV,2023-05-31,inter-total,107,9,1,2,0,4,0,1,1,2,29,156,136,145,FALSE,0.92948717948718,2022,2022-2023
WV,2023-05-31,inter-ucfe,0,0,0,0,0,0,0,0,0,0,0,0,0,0,FALSE,0,2022,2022-2023
WV,2023-05-31,inter-ucx,0,0,0,0,0,0,0,0,0,0,0,0,0,0,FALSE,0,2022,2022-2023
WV,2023-05-31,inter-ui,107,9,1,2,0,4,0,1,1,2,29,156,136,145,FALSE,0.92948717948718,2022,2022-2023
WV,2023-05-31,intra-total,943,97,28,10,14,9,8,2,5,29,316,1461,1259,1356,FALSE,0.928131416837782,2022,2022-2023
WV,2023-05-31,intra-ucfe,1,1,1,2,0,0,0,0,0,0,0,5,1,2,FALSE,0.4,2022,2022-2023
WV,2023-05-31,intra-ucx,0,0,0,0,0,0,0,0,0,0,0,0,0,0,FALSE,0,2022,2022-2023
WV,2023-05-31,intra-ui,942,96,27,8,14,9,8,2,5,29,316,1456,1258,1354,FALSE,0.929945054945055,2022,2022-2023
WV,2023-06-30,inter-total,187,18,4,5,2,3,0,0,0,4,69,292,256,274,FALSE,0.938356164383562,2022,2022-2023
WV,2023-06-30,inter-ucfe,0,0,0,0,0,0,0,0,0,0,0,0,0,0,FALSE,0,2022,2022-2023
WV,2023-06-30,inter-ucx,0,0,0,0,0,0,0,0,0,0,0,0,0,0,FALSE,0,2022,2022-2023
WV,2023-06-30,inter-ui,187,18,4,5,2,3,0,0,0,4,69,292,256,274,FALSE,0.938356164383562,2022,2022-2023
WV,2023-06-30,intra-total,1131,128,33,11,13,11,6,8,5,11,505,1862,1636,1764,FALSE,0.947368421052632,2022,2022-2023
WV,2023-06-30,intra-ucfe,2,0,0,0,0,0,0,0,0,0,3,5,5,5,FALSE,1,2022,2022-2023
WV,2023-06-30,intra-ucx,0,0,0,0,1,0,0,0,0,0,0,1,0,0,FALSE,0,2022,2022-2023
WV,2023-06-30,intra-ui,1129,128,33,11,12,11,6,8,5,11,502,1856,1631,1759,FALSE,0.947737068965517,2022,2022-2023
WV,2023-07-31,inter-total,110,36,7,1,1,3,0,2,0,5,42,207,152,188,FALSE,0.908212560386474,2023,2023-2024
WV,2023-07-31,inter-ucfe,1,2,0,0,0,0,0,0,0,0,1,4,2,4,FALSE,1,2023,2023-2024
WV,2023-07-31,inter-ucx,0,0,0,0,0,0,0,0,0,0,0,0,0,0,FALSE,0,2023,2023-2024
WV,2023-07-31,inter-ui,109,34,7,1,1,3,0,2,0,5,41,203,150,184,FALSE,0.906403940886699,2023,2023-2024
WV,2023-07-31,intra-total,917,196,51,20,20,9,10,5,1,10,392,1631,1309,1505,FALSE,0.92274678111588,2023,2023-2024
WV,2023-07-31,intra-ucfe,2,1,0,0,1,0,0,0,0,0,4,8,6,7,FALSE,0.875,2023,2023-2024
WV,2023-07-31,intra-ucx,2,0,1,0,0,0,0,0,0,0,0,3,2,2,FALSE,0.666666666666667,2023,2023-2024
WV,2023-07-31,intra-ui,913,195,50,20,19,9,10,5,1,10,388,1620,1301,1496,FALSE,0.923456790123457,2023,2023-2024
WV,2023-08-31,inter-total,158,20,6,1,4,2,0,1,0,1,44,237,202,222,FALSE,0.936708860759494,2023,2023-2024
WV,2023-08-31,inter-ucfe,0,0,0,0,0,1,0,0,0,0,0,1,0,0,FALSE,0,2023,2023-2024
WV,2023-08-31,inter-ucx,0,0,0,0,0,0,0,0,0,0,0,0,0,0,FALSE,0,2023,2023-2024
WV,2023-08-31,inter-ui,158,20,6,1,4,1,0,1,0,1,44,236,202,222,FALSE,0.940677966101695,2023,2023-2024
WV,2023-08-31,intra-total,903,123,32,18,9,15,10,5,5,18,379,1517,1282,1405,FALSE,0.926170072511536,2023,2023-2024
WV,2023-08-31,intra-ucfe,5,1,0,1,0,0,0,0,0,0,1,8,6,7,FALSE,0.875,2023,2023-2024
WV,2023-08-31,intra-ucx,1,0,0,0,0,0,0,0,0,0,0,1,1,1,FALSE,1,2023,2023-2024
WV,2023-08-31,intra-ui,897,122,32,17,9,15,10,5,5,18,378,1508,1275,1397,FALSE,0.926392572944297,2023,2023-2024
WV,2023-09-30,inter-total,74,5,2,2,1,1,1,3,1,3,29,122,103,108,FALSE,0.885245901639344,2023,2023-2024
WV,2023-09-30,inter-ucfe,0,0,0,0,0,0,0,0,0,0,0,0,0,0,FALSE,0,2023,2023-2024
WV,2023-09-30,inter-ucx,0,0,0,0,0,0,0,0,0,0,0,0,0,0,FALSE,0,2023,2023-2024
WV,2023-09-30,inter-ui,74,5,2,2,1,1,1,3,1,3,29,122,103,108,FALSE,0.885245901639344,2023,2023-2024
WV,2023-09-30,intra-total,676,63,14,4,12,5,8,7,3,10,282,1084,958,1021,FALSE,0.941881918819188,2023,2023-2024
WV,2023-09-30,intra-ucfe,0,0,2,0,0,0,0,0,0,1,1,4,1,1,FALSE,0.25,2023,2023-2024
WV,2023-09-30,intra-ucx,1,0,0,0,0,0,0,0,0,0,0,1,1,1,FALSE,1,2023,2023-2024
WV,2023-09-30,intra-ui,675,63,12,4,12,5,8,7,3,9,281,1079,956,1019,FALSE,0.944392956441149,2023,2023-2024
WV,2023-10-31,inter-total,82,9,3,2,1,1,1,1,0,4,28,132,110,119,FALSE,0.901515151515152,2023,2023-2024
WV,2023-10-31,inter-ucfe,0,1,0,0,0,0,0,0,0,0,0,1,0,1,FALSE,1,2023,2023-2024
WV,2023-10-31,inter-ucx,0,0,0,0,0,0,0,0,0,0,0,0,0,0,FALSE,0,2023,2023-2024
WV,2023-10-31,inter-ui,82,8,3,2,1,1,1,1,0,4,28,131,110,118,FALSE,0.900763358778626,2023,2023-2024
WV,2023-10-31,intra-total,708,51,18,11,7,9,9,6,3,28,299,1149,1007,1058,FALSE,0.920800696257615,2023,2023-2024
WV,2023-10-31,intra-ucfe,3,1,1,0,0,0,0,0,0,0,1,6,4,5,FALSE,0.833333333333333,2023,2023-2024
WV,2023-10-31,intra-ucx,5,0,0,1,0,0,0,0,0,0,1,7,6,6,FALSE,0.857142857142857,2023,2023-2024
WV,2023-10-31,intra-ui,700,50,17,10,7,9,9,6,3,28,297,1136,997,1047,FALSE,0.921654929577465,2023,2023-2024
WV,2023-11-30,inter-total,123,11,2,2,0,1,4,0,0,2,47,192,170,181,FALSE,0.942708333333333,2023,2023-2024
WV,2023-11-30,inter-ucfe,1,0,0,0,0,0,0,0,0,0,0,1,1,1,FALSE,1,2023,2023-2024
WV,2023-11-30,inter-ucx,0,0,0,0,0,0,0,0,0,0,0,0,0,0,FALSE,0,2023,2023-2024
WV,2023-11-30,inter-ui,122,11,2,2,0,1,4,0,0,2,47,191,169,180,FALSE,0.942408376963351,2023,2023-2024
WV,2023-11-30,intra-total,935,122,31,14,9,11,5,3,3,38,336,1507,1271,1393,FALSE,0.92435301924353,2023,2023-2024
WV,2023-11-30,intra-ucfe,0,0,0,1,0,0,0,0,0,1,2,4,2,2,FALSE,0.5,2023,2023-2024
WV,2023-11-30,intra-ucx,3,0,0,0,0,1,0,0,0,0,1,5,4,4,FALSE,0.8,2023,2023-2024
WV,2023-11-30,intra-ui,932,122,31,13,9,10,5,3,3,37,333,1498,1265,1387,FALSE,0.925901201602136,2023,2023-2024
WV,2023-12-31,inter-total,218,26,7,0,2,2,0,0,0,3,61,319,279,305,FALSE,0.956112852664577,2023,2023-2024
WV,2023-12-31,inter-ucfe,0,0,0,0,0,0,0,0,0,0,0,0,0,0,FALSE,0,2023,2023-2024
WV,2023-12-31,inter-ucx,0,0,0,0,0,0,0,0,0,0,0,0,0,0,FALSE,0,2023,2023-2024
WV,2023-12-31,inter-ui,218,26,7,0,2,2,0,0,0,3,61,319,279,305,FALSE,0.956112852664577,2023,2023-2024
WV,2023-12-31,intra-total,1414,160,53,16,11,12,7,3,3,26,695,2400,2109,2269,FALSE,0.945416666666667,2023,2023-2024
WV,2023-12-31,intra-ucfe,2,0,0,1,0,0,0,0,0,0,6,9,8,8,FALSE,0.888888888888889,2023,2023-2024
WV,2023-12-31,intra-ucx,3,0,0,0,0,0,0,0,0,0,0,3,3,3,FALSE,1,2023,2023-2024
WV,2023-12-31,intra-ui,1409,160,53,15,11,12,7,3,3,26,689,2388,2098,2258,FALSE,0.945561139028476,2023,2023-2024
WV,2024-01-31,inter-total,337,28,14,3,5,4,2,0,0,0,120,513,457,485,FALSE,0.94541910331384,2023,2023-2024
WV,2024-01-31,inter-ucfe,0,1,1,0,0,0,0,0,0,0,0,2,0,1,FALSE,0.5,2023,2023-2024
WV,2024-01-31,inter-ucx,0,0,0,0,0,0,0,0,0,0,0,0,0,0,FALSE,0,2023,2023-2024
WV,2024-01-31,inter-ui,337,27,13,3,5,4,2,0,0,0,120,511,457,484,FALSE,0.947162426614481,2023,2023-2024
WV,2024-01-31,intra-total,2374,443,132,35,24,14,11,4,2,15,1490,4544,3864,4307,FALSE,0.947843309859155,2023,2023-2024
WV,2024-01-31,intra-ucfe,5,1,1,0,1,0,0,0,0,2,5,15,10,11,FALSE,0.733333333333333,2023,2023-2024
WV,2024-01-31,intra-ucx,2,0,0,0,0,0,0,0,0,0,0,2,2,2,FALSE,1,2023,2023-2024
WV,2024-01-31,intra-ui,2367,442,131,35,23,14,11,4,2,13,1485,4527,3852,4294,FALSE,0.948531036006185,2023,2023-2024
WV,2024-02-29,inter-total,202,41,10,6,2,2,1,0,2,2,79,347,281,322,FALSE,0.927953890489914,2023,2023-2024
WV,2024-02-29,inter-ucfe,0,0,0,0,0,0,0,0,0,1,1,2,1,1,FALSE,0.5,2023,2023-2024
WV,2024-02-29,inter-ucx,0,0,0,0,0,0,0,0,0,0,0,0,0,0,FALSE,0,2023,2023-2024
WV,2024-02-29,inter-ui,202,41,10,6,2,2,1,0,2,1,78,345,280,321,FALSE,0.930434782608696,2023,2023-2024
WV,2024-02-29,intra-total,1238,310,82,31,21,17,9,7,1,12,680,2408,1918,2228,FALSE,0.925249169435216,2023,2023-2024
WV,2024-02-29,intra-ucfe,0,2,1,0,0,0,0,0,0,1,3,7,3,5,FALSE,0.714285714285714,2023,2023-2024
WV,2024-02-29,intra-ucx,4,0,1,0,0,0,0,0,0,0,0,5,4,4,FALSE,0.8,2023,2023-2024
WV,2024-02-29,intra-ui,1234,308,80,31,21,17,9,7,1,11,677,2396,1911,2219,FALSE,0.926126878130217,2023,2023-2024
WV,2024-03-31,inter-total,186,11,8,9,5,3,2,2,0,4,53,283,239,250,FALSE,0.88339222614841,2023,2023-2024
WV,2024-03-31,inter-ucfe,0,0,0,0,0,0,0,0,0,0,1,1,1,1,FALSE,1,2023,2023-2024
WV,2024-03-31,inter-ucx,0,0,0,0,0,0,0,0,0,0,0,0,0,0,FALSE,0,2023,2023-2024
WV,2024-03-31,inter-ui,186,11,8,9,5,3,2,2,0,4,52,282,238,249,FALSE,0.882978723404255,2023,2023-2024
WV,2024-03-31,intra-total,1076,135,38,8,13,18,9,5,6,10,399,1717,1475,1610,FALSE,0.937682003494467,2023,2023-2024
WV,2024-03-31,intra-ucfe,0,2,1,0,1,0,0,0,0,0,1,5,1,3,FALSE,0.6,2023,2023-2024
WV,2024-03-31,intra-ucx,2,1,0,0,0,0,0,0,0,0,2,5,4,5,FALSE,1,2023,2023-2024
WV,2024-03-31,intra-ui,1074,132,37,8,12,18,9,5,6,10,396,1707,1470,1602,FALSE,0.938488576449912,2023,2023-2024
WV,2024-04-30,inter-total,207,19,11,2,2,2,3,1,1,2,50,300,257,276,FALSE,0.92,2023,2023-2024
WV,2024-04-30,inter-ucfe,0,0,0,0,0,0,0,0,0,0,0,0,0,0,FALSE,0,2023,2023-2024
WV,2024-04-30,inter-ucx,0,0,0,0,0,0,0,0,0,0,0,0,0,0,FALSE,0,2023,2023-2024
WV,2024-04-30,inter-ui,207,19,11,2,2,2,3,1,1,2,50,300,257,276,FALSE,0.92,2023,2023-2024
WV,2024-04-30,intra-total,1055,122,39,12,10,18,12,5,0,9,415,1697,1470,1592,FALSE,0.938126104890984,2023,2023-2024
WV,2024-04-30,intra-ucfe,3,2,1,0,0,0,1,0,0,0,3,10,6,8,FALSE,0.8,2023,2023-2024
WV,2024-04-30,intra-ucx,4,0,0,0,0,0,0,0,0,0,2,6,6,6,FALSE,1,2023,2023-2024
WV,2024-04-30,intra-ui,1048,120,38,12,10,18,11,5,0,9,410,1681,1458,1578,FALSE,0.938726948245092,2023,2023-2024
WV,2024-05-31,inter-total,272,14,4,5,1,1,1,1,0,2,47,348,319,333,FALSE,0.956896551724138,2023,2023-2024
WV,2024-05-31,inter-ucfe,0,0,0,0,0,0,0,0,0,0,0,0,0,0,FALSE,0,2023,2023-2024
WV,2024-05-31,inter-ucx,0,0,0,0,0,0,0,0,0,0,0,0,0,0,FALSE,0,2023,2023-2024
WV,2024-05-31,inter-ui,272,14,4,5,1,1,1,1,0,2,47,348,319,333,FALSE,0.956896551724138,2023,2023-2024
WV,2024-05-31,intra-total,1033,108,41,11,16,5,5,2,0,9,352,1582,1385,1493,FALSE,0.943742098609355,2023,2023-2024
WV,2024-05-31,intra-ucfe,1,0,0,1,0,0,0,0,0,0,1,3,2,2,FALSE,0.666666666666667,2023,2023-2024
WV,2024-05-31,intra-ucx,1,0,0,0,0,0,0,0,0,0,1,2,2,2,FALSE,1,2023,2023-2024
WV,2024-05-31,intra-ui,1031,108,41,10,16,5,5,2,0,9,350,1577,1381,1489,FALSE,0.944197844007609,2023,2023-2024
WV,2024-06-30,inter-total,167,13,6,2,3,1,3,0,0,1,50,246,217,230,FALSE,0.934959349593496,2023,2023-2024
WV,2024-06-30,inter-ucfe,0,0,0,0,0,0,0,0,0,0,0,0,0,0,FALSE,0,2023,2023-2024
WV,2024-06-30,inter-ucx,0,0,0,0,0,0,0,0,0,0,0,0,0,0,FALSE,0,2023,2023-2024
WV,2024-06-30,inter-ui,167,13,6,2,3,1,3,0,0,1,50,246,217,230,FALSE,0.934959349593496,2023,2023-2024
WV,2024-06-30,intra-total,924,139,46,13,9,14,10,2,1,7,458,1623,1382,1521,FALSE,0.937153419593346,2023,2023-2024
WV,2024-06-30,intra-ucfe,0,1,0,0,0,0,0,0,0,0,0,1,0,1,FALSE,1,2023,2023-2024
WV,2024-06-30,intra-ucx,4,0,0,0,0,0,0,0,0,0,1,5,5,5,FALSE,1,2023,2023-2024
WV,2024-06-30,intra-ui,920,138,46,13,9,14,10,2,1,7,457,1617,1377,1515,FALSE,0.936920222634508,2023,2023-2024
WV,2024-07-31,inter-total,176,15,7,2,2,0,2,2,1,1,53,261,229,244,FALSE,0.934865900383142,2024,2024-2025
WV,2024-07-31,inter-ucfe,2,0,0,0,0,0,1,0,0,0,0,3,2,2,FALSE,0.666666666666667,2024,2024-2025
WV,2024-07-31,inter-ucx,0,0,0,0,0,0,0,0,0,0,0,0,0,0,FALSE,0,2024,2024-2025
WV,2024-07-31,inter-ui,174,15,7,2,2,0,1,2,1,1,53,258,227,242,FALSE,0.937984496124031,2024,2024-2025
WV,2024-07-31,intra-total,934,173,64,17,8,13,12,2,4,6,508,1741,1442,1615,FALSE,0.927627800114877,2024,2024-2025
WV,2024-07-31,intra-ucfe,1,1,1,0,1,0,0,0,0,0,3,7,4,5,FALSE,0.714285714285714,2024,2024-2025
WV,2024-07-31,intra-ucx,5,0,0,0,0,0,0,0,0,0,0,5,5,5,FALSE,1,2024,2024-2025
WV,2024-07-31,intra-ui,928,172,63,17,7,13,12,2,4,6,505,1729,1433,1605,FALSE,0.928282244071718,2024,2024-2025
WV,2024-08-31,inter-total,94,7,2,1,2,2,1,2,1,2,37,151,131,138,FALSE,0.913907284768212,2024,2024-2025
WV,2024-08-31,inter-ucfe,0,0,0,0,0,0,0,0,0,0,0,0,0,0,FALSE,0,2024,2024-2025
WV,2024-08-31,inter-ucx,0,0,0,0,0,0,0,0,0,0,1,1,1,1,FALSE,1,2024,2024-2025
WV,2024-08-31,inter-ui,94,7,2,1,2,2,1,2,1,2,36,150,130,137,FALSE,0.913333333333333,2024,2024-2025
WV,2024-08-31,intra-total,664,96,33,15,9,10,6,3,2,7,317,1162,981,1077,FALSE,0.926850258175559,2024,2024-2025
WV,2024-08-31,intra-ucfe,2,1,0,0,1,0,0,0,0,0,0,4,2,3,FALSE,0.75,2024,2024-2025
WV,2024-08-31,intra-ucx,1,0,0,0,0,0,0,0,0,0,0,1,1,1,FALSE,1,2024,2024-2025
WV,2024-08-31,intra-ui,661,95,33,15,8,10,6,3,2,7,317,1157,978,1073,FALSE,0.927398444252377,2024,2024-2025
WV,2024-09-30,inter-total,89,3,3,2,1,1,0,0,0,4,38,141,127,130,FALSE,0.921985815602837,2024,2024-2025
WV,2024-09-30,inter-ucfe,0,0,0,0,0,0,0,0,0,0,0,0,0,0,FALSE,0,2024,2024-2025
WV,2024-09-30,inter-ucx,0,0,0,0,0,0,0,0,0,0,0,0,0,0,FALSE,0,2024,2024-2025
WV,2024-09-30,inter-ui,89,3,3,2,1,1,0,0,0,4,38,141,127,130,FALSE,0.921985815602837,2024,2024-2025
WV,2024-09-30,intra-total,713,59,22,8,13,16,3,5,2,6,260,1107,973,1032,FALSE,0.932249322493225,2024,2024-2025
WV,2024-09-30,intra-ucfe,1,0,1,1,0,1,0,0,0,0,2,6,3,3,FALSE,0.5,2024,2024-2025
WV,2024-09-30,intra-ucx,1,1,0,0,0,0,0,0,0,0,0,2,1,2,FALSE,1,2024,2024-2025
WV,2024-09-30,intra-ui,711,58,21,7,13,15,3,5,2,6,258,1099,969,1027,FALSE,0.934485896269336,2024,2024-2025
WV,2024-10-31,inter-total,109,3,2,1,1,0,0,0,0,2,33,151,142,145,FALSE,0.960264900662252,2024,2024-2025
WV,2024-10-31,inter-ucfe,0,0,0,0,0,0,0,0,0,0,0,0,0,0,FALSE,0,2024,2024-2025
WV,2024-10-31,inter-ucx,0,0,0,0,0,0,0,0,0,0,0,0,0,0,FALSE,0,2024,2024-2025
WV,2024-10-31,inter-ui,109,3,2,1,1,0,0,0,0,2,33,151,142,145,FALSE,0.960264900662252,2024,2024-2025
WV,2024-10-31,intra-total,784,76,15,10,13,16,6,1,3,9,383,1316,1167,1243,FALSE,0.944528875379939,2024,2024-2025
WV,2024-10-31,intra-ucfe,2,1,0,0,0,1,0,0,0,0,1,5,3,4,FALSE,0.8,2024,2024-2025
WV,2024-10-31,intra-ucx,2,1,0,0,0,0,0,0,0,0,1,4,3,4,FALSE,1,2024,2024-2025
WV,2024-10-31,intra-ui,780,74,15,10,13,15,6,1,3,9,381,1307,1161,1235,FALSE,0.944912012241775,2024,2024-2025
WV,2024-11-30,inter-total,113,6,4,2,0,2,4,0,0,0,25,156,138,144,FALSE,0.923076923076923,2024,2024-2025
WV,2024-11-30,inter-ucfe,0,0,0,0,0,0,0,0,0,0,0,0,0,0,FALSE,0,2024,2024-2025
WV,2024-11-30,inter-ucx,0,0,0,0,0,0,0,0,0,0,0,0,0,0,FALSE,0,2024,2024-2025
WV,2024-11-30,inter-ui,113,6,4,2,0,2,4,0,0,0,25,156,138,144,FALSE,0.923076923076923,2024,2024-2025
WV,2024-11-30,intra-total,825,93,32,11,3,11,7,5,3,6,381,1377,1206,1299,FALSE,0.943355119825708,2024,2024-2025
WV,2024-11-30,intra-ucfe,0,0,2,0,0,0,0,0,0,0,1,3,1,1,FALSE,0.333333333333333,2024,2024-2025
WV,2024-11-30,intra-ucx,2,1,0,0,0,0,0,0,0,0,1,4,3,4,FALSE,1,2024,2024-2025
WV,2024-11-30,intra-ui,823,92,30,11,3,11,7,5,3,6,379,1370,1202,1294,FALSE,0.944525547445255,2024,2024-2025
WV,2024-12-31,inter-total,188,21,5,3,4,1,1,0,0,0,60,283,248,269,FALSE,0.950530035335689,2024,2024-2025
WV,2024-12-31,inter-ucfe,0,0,0,0,0,0,0,0,0,0,0,0,0,0,FALSE,0,2024,2024-2025
WV,2024-12-31,inter-ucx,0,0,0,0,0,0,0,0,0,0,0,0,0,0,FALSE,0,2024,2024-2025
WV,2024-12-31,inter-ui,188,21,5,3,4,1,1,0,0,0,60,283,248,269,FALSE,0.950530035335689,2024,2024-2025
WV,2024-12-31,intra-total,1544,231,55,15,8,13,8,2,2,10,884,2772,2428,2659,FALSE,0.959235209235209,2024,2024-2025
WV,2024-12-31,intra-ucfe,6,0,1,1,0,0,0,0,0,0,3,11,9,9,FALSE,0.818181818181818,2024,2024-2025
WV,2024-12-31,intra-ucx,5,0,0,0,0,0,0,0,0,0,0,5,5,5,FALSE,1,2024,2024-2025
WV,2024-12-31,intra-ui,1533,231,54,14,8,13,8,2,2,10,881,2756,2414,2645,FALSE,0.959724238026125,2024,2024-2025
WY,2019-01-31,inter-total,220,11,5,0,1,1,0,0,0,1,33,272,253,264,TRUE,0.930147058823529,2018,2018-2019
WY,2019-01-31,inter-ucfe,45,5,3,0,0,0,0,0,0,1,14,68,59,64,TRUE,0.867647058823529,2018,2018-2019
WY,2019-01-31,inter-ucx,0,0,0,0,0,0,0,0,0,0,0,0,0,0,TRUE,0,2018,2018-2019
WY,2019-01-31,inter-ui,175,6,2,0,1,1,0,0,0,0,19,204,194,200,TRUE,0.950980392156863,2018,2018-2019
WY,2019-01-31,intra-total,1279,41,5,5,3,2,0,0,1,0,221,1557,1500,1541,TRUE,0.963391136801541,2018,2018-2019
WY,2019-01-31,intra-ucfe,157,19,0,0,0,1,0,0,0,0,51,228,208,227,TRUE,0.912280701754386,2018,2018-2019
WY,2019-01-31,intra-ucx,0,0,0,0,0,0,0,0,0,0,1,1,1,1,TRUE,1,2018,2018-2019
WY,2019-01-31,intra-ui,1122,22,5,5,3,1,0,0,1,0,169,1328,1291,1313,TRUE,0.972138554216867,2018,2018-2019
WY,2019-02-28,inter-total,96,10,3,2,0,0,1,0,0,2,11,125,107,117,TRUE,0.856,2018,2018-2019
WY,2019-02-28,inter-ucfe,13,4,0,1,0,0,0,0,0,2,3,23,16,20,TRUE,0.695652173913044,2018,2018-2019
WY,2019-02-28,inter-ucx,0,0,0,0,0,0,0,0,0,0,0,0,0,0,TRUE,0,2018,2018-2019
WY,2019-02-28,inter-ui,83,6,3,1,0,0,1,0,0,0,8,102,91,97,TRUE,0.892156862745098,2018,2018-2019
WY,2019-02-28,intra-total,672,31,4,7,2,1,0,0,1,1,112,831,784,815,TRUE,0.943441636582431,2018,2018-2019
WY,2019-02-28,intra-ucfe,14,1,0,1,0,0,0,0,0,0,5,21,19,20,TRUE,0.904761904761905,2018,2018-2019
WY,2019-02-28,intra-ucx,1,0,0,0,0,0,0,0,0,0,0,1,1,1,TRUE,1,2018,2018-2019
WY,2019-02-28,intra-ui,657,30,4,6,2,1,0,0,1,1,107,809,764,794,TRUE,0.944375772558714,2018,2018-2019
WY,2019-03-31,inter-total,66,1,0,1,2,1,0,0,0,1,9,81,75,76,TRUE,0.925925925925926,2018,2018-2019
WY,2019-03-31,inter-ucfe,11,0,0,0,0,0,0,0,0,1,2,14,13,13,TRUE,0.928571428571429,2018,2018-2019
WY,2019-03-31,inter-ucx,1,0,0,0,0,0,0,0,0,0,0,1,1,1,TRUE,1,2018,2018-2019
WY,2019-03-31,inter-ui,54,1,0,1,2,1,0,0,0,0,7,66,61,62,TRUE,0.924242424242424,2018,2018-2019
WY,2019-03-31,intra-total,447,11,4,3,2,2,1,0,1,1,81,553,528,539,TRUE,0.954792043399638,2018,2018-2019
WY,2019-03-31,intra-ucfe,8,1,0,0,0,0,0,0,0,0,3,12,11,12,TRUE,0.916666666666667,2018,2018-2019
WY,2019-03-31,intra-ucx,1,0,0,0,0,0,0,0,0,0,0,1,1,1,TRUE,1,2018,2018-2019
WY,2019-03-31,intra-ui,438,10,4,3,2,2,1,0,1,1,78,540,516,526,TRUE,0.955555555555556,2018,2018-2019
WY,2019-04-30,inter-total,99,0,1,2,0,1,2,0,0,0,14,119,113,113,TRUE,0.949579831932773,2018,2018-2019
WY,2019-04-30,inter-ucfe,9,0,0,0,0,0,0,0,0,0,1,10,10,10,TRUE,1,2018,2018-2019
WY,2019-04-30,inter-ucx,0,0,0,0,0,0,0,0,0,0,0,0,0,0,TRUE,0,2018,2018-2019
WY,2019-04-30,inter-ui,90,0,1,2,0,1,2,0,0,0,13,109,103,103,TRUE,0.944954128440367,2018,2018-2019
WY,2019-04-30,intra-total,579,8,4,3,2,0,0,1,0,1,85,683,664,672,TRUE,0.972181551976574,2018,2018-2019
WY,2019-04-30,intra-ucfe,8,0,0,0,0,0,0,0,0,0,3,11,11,11,TRUE,1,2018,2018-2019
WY,2019-04-30,intra-ucx,3,0,0,0,0,0,0,0,0,0,0,3,3,3,TRUE,1,2018,2018-2019
WY,2019-04-30,intra-ui,568,8,4,3,2,0,0,1,0,1,82,669,650,658,TRUE,0.971599402092676,2018,2018-2019
WY,2019-05-31,inter-total,53,0,0,0,0,0,0,0,0,0,23,76,76,76,TRUE,1,2018,2018-2019
WY,2019-05-31,inter-ucfe,2,0,0,0,0,0,0,0,0,0,1,3,3,3,TRUE,1,2018,2018-2019
WY,2019-05-31,inter-ucx,0,0,0,0,0,0,0,0,0,0,0,0,0,0,TRUE,0,2018,2018-2019
WY,2019-05-31,inter-ui,51,0,0,0,0,0,0,0,0,0,22,73,73,73,TRUE,1,2018,2018-2019
WY,2019-05-31,intra-total,268,16,5,3,2,2,1,0,0,1,91,389,359,375,TRUE,0.922879177377892,2018,2018-2019
WY,2019-05-31,intra-ucfe,3,0,0,1,0,0,0,0,0,1,1,6,4,4,TRUE,0.666666666666667,2018,2018-2019
WY,2019-05-31,intra-ucx,1,0,0,0,0,0,0,0,0,0,0,1,1,1,TRUE,1,2018,2018-2019
WY,2019-05-31,intra-ui,264,16,5,2,2,2,1,0,0,0,90,382,354,370,TRUE,0.926701570680628,2018,2018-2019
WY,2019-06-30,inter-total,81,3,3,1,0,0,0,0,0,0,14,102,95,98,TRUE,0.931372549019608,2018,2018-2019
WY,2019-06-30,inter-ucfe,4,0,0,0,0,0,0,0,0,0,0,4,4,4,TRUE,1,2018,2018-2019
WY,2019-06-30,inter-ucx,0,0,0,0,0,0,0,0,0,0,0,0,0,0,TRUE,0,2018,2018-2019
WY,2019-06-30,inter-ui,77,3,3,1,0,0,0,0,0,0,14,98,91,94,TRUE,0.928571428571429,2018,2018-2019
WY,2019-06-30,intra-total,397,11,3,2,0,3,1,0,0,0,54,471,451,462,TRUE,0.957537154989384,2018,2018-2019
WY,2019-06-30,intra-ucfe,2,0,0,0,0,0,0,0,0,0,0,2,2,2,TRUE,1,2018,2018-2019
WY,2019-06-30,intra-ucx,1,0,0,0,0,0,0,0,0,0,0,1,1,1,TRUE,1,2018,2018-2019
WY,2019-06-30,intra-ui,394,11,3,2,0,3,1,0,0,0,54,468,448,459,TRUE,0.957264957264957,2018,2018-2019
WY,2019-07-31,inter-total,77,3,0,0,0,1,0,0,0,0,18,99,95,98,TRUE,0.95959595959596,2019,2019-2020
WY,2019-07-31,inter-ucfe,1,0,0,0,0,0,0,0,0,0,0,1,1,1,TRUE,1,2019,2019-2020
WY,2019-07-31,inter-ucx,0,0,0,0,0,0,0,0,0,0,0,0,0,0,TRUE,0,2019,2019-2020
WY,2019-07-31,inter-ui,76,3,0,0,0,1,0,0,0,0,18,98,94,97,TRUE,0.959183673469388,2019,2019-2020
WY,2019-07-31,intra-total,664,10,4,0,2,1,0,1,0,0,95,777,759,769,TRUE,0.976833976833977,2019,2019-2020
WY,2019-07-31,intra-ucfe,0,0,0,0,0,0,0,0,0,0,0,0,0,0,TRUE,0,2019,2019-2020
WY,2019-07-31,intra-ucx,3,0,0,0,0,0,0,0,0,0,0,3,3,3,TRUE,1,2019,2019-2020
WY,2019-07-31,intra-ui,661,10,4,0,2,1,0,1,0,0,95,774,756,766,TRUE,0.976744186046512,2019,2019-2020
WY,2019-08-31,inter-total,39,6,3,0,2,0,0,0,0,0,10,60,49,55,TRUE,0.816666666666667,2019,2019-2020
WY,2019-08-31,inter-ucfe,0,1,0,0,0,0,0,0,0,0,0,1,0,1,TRUE,0,2019,2019-2020
WY,2019-08-31,inter-ucx,0,0,0,0,0,0,0,0,0,0,1,1,1,1,TRUE,1,2019,2019-2020
WY,2019-08-31,inter-ui,39,5,3,0,2,0,0,0,0,0,9,58,48,53,TRUE,0.827586206896552,2019,2019-2020
WY,2019-08-31,intra-total,262,8,5,3,0,1,0,0,0,0,50,329,312,320,TRUE,0.948328267477204,2019,2019-2020
WY,2019-08-31,intra-ucfe,0,0,0,0,0,0,0,0,0,0,1,1,1,1,TRUE,1,2019,2019-2020
WY,2019-08-31,intra-ucx,0,0,0,0,0,0,0,0,0,0,1,1,1,1,TRUE,1,2019,2019-2020
WY,2019-08-31,intra-ui,262,8,5,3,0,1,0,0,0,0,48,327,310,318,TRUE,0.948012232415902,2019,2019-2020
WY,2019-09-30,inter-total,52,3,0,1,0,1,0,0,0,0,9,66,61,64,TRUE,0.924242424242424,2019,2019-2020
WY,2019-09-30,inter-ucfe,1,1,0,0,0,0,0,0,0,0,1,3,2,3,TRUE,0.666666666666667,2019,2019-2020
WY,2019-09-30,inter-ucx,0,0,0,0,0,0,0,0,0,0,0,0,0,0,TRUE,0,2019,2019-2020
WY,2019-09-30,inter-ui,51,2,0,1,0,1,0,0,0,0,8,63,59,61,TRUE,0.936507936507937,2019,2019-2020
WY,2019-09-30,intra-total,269,6,4,2,0,1,0,1,1,1,61,346,330,336,TRUE,0.953757225433526,2019,2019-2020
WY,2019-09-30,intra-ucfe,0,1,0,0,0,1,0,1,0,0,0,3,0,1,TRUE,0,2019,2019-2020
WY,2019-09-30,intra-ucx,1,0,0,0,0,0,0,0,0,0,0,1,1,1,TRUE,1,2019,2019-2020
WY,2019-09-30,intra-ui,268,5,4,2,0,0,0,0,1,1,61,342,329,334,TRUE,0.961988304093567,2019,2019-2020
WY,2019-10-31,inter-total,171,2,1,0,0,0,0,0,0,0,23,197,194,196,TRUE,0.984771573604061,2019,2019-2020
WY,2019-10-31,inter-ucfe,2,0,1,0,0,0,0,0,0,0,4,7,6,6,TRUE,0.857142857142857,2019,2019-2020
WY,2019-10-31,inter-ucx,0,0,0,0,0,0,0,0,0,0,0,0,0,0,TRUE,0,2019,2019-2020
WY,2019-10-31,inter-ui,169,2,0,0,0,0,0,0,0,0,19,190,188,190,TRUE,0.989473684210526,2019,2019-2020
WY,2019-10-31,intra-total,389,8,2,1,2,1,0,1,0,5,68,477,457,465,TRUE,0.958071278825996,2019,2019-2020
WY,2019-10-31,intra-ucfe,3,0,0,0,0,0,0,0,0,0,0,3,3,3,TRUE,1,2019,2019-2020
WY,2019-10-31,intra-ucx,2,0,0,0,0,0,0,0,0,0,0,2,2,2,TRUE,1,2019,2019-2020
WY,2019-10-31,intra-ui,384,8,2,1,2,1,0,1,0,5,68,472,452,460,TRUE,0.957627118644068,2019,2019-2020
WY,2019-11-30,inter-total,258,17,5,2,1,1,0,0,0,0,40,324,298,315,TRUE,0.919753086419753,2019,2019-2020
WY,2019-11-30,inter-ucfe,23,3,1,0,0,0,0,0,0,0,9,36,32,35,TRUE,0.888888888888889,2019,2019-2020
WY,2019-11-30,inter-ucx,0,0,0,0,0,0,0,0,0,0,0,0,0,0,TRUE,0,2019,2019-2020
WY,2019-11-30,inter-ui,235,14,4,2,1,1,0,0,0,0,31,288,266,280,TRUE,0.923611111111111,2019,2019-2020
WY,2019-11-30,intra-total,661,28,3,4,1,1,1,0,1,0,120,820,781,809,TRUE,0.952439024390244,2019,2019-2020
WY,2019-11-30,intra-ucfe,18,1,1,0,0,0,0,0,0,0,2,22,20,21,TRUE,0.909090909090909,2019,2019-2020
WY,2019-11-30,intra-ucx,1,0,0,0,0,0,0,0,0,0,0,1,1,1,TRUE,1,2019,2019-2020
WY,2019-11-30,intra-ui,642,27,2,4,1,1,1,0,1,0,118,797,760,787,TRUE,0.95357590966123,2019,2019-2020
WY,2019-12-31,inter-total,232,12,2,2,4,2,2,0,0,0,40,296,272,284,TRUE,0.918918918918919,2019,2019-2020
WY,2019-12-31,inter-ucfe,18,2,0,1,0,0,1,0,0,0,9,31,27,29,TRUE,0.870967741935484,2019,2019-2020
WY,2019-12-31,inter-ucx,0,0,0,0,0,0,0,0,0,0,0,0,0,0,TRUE,0,2019,2019-2020
WY,2019-12-31,inter-ui,214,10,2,1,4,2,1,0,0,0,31,265,245,255,TRUE,0.924528301886792,2019,2019-2020
WY,2019-12-31,intra-total,925,22,5,3,7,5,2,4,0,1,150,1124,1075,1097,TRUE,0.956405693950178,2019,2019-2020
WY,2019-12-31,intra-ucfe,36,1,0,1,0,2,1,0,0,0,6,47,42,43,TRUE,0.893617021276596,2019,2019-2020
WY,2019-12-31,intra-ucx,2,0,0,0,0,0,0,0,0,0,0,2,2,2,TRUE,1,2019,2019-2020
WY,2019-12-31,intra-ui,887,21,5,2,7,3,1,4,0,1,144,1075,1031,1052,TRUE,0.95906976744186,2019,2019-2020
WY,2020-01-31,inter-total,192,12,3,4,1,0,2,0,0,1,43,258,235,247,TRUE,0.910852713178295,2019,2019-2020
WY,2020-01-31,inter-ucfe,19,0,1,1,0,0,0,0,0,0,6,27,25,25,TRUE,0.925925925925926,2019,2019-2020
WY,2020-01-31,inter-ucx,0,0,0,0,0,0,0,0,0,0,0,0,0,0,TRUE,0,2019,2019-2020
WY,2020-01-31,inter-ui,173,12,2,3,1,0,2,0,0,1,37,231,210,222,TRUE,0.909090909090909,2019,2019-2020
WY,2020-01-31,intra-total,1112,33,11,5,2,4,2,2,1,0,129,1301,1241,1274,TRUE,0.953881629515757,2019,2019-2020
WY,2020-01-31,intra-ucfe,17,0,1,0,0,0,0,1,0,0,2,21,19,19,TRUE,0.904761904761905,2019,2019-2020
WY,2020-01-31,intra-ucx,2,0,0,0,0,0,0,0,0,0,0,2,2,2,TRUE,1,2019,2019-2020
WY,2020-01-31,intra-ui,1093,33,10,5,2,4,2,1,1,0,127,1278,1220,1253,TRUE,0.954616588419405,2019,2019-2020
WY,2020-02-29,inter-total,133,13,4,5,2,1,0,1,0,0,35,194,168,181,TRUE,0.865979381443299,2019,2019-2020
WY,2020-02-29,inter-ucfe,11,1,1,0,0,0,0,0,0,0,4,17,15,16,TRUE,0.882352941176471,2019,2019-2020
WY,2020-02-29,inter-ucx,0,0,0,0,0,0,0,0,0,0,0,0,0,0,TRUE,0,2019,2019-2020
WY,2020-02-29,inter-ui,122,12,3,5,2,1,0,1,0,0,31,177,153,165,TRUE,0.864406779661017,2019,2019-2020
WY,2020-02-29,intra-total,791,21,16,3,1,1,2,0,1,1,138,975,929,950,TRUE,0.952820512820513,2019,2019-2020
WY,2020-02-29,intra-ucfe,14,3,1,0,0,0,0,0,1,0,5,24,19,22,TRUE,0.791666666666667,2019,2019-2020
WY,2020-02-29,intra-ucx,0,0,0,0,0,0,0,0,0,0,0,0,0,0,TRUE,0,2019,2019-2020
WY,2020-02-29,intra-ui,777,18,15,3,1,1,2,0,0,1,133,951,910,928,TRUE,0.956887486855941,2019,2019-2020
WY,2020-03-31,inter-total,193,7,1,2,0,1,1,0,2,1,27,235,220,227,TRUE,0.936170212765957,2019,2019-2020
WY,2020-03-31,inter-ucfe,5,0,0,0,0,0,0,0,1,0,1,7,6,6,TRUE,0.857142857142857,2019,2019-2020
WY,2020-03-31,inter-ucx,0,0,0,0,0,0,0,0,0,0,0,0,0,0,TRUE,0,2019,2019-2020
WY,2020-03-31,inter-ui,188,7,1,2,0,1,1,0,1,1,26,228,214,221,TRUE,0.93859649122807,2019,2019-2020
WY,2020-03-31,intra-total,1548,13,12,4,0,3,2,0,0,3,121,1706,1669,1682,TRUE,0.97831184056272,2019,2019-2020
WY,2020-03-31,intra-ucfe,8,2,0,1,0,0,0,0,0,0,2,13,10,12,TRUE,0.769230769230769,2019,2019-2020
WY,2020-03-31,intra-ucx,0,0,0,0,0,0,0,0,0,0,0,0,0,0,TRUE,0,2019,2019-2020
WY,2020-03-31,intra-ui,1540,11,12,3,0,3,2,0,0,3,119,1693,1659,1670,TRUE,0.979917306556409,2019,2019-2020
WY,2020-04-30,inter-total,843,37,15,4,1,0,0,0,0,3,154,1057,997,1034,TRUE,0.943235572374645,2019,2019-2020
WY,2020-04-30,inter-ucfe,11,1,1,1,0,0,0,0,0,0,2,16,13,14,TRUE,0.8125,2019,2019-2020
WY,2020-04-30,inter-ucx,1,0,0,0,0,0,0,0,0,0,1,2,2,2,TRUE,1,2019,2019-2020
WY,2020-04-30,inter-ui,831,36,14,3,1,0,0,0,0,3,151,1039,982,1018,TRUE,0.945139557266602,2019,2019-2020
WY,2020-04-30,intra-total,8169,322,54,10,1,0,1,0,1,0,1922,10480,10091,10413,TRUE,0.962881679389313,2019,2019-2020
WY,2020-04-30,intra-ucfe,15,0,0,0,0,0,0,0,0,0,2,17,17,17,TRUE,1,2019,2019-2020
WY,2020-04-30,intra-ucx,0,0,0,0,0,0,0,0,0,0,1,1,1,1,TRUE,1,2019,2019-2020
WY,2020-04-30,intra-ui,8154,322,54,10,1,0,1,0,1,0,1919,10462,10073,10395,TRUE,0.962817816861021,2019,2019-2020
WY,2020-05-31,inter-total,427,64,42,29,20,8,2,1,0,0,146,739,573,637,TRUE,0.775372124492558,2019,2019-2020
WY,2020-05-31,inter-ucfe,5,2,0,0,0,0,0,0,0,0,5,12,10,12,TRUE,0.833333333333333,2019,2019-2020
WY,2020-05-31,inter-ucx,0,0,0,0,0,0,0,0,0,0,0,0,0,0,TRUE,0,2019,2019-2020
WY,2020-05-31,inter-ui,422,62,42,29,20,8,2,1,0,0,141,727,563,625,TRUE,0.774415405777166,2019,2019-2020
WY,2020-05-31,intra-total,2449,479,225,120,50,21,16,7,0,2,940,4309,3389,3868,TRUE,0.786493385936412,2019,2019-2020
WY,2020-05-31,intra-ucfe,2,1,1,1,0,0,1,0,0,0,1,7,3,4,TRUE,0.428571428571429,2019,2019-2020
WY,2020-05-31,intra-ucx,1,0,0,0,0,0,0,0,0,0,1,2,2,2,TRUE,1,2019,2019-2020
WY,2020-05-31,intra-ui,2446,478,224,119,50,21,15,7,0,2,938,4300,3384,3862,TRUE,0.786976744186046,2019,2019-2020
WY,2020-06-30,inter-total,199,38,49,45,36,32,15,19,7,13,78,531,277,315,TRUE,0.52165725047081,2019,2019-2020
WY,2020-06-30,inter-ucfe,3,0,2,1,0,0,0,0,0,1,0,7,3,3,TRUE,0.428571428571429,2019,2019-2020
WY,2020-06-30,inter-ucx,0,0,0,0,0,0,0,0,0,0,0,0,0,0,TRUE,0,2019,2019-2020
WY,2020-06-30,inter-ui,196,38,47,44,36,32,15,19,7,12,78,524,274,312,TRUE,0.522900763358779,2019,2019-2020
WY,2020-06-30,intra-total,1269,309,239,171,124,108,81,38,42,34,512,2927,1781,2090,TRUE,0.608472839084387,2019,2019-2020
WY,2020-06-30,intra-ucfe,0,0,0,0,0,0,0,0,0,0,0,0,0,0,TRUE,0,2019,2019-2020
WY,2020-06-30,intra-ucx,1,0,1,0,0,0,0,0,0,0,1,3,2,2,TRUE,0.666666666666667,2019,2019-2020
WY,2020-06-30,intra-ui,1268,309,238,171,124,108,81,38,42,34,511,2924,1779,2088,TRUE,0.608413132694938,2019,2019-2020
WY,2020-07-31,inter-total,140,32,30,17,19,7,10,6,8,33,50,352,190,222,TRUE,0.539772727272727,2020,2020-2021
WY,2020-07-31,inter-ucfe,1,0,1,0,0,0,0,1,0,1,1,5,2,2,TRUE,0.4,2020,2020-2021
WY,2020-07-31,inter-ucx,0,1,0,0,0,0,0,0,0,0,0,1,0,1,TRUE,0,2020,2020-2021
WY,2020-07-31,inter-ui,139,31,29,17,19,7,10,5,8,32,49,346,188,219,TRUE,0.543352601156069,2020,2020-2021
WY,2020-07-31,intra-total,856,258,174,98,44,35,36,33,23,100,349,2006,1205,1463,TRUE,0.600697906281157,2020,2020-2021
WY,2020-07-31,intra-ucfe,0,0,1,1,1,0,0,0,0,1,0,4,0,0,TRUE,0,2020,2020-2021
WY,2020-07-31,intra-ucx,1,0,0,0,0,0,0,0,0,0,0,1,1,1,TRUE,1,2020,2020-2021
WY,2020-07-31,intra-ui,855,258,173,97,43,35,36,33,23,99,349,2001,1204,1462,TRUE,0.601699150424788,2020,2020-2021
WY,2020-08-31,inter-total,80,21,15,10,10,6,1,2,1,34,30,210,110,131,TRUE,0.523809523809524,2020,2020-2021
WY,2020-08-31,inter-ucfe,0,0,1,0,1,0,0,0,0,0,0,2,0,0,TRUE,0,2020,2020-2021
WY,2020-08-31,inter-ucx,0,0,0,0,0,0,0,0,0,0,0,0,0,0,TRUE,0,2020,2020-2021
WY,2020-08-31,inter-ui,80,21,14,10,9,6,1,2,1,34,30,208,110,131,TRUE,0.528846153846154,2020,2020-2021
WY,2020-08-31,intra-total,504,102,81,45,32,14,10,7,11,56,185,1047,689,791,TRUE,0.658070678127985,2020,2020-2021
WY,2020-08-31,intra-ucfe,1,1,2,0,1,1,0,0,1,0,0,7,1,2,TRUE,0.142857142857143,2020,2020-2021
WY,2020-08-31,intra-ucx,0,0,0,0,0,0,0,0,0,1,0,1,0,0,TRUE,0,2020,2020-2021
WY,2020-08-31,intra-ui,503,101,79,45,31,13,10,7,10,55,185,1039,688,789,TRUE,0.662175168431184,2020,2020-2021
WY,2020-09-30,inter-total,75,7,14,8,4,4,4,3,3,30,19,171,94,101,TRUE,0.549707602339181,2020,2020-2021
WY,2020-09-30,inter-ucfe,0,1,0,0,0,0,0,0,0,1,0,2,0,1,TRUE,0,2020,2020-2021
WY,2020-09-30,inter-ucx,0,0,0,0,0,0,0,0,0,0,0,0,0,0,TRUE,0,2020,2020-2021
WY,2020-09-30,inter-ui,75,6,14,8,4,4,4,3,3,29,19,169,94,100,TRUE,0.556213017751479,2020,2020-2021
WY,2020-09-30,intra-total,459,88,37,22,8,6,6,4,3,49,162,844,621,709,TRUE,0.735781990521327,2020,2020-2021
WY,2020-09-30,intra-ucfe,0,1,0,0,0,0,0,0,0,0,0,1,0,1,TRUE,0,2020,2020-2021
WY,2020-09-30,intra-ucx,1,0,0,0,0,0,0,0,0,0,1,2,2,2,TRUE,1,2020,2020-2021
WY,2020-09-30,intra-ui,458,87,37,22,8,6,6,4,3,49,161,841,619,706,TRUE,0.73602853745541,2020,2020-2021
WY,2020-10-31,inter-total,100,9,2,3,2,0,3,3,2,16,18,158,118,127,TRUE,0.746835443037975,2020,2020-2021
WY,2020-10-31,inter-ucfe,1,0,0,0,0,0,0,0,0,0,0,1,1,1,TRUE,1,2020,2020-2021
WY,2020-10-31,inter-ucx,1,0,0,0,0,0,0,0,0,0,0,1,1,1,TRUE,1,2020,2020-2021
WY,2020-10-31,inter-ui,98,9,2,3,2,0,3,3,2,16,18,156,116,125,TRUE,0.743589743589744,2020,2020-2021
WY,2020-10-31,intra-total,452,33,20,13,7,0,1,1,4,32,119,682,571,604,TRUE,0.837243401759531,2020,2020-2021
WY,2020-10-31,intra-ucfe,0,0,1,1,0,0,0,0,0,0,0,2,0,0,TRUE,0,2020,2020-2021
WY,2020-10-31,intra-ucx,2,0,0,0,0,0,0,0,0,0,0,2,2,2,TRUE,1,2020,2020-2021
WY,2020-10-31,intra-ui,450,33,19,12,7,0,1,1,4,32,119,678,569,602,TRUE,0.839233038348083,2020,2020-2021
WY,2020-11-30,inter-total,149,19,3,4,3,2,0,1,1,19,43,244,192,211,TRUE,0.786885245901639,2020,2020-2021
WY,2020-11-30,inter-ucfe,4,1,0,0,0,0,0,0,0,1,9,15,13,14,TRUE,0.866666666666667,2020,2020-2021
WY,2020-11-30,inter-ucx,0,0,0,0,0,0,0,0,0,0,0,0,0,0,TRUE,0,2020,2020-2021
WY,2020-11-30,inter-ui,145,18,3,4,3,2,0,1,1,18,34,229,179,197,TRUE,0.781659388646288,2020,2020-2021
WY,2020-11-30,intra-total,528,73,18,9,5,2,1,2,1,22,178,839,706,779,TRUE,0.841477949940405,2020,2020-2021
WY,2020-11-30,intra-ucfe,7,0,1,0,0,0,0,0,0,1,4,13,11,11,TRUE,0.846153846153846,2020,2020-2021
WY,2020-11-30,intra-ucx,0,0,1,0,0,0,0,0,0,1,0,2,0,0,TRUE,0,2020,2020-2021
WY,2020-11-30,intra-ui,521,73,16,9,5,2,1,2,1,20,174,824,695,768,TRUE,0.843446601941748,2020,2020-2021
WY,2020-12-31,inter-total,131,21,13,4,3,4,5,2,0,15,34,232,165,186,TRUE,0.711206896551724,2020,2020-2021
WY,2020-12-31,inter-ucfe,13,4,1,1,1,0,1,0,0,1,4,26,17,21,TRUE,0.653846153846154,2020,2020-2021
WY,2020-12-31,inter-ucx,0,0,0,0,0,0,0,0,0,0,0,0,0,0,TRUE,0,2020,2020-2021
WY,2020-12-31,inter-ui,118,17,12,3,2,4,4,2,0,14,30,206,148,165,TRUE,0.718446601941748,2020,2020-2021
WY,2020-12-31,intra-total,878,112,55,20,5,1,2,3,1,16,226,1319,1104,1216,TRUE,0.836997725549659,2020,2020-2021
WY,2020-12-31,intra-ucfe,26,5,2,2,0,0,0,1,0,0,6,42,32,37,TRUE,0.761904761904762,2020,2020-2021
WY,2020-12-31,intra-ucx,1,0,0,0,0,0,0,0,0,0,1,2,2,2,TRUE,1,2020,2020-2021
WY,2020-12-31,intra-ui,851,107,53,18,5,1,2,2,1,16,219,1275,1070,1177,TRUE,0.83921568627451,2020,2020-2021
WY,2021-01-31,inter-total,124,14,7,8,4,5,4,1,1,17,41,226,165,179,TRUE,0.730088495575221,2020,2020-2021
WY,2021-01-31,inter-ucfe,9,1,0,0,0,1,1,0,1,1,4,18,13,14,TRUE,0.722222222222222,2020,2020-2021
WY,2021-01-31,inter-ucx,0,0,0,1,0,0,0,0,0,0,0,1,0,0,TRUE,0,2020,2020-2021
WY,2021-01-31,inter-ui,115,13,7,7,4,4,3,1,0,16,37,207,152,165,TRUE,0.734299516908213,2020,2020-2021
WY,2021-01-31,intra-total,1022,91,64,29,14,5,8,2,1,17,233,1486,1255,1346,TRUE,0.844549125168237,2020,2020-2021
WY,2021-01-31,intra-ucfe,21,4,0,2,1,0,2,0,0,2,13,45,34,38,TRUE,0.755555555555556,2020,2020-2021
WY,2021-01-31,intra-ucx,1,0,0,0,0,0,0,0,0,0,0,1,1,1,TRUE,1,2020,2020-2021
WY,2021-01-31,intra-ui,1000,87,64,27,13,5,6,2,1,15,220,1440,1220,1307,TRUE,0.847222222222222,2020,2020-2021
WY,2021-02-28,inter-total,110,19,5,7,4,2,0,1,2,13,33,196,143,162,TRUE,0.729591836734694,2020,2020-2021
WY,2021-02-28,inter-ucfe,9,3,1,4,0,0,0,0,0,0,8,25,17,20,TRUE,0.68,2020,2020-2021
WY,2021-02-28,inter-ucx,0,0,0,0,0,0,0,0,0,0,0,0,0,0,TRUE,0,2020,2020-2021
WY,2021-02-28,inter-ui,101,16,4,3,4,2,0,1,2,13,25,171,126,142,TRUE,0.736842105263158,2020,2020-2021
WY,2021-02-28,intra-total,839,85,34,17,7,4,2,5,0,22,222,1237,1061,1146,TRUE,0.857720291026677,2020,2020-2021
WY,2021-02-28,intra-ucfe,15,5,2,2,1,0,0,0,0,3,11,39,26,31,TRUE,0.666666666666667,2020,2020-2021
WY,2021-02-28,intra-ucx,0,0,1,0,0,0,0,0,0,0,1,2,1,1,TRUE,0.5,2020,2020-2021
WY,2021-02-28,intra-ui,824,80,31,15,6,4,2,5,0,19,210,1196,1034,1114,TRUE,0.864548494983278,2020,2020-2021
WY,2021-03-31,inter-total,87,10,7,4,4,4,1,4,2,15,14,152,101,111,TRUE,0.664473684210526,2020,2020-2021
WY,2021-03-31,inter-ucfe,4,2,0,1,1,0,1,0,0,4,1,14,5,7,TRUE,0.357142857142857,2020,2020-2021
WY,2021-03-31,inter-ucx,0,0,0,0,0,0,0,0,0,0,0,0,0,0,TRUE,0,2020,2020-2021
WY,2021-03-31,inter-ui,83,8,7,3,3,4,0,4,2,11,13,138,96,104,TRUE,0.695652173913044,2020,2020-2021
WY,2021-03-31,intra-total,580,30,18,10,5,11,3,4,5,28,145,839,725,755,TRUE,0.864123957091776,2020,2020-2021
WY,2021-03-31,intra-ucfe,4,0,0,0,0,2,0,0,1,5,2,14,6,6,TRUE,0.428571428571429,2020,2020-2021
WY,2021-03-31,intra-ucx,0,0,0,0,0,0,0,0,0,1,0,1,0,0,TRUE,0,2020,2020-2021
WY,2021-03-31,intra-ui,576,30,18,10,5,9,3,4,4,22,143,824,719,749,TRUE,0.872572815533981,2020,2020-2021
WY,2021-04-30,inter-total,118,3,3,3,2,1,2,0,1,11,17,161,135,138,TRUE,0.838509316770186,2020,2020-2021
WY,2021-04-30,inter-ucfe,6,0,0,1,0,0,0,0,0,0,1,8,7,7,TRUE,0.875,2020,2020-2021
WY,2021-04-30,inter-ucx,0,0,0,0,0,0,0,0,0,0,0,0,0,0,TRUE,0,2020,2020-2021
WY,2021-04-30,inter-ui,112,3,3,2,2,1,2,0,1,11,16,153,128,131,TRUE,0.836601307189543,2020,2020-2021
WY,2021-04-30,intra-total,782,39,19,9,3,4,1,2,5,24,134,1022,916,955,TRUE,0.896281800391389,2020,2020-2021
WY,2021-04-30,intra-ucfe,12,0,1,0,1,0,0,0,1,2,7,24,19,19,TRUE,0.791666666666667,2020,2020-2021
WY,2021-04-30,intra-ucx,2,0,0,0,0,0,0,0,0,0,0,2,2,2,TRUE,1,2020,2020-2021
WY,2021-04-30,intra-ui,768,39,18,9,2,4,1,2,4,22,127,996,895,934,TRUE,0.89859437751004,2020,2020-2021
WY,2021-05-31,inter-total,68,12,3,1,2,0,0,1,0,11,23,121,91,103,TRUE,0.752066115702479,2020,2020-2021
WY,2021-05-31,inter-ucfe,0,1,0,0,1,0,0,0,0,1,2,5,2,3,TRUE,0.4,2020,2020-2021
WY,2021-05-31,inter-ucx,0,0,0,0,0,0,0,0,0,0,0,0,0,0,TRUE,0,2020,2020-2021
WY,2021-05-31,inter-ui,68,11,3,1,1,0,0,1,0,10,21,116,89,100,TRUE,0.767241379310345,2020,2020-2021
WY,2021-05-31,intra-total,450,57,9,7,4,1,0,0,2,20,139,689,589,646,TRUE,0.854862119013063,2020,2020-2021
WY,2021-05-31,intra-ucfe,1,1,0,1,0,0,0,0,0,0,1,4,2,3,TRUE,0.5,2020,2020-2021
WY,2021-05-31,intra-ucx,1,0,0,0,0,0,0,0,0,0,0,1,1,1,TRUE,1,2020,2020-2021
WY,2021-05-31,intra-ui,448,56,9,6,4,1,0,0,2,20,138,684,586,642,TRUE,0.85672514619883,2020,2020-2021
WY,2021-06-30,inter-total,43,4,1,2,0,1,1,0,3,18,10,83,53,57,TRUE,0.63855421686747,2020,2020-2021
WY,2021-06-30,inter-ucfe,2,0,0,0,0,0,1,0,0,1,0,4,2,2,TRUE,0.5,2020,2020-2021
WY,2021-06-30,inter-ucx,0,0,0,0,0,0,0,0,0,0,0,0,0,0,TRUE,0,2020,2020-2021
WY,2021-06-30,inter-ui,41,4,1,2,0,1,0,0,3,17,10,79,51,55,TRUE,0.645569620253165,2020,2020-2021
WY,2021-06-30,intra-total,419,25,8,2,6,5,5,0,3,15,91,579,510,535,TRUE,0.880829015544041,2020,2020-2021
WY,2021-06-30,intra-ucfe,3,0,0,0,0,0,1,0,1,0,0,5,3,3,TRUE,0.6,2020,2020-2021
WY,2021-06-30,intra-ucx,0,0,0,0,0,0,0,0,0,0,0,0,0,0,TRUE,0,2020,2020-2021
WY,2021-06-30,intra-ui,416,25,8,2,6,5,4,0,2,15,91,574,507,532,TRUE,0.883275261324042,2020,2020-2021
WY,2021-07-31,inter-total,45,2,3,0,0,1,0,0,0,6,17,74,62,64,TRUE,0.837837837837838,2021,2021-2022
WY,2021-07-31,inter-ucfe,0,0,0,0,0,0,0,0,0,0,1,1,1,1,TRUE,1,2021,2021-2022
WY,2021-07-31,inter-ucx,0,0,0,0,0,0,0,0,0,0,0,0,0,0,TRUE,0,2021,2021-2022
WY,2021-07-31,inter-ui,45,2,3,0,0,1,0,0,0,6,16,73,61,63,TRUE,0.835616438356164,2021,2021-2022
WY,2021-07-31,intra-total,353,16,6,1,0,2,1,1,1,17,87,485,440,456,TRUE,0.907216494845361,2021,2021-2022
WY,2021-07-31,intra-ucfe,2,0,0,0,0,0,0,0,0,1,0,3,2,2,TRUE,0.666666666666667,2021,2021-2022
WY,2021-07-31,intra-ucx,0,0,0,0,0,0,0,0,0,0,0,0,0,0,TRUE,0,2021,2021-2022
WY,2021-07-31,intra-ui,351,16,6,1,0,2,1,1,1,16,87,482,438,454,TRUE,0.908713692946058,2021,2021-2022
WY,2021-08-31,inter-total,28,4,0,1,0,2,1,1,1,14,12,64,40,44,TRUE,0.625,2021,2021-2022
WY,2021-08-31,inter-ucfe,1,0,0,0,0,0,0,0,0,0,0,1,1,1,TRUE,1,2021,2021-2022
WY,2021-08-31,inter-ucx,0,0,0,0,0,0,0,0,0,0,0,0,0,0,TRUE,0,2021,2021-2022
WY,2021-08-31,inter-ui,27,4,0,1,0,2,1,1,1,14,12,63,39,43,TRUE,0.619047619047619,2021,2021-2022
WY,2021-08-31,intra-total,237,26,7,2,4,2,5,1,1,20,79,384,316,342,TRUE,0.822916666666667,2021,2021-2022
WY,2021-08-31,intra-ucfe,2,0,0,0,0,0,0,0,0,2,1,5,3,3,TRUE,0.6,2021,2021-2022
WY,2021-08-31,intra-ucx,0,0,0,0,0,0,0,0,0,0,0,0,0,0,TRUE,0,2021,2021-2022
WY,2021-08-31,intra-ui,235,26,7,2,4,2,5,1,1,18,78,379,313,339,TRUE,0.825857519788918,2021,2021-2022
WY,2021-09-30,inter-total,28,2,0,1,1,0,0,0,0,7,3,42,31,33,TRUE,0.738095238095238,2021,2021-2022
WY,2021-09-30,inter-ucfe,2,0,0,0,0,0,0,0,0,0,0,2,2,2,TRUE,1,2021,2021-2022
WY,2021-09-30,inter-ucx,0,0,0,0,0,0,0,0,0,0,0,0,0,0,TRUE,0,2021,2021-2022
WY,2021-09-30,inter-ui,26,2,0,1,1,0,0,0,0,7,3,40,29,31,TRUE,0.725,2021,2021-2022
WY,2021-09-30,intra-total,192,14,4,0,4,2,5,1,4,4,80,310,272,286,TRUE,0.87741935483871,2021,2021-2022
WY,2021-09-30,intra-ucfe,0,0,0,0,0,0,0,0,0,0,0,0,0,0,TRUE,0,2021,2021-2022
WY,2021-09-30,intra-ucx,0,0,0,0,0,0,0,0,0,0,1,1,1,1,TRUE,1,2021,2021-2022
WY,2021-09-30,intra-ui,192,14,4,0,4,2,5,1,4,4,79,309,271,285,TRUE,0.877022653721683,2021,2021-2022
WY,2021-10-31,inter-total,69,3,1,0,1,0,0,0,0,3,13,90,82,85,TRUE,0.911111111111111,2021,2021-2022
WY,2021-10-31,inter-ucfe,7,0,0,0,0,0,0,0,0,1,0,8,7,7,TRUE,0.875,2021,2021-2022
WY,2021-10-31,inter-ucx,0,0,0,0,0,0,0,0,0,0,0,0,0,0,TRUE,0,2021,2021-2022
WY,2021-10-31,inter-ui,62,3,1,0,1,0,0,0,0,2,13,82,75,78,TRUE,0.914634146341463,2021,2021-2022
WY,2021-10-31,intra-total,275,14,6,3,4,2,3,3,0,5,66,381,341,355,TRUE,0.89501312335958,2021,2021-2022
WY,2021-10-31,intra-ucfe,4,0,0,0,0,0,0,0,0,0,0,4,4,4,TRUE,1,2021,2021-2022
WY,2021-10-31,intra-ucx,1,0,0,0,0,0,0,0,0,0,0,1,1,1,TRUE,1,2021,2021-2022
WY,2021-10-31,intra-ui,270,14,6,3,4,2,3,3,0,5,66,376,336,350,TRUE,0.893617021276596,2021,2021-2022
WY,2021-11-30,inter-total,161,5,1,2,1,1,0,0,0,2,25,198,186,191,TRUE,0.939393939393939,2021,2021-2022
WY,2021-11-30,inter-ucfe,9,1,0,0,0,0,0,0,0,0,5,15,14,15,TRUE,0.933333333333333,2021,2021-2022
WY,2021-11-30,inter-ucx,0,0,0,0,0,0,0,0,0,0,0,0,0,0,TRUE,0,2021,2021-2022
WY,2021-11-30,inter-ui,152,4,1,2,1,1,0,0,0,2,20,183,172,176,TRUE,0.939890710382514,2021,2021-2022
WY,2021-11-30,intra-total,541,30,9,3,5,4,0,0,0,4,116,712,657,687,TRUE,0.922752808988764,2021,2021-2022
WY,2021-11-30,intra-ucfe,14,0,2,0,0,0,0,0,0,0,5,21,19,19,TRUE,0.904761904761905,2021,2021-2022
WY,2021-11-30,intra-ucx,1,1,0,0,0,0,0,0,0,1,0,3,1,2,TRUE,0.333333333333333,2021,2021-2022
WY,2021-11-30,intra-ui,526,29,7,3,5,4,0,0,0,3,111,688,637,666,TRUE,0.925872093023256,2021,2021-2022
WY,2021-12-31,inter-total,107,10,5,4,4,1,0,0,0,0,19,150,126,136,TRUE,0.84,2021,2021-2022
WY,2021-12-31,inter-ucfe,12,3,0,0,1,0,0,0,0,0,3,19,15,18,TRUE,0.789473684210526,2021,2021-2022
WY,2021-12-31,inter-ucx,0,0,0,0,0,0,0,0,0,0,0,0,0,0,TRUE,0,2021,2021-2022
WY,2021-12-31,inter-ui,95,7,5,4,3,1,0,0,0,0,16,131,111,118,TRUE,0.847328244274809,2021,2021-2022
WY,2021-12-31,intra-total,622,19,8,8,1,3,1,4,0,3,112,781,734,753,TRUE,0.939820742637644,2021,2021-2022
WY,2021-12-31,intra-ucfe,23,0,0,1,0,1,0,2,0,0,4,31,27,27,TRUE,0.870967741935484,2021,2021-2022
WY,2021-12-31,intra-ucx,1,0,0,0,0,0,0,0,0,0,0,1,1,1,TRUE,1,2021,2021-2022
WY,2021-12-31,intra-ui,598,19,8,7,1,2,1,2,0,3,108,749,706,725,TRUE,0.942590120160214,2021,2021-2022
WY,2022-01-31,inter-total,121,10,3,6,1,0,1,0,0,1,20,163,141,151,TRUE,0.865030674846626,2021,2021-2022
WY,2022-01-31,inter-ucfe,14,2,0,1,0,0,0,0,0,0,1,18,15,17,TRUE,0.833333333333333,2021,2021-2022
WY,2022-01-31,inter-ucx,0,0,0,0,0,0,0,0,0,0,0,0,0,0,TRUE,0,2021,2021-2022
WY,2022-01-31,inter-ui,107,8,3,5,1,0,1,0,0,1,19,145,126,134,TRUE,0.868965517241379,2021,2021-2022
WY,2022-01-31,intra-total,946,19,7,5,4,4,1,2,2,2,123,1115,1069,1088,TRUE,0.958744394618834,2021,2021-2022
WY,2022-01-31,intra-ucfe,17,2,0,0,1,0,0,0,0,0,3,23,20,22,TRUE,0.869565217391304,2021,2021-2022
WY,2022-01-31,intra-ucx,0,0,0,0,0,0,0,0,0,0,0,0,0,0,TRUE,0,2021,2021-2022
WY,2022-01-31,intra-ui,929,17,7,5,3,4,1,2,2,2,120,1092,1049,1066,TRUE,0.960622710622711,2021,2021-2022
WY,2022-02-28,inter-total,92,4,4,2,0,2,0,0,1,0,23,128,115,119,TRUE,0.8984375,2021,2021-2022
WY,2022-02-28,inter-ucfe,10,0,2,2,0,0,0,0,0,0,2,16,12,12,TRUE,0.75,2021,2021-2022
WY,2022-02-28,inter-ucx,0,0,0,0,0,0,0,0,0,0,0,0,0,0,TRUE,0,2021,2021-2022
WY,2022-02-28,inter-ui,82,4,2,0,0,2,0,0,1,0,21,112,103,107,TRUE,0.919642857142857,2021,2021-2022
WY,2022-02-28,intra-total,529,20,7,2,1,1,1,2,1,1,96,661,625,645,TRUE,0.94553706505295,2021,2021-2022
WY,2022-02-28,intra-ucfe,11,1,1,1,1,1,0,1,1,0,0,18,11,12,TRUE,0.611111111111111,2021,2021-2022
WY,2022-02-28,intra-ucx,2,0,0,0,0,0,0,0,0,0,0,2,2,2,TRUE,1,2021,2021-2022
WY,2022-02-28,intra-ui,516,19,6,1,0,0,1,1,0,1,96,641,612,631,TRUE,0.954758190327613,2021,2021-2022
WY,2022-03-31,inter-total,76,7,4,1,1,0,2,1,1,3,16,112,92,99,TRUE,0.821428571428571,2021,2021-2022
WY,2022-03-31,inter-ucfe,6,1,0,0,0,0,1,0,0,1,4,13,10,11,TRUE,0.769230769230769,2021,2021-2022
WY,2022-03-31,inter-ucx,0,0,0,0,0,0,0,0,0,0,0,0,0,0,TRUE,0,2021,2021-2022
WY,2022-03-31,inter-ui,70,6,4,1,1,0,1,1,1,2,12,99,82,88,TRUE,0.828282828282828,2021,2021-2022
WY,2022-03-31,intra-total,445,23,9,6,3,5,2,3,0,5,95,596,540,563,TRUE,0.906040268456376,2021,2021-2022
WY,2022-03-31,intra-ucfe,9,1,1,0,1,0,0,0,0,2,3,17,12,13,TRUE,0.705882352941177,2021,2021-2022
WY,2022-03-31,intra-ucx,2,0,0,0,0,0,0,0,0,0,0,2,2,2,TRUE,1,2021,2021-2022
WY,2022-03-31,intra-ui,434,22,8,6,2,5,2,3,0,3,92,577,526,548,TRUE,0.911611785095321,2021,2021-2022
WY,2022-04-30,inter-total,104,2,2,0,0,0,1,1,2,2,16,130,120,122,TRUE,0.923076923076923,2021,2021-2022
WY,2022-04-30,inter-ucfe,9,0,2,0,0,0,0,0,0,0,5,16,14,14,TRUE,0.875,2021,2021-2022
WY,2022-04-30,inter-ucx,0,0,0,0,0,0,0,0,0,0,0,0,0,0,TRUE,0,2021,2021-2022
WY,2022-04-30,inter-ui,95,2,0,0,0,0,1,1,2,2,11,114,106,108,TRUE,0.929824561403509,2021,2021-2022
WY,2022-04-30,intra-total,398,14,4,3,3,2,1,1,0,1,81,508,479,493,TRUE,0.942913385826772,2021,2021-2022
WY,2022-04-30,intra-ucfe,8,0,1,0,1,0,0,0,0,0,4,14,12,12,TRUE,0.857142857142857,2021,2021-2022
WY,2022-04-30,intra-ucx,1,0,0,0,0,0,0,0,0,0,0,1,1,1,TRUE,1,2021,2021-2022
WY,2022-04-30,intra-ui,389,14,3,3,2,2,1,1,0,1,77,493,466,480,TRUE,0.945233265720081,2021,2021-2022
WY,2022-05-31,inter-total,72,7,1,2,1,1,0,0,1,3,11,99,83,90,TRUE,0.838383838383838,2021,2021-2022
WY,2022-05-31,inter-ucfe,1,0,0,1,0,0,0,0,0,0,0,2,1,1,TRUE,0.5,2021,2021-2022
WY,2022-05-31,inter-ucx,0,0,0,0,0,0,0,0,0,0,0,0,0,0,TRUE,0,2021,2021-2022
WY,2022-05-31,inter-ui,71,7,1,1,1,1,0,0,1,3,11,97,82,89,TRUE,0.845360824742268,2021,2021-2022
WY,2022-05-31,intra-total,291,29,4,2,0,0,1,0,2,2,90,421,381,410,TRUE,0.904988123515439,2021,2021-2022
WY,2022-05-31,intra-ucfe,1,0,0,0,0,0,0,0,0,0,1,2,2,2,TRUE,1,2021,2021-2022
WY,2022-05-31,intra-ucx,2,0,0,0,0,0,0,0,0,0,0,2,2,2,TRUE,1,2021,2021-2022
WY,2022-05-31,intra-ui,288,29,4,2,0,0,1,0,2,2,89,417,377,406,TRUE,0.904076738609113,2021,2021-2022
WY,2022-06-30,inter-total,59,3,1,0,1,0,1,3,0,1,9,78,68,71,TRUE,0.871794871794872,2021,2021-2022
WY,2022-06-30,inter-ucfe,0,0,0,0,0,0,0,0,0,0,0,0,0,0,TRUE,0,2021,2021-2022
WY,2022-06-30,inter-ucx,0,0,0,0,0,0,0,0,0,0,0,0,0,0,TRUE,0,2021,2021-2022
WY,2022-06-30,inter-ui,59,3,1,0,1,0,1,3,0,1,9,78,68,71,TRUE,0.871794871794872,2021,2021-2022
WY,2022-06-30,intra-total,339,18,5,5,4,1,1,0,1,2,60,436,399,417,TRUE,0.915137614678899,2021,2021-2022
WY,2022-06-30,intra-ucfe,0,1,0,0,0,0,0,0,0,0,0,1,0,1,TRUE,0,2021,2021-2022
WY,2022-06-30,intra-ucx,1,0,0,0,0,0,0,0,0,0,1,2,2,2,TRUE,1,2021,2021-2022
WY,2022-06-30,intra-ui,338,17,5,5,4,1,1,0,1,2,59,433,397,414,TRUE,0.916859122401848,2021,2021-2022
WY,2022-07-31,inter-total,55,3,0,0,2,1,1,0,0,1,6,69,61,64,TRUE,0.884057971014493,2022,2022-2023
WY,2022-07-31,inter-ucfe,1,0,0,0,0,0,0,0,0,0,0,1,1,1,TRUE,1,2022,2022-2023
WY,2022-07-31,inter-ucx,0,0,0,0,0,0,0,0,0,0,0,0,0,0,TRUE,0,2022,2022-2023
WY,2022-07-31,inter-ui,54,3,0,0,2,1,1,0,0,1,6,68,60,63,TRUE,0.882352941176471,2022,2022-2023
WY,2022-07-31,intra-total,239,18,4,6,2,6,1,0,1,1,77,355,316,334,TRUE,0.890140845070423,2022,2022-2023
WY,2022-07-31,intra-ucfe,0,0,0,1,0,0,0,0,0,0,1,2,1,1,TRUE,0.5,2022,2022-2023
WY,2022-07-31,intra-ucx,1,0,0,0,0,0,0,0,0,0,0,1,1,1,TRUE,1,2022,2022-2023
WY,2022-07-31,intra-ui,238,18,4,5,2,6,1,0,1,1,76,352,314,332,TRUE,0.892045454545455,2022,2022-2023
WY,2022-08-31,inter-total,49,1,0,0,1,0,2,2,0,0,6,61,55,56,TRUE,0.901639344262295,2022,2022-2023
WY,2022-08-31,inter-ucfe,0,0,0,0,0,0,0,1,0,0,0,1,0,0,TRUE,0,2022,2022-2023
WY,2022-08-31,inter-ucx,0,0,0,0,0,0,0,0,0,0,0,0,0,0,TRUE,0,2022,2022-2023
WY,2022-08-31,inter-ui,49,1,0,0,1,0,2,1,0,0,6,60,55,56,TRUE,0.916666666666667,2022,2022-2023
WY,2022-08-31,intra-total,259,14,6,5,1,1,0,1,2,2,81,372,340,354,TRUE,0.913978494623656,2022,2022-2023
WY,2022-08-31,intra-ucfe,0,0,0,0,0,0,0,0,0,0,1,1,1,1,TRUE,1,2022,2022-2023
WY,2022-08-31,intra-ucx,0,1,0,0,0,0,0,1,0,0,0,2,0,1,TRUE,0,2022,2022-2023
WY,2022-08-31,intra-ui,259,13,6,5,1,1,0,0,2,2,80,369,339,352,TRUE,0.91869918699187,2022,2022-2023
WY,2022-09-30,inter-total,30,1,1,0,2,0,0,1,0,1,2,38,32,33,TRUE,0.842105263157895,2022,2022-2023
WY,2022-09-30,inter-ucfe,0,0,0,0,0,0,0,0,0,0,0,0,0,0,TRUE,0,2022,2022-2023
WY,2022-09-30,inter-ucx,0,0,0,0,0,0,0,0,0,0,0,0,0,0,TRUE,0,2022,2022-2023
WY,2022-09-30,inter-ui,30,1,1,0,2,0,0,1,0,1,2,38,32,33,TRUE,0.842105263157895,2022,2022-2023
WY,2022-09-30,intra-total,172,18,7,2,1,2,2,0,0,1,44,249,216,234,TRUE,0.867469879518072,2022,2022-2023
WY,2022-09-30,intra-ucfe,0,1,1,0,0,0,0,0,0,0,0,2,0,1,TRUE,0,2022,2022-2023
WY,2022-09-30,intra-ucx,1,0,0,0,0,0,0,0,0,0,0,1,1,1,TRUE,1,2022,2022-2023
WY,2022-09-30,intra-ui,171,17,6,2,1,2,2,0,0,1,44,246,215,232,TRUE,0.873983739837398,2022,2022-2023
WY,2022-10-31,inter-total,75,2,2,2,1,1,1,0,0,0,19,103,94,96,TRUE,0.912621359223301,2022,2022-2023
WY,2022-10-31,inter-ucfe,5,0,0,0,0,0,0,0,0,0,4,9,9,9,TRUE,1,2022,2022-2023
WY,2022-10-31,inter-ucx,0,0,0,0,0,0,0,0,0,0,0,0,0,0,TRUE,0,2022,2022-2023
WY,2022-10-31,inter-ui,70,2,2,2,1,1,1,0,0,0,15,94,85,87,TRUE,0.904255319148936,2022,2022-2023
WY,2022-10-31,intra-total,252,13,6,3,7,3,1,1,0,0,83,369,335,348,TRUE,0.907859078590786,2022,2022-2023
WY,2022-10-31,intra-ucfe,4,1,0,0,0,0,0,0,0,0,1,6,5,6,TRUE,0.833333333333333,2022,2022-2023
WY,2022-10-31,intra-ucx,0,0,0,0,0,0,0,0,0,0,0,0,0,0,TRUE,0,2022,2022-2023
WY,2022-10-31,intra-ui,248,12,6,3,7,3,1,1,0,0,82,363,330,342,TRUE,0.909090909090909,2022,2022-2023
WY,2022-11-30,inter-total,171,14,3,1,1,0,0,0,0,0,35,225,206,220,TRUE,0.915555555555556,2022,2022-2023
WY,2022-11-30,inter-ucfe,18,5,0,0,0,0,0,0,0,0,3,26,21,26,TRUE,0.807692307692308,2022,2022-2023
WY,2022-11-30,inter-ucx,0,0,0,0,0,0,0,0,0,0,0,0,0,0,TRUE,0,2022,2022-2023
WY,2022-11-30,inter-ui,153,9,3,1,1,0,0,0,0,0,32,199,185,194,TRUE,0.92964824120603,2022,2022-2023
WY,2022-11-30,intra-total,542,36,17,2,1,0,1,0,0,0,120,719,662,698,TRUE,0.920723226703755,2022,2022-2023
WY,2022-11-30,intra-ucfe,12,1,0,0,1,0,0,0,0,0,1,15,13,14,TRUE,0.866666666666667,2022,2022-2023
WY,2022-11-30,intra-ucx,0,0,0,0,0,0,0,0,0,0,0,0,0,0,TRUE,0,2022,2022-2023
WY,2022-11-30,intra-ui,530,35,17,2,0,0,1,0,0,0,119,704,649,684,TRUE,0.921875,2022,2022-2023
WY,2022-12-31,inter-total,85,2,2,2,0,1,1,1,0,0,16,110,101,103,TRUE,0.918181818181818,2022,2022-2023
WY,2022-12-31,inter-ucfe,10,0,0,0,0,0,0,1,0,0,2,13,12,12,TRUE,0.923076923076923,2022,2022-2023
WY,2022-12-31,inter-ucx,0,0,0,0,0,0,0,0,0,0,0,0,0,0,TRUE,0,2022,2022-2023
WY,2022-12-31,inter-ui,75,2,2,2,0,1,1,0,0,0,14,97,89,91,TRUE,0.917525773195876,2022,2022-2023
WY,2022-12-31,intra-total,583,44,13,2,7,4,4,0,0,1,116,774,699,743,TRUE,0.903100775193798,2022,2022-2023
WY,2022-12-31,intra-ucfe,20,1,1,0,0,1,0,0,0,0,7,30,27,28,TRUE,0.9,2022,2022-2023
WY,2022-12-31,intra-ucx,0,0,0,0,0,0,0,0,0,0,0,0,0,0,TRUE,0,2022,2022-2023
WY,2022-12-31,intra-ui,563,43,12,2,7,3,4,0,0,1,109,744,672,715,TRUE,0.903225806451613,2022,2022-2023
WY,2023-01-31,inter-total,102,7,7,3,0,0,2,1,0,1,20,143,122,129,TRUE,0.853146853146853,2022,2022-2023
WY,2023-01-31,inter-ucfe,7,2,0,0,0,0,0,1,0,0,10,20,17,19,TRUE,0.85,2022,2022-2023
WY,2023-01-31,inter-ucx,0,0,0,0,0,0,0,0,0,0,0,0,0,0,TRUE,0,2022,2022-2023
WY,2023-01-31,inter-ui,95,5,7,3,0,0,2,0,0,1,10,123,105,110,TRUE,0.853658536585366,2022,2022-2023
WY,2023-01-31,intra-total,851,38,15,9,4,2,3,1,2,6,144,1075,995,1033,TRUE,0.925581395348837,2022,2022-2023
WY,2023-01-31,intra-ucfe,6,2,1,2,2,0,0,0,0,0,5,18,11,13,TRUE,0.611111111111111,2022,2022-2023
WY,2023-01-31,intra-ucx,0,0,0,0,0,0,0,0,0,0,0,0,0,0,TRUE,0,2022,2022-2023
WY,2023-01-31,intra-ui,845,36,14,7,2,2,3,1,2,6,139,1057,984,1020,TRUE,0.930936613055818,2022,2022-2023
WY,2023-02-28,inter-total,66,4,3,3,2,2,0,0,0,0,22,102,88,92,TRUE,0.862745098039216,2022,2022-2023
WY,2023-02-28,inter-ucfe,6,0,1,0,0,1,0,0,0,0,3,11,9,9,TRUE,0.818181818181818,2022,2022-2023
WY,2023-02-28,inter-ucx,0,0,0,0,0,0,0,0,0,0,0,0,0,0,TRUE,0,2022,2022-2023
WY,2023-02-28,inter-ui,60,4,2,3,2,1,0,0,0,0,19,91,79,83,TRUE,0.868131868131868,2022,2022-2023
WY,2023-02-28,intra-total,501,33,15,6,2,3,2,3,1,6,114,686,615,648,TRUE,0.896501457725947,2022,2022-2023
WY,2023-02-28,intra-ucfe,7,1,1,0,0,0,0,0,0,0,4,13,11,12,TRUE,0.846153846153846,2022,2022-2023
WY,2023-02-28,intra-ucx,0,0,0,0,0,0,0,0,0,0,0,0,0,0,TRUE,0,2022,2022-2023
WY,2023-02-28,intra-ui,494,32,14,6,2,3,2,3,1,6,110,673,604,636,TRUE,0.897473997028232,2022,2022-2023
WY,2023-03-31,inter-total,53,4,5,1,1,2,0,0,1,0,12,79,65,69,TRUE,0.822784810126582,2022,2022-2023
WY,2023-03-31,inter-ucfe,3,0,0,1,0,1,0,0,0,0,2,7,5,5,TRUE,0.714285714285714,2022,2022-2023
WY,2023-03-31,inter-ucx,0,0,0,0,0,0,0,0,0,0,0,0,0,0,TRUE,0,2022,2022-2023
WY,2023-03-31,inter-ui,50,4,5,0,1,1,0,0,1,0,10,72,60,64,TRUE,0.833333333333333,2022,2022-2023
WY,2023-03-31,intra-total,393,34,16,6,4,1,1,1,1,3,103,563,496,530,TRUE,0.880994671403197,2022,2022-2023
WY,2023-03-31,intra-ucfe,3,2,0,1,0,0,0,0,0,0,0,6,3,5,TRUE,0.5,2022,2022-2023
WY,2023-03-31,intra-ucx,1,0,0,0,0,0,0,0,0,0,0,1,1,1,TRUE,1,2022,2022-2023
WY,2023-03-31,intra-ui,389,32,16,5,4,1,1,1,1,3,103,556,492,524,TRUE,0.884892086330935,2022,2022-2023
WY,2023-04-30,inter-total,57,4,3,0,0,1,0,0,0,2,10,77,67,71,TRUE,0.87012987012987,2022,2022-2023
WY,2023-04-30,inter-ucfe,9,1,1,0,0,1,0,0,0,0,3,15,12,13,TRUE,0.8,2022,2022-2023
WY,2023-04-30,inter-ucx,0,0,0,0,0,0,0,0,0,0,0,0,0,0,TRUE,0,2022,2022-2023
WY,2023-04-30,inter-ui,48,3,2,0,0,0,0,0,0,2,7,62,55,58,TRUE,0.887096774193548,2022,2022-2023
WY,2023-04-30,intra-total,363,23,7,5,7,1,1,0,0,3,90,500,453,476,TRUE,0.906,2022,2022-2023
WY,2023-04-30,intra-ucfe,5,2,0,0,0,0,0,0,0,0,4,11,9,11,TRUE,0.818181818181818,2022,2022-2023
WY,2023-04-30,intra-ucx,2,0,0,0,0,0,0,0,0,0,1,3,3,3,TRUE,1,2022,2022-2023
WY,2023-04-30,intra-ui,356,21,7,5,7,1,1,0,0,3,85,486,441,462,TRUE,0.907407407407407,2022,2022-2023
WY,2023-05-31,inter-total,50,11,7,4,1,0,0,0,0,4,19,96,69,80,TRUE,0.71875,2022,2022-2023
WY,2023-05-31,inter-ucfe,0,1,2,0,0,0,0,0,0,1,1,5,1,2,TRUE,0.2,2022,2022-2023
WY,2023-05-31,inter-ucx,0,0,0,0,0,0,0,0,0,0,0,0,0,0,TRUE,0,2022,2022-2023
WY,2023-05-31,inter-ui,50,10,5,4,1,0,0,0,0,3,18,91,68,78,TRUE,0.747252747252747,2022,2022-2023
WY,2023-05-31,intra-total,199,74,24,14,4,2,3,1,1,6,131,459,330,404,TRUE,0.718954248366013,2022,2022-2023
WY,2023-05-31,intra-ucfe,2,2,0,0,0,0,0,1,0,0,0,5,2,4,TRUE,0.4,2022,2022-2023
WY,2023-05-31,intra-ucx,0,0,0,0,0,0,0,0,0,0,0,0,0,0,TRUE,0,2022,2022-2023
WY,2023-05-31,intra-ui,197,72,24,14,4,2,3,0,1,6,131,454,328,400,TRUE,0.722466960352423,2022,2022-2023
WY,2023-06-30,inter-total,25,5,5,1,0,0,0,2,0,1,26,65,51,56,TRUE,0.784615384615385,2022,2022-2023
WY,2023-06-30,inter-ucfe,1,0,0,0,0,0,0,1,0,0,0,2,1,1,TRUE,0.5,2022,2022-2023
WY,2023-06-30,inter-ucx,1,0,0,0,0,0,0,0,0,0,0,1,1,1,TRUE,1,2022,2022-2023
WY,2023-06-30,inter-ui,23,5,5,1,0,0,0,1,0,1,26,62,49,54,TRUE,0.790322580645161,2022,2022-2023
WY,2023-06-30,intra-total,186,61,19,6,2,7,0,3,0,5,145,434,331,392,TRUE,0.762672811059908,2022,2022-2023
WY,2023-06-30,intra-ucfe,0,0,0,0,0,0,0,0,0,0,0,0,0,0,TRUE,0,2022,2022-2023
WY,2023-06-30,intra-ucx,1,0,0,1,0,0,0,0,0,0,0,2,1,1,TRUE,0.5,2022,2022-2023
WY,2023-06-30,intra-ui,185,61,19,5,2,7,0,3,0,5,145,432,330,391,TRUE,0.763888888888889,2022,2022-2023
WY,2023-07-31,inter-total,35,8,2,1,0,1,1,1,0,2,20,71,55,63,TRUE,0.774647887323944,2023,2023-2024
WY,2023-07-31,inter-ucfe,0,0,0,0,0,0,0,0,0,0,0,0,0,0,TRUE,0,2023,2023-2024
WY,2023-07-31,inter-ucx,0,0,0,0,0,0,1,0,0,0,0,1,0,0,TRUE,0,2023,2023-2024
WY,2023-07-31,inter-ui,35,8,2,1,0,1,0,1,0,2,20,70,55,63,TRUE,0.785714285714286,2023,2023-2024
WY,2023-07-31,intra-total,172,69,11,6,3,3,0,0,1,5,112,382,284,353,TRUE,0.743455497382199,2023,2023-2024
WY,2023-07-31,intra-ucfe,0,0,0,0,0,0,0,0,0,0,0,0,0,0,TRUE,0,2023,2023-2024
WY,2023-07-31,intra-ucx,1,1,0,0,0,0,0,0,0,0,0,2,1,2,TRUE,0.5,2023,2023-2024
WY,2023-07-31,intra-ui,171,68,11,6,3,3,0,0,1,5,112,380,283,351,TRUE,0.744736842105263,2023,2023-2024
WY,2023-08-31,inter-total,23,5,1,0,2,0,0,0,0,0,18,49,41,46,TRUE,0.836734693877551,2023,2023-2024
WY,2023-08-31,inter-ucfe,0,0,0,0,1,0,0,0,0,0,1,2,1,1,TRUE,0.5,2023,2023-2024
WY,2023-08-31,inter-ucx,0,0,0,0,0,0,0,0,0,0,0,0,0,0,TRUE,0,2023,2023-2024
WY,2023-08-31,inter-ui,23,5,1,0,1,0,0,0,0,0,17,47,40,45,TRUE,0.851063829787234,2023,2023-2024
WY,2023-08-31,intra-total,137,56,19,1,2,5,1,1,1,9,124,356,261,317,TRUE,0.73314606741573,2023,2023-2024
WY,2023-08-31,intra-ucfe,0,0,0,0,0,0,0,0,0,0,3,3,3,3,TRUE,1,2023,2023-2024
WY,2023-08-31,intra-ucx,3,0,0,0,0,0,0,0,0,0,0,3,3,3,TRUE,1,2023,2023-2024
WY,2023-08-31,intra-ui,134,56,19,1,2,5,1,1,1,9,121,350,255,311,TRUE,0.728571428571429,2023,2023-2024
WY,2023-09-30,inter-total,12,5,5,3,2,0,0,0,0,2,12,41,24,29,TRUE,0.585365853658537,2023,2023-2024
WY,2023-09-30,inter-ucfe,0,0,0,0,0,0,0,0,0,0,0,0,0,0,TRUE,0,2023,2023-2024
WY,2023-09-30,inter-ucx,0,0,0,0,0,0,0,0,0,0,0,0,0,0,TRUE,0,2023,2023-2024
WY,2023-09-30,inter-ui,12,5,5,3,2,0,0,0,0,2,12,41,24,29,TRUE,0.585365853658537,2023,2023-2024
WY,2023-09-30,intra-total,106,64,14,4,1,2,2,2,1,4,100,300,206,270,TRUE,0.686666666666667,2023,2023-2024
WY,2023-09-30,intra-ucfe,0,0,0,0,0,0,0,0,0,0,0,0,0,0,TRUE,0,2023,2023-2024
WY,2023-09-30,intra-ucx,0,2,0,0,0,0,0,0,0,0,0,2,0,2,TRUE,0,2023,2023-2024
WY,2023-09-30,intra-ui,106,62,14,4,1,2,2,2,1,4,100,298,206,268,TRUE,0.691275167785235,2023,2023-2024
WY,2023-10-31,inter-total,108,15,5,2,2,3,0,0,0,2,62,199,170,185,TRUE,0.85427135678392,2023,2023-2024
WY,2023-10-31,inter-ucfe,1,2,1,0,0,0,0,0,0,0,4,8,5,7,TRUE,0.625,2023,2023-2024
WY,2023-10-31,inter-ucx,0,0,0,0,0,0,0,0,0,0,0,0,0,0,TRUE,0,2023,2023-2024
WY,2023-10-31,inter-ui,107,13,4,2,2,3,0,0,0,2,58,191,165,178,TRUE,0.863874345549738,2023,2023-2024
WY,2023-10-31,intra-total,246,62,10,5,1,2,1,0,1,3,146,477,392,454,TRUE,0.821802935010482,2023,2023-2024
WY,2023-10-31,intra-ucfe,1,2,1,0,0,0,0,0,0,1,0,5,1,3,TRUE,0.2,2023,2023-2024
WY,2023-10-31,intra-ucx,0,0,0,0,0,0,0,0,1,0,2,3,2,2,TRUE,0.666666666666667,2023,2023-2024
WY,2023-10-31,intra-ui,245,60,9,5,1,2,1,0,0,2,144,469,389,449,TRUE,0.829424307036247,2023,2023-2024
WY,2023-11-30,inter-total,129,23,7,4,2,0,0,0,0,1,58,224,187,210,TRUE,0.834821428571429,2023,2023-2024
WY,2023-11-30,inter-ucfe,3,4,1,0,1,0,0,0,0,0,6,15,9,13,TRUE,0.6,2023,2023-2024
WY,2023-11-30,inter-ucx,0,0,0,0,0,0,0,0,0,0,0,0,0,0,TRUE,0,2023,2023-2024
WY,2023-11-30,inter-ui,126,19,6,4,1,0,0,0,0,1,52,209,178,197,TRUE,0.851674641148325,2023,2023-2024
WY,2023-11-30,intra-total,350,79,24,6,4,1,0,0,0,4,191,659,541,620,TRUE,0.820940819423369,2023,2023-2024
WY,2023-11-30,intra-ucfe,5,2,0,0,1,0,0,0,0,0,15,23,20,22,TRUE,0.869565217391304,2023,2023-2024
WY,2023-11-30,intra-ucx,0,1,0,0,0,0,0,0,0,0,0,1,0,1,TRUE,0,2023,2023-2024
WY,2023-11-30,intra-ui,345,76,24,6,3,1,0,0,0,4,176,635,521,597,TRUE,0.820472440944882,2023,2023-2024
WY,2023-12-31,inter-total,74,19,6,1,1,3,3,1,0,1,44,153,118,137,TRUE,0.77124183006536,2023,2023-2024
WY,2023-12-31,inter-ucfe,6,3,0,0,0,1,1,1,0,0,10,22,16,19,TRUE,0.727272727272727,2023,2023-2024
WY,2023-12-31,inter-ucx,0,0,0,0,0,0,0,0,0,0,0,0,0,0,TRUE,0,2023,2023-2024
WY,2023-12-31,inter-ui,68,16,6,1,1,2,2,0,0,1,34,131,102,118,TRUE,0.778625954198473,2023,2023-2024
WY,2023-12-31,intra-total,491,66,21,7,5,5,2,2,0,4,189,792,680,746,TRUE,0.858585858585859,2023,2023-2024
WY,2023-12-31,intra-ucfe,5,2,2,0,0,0,0,0,0,0,19,28,24,26,TRUE,0.857142857142857,2023,2023-2024
WY,2023-12-31,intra-ucx,0,0,0,0,0,0,0,0,0,0,1,1,1,1,TRUE,1,2023,2023-2024
WY,2023-12-31,intra-ui,486,64,19,7,5,5,2,2,0,4,169,763,655,719,TRUE,0.858453473132372,2023,2023-2024
WY,2024-01-31,inter-total,95,8,4,2,0,1,1,1,0,3,53,168,148,156,TRUE,0.880952380952381,2023,2023-2024
WY,2024-01-31,inter-ucfe,6,0,1,0,0,1,0,0,0,0,9,17,15,15,TRUE,0.882352941176471,2023,2023-2024
WY,2024-01-31,inter-ucx,0,0,0,0,0,0,0,0,0,0,0,0,0,0,TRUE,0,2023,2023-2024
WY,2024-01-31,inter-ui,89,8,3,2,0,0,1,1,0,3,44,151,133,141,TRUE,0.880794701986755,2023,2023-2024
WY,2024-01-31,intra-total,859,93,26,8,7,6,4,4,3,6,255,1271,1114,1207,TRUE,0.876475216365067,2023,2023-2024
WY,2024-01-31,intra-ucfe,4,0,0,0,0,0,0,0,0,0,7,11,11,11,TRUE,1,2023,2023-2024
WY,2024-01-31,intra-ucx,0,1,0,0,0,0,0,0,0,0,0,1,0,1,TRUE,0,2023,2023-2024
WY,2024-01-31,intra-ui,855,92,26,8,7,6,4,4,3,6,248,1259,1103,1195,TRUE,0.876092136616362,2023,2023-2024
WY,2024-02-29,inter-total,38,14,5,2,1,0,1,2,1,0,24,88,62,76,TRUE,0.704545454545455,2023,2023-2024
WY,2024-02-29,inter-ucfe,1,1,1,0,1,0,0,0,0,0,8,12,9,10,TRUE,0.75,2023,2023-2024
WY,2024-02-29,inter-ucx,0,0,0,0,0,0,0,0,0,0,0,0,0,0,TRUE,0,2023,2023-2024
WY,2024-02-29,inter-ui,37,13,4,2,0,0,1,2,1,0,16,76,53,66,TRUE,0.697368421052632,2023,2023-2024
WY,2024-02-29,intra-total,325,86,17,7,8,7,0,0,0,6,202,658,527,613,TRUE,0.800911854103343,2023,2023-2024
WY,2024-02-29,intra-ucfe,2,2,0,0,1,1,0,0,0,0,6,12,8,10,TRUE,0.666666666666667,2023,2023-2024
WY,2024-02-29,intra-ucx,0,1,0,0,0,0,0,0,0,0,2,3,2,3,TRUE,0.666666666666667,2023,2023-2024
WY,2024-02-29,intra-ui,323,83,17,7,7,6,0,0,0,6,194,643,517,600,TRUE,0.804043545878694,2023,2023-2024
WY,2024-03-31,inter-total,60,9,3,1,1,0,0,0,0,0,20,94,80,89,TRUE,0.851063829787234,2023,2023-2024
WY,2024-03-31,inter-ucfe,5,0,0,0,0,0,0,0,0,0,3,8,8,8,TRUE,1,2023,2023-2024
WY,2024-03-31,inter-ucx,0,0,0,0,0,0,0,0,0,0,0,0,0,0,TRUE,0,2023,2023-2024
WY,2024-03-31,inter-ui,55,9,3,1,1,0,0,0,0,0,17,86,72,81,TRUE,0.837209302325582,2023,2023-2024
WY,2024-03-31,intra-total,211,67,27,10,2,4,6,0,2,3,152,484,363,430,TRUE,0.75,2023,2023-2024
WY,2024-03-31,intra-ucfe,5,2,2,0,0,0,0,0,0,0,4,13,9,11,TRUE,0.692307692307692,2023,2023-2024
WY,2024-03-31,intra-ucx,0,0,0,0,0,0,1,0,0,0,1,2,1,1,TRUE,0.5,2023,2023-2024
WY,2024-03-31,intra-ui,206,65,25,10,2,4,5,0,2,3,147,469,353,418,TRUE,0.752665245202559,2023,2023-2024
WY,2024-04-30,inter-total,54,6,3,3,1,0,0,0,0,1,27,95,81,87,TRUE,0.852631578947369,2023,2023-2024
WY,2024-04-30,inter-ucfe,2,1,0,0,0,0,0,0,0,0,4,7,6,7,TRUE,0.857142857142857,2023,2023-2024
WY,2024-04-30,inter-ucx,0,0,0,0,0,0,0,0,0,0,0,0,0,0,TRUE,0,2023,2023-2024
WY,2024-04-30,inter-ui,52,5,3,3,1,0,0,0,0,1,23,88,75,80,TRUE,0.852272727272727,2023,2023-2024
WY,2024-04-30,intra-total,347,73,12,4,7,3,0,0,2,9,151,608,498,571,TRUE,0.819078947368421,2023,2023-2024
WY,2024-04-30,intra-ucfe,3,0,2,0,0,0,0,0,0,2,6,13,9,9,TRUE,0.692307692307692,2023,2023-2024
WY,2024-04-30,intra-ucx,2,0,0,1,0,0,0,0,0,0,0,3,2,2,TRUE,0.666666666666667,2023,2023-2024
WY,2024-04-30,intra-ui,342,73,10,3,7,3,0,0,2,7,145,592,487,560,TRUE,0.822635135135135,2023,2023-2024
WY,2024-05-31,inter-total,45,8,3,1,2,0,0,1,0,0,27,87,72,80,TRUE,0.827586206896552,2023,2023-2024
WY,2024-05-31,inter-ucfe,0,1,0,0,1,0,0,0,0,0,2,4,2,3,TRUE,0.5,2023,2023-2024
WY,2024-05-31,inter-ucx,0,0,0,0,0,0,0,0,0,0,0,0,0,0,TRUE,0,2023,2023-2024
WY,2024-05-31,inter-ui,45,7,3,1,1,0,0,1,0,0,25,83,70,77,TRUE,0.843373493975904,2023,2023-2024
WY,2024-05-31,intra-total,220,53,12,7,5,4,1,2,2,7,137,450,357,410,TRUE,0.793333333333333,2023,2023-2024
WY,2024-05-31,intra-ucfe,2,0,0,0,1,0,0,0,1,0,1,5,3,3,TRUE,0.6,2023,2023-2024
WY,2024-05-31,intra-ucx,0,0,0,0,0,0,0,0,0,0,0,0,0,0,TRUE,0,2023,2023-2024
WY,2024-05-31,intra-ui,218,53,12,7,4,4,1,2,1,7,136,445,354,407,TRUE,0.795505617977528,2023,2023-2024
WY,2024-06-30,inter-total,32,2,4,1,0,0,0,0,0,2,18,59,50,52,TRUE,0.847457627118644,2023,2023-2024
WY,2024-06-30,inter-ucfe,0,0,0,0,0,0,0,0,0,0,0,0,0,0,TRUE,0,2023,2023-2024
WY,2024-06-30,inter-ucx,0,0,0,0,0,0,0,0,0,0,0,0,0,0,TRUE,0,2023,2023-2024
WY,2024-06-30,inter-ui,32,2,4,1,0,0,0,0,0,2,18,59,50,52,TRUE,0.847457627118644,2023,2023-2024
WY,2024-06-30,intra-total,228,51,11,3,1,1,3,2,0,3,128,431,356,407,TRUE,0.825986078886311,2023,2023-2024
WY,2024-06-30,intra-ucfe,0,1,0,0,0,0,0,0,0,1,0,2,0,1,TRUE,0,2023,2023-2024
WY,2024-06-30,intra-ucx,0,0,0,1,0,0,0,0,0,0,0,1,0,0,TRUE,0,2023,2023-2024
WY,2024-06-30,intra-ui,228,50,11,2,1,1,3,2,0,2,128,428,356,406,TRUE,0.831775700934579,2023,2023-2024
WY,2024-07-31,inter-total,29,11,1,0,1,0,0,0,0,1,18,61,47,58,TRUE,0.770491803278689,2024,2024-2025
WY,2024-07-31,inter-ucfe,0,1,0,0,0,0,0,0,0,0,0,1,0,1,TRUE,0,2024,2024-2025
WY,2024-07-31,inter-ucx,0,0,0,0,0,0,0,0,0,0,0,0,0,0,TRUE,0,2024,2024-2025
WY,2024-07-31,inter-ui,29,10,1,0,1,0,0,0,0,1,18,60,47,57,TRUE,0.783333333333333,2024,2024-2025
WY,2024-07-31,intra-total,196,58,22,5,2,5,1,1,0,4,114,408,310,368,TRUE,0.759803921568627,2024,2024-2025
WY,2024-07-31,intra-ucfe,2,0,0,0,0,0,0,0,0,0,1,3,3,3,TRUE,1,2024,2024-2025
WY,2024-07-31,intra-ucx,0,0,0,0,0,0,0,0,0,0,0,0,0,0,TRUE,0,2024,2024-2025
WY,2024-07-31,intra-ui,194,58,22,5,2,5,1,1,0,4,113,405,307,365,TRUE,0.758024691358025,2024,2024-2025
WY,2024-08-31,inter-total,20,6,4,1,1,0,0,0,0,1,14,47,34,40,TRUE,0.723404255319149,2024,2024-2025
WY,2024-08-31,inter-ucfe,0,0,0,0,0,0,0,0,0,1,1,2,1,1,TRUE,0.5,2024,2024-2025
WY,2024-08-31,inter-ucx,0,0,0,0,0,0,0,0,0,0,0,0,0,0,TRUE,0,2024,2024-2025
WY,2024-08-31,inter-ui,20,6,4,1,1,0,0,0,0,0,13,45,33,39,TRUE,0.733333333333333,2024,2024-2025
WY,2024-08-31,intra-total,126,62,18,6,2,4,1,1,3,10,112,345,238,300,TRUE,0.689855072463768,2024,2024-2025
WY,2024-08-31,intra-ucfe,0,0,0,0,0,0,0,0,0,1,0,1,0,0,TRUE,0,2024,2024-2025
WY,2024-08-31,intra-ucx,0,0,0,0,0,0,0,0,0,0,0,0,0,0,TRUE,0,2024,2024-2025
WY,2024-08-31,intra-ui,126,62,18,6,2,4,1,1,3,9,112,344,238,300,TRUE,0.691860465116279,2024,2024-2025
WY,2024-09-30,inter-total,18,2,2,0,1,0,0,0,0,2,17,42,35,37,TRUE,0.833333333333333,2024,2024-2025
WY,2024-09-30,inter-ucfe,1,0,0,0,0,0,0,0,0,0,0,1,1,1,TRUE,1,2024,2024-2025
WY,2024-09-30,inter-ucx,0,0,0,0,0,0,0,0,0,0,0,0,0,0,TRUE,0,2024,2024-2025
WY,2024-09-30,inter-ui,17,2,2,0,1,0,0,0,0,2,17,41,34,36,TRUE,0.829268292682927,2024,2024-2025
WY,2024-09-30,intra-total,122,43,18,3,4,3,4,2,0,7,121,327,243,286,TRUE,0.743119266055046,2024,2024-2025
WY,2024-09-30,intra-ucfe,1,0,0,0,0,0,0,0,0,0,1,2,2,2,TRUE,1,2024,2024-2025
WY,2024-09-30,intra-ucx,0,1,0,0,0,0,0,0,0,0,0,1,0,1,TRUE,0,2024,2024-2025
WY,2024-09-30,intra-ui,121,42,18,3,4,3,4,2,0,7,120,324,241,283,TRUE,0.743827160493827,2024,2024-2025
WY,2024-10-31,inter-total,114,13,0,0,0,0,1,1,0,0,39,168,153,166,TRUE,0.910714285714286,2024,2024-2025
WY,2024-10-31,inter-ucfe,4,0,0,0,0,0,0,1,0,0,4,9,8,8,TRUE,0.888888888888889,2024,2024-2025
WY,2024-10-31,inter-ucx,0,0,0,0,0,0,0,0,0,0,0,0,0,0,TRUE,0,2024,2024-2025
WY,2024-10-31,inter-ui,110,13,0,0,0,0,1,0,0,0,35,159,145,158,TRUE,0.911949685534591,2024,2024-2025
WY,2024-10-31,intra-total,323,73,16,3,5,2,3,1,0,9,140,575,463,536,TRUE,0.805217391304348,2024,2024-2025
WY,2024-10-31,intra-ucfe,2,0,0,0,0,0,0,1,0,0,0,3,2,2,TRUE,0.666666666666667,2024,2024-2025
WY,2024-10-31,intra-ucx,0,0,1,0,0,0,0,0,0,0,0,1,0,0,TRUE,0,2024,2024-2025
WY,2024-10-31,intra-ui,321,73,15,3,5,2,3,0,0,9,140,571,461,534,TRUE,0.807355516637478,2024,2024-2025
WY,2024-11-30,inter-total,147,19,9,3,3,1,0,0,2,0,73,257,220,239,TRUE,0.856031128404669,2024,2024-2025
WY,2024-11-30,inter-ucfe,5,0,1,2,0,0,0,0,0,0,13,21,18,18,TRUE,0.857142857142857,2024,2024-2025
WY,2024-11-30,inter-ucx,0,0,0,0,0,0,0,0,0,0,0,0,0,0,TRUE,0,2024,2024-2025
WY,2024-11-30,inter-ui,142,19,8,1,3,1,0,0,2,0,60,236,202,221,TRUE,0.855932203389831,2024,2024-2025
WY,2024-11-30,intra-total,407,87,28,6,0,1,3,0,2,2,193,729,600,687,TRUE,0.823045267489712,2024,2024-2025
WY,2024-11-30,intra-ucfe,6,1,0,0,0,0,0,0,0,0,15,22,21,22,TRUE,0.954545454545455,2024,2024-2025
WY,2024-11-30,intra-ucx,0,0,0,0,0,0,0,0,0,0,0,0,0,0,TRUE,0,2024,2024-2025
WY,2024-11-30,intra-ui,401,86,28,6,0,1,3,0,2,2,178,707,579,665,TRUE,0.818953323903819,2024,2024-2025
WY,2024-12-31,inter-total,83,21,8,3,3,0,1,0,0,1,55,175,138,159,TRUE,0.788571428571429,2024,2024-2025
WY,2024-12-31,inter-ucfe,4,4,1,0,0,0,0,0,0,0,16,25,20,24,TRUE,0.8,2024,2024-2025
WY,2024-12-31,inter-ucx,0,0,0,0,0,0,0,0,0,0,0,0,0,0,TRUE,0,2024,2024-2025
WY,2024-12-31,inter-ui,79,17,7,3,3,0,1,0,0,1,39,150,118,135,TRUE,0.786666666666667,2024,2024-2025
WY,2024-12-31,intra-total,581,96,36,11,5,5,1,2,0,1,215,953,796,892,TRUE,0.835257082896118,2024,2024-2025
WY,2024-12-31,intra-ucfe,15,3,2,0,0,1,0,0,0,0,14,35,29,32,TRUE,0.828571428571429,2024,2024-2025
WY,2024-12-31,intra-ucx,0,0,0,0,0,0,0,0,0,0,0,0,0,0,TRUE,0,2024,2024-2025
WY,2024-12-31,intra-ui,566,93,34,11,5,4,1,2,0,1,201,918,767,860,TRUE,0.835511982570806,2024,2024-2025
